FIPS,state,county,year,labor_force,employed,unemployed,urate
"01001",1,1,1990,16908,15813,1095,6.5
"01001",1,1,1991,16928,15777,1151,6.8
"01001",1,1,1992,17656,16500,1156,6.5
"01001",1,1,1993,18234,17139,1095,6
"01001",1,1,1994,18820,17874,946,5
"01001",1,1,1995,19647,18515,1132,5.8
"01001",1,1,1996,20214,19422,792,3.9
"01001",1,1,1997,21098,20269,829,3.9
"01001",1,1,1998,21628,20947,681,3.1
"01001",1,1,1999,22433,21577,856,3.8
"01001",1,1,2000,21720,20846,874,4
"01001",1,1,2001,21955,21055,900,4.1
"01001",1,1,2002,22094,21035,1059,4.8
"01001",1,1,2003,22604,21462,1142,5.1
"01001",1,1,2004,23218,22103,1115,4.8
"01001",1,1,2005,23949,23037,912,3.8
"01001",1,1,2006,24398,23585,813,3.3
"01001",1,1,2007,24383,23577,806,3.3
"01001",1,1,2008,24687,23420,1267,5.1
"01001",1,1,2009,24703,22301,2402,9.7
"01001",1,1,2010,25713,23431,2282,8.9
"01001",1,1,2011,25836,23677,2159,8.4
"01001",1,1,2012,25740,23961,1779,6.9
"01001",1,1,2013,25810,24205,1605,6.2
"01001",1,1,2014,25602,24107,1495,5.8
"01001",1,1,2015,25602,24272,1330,5.2
"01001",1,1,2016,25918,24593,1325,5.1
"01001",1,1,2017,25909,24908,1001,3.9
"01003",1,3,1990,46824,44379,2445,5.2
"01003",1,3,1991,49426,46695,2731,5.5
"01003",1,3,1992,52209,48921,3288,6.3
"01003",1,3,1993,55079,51755,3324,6
"01003",1,3,1994,57891,55071,2820,4.9
"01003",1,3,1995,60820,57883,2937,4.8
"01003",1,3,1996,63829,60981,2848,4.5
"01003",1,3,1997,67150,64799,2351,3.5
"01003",1,3,1998,69285,67354,1931,2.8
"01003",1,3,1999,70912,68556,2356,3.3
"01003",1,3,2000,69533,66971,2562,3.7
"01003",1,3,2001,69161,66195,2966,4.3
"01003",1,3,2002,69169,65691,3478,5
"01003",1,3,2003,72299,68702,3597,5
"01003",1,3,2004,74772,70919,3853,5.2
"01003",1,3,2005,76804,73743,3061,4
"01003",1,3,2006,79711,77147,2564,3.2
"01003",1,3,2007,82659,80099,2560,3.1
"01003",1,3,2008,83223,79372,3851,4.6
"01003",1,3,2009,82451,74403,8048,9.8
"01003",1,3,2010,83459,75120,8339,10
"01003",1,3,2011,85045,77418,7627,9
"01003",1,3,2012,84414,78065,6349,7.5
"01003",1,3,2013,85280,79626,5654,6.6
"01003",1,3,2014,86415,81115,5300,6.1
"01003",1,3,2015,87705,82843,4862,5.5
"01003",1,3,2016,90500,85656,4844,5.4
"01003",1,3,2017,91567,87915,3652,4
"01005",1,5,1990,11490,10592,898,7.8
"01005",1,5,1991,11628,10608,1020,8.8
"01005",1,5,1992,11613,10358,1255,10.8
"01005",1,5,1993,12004,10788,1216,10.1
"01005",1,5,1994,12103,11324,779,6.4
"01005",1,5,1995,12360,11329,1031,8.3
"01005",1,5,1996,12488,11291,1197,9.6
"01005",1,5,1997,12484,11565,919,7.4
"01005",1,5,1998,12826,12201,625,4.9
"01005",1,5,1999,13364,12720,644,4.8
"01005",1,5,2000,11373,10748,625,5.5
"01005",1,5,2001,11250,10412,838,7.4
"01005",1,5,2002,10971,10125,846,7.7
"01005",1,5,2003,10977,10196,781,7.1
"01005",1,5,2004,10633,9865,768,7.2
"01005",1,5,2005,10760,10136,624,5.8
"01005",1,5,2006,10705,10096,609,5.7
"01005",1,5,2007,10334,9684,650,6.3
"01005",1,5,2008,10161,9267,894,8.8
"01005",1,5,2009,10003,8572,1431,14.3
"01005",1,5,2010,10221,8959,1262,12.3
"01005",1,5,2011,9849,8712,1137,11.5
"01005",1,5,2012,9362,8283,1079,11.5
"01005",1,5,2013,9099,8168,931,10.2
"01005",1,5,2014,8848,7916,932,10.5
"01005",1,5,2015,8609,7844,765,8.9
"01005",1,5,2016,8402,7700,702,8.4
"01005",1,5,2017,8236,7750,486,5.9
"01007",1,7,1990,7434,6758,676,9.1
"01007",1,7,1991,7520,6627,893,11.9
"01007",1,7,1992,7990,7101,889,11.1
"01007",1,7,1993,7734,6833,901,11.6
"01007",1,7,1994,7721,7125,596,7.7
"01007",1,7,1995,7993,7461,532,6.7
"01007",1,7,1996,7870,7307,563,7.2
"01007",1,7,1997,8039,7436,603,7.5
"01007",1,7,1998,7755,7211,544,7
"01007",1,7,1999,7186,6695,491,6.8
"01007",1,7,2000,8565,8111,454,5.3
"01007",1,7,2001,9081,8468,613,6.8
"01007",1,7,2002,8933,8309,624,7
"01007",1,7,2003,8836,8309,527,6
"01007",1,7,2004,8843,8359,484,5.5
"01007",1,7,2005,8861,8463,398,4.5
"01007",1,7,2006,8850,8477,373,4.2
"01007",1,7,2007,8791,8432,359,4.1
"01007",1,7,2008,8749,8241,508,5.8
"01007",1,7,2009,8742,7581,1161,13.3
"01007",1,7,2010,8934,7914,1020,11.4
"01007",1,7,2011,8933,7996,937,10.5
"01007",1,7,2012,8798,8047,751,8.5
"01007",1,7,2013,8705,8016,689,7.9
"01007",1,7,2014,8562,7945,617,7.2
"01007",1,7,2015,8572,8005,567,6.6
"01007",1,7,2016,8607,8050,557,6.5
"01007",1,7,2017,8506,8133,373,4.4
"01009",1,9,1990,19168,17955,1213,6.3
"01009",1,9,1991,19132,18021,1111,5.8
"01009",1,9,1992,19553,18334,1219,6.2
"01009",1,9,1993,19929,18868,1061,5.3
"01009",1,9,1994,20263,19408,855,4.2
"01009",1,9,1995,20993,20055,938,4.5
"01009",1,9,1996,21631,20918,713,3.3
"01009",1,9,1997,22684,22003,681,3
"01009",1,9,1998,23611,22839,772,3.3
"01009",1,9,1999,23968,23297,671,2.8
"01009",1,9,2000,25106,24231,875,3.5
"01009",1,9,2001,25305,24393,912,3.6
"01009",1,9,2002,25757,24366,1391,5.4
"01009",1,9,2003,25900,24702,1198,4.6
"01009",1,9,2004,26208,25101,1107,4.2
"01009",1,9,2005,26446,25491,955,3.6
"01009",1,9,2006,26770,25902,868,3.2
"01009",1,9,2007,26629,25780,849,3.2
"01009",1,9,2008,26698,25453,1245,4.7
"01009",1,9,2009,26480,23832,2648,10
"01009",1,9,2010,24906,22460,2446,9.8
"01009",1,9,2011,25123,22939,2184,8.7
"01009",1,9,2012,24960,23244,1716,6.9
"01009",1,9,2013,24887,23325,1562,6.3
"01009",1,9,2014,24535,23032,1503,6.1
"01009",1,9,2015,24473,23152,1321,5.4
"01009",1,9,2016,24576,23248,1328,5.4
"01009",1,9,2017,24494,23509,985,4
"01011",1,11,1990,4407,3859,548,12.4
"01011",1,11,1991,4544,3688,856,18.8
"01011",1,11,1992,4303,3658,645,15
"01011",1,11,1993,4175,3555,620,14.9
"01011",1,11,1994,4264,3650,614,14.4
"01011",1,11,1995,4456,3704,752,16.9
"01011",1,11,1996,4552,3883,669,14.7
"01011",1,11,1997,4586,4108,478,10.4
"01011",1,11,1998,4552,4076,476,10.5
"01011",1,11,1999,4455,4009,446,10
"01011",1,11,2000,3971,3635,336,8.5
"01011",1,11,2001,3912,3524,388,9.9
"01011",1,11,2002,3877,3483,394,10.2
"01011",1,11,2003,3979,3540,439,11
"01011",1,11,2004,3880,3430,450,11.6
"01011",1,11,2005,3747,3391,356,9.5
"01011",1,11,2006,3702,3372,330,8.9
"01011",1,11,2007,3653,3308,345,9.4
"01011",1,11,2008,3634,3251,383,10.5
"01011",1,11,2009,3739,3156,583,15.6
"01011",1,11,2010,4941,4356,585,11.8
"01011",1,11,2011,4833,4272,561,11.6
"01011",1,11,2012,4736,4245,491,10.4
"01011",1,11,2013,4778,4331,447,9.4
"01011",1,11,2014,4733,4315,418,8.8
"01011",1,11,2015,4777,4398,379,7.9
"01011",1,11,2016,4824,4493,331,6.9
"01011",1,11,2017,4812,4575,237,4.9
"01013",1,13,1990,8838,7705,1133,12.8
"01013",1,13,1991,8709,7648,1061,12.2
"01013",1,13,1992,8921,7832,1089,12.2
"01013",1,13,1993,9217,8208,1009,10.9
"01013",1,13,1994,9533,8672,861,9
"01013",1,13,1995,10023,9168,855,8.5
"01013",1,13,1996,9950,9031,919,9.2
"01013",1,13,1997,9918,8940,978,9.9
"01013",1,13,1998,10020,8921,1099,11
"01013",1,13,1999,9873,8520,1353,13.7
"01013",1,13,2000,9156,8445,711,7.8
"01013",1,13,2001,9003,8328,675,7.5
"01013",1,13,2002,9144,8424,720,7.9
"01013",1,13,2003,9183,8386,797,8.7
"01013",1,13,2004,9088,8224,864,9.5
"01013",1,13,2005,9139,8547,592,6.5
"01013",1,13,2006,9238,8709,529,5.7
"01013",1,13,2007,9099,8539,560,6.2
"01013",1,13,2008,9051,8278,773,8.5
"01013",1,13,2009,9104,7615,1489,16.4
"01013",1,13,2010,9261,7998,1263,13.6
"01013",1,13,2011,9188,8042,1146,12.5
"01013",1,13,2012,9088,8039,1049,11.5
"01013",1,13,2013,9147,8206,941,10.3
"01013",1,13,2014,9272,8480,792,8.5
"01013",1,13,2015,9134,8440,694,7.6
"01013",1,13,2016,9190,8553,637,6.9
"01013",1,13,2017,8946,8455,491,5.5
"01015",1,15,1990,51519,47840,3679,7.1
"01015",1,15,1991,52124,48128,3996,7.7
"01015",1,15,1992,53226,48479,4747,8.9
"01015",1,15,1993,52826,48203,4623,8.8
"01015",1,15,1994,52317,48212,4105,7.8
"01015",1,15,1995,53449,49215,4234,7.9
"01015",1,15,1996,52807,49495,3312,6.3
"01015",1,15,1997,54241,51234,3007,5.5
"01015",1,15,1998,54358,51803,2555,4.7
"01015",1,15,1999,54364,51588,2776,5.1
"01015",1,15,2000,52896,50223,2673,5.1
"01015",1,15,2001,51578,48744,2834,5.5
"01015",1,15,2002,51952,48851,3101,6
"01015",1,15,2003,52817,49673,3144,6
"01015",1,15,2004,54026,51065,2961,5.5
"01015",1,15,2005,53955,51524,2431,4.5
"01015",1,15,2006,54063,51872,2191,4.1
"01015",1,15,2007,54861,52709,2152,3.9
"01015",1,15,2008,54564,51468,3096,5.7
"01015",1,15,2009,53925,47929,5996,11.1
"01015",1,15,2010,51559,45699,5860,11.4
"01015",1,15,2011,51268,45963,5305,10.3
"01015",1,15,2012,49649,45252,4397,8.9
"01015",1,15,2013,48405,44163,4242,8.8
"01015",1,15,2014,47257,43484,3773,8
"01015",1,15,2015,45910,42679,3231,7
"01015",1,15,2016,45818,42815,3003,6.6
"01015",1,15,2017,45582,43333,2249,4.9
"01017",1,17,1990,17705,16432,1273,7.2
"01017",1,17,1991,17542,15787,1755,10
"01017",1,17,1992,17252,15875,1377,8
"01017",1,17,1993,17472,15787,1685,9.6
"01017",1,17,1994,16996,15597,1399,8.2
"01017",1,17,1995,17161,15885,1276,7.4
"01017",1,17,1996,16802,15932,870,5.2
"01017",1,17,1997,17033,16245,788,4.6
"01017",1,17,1998,16870,16162,708,4.2
"01017",1,17,1999,16448,15674,774,4.7
"01017",1,17,2000,17373,16610,763,4.4
"01017",1,17,2001,17424,16481,943,5.4
"01017",1,17,2002,17158,16010,1148,6.7
"01017",1,17,2003,16829,15745,1084,6.4
"01017",1,17,2004,16607,15438,1169,7
"01017",1,17,2005,16353,15413,940,5.7
"01017",1,17,2006,15749,14828,921,5.8
"01017",1,17,2007,15474,14469,1005,6.5
"01017",1,17,2008,15012,12848,2164,14.4
"01017",1,17,2009,14650,11777,2873,19.6
"01017",1,17,2010,14754,12554,2200,14.9
"01017",1,17,2011,15200,13380,1820,12
"01017",1,17,2012,15140,13646,1494,9.9
"01017",1,17,2013,15275,14058,1217,8
"01017",1,17,2014,15307,14282,1025,6.7
"01017",1,17,2015,14975,14069,906,6.1
"01017",1,17,2016,14978,14158,820,5.5
"01017",1,17,2017,15176,14557,619,4.1
"01019",1,19,1990,9644,8693,951,9.9
"01019",1,19,1991,9610,8786,824,8.6
"01019",1,19,1992,9569,8886,683,7.1
"01019",1,19,1993,9683,9075,608,6.3
"01019",1,19,1994,9973,9347,626,6.3
"01019",1,19,1995,10157,9511,646,6.4
"01019",1,19,1996,10486,10023,463,4.4
"01019",1,19,1997,10737,10298,439,4.1
"01019",1,19,1998,10282,9839,443,4.3
"01019",1,19,1999,10177,9675,502,4.9
"01019",1,19,2000,11304,10797,507,4.5
"01019",1,19,2001,11339,10824,515,4.5
"01019",1,19,2002,11555,11007,548,4.7
"01019",1,19,2003,11929,11342,587,4.9
"01019",1,19,2004,12058,11478,580,4.8
"01019",1,19,2005,12044,11519,525,4.4
"01019",1,19,2006,11854,11352,502,4.2
"01019",1,19,2007,11984,11484,500,4.2
"01019",1,19,2008,11996,11308,688,5.7
"01019",1,19,2009,11758,10384,1374,11.7
"01019",1,19,2010,11464,10245,1219,10.6
"01019",1,19,2011,11476,10364,1112,9.7
"01019",1,19,2012,11268,10363,905,8
"01019",1,19,2013,11403,10649,754,6.6
"01019",1,19,2014,11390,10729,661,5.8
"01019",1,19,2015,11158,10549,609,5.5
"01019",1,19,2016,11332,10757,575,5.1
"01019",1,19,2017,11174,10721,453,4.1
"01021",1,21,1990,15187,13833,1354,8.9
"01021",1,21,1991,15218,13702,1516,10
"01021",1,21,1992,15686,14102,1584,10.1
"01021",1,21,1993,16338,14882,1456,8.9
"01021",1,21,1994,16921,15743,1178,7
"01021",1,21,1995,17555,16443,1112,6.3
"01021",1,21,1996,17612,16753,859,4.9
"01021",1,21,1997,18259,17360,899,4.9
"01021",1,21,1998,18010,17200,810,4.5
"01021",1,21,1999,18606,17896,710,3.8
"01021",1,21,2000,19475,18641,834,4.3
"01021",1,21,2001,19464,18533,931,4.8
"01021",1,21,2002,19393,18403,990,5.1
"01021",1,21,2003,19478,18499,979,5
"01021",1,21,2004,19630,18702,928,4.7
"01021",1,21,2005,19674,18901,773,3.9
"01021",1,21,2006,19771,19059,712,3.6
"01021",1,21,2007,19737,19067,670,3.4
"01021",1,21,2008,19610,18618,992,5.1
"01021",1,21,2009,19445,17375,2070,10.6
"01021",1,21,2010,19462,17464,1998,10.3
"01021",1,21,2011,19539,17753,1786,9.1
"01021",1,21,2012,19383,17982,1401,7.2
"01021",1,21,2013,19359,18090,1269,6.6
"01021",1,21,2014,19102,17906,1196,6.3
"01021",1,21,2015,19133,18054,1079,5.6
"01021",1,21,2016,19183,18128,1055,5.5
"01021",1,21,2017,19118,18344,774,4
"01023",1,23,1990,6711,5867,844,12.6
"01023",1,23,1991,6704,5997,707,10.5
"01023",1,23,1992,6992,6187,805,11.5
"01023",1,23,1993,7254,6217,1037,14.3
"01023",1,23,1994,7058,6260,798,11.3
"01023",1,23,1995,6827,6116,711,10.4
"01023",1,23,1996,6292,5410,882,14
"01023",1,23,1997,5985,5114,871,14.6
"01023",1,23,1998,5577,4955,622,11.2
"01023",1,23,1999,5802,5270,532,9.2
"01023",1,23,2000,6184,5781,403,6.5
"01023",1,23,2001,5869,5452,417,7.1
"01023",1,23,2002,5731,5224,507,8.8
"01023",1,23,2003,5651,5085,566,10
"01023",1,23,2004,5462,4992,470,8.6
"01023",1,23,2005,5300,4951,349,6.6
"01023",1,23,2006,5329,5030,299,5.6
"01023",1,23,2007,5183,4875,308,5.9
"01023",1,23,2008,5069,4646,423,8.3
"01023",1,23,2009,5134,4442,692,13.5
"01023",1,23,2010,4860,4216,644,13.3
"01023",1,23,2011,4764,4138,626,13.1
"01023",1,23,2012,4791,4297,494,10.3
"01023",1,23,2013,4703,4270,433,9.2
"01023",1,23,2014,4495,4090,405,9
"01023",1,23,2015,4378,3980,398,9.1
"01023",1,23,2016,4327,3958,369,8.5
"01023",1,23,2017,4336,4059,277,6.4
"01025",1,25,1990,11711,10756,955,8.2
"01025",1,25,1991,12077,10930,1147,9.5
"01025",1,25,1992,12872,11193,1679,13
"01025",1,25,1993,13005,11447,1558,12
"01025",1,25,1994,13373,12156,1217,9.1
"01025",1,25,1995,13568,12159,1409,10.4
"01025",1,25,1996,14712,13399,1313,8.9
"01025",1,25,1997,14584,13147,1437,9.9
"01025",1,25,1998,13723,12512,1211,8.8
"01025",1,25,1999,13577,12411,1166,8.6
"01025",1,25,2000,11597,10750,847,7.3
"01025",1,25,2001,11019,9945,1074,9.7
"01025",1,25,2002,10718,9747,971,9.1
"01025",1,25,2003,10769,9839,930,8.6
"01025",1,25,2004,10391,9464,927,8.9
"01025",1,25,2005,10126,9478,648,6.4
"01025",1,25,2006,10261,9622,639,6.2
"01025",1,25,2007,10358,9730,628,6.1
"01025",1,25,2008,10351,9419,932,9
"01025",1,25,2009,10381,8664,1717,16.5
"01025",1,25,2010,9108,7300,1808,19.9
"01025",1,25,2011,8843,7181,1662,18.8
"01025",1,25,2012,8374,7116,1258,15
"01025",1,25,2013,8285,7145,1140,13.8
"01025",1,25,2014,8157,7164,993,12.2
"01025",1,25,2015,7992,7054,938,11.7
"01025",1,25,2016,7953,7087,866,10.9
"01025",1,25,2017,7720,7065,655,8.5
"01027",1,27,1990,6338,5889,449,7.1
"01027",1,27,1991,6495,5860,635,9.8
"01027",1,27,1992,6468,6025,443,6.8
"01027",1,27,1993,6758,6047,711,10.5
"01027",1,27,1994,6515,6144,371,5.7
"01027",1,27,1995,6621,6249,372,5.6
"01027",1,27,1996,6600,6274,326,4.9
"01027",1,27,1997,6705,6398,307,4.6
"01027",1,27,1998,6668,6426,242,3.6
"01027",1,27,1999,6624,6264,360,5.4
"01027",1,27,2000,6565,6163,402,6.1
"01027",1,27,2001,6366,5981,385,6
"01027",1,27,2002,6146,5763,383,6.2
"01027",1,27,2003,5923,5492,431,7.3
"01027",1,27,2004,5891,5515,376,6.4
"01027",1,27,2005,5950,5655,295,5
"01027",1,27,2006,6182,5902,280,4.5
"01027",1,27,2007,6113,5775,338,5.5
"01027",1,27,2008,5733,5279,454,7.9
"01027",1,27,2009,5643,4703,940,16.7
"01027",1,27,2010,5851,5005,846,14.5
"01027",1,27,2011,5598,4935,663,11.8
"01027",1,27,2012,5413,4905,508,9.4
"01027",1,27,2013,5393,4943,450,8.3
"01027",1,27,2014,5513,5119,394,7.1
"01027",1,27,2015,5548,5208,340,6.1
"01027",1,27,2016,5624,5289,335,6
"01027",1,27,2017,5721,5471,250,4.4
"01029",1,29,1990,6279,5868,411,6.5
"01029",1,29,1991,6701,6212,489,7.3
"01029",1,29,1992,7099,6632,467,6.6
"01029",1,29,1993,6993,6523,470,6.7
"01029",1,29,1994,7320,7001,319,4.4
"01029",1,29,1995,7317,6910,407,5.6
"01029",1,29,1996,7095,6780,315,4.4
"01029",1,29,1997,7270,7013,257,3.5
"01029",1,29,1998,7257,6988,269,3.7
"01029",1,29,1999,7229,6918,311,4.3
"01029",1,29,2000,6958,6676,282,4.1
"01029",1,29,2001,6921,6559,362,5.2
"01029",1,29,2002,6774,6436,338,5
"01029",1,29,2003,6672,6267,405,6.1
"01029",1,29,2004,6682,6327,355,5.3
"01029",1,29,2005,6659,6396,263,3.9
"01029",1,29,2006,6639,6406,233,3.5
"01029",1,29,2007,6483,6246,237,3.7
"01029",1,29,2008,6557,6225,332,5.1
"01029",1,29,2009,6514,5851,663,10.2
"01029",1,29,2010,6033,5429,604,10
"01029",1,29,2011,5939,5365,574,9.7
"01029",1,29,2012,5838,5358,480,8.2
"01029",1,29,2013,5830,5383,447,7.7
"01029",1,29,2014,5855,5469,386,6.6
"01029",1,29,2015,5677,5335,342,6
"01029",1,29,2016,5785,5438,347,6
"01029",1,29,2017,5742,5486,256,4.5
"01031",1,31,1990,18836,17647,1189,6.3
"01031",1,31,1991,19075,17832,1243,6.5
"01031",1,31,1992,19862,18664,1198,6
"01031",1,31,1993,20868,19593,1275,6.1
"01031",1,31,1994,21220,20179,1041,4.9
"01031",1,31,1995,21554,20591,963,4.5
"01031",1,31,1996,21460,20376,1084,5.1
"01031",1,31,1997,22005,21127,878,4
"01031",1,31,1998,21841,20958,883,4
"01031",1,31,1999,21888,20853,1035,4.7
"01031",1,31,2000,19902,18748,1154,5.8
"01031",1,31,2001,19276,18084,1192,6.2
"01031",1,31,2002,19300,18301,999,5.2
"01031",1,31,2003,19932,18834,1098,5.5
"01031",1,31,2004,20221,19136,1085,5.4
"01031",1,31,2005,20104,19320,784,3.9
"01031",1,31,2006,20691,19917,774,3.7
"01031",1,31,2007,21077,20275,802,3.8
"01031",1,31,2008,20911,19897,1014,4.8
"01031",1,31,2009,21436,19612,1824,8.5
"01031",1,31,2010,21088,19271,1817,8.6
"01031",1,31,2011,20749,19059,1690,8.1
"01031",1,31,2012,20612,19159,1453,7
"01031",1,31,2013,20516,19105,1411,6.9
"01031",1,31,2014,20235,18892,1343,6.6
"01031",1,31,2015,20269,19062,1207,6
"01031",1,31,2016,20593,19382,1211,5.9
"01031",1,31,2017,20671,19764,907,4.4
"01033",1,33,1990,24501,22526,1975,8.1
"01033",1,33,1991,24904,22667,2237,9
"01033",1,33,1992,25225,23001,2224,8.8
"01033",1,33,1993,25663,23514,2149,8.4
"01033",1,33,1994,26000,24009,1991,7.7
"01033",1,33,1995,26724,24802,1922,7.2
"01033",1,33,1996,26855,24987,1868,7
"01033",1,33,1997,27064,25117,1947,7.2
"01033",1,33,1998,26136,24056,2080,8
"01033",1,33,1999,25356,23538,1818,7.2
"01033",1,33,2000,25950,24511,1439,5.5
"01033",1,33,2001,25609,23856,1753,6.8
"01033",1,33,2002,24971,22891,2080,8.3
"01033",1,33,2003,24562,22720,1842,7.5
"01033",1,33,2004,24751,22986,1765,7.1
"01033",1,33,2005,24960,23610,1350,5.4
"01033",1,33,2006,25307,24128,1179,4.7
"01033",1,33,2007,25386,24216,1170,4.6
"01033",1,33,2008,25160,23523,1637,6.5
"01033",1,33,2009,25414,22461,2953,11.6
"01033",1,33,2010,24228,21453,2775,11.5
"01033",1,33,2011,24386,21905,2481,10.2
"01033",1,33,2012,24026,21922,2104,8.8
"01033",1,33,2013,23896,21937,1959,8.2
"01033",1,33,2014,24036,22043,1993,8.3
"01033",1,33,2015,23603,21733,1870,7.9
"01033",1,33,2016,23449,21816,1633,7
"01033",1,33,2017,23092,21889,1203,5.2
"01035",1,35,1990,5763,5202,561,9.7
"01035",1,35,1991,5823,5188,635,10.9
"01035",1,35,1992,6097,5285,812,13.3
"01035",1,35,1993,6316,5667,649,10.3
"01035",1,35,1994,6537,5936,601,9.2
"01035",1,35,1995,6715,6005,710,10.6
"01035",1,35,1996,6924,6061,863,12.5
"01035",1,35,1997,6760,6051,709,10.5
"01035",1,35,1998,6454,5887,567,8.8
"01035",1,35,1999,5902,5351,551,9.3
"01035",1,35,2000,5483,5127,356,6.5
"01035",1,35,2001,5274,4890,384,7.3
"01035",1,35,2002,5163,4740,423,8.2
"01035",1,35,2003,5149,4707,442,8.6
"01035",1,35,2004,5061,4630,431,8.5
"01035",1,35,2005,5188,4866,322,6.2
"01035",1,35,2006,5123,4833,290,5.7
"01035",1,35,2007,4965,4646,319,6.4
"01035",1,35,2008,4878,4421,457,9.4
"01035",1,35,2009,4908,3930,978,19.9
"01035",1,35,2010,4991,4131,860,17.2
"01035",1,35,2011,4785,4057,728,15.2
"01035",1,35,2012,4635,4082,553,11.9
"01035",1,35,2013,4695,4191,504,10.7
"01035",1,35,2014,4718,4231,487,10.3
"01035",1,35,2015,4681,4249,432,9.2
"01035",1,35,2016,4548,4164,384,8.4
"01035",1,35,2017,4446,4173,273,6.1
"01037",1,37,1990,4983,4663,320,6.4
"01037",1,37,1991,5004,4666,338,6.8
"01037",1,37,1992,5042,4745,297,5.9
"01037",1,37,1993,5140,4822,318,6.2
"01037",1,37,1994,5297,5012,285,5.4
"01037",1,37,1995,5411,5144,267,4.9
"01037",1,37,1996,5315,5057,258,4.9
"01037",1,37,1997,5320,5086,234,4.4
"01037",1,37,1998,5318,5090,228,4.3
"01037",1,37,1999,5270,4977,293,5.6
"01037",1,37,2000,5295,5009,286,5.4
"01037",1,37,2001,5300,4942,358,6.8
"01037",1,37,2002,5182,4699,483,9.3
"01037",1,37,2003,5056,4641,415,8.2
"01037",1,37,2004,4911,4560,351,7.1
"01037",1,37,2005,4892,4645,247,5
"01037",1,37,2006,4794,4525,269,5.6
"01037",1,37,2007,4686,4415,271,5.8
"01037",1,37,2008,4659,4274,385,8.3
"01037",1,37,2009,4593,3856,737,16
"01037",1,37,2010,4654,3937,717,15.4
"01037",1,37,2011,4477,3918,559,12.5
"01037",1,37,2012,4445,4029,416,9.4
"01037",1,37,2013,4452,4044,408,9.2
"01037",1,37,2014,4469,4075,394,8.8
"01037",1,37,2015,4426,4130,296,6.7
"01037",1,37,2016,4379,4117,262,6
"01037",1,37,2017,4348,4147,201,4.6
"01039",1,39,1990,17161,15834,1327,7.7
"01039",1,39,1991,16775,15162,1613,9.6
"01039",1,39,1992,16914,15098,1816,10.7
"01039",1,39,1993,16953,15373,1580,9.3
"01039",1,39,1994,17251,16211,1040,6
"01039",1,39,1995,17682,16478,1204,6.8
"01039",1,39,1996,17591,16178,1413,8
"01039",1,39,1997,17666,16468,1198,6.8
"01039",1,39,1998,17243,16098,1145,6.6
"01039",1,39,1999,17066,15667,1399,8.2
"01039",1,39,2000,17316,16124,1192,6.9
"01039",1,39,2001,16846,15782,1064,6.3
"01039",1,39,2002,17095,16082,1013,5.9
"01039",1,39,2003,17322,16110,1212,7
"01039",1,39,2004,17171,16019,1152,6.7
"01039",1,39,2005,16933,16167,766,4.5
"01039",1,39,2006,17195,16529,666,3.9
"01039",1,39,2007,17070,16409,661,3.9
"01039",1,39,2008,16800,15803,997,5.9
"01039",1,39,2009,16719,14912,1807,10.8
"01039",1,39,2010,16417,14721,1696,10.3
"01039",1,39,2011,16367,14764,1603,9.8
"01039",1,39,2012,16345,14978,1367,8.4
"01039",1,39,2013,16066,14768,1298,8.1
"01039",1,39,2014,15915,14679,1236,7.8
"01039",1,39,2015,15457,14353,1104,7.1
"01039",1,39,2016,15490,14441,1049,6.8
"01039",1,39,2017,15646,14826,820,5.2
"01041",1,41,1990,6082,5629,453,7.4
"01041",1,41,1991,6107,5586,521,8.5
"01041",1,41,1992,6200,5650,550,8.9
"01041",1,41,1993,5959,5483,476,8
"01041",1,41,1994,5916,5563,353,6
"01041",1,41,1995,6039,5689,350,5.8
"01041",1,41,1996,6036,5485,551,9.1
"01041",1,41,1997,5932,5442,490,8.3
"01041",1,41,1998,5605,5144,461,8.2
"01041",1,41,1999,5388,4790,598,11.1
"01041",1,41,2000,6115,5766,349,5.7
"01041",1,41,2001,6000,5641,359,6
"01041",1,41,2002,5827,5473,354,6.1
"01041",1,41,2003,5920,5517,403,6.8
"01041",1,41,2004,5818,5418,400,6.9
"01041",1,41,2005,6186,5882,304,4.9
"01041",1,41,2006,6595,6332,263,4
"01041",1,41,2007,6546,6264,282,4.3
"01041",1,41,2008,6464,6105,359,5.6
"01041",1,41,2009,6439,5768,671,10.4
"01041",1,41,2010,6285,5646,639,10.2
"01041",1,41,2011,6432,5798,634,9.9
"01041",1,41,2012,6251,5732,519,8.3
"01041",1,41,2013,6311,5828,483,7.7
"01041",1,41,2014,6301,5864,437,6.9
"01041",1,41,2015,6355,5974,381,6
"01041",1,41,2016,6451,6072,379,5.9
"01041",1,41,2017,6417,6130,287,4.5
"01043",1,43,1990,32848,30527,2321,7.1
"01043",1,43,1991,33052,30561,2491,7.5
"01043",1,43,1992,34510,32048,2462,7.1
"01043",1,43,1993,35320,33020,2300,6.5
"01043",1,43,1994,36480,34601,1879,5.2
"01043",1,43,1995,37455,35464,1991,5.3
"01043",1,43,1996,37459,35674,1785,4.8
"01043",1,43,1997,38577,36969,1608,4.2
"01043",1,43,1998,38708,37325,1383,3.6
"01043",1,43,1999,39497,37945,1552,3.9
"01043",1,43,2000,38647,37053,1594,4.1
"01043",1,43,2001,37982,36230,1752,4.6
"01043",1,43,2002,37936,35655,2281,6
"01043",1,43,2003,38276,36045,2231,5.8
"01043",1,43,2004,38483,36472,2011,5.2
"01043",1,43,2005,38494,36946,1548,4
"01043",1,43,2006,39375,38026,1349,3.4
"01043",1,43,2007,39367,38047,1320,3.4
"01043",1,43,2008,39096,37188,1908,4.9
"01043",1,43,2009,38537,34585,3952,10.3
"01043",1,43,2010,35959,32202,3757,10.4
"01043",1,43,2011,35669,32279,3390,9.5
"01043",1,43,2012,35568,32835,2733,7.7
"01043",1,43,2013,35783,33402,2381,6.7
"01043",1,43,2014,35929,33751,2178,6.1
"01043",1,43,2015,36384,34472,1912,5.3
"01043",1,43,2016,37898,36010,1888,5
"01043",1,43,2017,37637,36239,1398,3.7
"01045",1,45,1990,20535,19384,1151,5.6
"01045",1,45,1991,20620,19286,1334,6.5
"01045",1,45,1992,20809,19357,1452,7
"01045",1,45,1993,20959,19070,1889,9
"01045",1,45,1994,20951,19319,1632,7.8
"01045",1,45,1995,21011,19599,1412,6.7
"01045",1,45,1996,20955,19841,1114,5.3
"01045",1,45,1997,21211,20044,1167,5.5
"01045",1,45,1998,20874,20010,864,4.1
"01045",1,45,1999,21267,20236,1031,4.8
"01045",1,45,2000,20785,19702,1083,5.2
"01045",1,45,2001,20127,19012,1115,5.5
"01045",1,45,2002,20260,19107,1153,5.7
"01045",1,45,2003,20546,19457,1089,5.3
"01045",1,45,2004,20505,19401,1104,5.4
"01045",1,45,2005,20168,19269,899,4.5
"01045",1,45,2006,20480,19522,958,4.7
"01045",1,45,2007,20250,19450,800,4
"01045",1,45,2008,19832,18760,1072,5.4
"01045",1,45,2009,20033,18100,1933,9.6
"01045",1,45,2010,22072,20124,1948,8.8
"01045",1,45,2011,22017,20188,1829,8.3
"01045",1,45,2012,21370,19781,1589,7.4
"01045",1,45,2013,20750,19220,1530,7.4
"01045",1,45,2014,20323,18885,1438,7.1
"01045",1,45,2015,19837,18575,1262,6.4
"01045",1,45,2016,19956,18799,1157,5.8
"01045",1,45,2017,19868,18987,881,4.4
"01047",1,47,1990,19459,17096,2363,12.1
"01047",1,47,1991,19666,17113,2553,13
"01047",1,47,1992,20259,17465,2794,13.8
"01047",1,47,1993,20419,17359,3060,15
"01047",1,47,1994,20601,18115,2486,12.1
"01047",1,47,1995,21021,18357,2664,12.7
"01047",1,47,1996,20175,17658,2517,12.5
"01047",1,47,1997,20245,18010,2235,11
"01047",1,47,1998,19897,17883,2014,10.1
"01047",1,47,1999,19615,17464,2151,11
"01047",1,47,2000,17823,16389,1434,8
"01047",1,47,2001,17483,15881,1602,9.2
"01047",1,47,2002,17135,15181,1954,11.4
"01047",1,47,2003,16783,14878,1905,11.4
"01047",1,47,2004,16375,14726,1649,10.1
"01047",1,47,2005,16007,14636,1371,8.6
"01047",1,47,2006,15903,14594,1309,8.2
"01047",1,47,2007,15555,14259,1296,8.3
"01047",1,47,2008,15473,13758,1715,11.1
"01047",1,47,2009,15868,12516,3352,21.1
"01047",1,47,2010,17808,14806,3002,16.9
"01047",1,47,2011,17514,14866,2648,15.1
"01047",1,47,2012,16746,14583,2163,12.9
"01047",1,47,2013,16293,14301,1992,12.2
"01047",1,47,2014,16008,14209,1799,11.2
"01047",1,47,2015,15589,14094,1495,9.6
"01047",1,47,2016,15417,13993,1424,9.2
"01047",1,47,2017,14935,13811,1124,7.5
"01049",1,49,1990,27386,25349,2037,7.4
"01049",1,49,1991,27540,25369,2171,7.9
"01049",1,49,1992,28276,26277,1999,7.1
"01049",1,49,1993,29482,27490,1992,6.8
"01049",1,49,1994,30171,28491,1680,5.6
"01049",1,49,1995,31232,29600,1632,5.2
"01049",1,49,1996,31589,29751,1838,5.8
"01049",1,49,1997,32164,30497,1667,5.2
"01049",1,49,1998,32099,30715,1384,4.3
"01049",1,49,1999,32473,31206,1267,3.9
"01049",1,49,2000,32308,31009,1299,4
"01049",1,49,2001,32237,30689,1548,4.8
"01049",1,49,2002,32384,30717,1667,5.1
"01049",1,49,2003,32218,30363,1855,5.8
"01049",1,49,2004,32051,30191,1860,5.8
"01049",1,49,2005,31239,29648,1591,5.1
"01049",1,49,2006,31493,30176,1317,4.2
"01049",1,49,2007,31013,29689,1324,4.3
"01049",1,49,2008,30682,28895,1787,5.8
"01049",1,49,2009,29912,25647,4265,14.3
"01049",1,49,2010,30942,27026,3916,12.7
"01049",1,49,2011,29809,26279,3530,11.8
"01049",1,49,2012,28833,26224,2609,9
"01049",1,49,2013,29033,26823,2210,7.6
"01049",1,49,2014,28954,26965,1989,6.9
"01049",1,49,2015,28767,27022,1745,6.1
"01049",1,49,2016,29229,27453,1776,6.1
"01049",1,49,2017,29038,27734,1304,4.5
"01051",1,51,1990,22533,21150,1383,6.1
"01051",1,51,1991,22721,21201,1520,6.7
"01051",1,51,1992,23837,22300,1537,6.4
"01051",1,51,1993,24742,23223,1519,6.1
"01051",1,51,1994,25271,24063,1208,4.8
"01051",1,51,1995,26367,25075,1292,4.9
"01051",1,51,1996,27312,26259,1053,3.9
"01051",1,51,1997,28481,27449,1032,3.6
"01051",1,51,1998,29450,28581,869,3
"01051",1,51,1999,30513,29493,1020,3.3
"01051",1,51,2000,30995,29767,1228,4
"01051",1,51,2001,31470,30138,1332,4.2
"01051",1,51,2002,31677,30160,1517,4.8
"01051",1,51,2003,32603,30929,1674,5.1
"01051",1,51,2004,33284,31657,1627,4.9
"01051",1,51,2005,34448,33157,1291,3.7
"01051",1,51,2006,35169,33968,1201,3.4
"01051",1,51,2007,35805,34620,1185,3.3
"01051",1,51,2008,36220,34371,1849,5.1
"01051",1,51,2009,36392,32944,3448,9.5
"01051",1,51,2010,36683,33362,3321,9.1
"01051",1,51,2011,36597,33521,3076,8.4
"01051",1,51,2012,36629,34087,2542,6.9
"01051",1,51,2013,36930,34658,2272,6.2
"01051",1,51,2014,36557,34469,2088,5.7
"01051",1,51,2015,36743,34897,1846,5
"01051",1,51,2016,37221,35446,1775,4.8
"01051",1,51,2017,37236,35880,1356,3.6
"01053",1,53,1990,15003,13706,1297,8.6
"01053",1,53,1991,15218,13823,1395,9.2
"01053",1,53,1992,15799,13888,1911,12.1
"01053",1,53,1993,16168,14543,1625,10.1
"01053",1,53,1994,16042,14758,1284,8
"01053",1,53,1995,16320,14955,1365,8.4
"01053",1,53,1996,16323,15309,1014,6.2
"01053",1,53,1997,16896,15788,1108,6.6
"01053",1,53,1998,16422,15418,1004,6.1
"01053",1,53,1999,16464,15416,1048,6.4
"01053",1,53,2000,16092,15257,835,5.2
"01053",1,53,2001,15537,14585,952,6.1
"01053",1,53,2002,14917,13619,1298,8.7
"01053",1,53,2003,14644,13379,1265,8.6
"01053",1,53,2004,14306,13217,1089,7.6
"01053",1,53,2005,14329,13530,799,5.6
"01053",1,53,2006,14348,13634,714,5
"01053",1,53,2007,14288,13530,758,5.3
"01053",1,53,2008,14412,13321,1091,7.6
"01053",1,53,2009,14762,12770,1992,13.5
"01053",1,53,2010,15007,13238,1769,11.8
"01053",1,53,2011,14978,13355,1623,10.8
"01053",1,53,2012,14732,13374,1358,9.2
"01053",1,53,2013,14292,13065,1227,8.6
"01053",1,53,2014,14369,13220,1149,8
"01053",1,53,2015,14597,13571,1026,7
"01053",1,53,2016,14551,13582,969,6.7
"01053",1,53,2017,14352,13630,722,5
"01055",1,55,1990,46628,41522,5106,11
"01055",1,55,1991,46379,41484,4895,10.6
"01055",1,55,1992,46582,42464,4118,8.8
"01055",1,55,1993,47551,43866,3685,7.7
"01055",1,55,1994,47825,44630,3195,6.7
"01055",1,55,1995,48527,45426,3101,6.4
"01055",1,55,1996,48747,46109,2638,5.4
"01055",1,55,1997,49449,46921,2528,5.1
"01055",1,55,1998,49893,47367,2526,5.1
"01055",1,55,1999,49440,46003,3437,7
"01055",1,55,2000,48177,45380,2797,5.8
"01055",1,55,2001,46764,43689,3075,6.6
"01055",1,55,2002,46892,43899,2993,6.4
"01055",1,55,2003,46388,43351,3037,6.5
"01055",1,55,2004,47170,44143,3027,6.4
"01055",1,55,2005,46762,44542,2220,4.7
"01055",1,55,2006,46521,44546,1975,4.2
"01055",1,55,2007,45459,43431,2028,4.5
"01055",1,55,2008,45727,42995,2732,6
"01055",1,55,2009,44993,39838,5155,11.5
"01055",1,55,2010,44000,39193,4807,10.9
"01055",1,55,2011,44722,40238,4484,10
"01055",1,55,2012,44232,40589,3643,8.2
"01055",1,55,2013,43862,40538,3324,7.6
"01055",1,55,2014,43735,40655,3080,7
"01055",1,55,2015,42684,40045,2639,6.2
"01055",1,55,2016,43261,40701,2560,5.9
"01055",1,55,2017,42894,40932,1962,4.6
"01057",1,57,1990,8493,7658,835,9.8
"01057",1,57,1991,8474,7573,901,10.6
"01057",1,57,1992,8645,7883,762,8.8
"01057",1,57,1993,8756,7941,815,9.3
"01057",1,57,1994,8793,8222,571,6.5
"01057",1,57,1995,8755,8250,505,5.8
"01057",1,57,1996,8486,8126,360,4.2
"01057",1,57,1997,8641,8219,422,4.9
"01057",1,57,1998,8273,7670,603,7.3
"01057",1,57,1999,7853,7088,765,9.7
"01057",1,57,2000,8276,7792,484,5.8
"01057",1,57,2001,8145,7632,513,6.3
"01057",1,57,2002,7881,7209,672,8.5
"01057",1,57,2003,8048,7490,558,6.9
"01057",1,57,2004,7876,7329,547,6.9
"01057",1,57,2005,7886,7533,353,4.5
"01057",1,57,2006,7743,7414,329,4.2
"01057",1,57,2007,7387,7039,348,4.7
"01057",1,57,2008,7118,6604,514,7.2
"01057",1,57,2009,6971,5993,978,14
"01057",1,57,2010,6831,5942,889,13
"01057",1,57,2011,6632,5896,736,11.1
"01057",1,57,2012,6503,5943,560,8.6
"01057",1,57,2013,6406,5875,531,8.3
"01057",1,57,2014,6351,5853,498,7.8
"01057",1,57,2015,6422,5971,451,7
"01057",1,57,2016,6594,6149,445,6.7
"01057",1,57,2017,6529,6220,309,4.7
"01059",1,59,1990,13641,12098,1543,11.3
"01059",1,59,1991,14201,12855,1346,9.5
"01059",1,59,1992,14938,13724,1214,8.1
"01059",1,59,1993,15296,14145,1151,7.5
"01059",1,59,1994,15531,14477,1054,6.8
"01059",1,59,1995,15939,14796,1143,7.2
"01059",1,59,1996,16505,15298,1207,7.3
"01059",1,59,1997,16841,15422,1419,8.4
"01059",1,59,1998,17047,15765,1282,7.5
"01059",1,59,1999,16828,15592,1236,7.3
"01059",1,59,2000,14629,13674,955,6.5
"01059",1,59,2001,13965,12902,1063,7.6
"01059",1,59,2002,13686,12154,1532,11.2
"01059",1,59,2003,13561,12265,1296,9.6
"01059",1,59,2004,13443,12503,940,7
"01059",1,59,2005,13789,13059,730,5.3
"01059",1,59,2006,13939,13291,648,4.6
"01059",1,59,2007,13742,13108,634,4.6
"01059",1,59,2008,13380,12387,993,7.4
"01059",1,59,2009,13240,11463,1777,13.4
"01059",1,59,2010,14255,12724,1531,10.7
"01059",1,59,2011,14362,12986,1376,9.6
"01059",1,59,2012,13976,12806,1170,8.4
"01059",1,59,2013,13678,12578,1100,8
"01059",1,59,2014,13718,12658,1060,7.7
"01059",1,59,2015,13661,12782,879,6.4
"01059",1,59,2016,13864,13047,817,5.9
"01059",1,59,2017,13960,13369,591,4.2
"01061",1,61,1990,11109,10584,525,4.7
"01061",1,61,1991,11385,10803,582,5.1
"01061",1,61,1992,11970,11372,598,5
"01061",1,61,1993,12140,11402,738,6.1
"01061",1,61,1994,12770,12108,662,5.2
"01061",1,61,1995,12614,11767,847,6.7
"01061",1,61,1996,11885,10873,1012,8.5
"01061",1,61,1997,12045,11338,707,5.9
"01061",1,61,1998,11334,10630,704,6.2
"01061",1,61,1999,10675,9874,801,7.5
"01061",1,61,2000,12180,11562,618,5.1
"01061",1,61,2001,12047,11276,771,6.4
"01061",1,61,2002,11709,11131,578,4.9
"01061",1,61,2003,11722,11065,657,5.6
"01061",1,61,2004,11688,11110,578,4.9
"01061",1,61,2005,11628,11174,454,3.9
"01061",1,61,2006,11699,11257,442,3.8
"01061",1,61,2007,11535,11137,398,3.5
"01061",1,61,2008,11337,10717,620,5.5
"01061",1,61,2009,11173,9970,1203,10.8
"01061",1,61,2010,11559,10362,1197,10.4
"01061",1,61,2011,11486,10429,1057,9.2
"01061",1,61,2012,11274,10421,853,7.6
"01061",1,61,2013,11044,10276,768,7
"01061",1,61,2014,10796,10075,721,6.7
"01061",1,61,2015,10785,10147,638,5.9
"01061",1,61,2016,10804,10178,626,5.8
"01061",1,61,2017,10817,10355,462,4.3
"01063",1,63,1990,3777,3338,439,11.6
"01063",1,63,1991,3789,3355,434,11.5
"01063",1,63,1992,3804,3285,519,13.6
"01063",1,63,1993,3731,3174,557,14.9
"01063",1,63,1994,3693,3176,517,14
"01063",1,63,1995,3636,3122,514,14.1
"01063",1,63,1996,3579,2929,650,18.2
"01063",1,63,1997,3507,2855,652,18.6
"01063",1,63,1998,3255,2815,440,13.5
"01063",1,63,1999,3094,2711,383,12.4
"01063",1,63,2000,3510,3271,239,6.8
"01063",1,63,2001,3494,3245,249,7.1
"01063",1,63,2002,3522,3224,298,8.5
"01063",1,63,2003,3504,3205,299,8.5
"01063",1,63,2004,3484,3178,306,8.8
"01063",1,63,2005,3456,3225,231,6.7
"01063",1,63,2006,3392,3201,191,5.6
"01063",1,63,2007,3284,3075,209,6.4
"01063",1,63,2008,3280,3001,279,8.5
"01063",1,63,2009,3131,2653,478,15.3
"01063",1,63,2010,3306,2735,571,17.3
"01063",1,63,2011,3226,2668,558,17.3
"01063",1,63,2012,3125,2701,424,13.6
"01063",1,63,2013,2997,2614,383,12.8
"01063",1,63,2014,2986,2614,372,12.5
"01063",1,63,2015,2878,2559,319,11.1
"01063",1,63,2016,2871,2585,286,10
"01063",1,63,2017,2833,2616,217,7.7
"01065",1,65,1990,6204,5725,479,7.7
"01065",1,65,1991,6111,5547,564,9.2
"01065",1,65,1992,6425,5762,663,10.3
"01065",1,65,1993,6972,6284,688,9.9
"01065",1,65,1994,7192,6505,687,9.6
"01065",1,65,1995,7129,6453,676,9.5
"01065",1,65,1996,7136,6549,587,8.2
"01065",1,65,1997,7392,6823,569,7.7
"01065",1,65,1998,7368,6811,557,7.6
"01065",1,65,1999,7016,6488,528,7.5
"01065",1,65,2000,6976,6557,419,6
"01065",1,65,2001,7019,6513,506,7.2
"01065",1,65,2002,7054,6462,592,8.4
"01065",1,65,2003,7086,6485,601,8.5
"01065",1,65,2004,7049,6516,533,7.6
"01065",1,65,2005,7053,6669,384,5.4
"01065",1,65,2006,7170,6792,378,5.3
"01065",1,65,2007,6976,6602,374,5.4
"01065",1,65,2008,6991,6473,518,7.4
"01065",1,65,2009,6869,5890,979,14.3
"01065",1,65,2010,6445,5473,972,15.1
"01065",1,65,2011,6296,5426,870,13.8
"01065",1,65,2012,6212,5499,713,11.5
"01065",1,65,2013,6208,5486,722,11.6
"01065",1,65,2014,6034,5438,596,9.9
"01065",1,65,2015,6047,5577,470,7.8
"01065",1,65,2016,5981,5522,459,7.7
"01065",1,65,2017,6007,5653,354,5.9
"01067",1,67,1990,6867,6539,328,4.8
"01067",1,67,1991,6648,6106,542,8.2
"01067",1,67,1992,6762,6231,531,7.9
"01067",1,67,1993,6553,5905,648,9.9
"01067",1,67,1994,6395,5911,484,7.6
"01067",1,67,1995,6472,6018,454,7
"01067",1,67,1996,6440,6004,436,6.8
"01067",1,67,1997,6456,6087,369,5.7
"01067",1,67,1998,6412,6087,325,5.1
"01067",1,67,1999,6428,6093,335,5.2
"01067",1,67,2000,7634,7259,375,4.9
"01067",1,67,2001,7542,7137,405,5.4
"01067",1,67,2002,7530,7075,455,6
"01067",1,67,2003,7494,7059,435,5.8
"01067",1,67,2004,7548,7122,426,5.6
"01067",1,67,2005,7469,7146,323,4.3
"01067",1,67,2006,7506,7204,302,4
"01067",1,67,2007,7540,7135,405,5.4
"01067",1,67,2008,7376,6807,569,7.7
"01067",1,67,2009,7132,6334,798,11.2
"01067",1,67,2010,7259,6469,790,10.9
"01067",1,67,2011,7270,6563,707,9.7
"01067",1,67,2012,7030,6447,583,8.3
"01067",1,67,2013,6954,6421,533,7.7
"01067",1,67,2014,6778,6270,508,7.5
"01067",1,67,2015,6715,6259,456,6.8
"01067",1,67,2016,6721,6282,439,6.5
"01067",1,67,2017,6697,6371,326,4.9
"01069",1,69,1990,40846,39065,1781,4.4
"01069",1,69,1991,41159,39022,2137,5.2
"01069",1,69,1992,41933,39596,2337,5.6
"01069",1,69,1993,42408,39455,2953,7
"01069",1,69,1994,42122,39588,2534,6
"01069",1,69,1995,42294,40235,2059,4.9
"01069",1,69,1996,43361,41529,1832,4.2
"01069",1,69,1997,44543,42577,1966,4.4
"01069",1,69,1998,44396,42895,1501,3.4
"01069",1,69,1999,45134,43448,1686,3.7
"01069",1,69,2000,45170,43186,1984,4.4
"01069",1,69,2001,44752,42833,1919,4.3
"01069",1,69,2002,44752,42631,2121,4.7
"01069",1,69,2003,45185,42984,2201,4.9
"01069",1,69,2004,45913,43753,2160,4.7
"01069",1,69,2005,46102,44334,1768,3.8
"01069",1,69,2006,46701,45099,1602,3.4
"01069",1,69,2007,47179,45607,1572,3.3
"01069",1,69,2008,46452,44180,2272,4.9
"01069",1,69,2009,45903,41638,4265,9.3
"01069",1,69,2010,46414,42170,4244,9.1
"01069",1,69,2011,46778,42747,4031,8.6
"01069",1,69,2012,46054,42578,3476,7.5
"01069",1,69,2013,45711,42553,3158,6.9
"01069",1,69,2014,45159,42097,3062,6.8
"01069",1,69,2015,44550,41767,2783,6.2
"01069",1,69,2016,44543,41959,2584,5.8
"01069",1,69,2017,44411,42484,1927,4.3
"01071",1,71,1990,23677,21518,2159,9.1
"01071",1,71,1991,24289,21692,2597,10.7
"01071",1,71,1992,24958,22261,2697,10.8
"01071",1,71,1993,25866,23343,2523,9.8
"01071",1,71,1994,25312,22896,2416,9.5
"01071",1,71,1995,25255,22862,2393,9.5
"01071",1,71,1996,25922,23463,2459,9.5
"01071",1,71,1997,26010,23884,2126,8.2
"01071",1,71,1998,25246,23687,1559,6.2
"01071",1,71,1999,25698,23999,1699,6.6
"01071",1,71,2000,27899,26454,1445,5.2
"01071",1,71,2001,27016,25256,1760,6.5
"01071",1,71,2002,26798,24913,1885,7
"01071",1,71,2003,27187,25272,1915,7
"01071",1,71,2004,27035,25181,1854,6.9
"01071",1,71,2005,26776,25427,1349,5
"01071",1,71,2006,27066,25852,1214,4.5
"01071",1,71,2007,27020,25799,1221,4.5
"01071",1,71,2008,26857,25201,1656,6.2
"01071",1,71,2009,26370,23005,3365,12.8
"01071",1,71,2010,24348,21468,2880,11.8
"01071",1,71,2011,24163,21682,2481,10.3
"01071",1,71,2012,23731,21695,2036,8.6
"01071",1,71,2013,23687,21822,1865,7.9
"01071",1,71,2014,23454,21752,1702,7.3
"01071",1,71,2015,23461,21900,1561,6.7
"01071",1,71,2016,23580,22089,1491,6.3
"01071",1,71,2017,23066,21966,1100,4.8
"01073",1,73,1990,311022,295321,15701,5
"01073",1,73,1991,311177,293991,17186,5.5
"01073",1,73,1992,316293,297078,19215,6.1
"01073",1,73,1993,318131,300003,18128,5.7
"01073",1,73,1994,320171,305540,14631,4.6
"01073",1,73,1995,325223,311038,14185,4.4
"01073",1,73,1996,326349,314785,11564,3.5
"01073",1,73,1997,333502,321342,12160,3.6
"01073",1,73,1998,334528,323690,10838,3.2
"01073",1,73,1999,332540,321121,11419,3.4
"01073",1,73,2000,329015,315985,13030,4
"01073",1,73,2001,325883,311802,14081,4.3
"01073",1,73,2002,322122,305378,16744,5.2
"01073",1,73,2003,321042,303282,17760,5.5
"01073",1,73,2004,320336,303284,17052,5.3
"01073",1,73,2005,317359,303260,14099,4.4
"01073",1,73,2006,316750,304027,12723,4
"01073",1,73,2007,314739,302603,12136,3.9
"01073",1,73,2008,311615,294792,16823,5.4
"01073",1,73,2009,307018,274011,33007,10.8
"01073",1,73,2010,318520,285627,32893,10.3
"01073",1,73,2011,319652,289916,29736,9.3
"01073",1,73,2012,316511,293020,23491,7.4
"01073",1,73,2013,315405,294426,20979,6.7
"01073",1,73,2014,312247,292621,19626,6.3
"01073",1,73,2015,310883,292958,17925,5.8
"01073",1,73,2016,311128,293251,17877,5.7
"01073",1,73,2017,309076,295970,13106,4.2
"01075",1,75,1990,7689,7077,612,8
"01075",1,75,1991,7822,7037,785,10
"01075",1,75,1992,7767,7025,742,9.6
"01075",1,75,1993,7859,7104,755,9.6
"01075",1,75,1994,7522,7047,475,6.3
"01075",1,75,1995,7905,7423,482,6.1
"01075",1,75,1996,7901,7366,535,6.8
"01075",1,75,1997,7762,7106,656,8.5
"01075",1,75,1998,7479,6870,609,8.1
"01075",1,75,1999,7188,6510,678,9.4
"01075",1,75,2000,7446,6929,517,6.9
"01075",1,75,2001,7220,6640,580,8
"01075",1,75,2002,6961,6374,587,8.4
"01075",1,75,2003,6691,6104,587,8.8
"01075",1,75,2004,6382,5856,526,8.2
"01075",1,75,2005,6132,5788,344,5.6
"01075",1,75,2006,6043,5727,316,5.2
"01075",1,75,2007,5854,5488,366,6.3
"01075",1,75,2008,5692,5237,455,8
"01075",1,75,2009,5546,4658,888,16
"01075",1,75,2010,5802,5035,767,13.2
"01075",1,75,2011,5826,5260,566,9.7
"01075",1,75,2012,5806,5369,437,7.5
"01075",1,75,2013,5802,5394,408,7
"01075",1,75,2014,5626,5234,392,7
"01075",1,75,2015,5615,5260,355,6.3
"01075",1,75,2016,5688,5367,321,5.6
"01075",1,75,2017,5703,5462,241,4.2
"01077",1,77,1990,38029,35389,2640,6.9
"01077",1,77,1991,38609,35698,2911,7.5
"01077",1,77,1992,39371,36606,2765,7
"01077",1,77,1993,40555,37631,2924,7.2
"01077",1,77,1994,41283,38654,2629,6.4
"01077",1,77,1995,42640,40169,2471,5.8
"01077",1,77,1996,43196,40631,2565,5.9
"01077",1,77,1997,43181,40531,2650,6.1
"01077",1,77,1998,41893,39004,2889,6.9
"01077",1,77,1999,41083,38490,2593,6.3
"01077",1,77,2000,43446,41285,2161,5
"01077",1,77,2001,42826,40026,2800,6.5
"01077",1,77,2002,41969,38359,3610,8.6
"01077",1,77,2003,41196,38184,3012,7.3
"01077",1,77,2004,41360,38702,2658,6.4
"01077",1,77,2005,42063,39905,2158,5.1
"01077",1,77,2006,42593,40795,1798,4.2
"01077",1,77,2007,43257,41389,1868,4.3
"01077",1,77,2008,42873,40408,2465,5.7
"01077",1,77,2009,43432,38804,4628,10.7
"01077",1,77,2010,43596,39193,4403,10.1
"01077",1,77,2011,44048,40026,4022,9.1
"01077",1,77,2012,43409,40084,3325,7.7
"01077",1,77,2013,43150,40083,3067,7.1
"01077",1,77,2014,43489,40362,3127,7.2
"01077",1,77,2015,42649,39687,2962,6.9
"01077",1,77,2016,42522,39811,2711,6.4
"01077",1,77,2017,41868,39937,1931,4.6
"01079",1,79,1990,15140,13875,1265,8.4
"01079",1,79,1991,15365,13858,1507,9.8
"01079",1,79,1992,15236,13662,1574,10.3
"01079",1,79,1993,15400,13883,1517,9.9
"01079",1,79,1994,15099,13902,1197,7.9
"01079",1,79,1995,15571,14408,1163,7.5
"01079",1,79,1996,15772,14726,1046,6.6
"01079",1,79,1997,16130,15060,1070,6.6
"01079",1,79,1998,16302,15402,900,5.5
"01079",1,79,1999,16579,15593,986,5.9
"01079",1,79,2000,16573,15749,824,5
"01079",1,79,2001,16521,15540,981,5.9
"01079",1,79,2002,16093,15001,1092,6.8
"01079",1,79,2003,15788,14728,1060,6.7
"01079",1,79,2004,15990,14963,1027,6.4
"01079",1,79,2005,15979,15087,892,5.6
"01079",1,79,2006,15644,14889,755,4.8
"01079",1,79,2007,15807,15160,647,4.1
"01079",1,79,2008,15867,14837,1030,6.5
"01079",1,79,2009,15788,13635,2153,13.6
"01079",1,79,2010,14901,13024,1877,12.6
"01079",1,79,2011,14788,13177,1611,10.9
"01079",1,79,2012,14391,13094,1297,9
"01079",1,79,2013,14282,13093,1189,8.3
"01079",1,79,2014,14026,12873,1153,8.2
"01079",1,79,2015,13673,12616,1057,7.7
"01079",1,79,2016,13717,12768,949,6.9
"01079",1,79,2017,13640,12974,666,4.9
"01081",1,81,1990,43457,40802,2655,6.1
"01081",1,81,1991,42976,40416,2560,6
"01081",1,81,1992,43974,41500,2474,5.6
"01081",1,81,1993,44427,41792,2635,5.9
"01081",1,81,1994,45232,43299,1933,4.3
"01081",1,81,1995,46536,44536,2000,4.3
"01081",1,81,1996,47494,45941,1553,3.3
"01081",1,81,1997,49626,47760,1866,3.8
"01081",1,81,1998,48731,46987,1744,3.6
"01081",1,81,1999,48770,47052,1718,3.5
"01081",1,81,2000,58023,55711,2312,4
"01081",1,81,2001,58218,55832,2386,4.1
"01081",1,81,2002,59209,56499,2710,4.6
"01081",1,81,2003,60597,57747,2850,4.7
"01081",1,81,2004,62500,59700,2800,4.5
"01081",1,81,2005,63530,61161,2369,3.7
"01081",1,81,2006,64828,62616,2212,3.4
"01081",1,81,2007,65326,62949,2377,3.6
"01081",1,81,2008,65189,61795,3394,5.2
"01081",1,81,2009,64893,58787,6106,9.4
"01081",1,81,2010,66764,60758,6006,9
"01081",1,81,2011,68316,62812,5504,8.1
"01081",1,81,2012,68918,64247,4671,6.8
"01081",1,81,2013,70523,66379,4144,5.9
"01081",1,81,2014,71372,67385,3987,5.6
"01081",1,81,2015,70859,67140,3719,5.2
"01081",1,81,2016,72336,68544,3792,5.2
"01081",1,81,2017,73520,70643,2877,3.9
"01083",1,83,1990,26653,24914,1739,6.5
"01083",1,83,1991,26932,24702,2230,8.3
"01083",1,83,1992,27329,25399,1930,7.1
"01083",1,83,1993,27300,25682,1618,5.9
"01083",1,83,1994,27279,25711,1568,5.7
"01083",1,83,1995,26810,25464,1346,5
"01083",1,83,1996,27403,26125,1278,4.7
"01083",1,83,1997,28289,27168,1121,4
"01083",1,83,1998,28911,27730,1181,4.1
"01083",1,83,1999,29003,27944,1059,3.7
"01083",1,83,2000,32829,31583,1246,3.8
"01083",1,83,2001,33256,31809,1447,4.4
"01083",1,83,2002,33129,31358,1771,5.3
"01083",1,83,2003,33924,32046,1878,5.5
"01083",1,83,2004,34650,32858,1792,5.2
"01083",1,83,2005,35123,33561,1562,4.4
"01083",1,83,2006,35764,34458,1306,3.7
"01083",1,83,2007,36340,35123,1217,3.3
"01083",1,83,2008,37427,35664,1763,4.7
"01083",1,83,2009,38288,34543,3745,9.8
"01083",1,83,2010,38321,34625,3696,9.6
"01083",1,83,2011,38990,35631,3359,8.6
"01083",1,83,2012,38990,36311,2679,6.9
"01083",1,83,2013,39435,36969,2466,6.3
"01083",1,83,2014,39591,37177,2414,6.1
"01083",1,83,2015,39948,37757,2191,5.5
"01083",1,83,2016,40679,38539,2140,5.3
"01083",1,83,2017,41092,39457,1635,4
"01085",1,85,1990,4826,4068,758,15.7
"01085",1,85,1991,4461,3724,737,16.5
"01085",1,85,1992,4455,3669,786,17.6
"01085",1,85,1993,4283,3469,814,19
"01085",1,85,1994,4213,3565,648,15.4
"01085",1,85,1995,4292,3590,702,16.4
"01085",1,85,1996,4296,3663,633,14.7
"01085",1,85,1997,4332,3711,621,14.3
"01085",1,85,1998,4064,3613,451,11.1
"01085",1,85,1999,4155,3633,522,12.6
"01085",1,85,2000,5052,4704,348,6.9
"01085",1,85,2001,5011,4650,361,7.2
"01085",1,85,2002,5032,4584,448,8.9
"01085",1,85,2003,5021,4557,464,9.2
"01085",1,85,2004,4965,4503,462,9.3
"01085",1,85,2005,4952,4554,398,8
"01085",1,85,2006,4814,4448,366,7.6
"01085",1,85,2007,4758,4400,358,7.5
"01085",1,85,2008,4851,4322,529,10.9
"01085",1,85,2009,4921,3970,951,19.3
"01085",1,85,2010,4350,3547,803,18.5
"01085",1,85,2011,4239,3489,750,17.7
"01085",1,85,2012,4081,3452,629,15.4
"01085",1,85,2013,4009,3443,566,14.1
"01085",1,85,2014,3874,3378,496,12.8
"01085",1,85,2015,3827,3385,442,11.5
"01085",1,85,2016,3800,3398,402,10.6
"01085",1,85,2017,3750,3450,300,8
"01087",1,87,1990,9220,8396,824,8.9
"01087",1,87,1991,8911,8082,829,9.3
"01087",1,87,1992,8889,8027,862,9.7
"01087",1,87,1993,8626,7771,855,9.9
"01087",1,87,1994,8457,7709,748,8.8
"01087",1,87,1995,8472,7758,714,8.4
"01087",1,87,1996,8206,7562,644,7.8
"01087",1,87,1997,8029,7383,646,8
"01087",1,87,1998,7986,7347,639,8
"01087",1,87,1999,7666,7019,647,8.4
"01087",1,87,2000,9080,8556,524,5.8
"01087",1,87,2001,8905,8389,516,5.8
"01087",1,87,2002,8762,8197,565,6.4
"01087",1,87,2003,8522,7924,598,7
"01087",1,87,2004,8618,8016,602,7
"01087",1,87,2005,8705,8191,514,5.9
"01087",1,87,2006,8836,8368,468,5.3
"01087",1,87,2007,8865,8385,480,5.4
"01087",1,87,2008,9104,8426,678,7.4
"01087",1,87,2009,9345,8203,1142,12.2
"01087",1,87,2010,8937,7618,1319,14.8
"01087",1,87,2011,8512,7317,1195,14
"01087",1,87,2012,8286,7397,889,10.7
"01087",1,87,2013,8414,7603,811,9.6
"01087",1,87,2014,8239,7489,750,9.1
"01087",1,87,2015,7967,7326,641,8
"01087",1,87,2016,7866,7266,600,7.6
"01087",1,87,2017,7892,7436,456,5.8
"01089",1,89,1990,128780,122589,6191,4.8
"01089",1,89,1991,128614,121251,7363,5.7
"01089",1,89,1992,131327,124709,6618,5
"01089",1,89,1993,134550,127066,7484,5.6
"01089",1,89,1994,133849,126325,7524,5.6
"01089",1,89,1995,134837,128718,6119,4.5
"01089",1,89,1996,135540,131058,4482,3.3
"01089",1,89,1997,139304,135261,4043,2.9
"01089",1,89,1998,141840,137842,3998,2.8
"01089",1,89,1999,142993,138333,4660,3.3
"01089",1,89,2000,148675,143415,5260,3.5
"01089",1,89,2001,149678,143919,5759,3.8
"01089",1,89,2002,149904,143021,6883,4.6
"01089",1,89,2003,154255,146915,7340,4.8
"01089",1,89,2004,157604,150260,7344,4.7
"01089",1,89,2005,158767,153075,5692,3.6
"01089",1,89,2006,161332,156018,5314,3.3
"01089",1,89,2007,165286,160218,5068,3.1
"01089",1,89,2008,168340,161326,7014,4.2
"01089",1,89,2009,168887,155310,13577,8
"01089",1,89,2010,169833,155656,14177,8.3
"01089",1,89,2011,171726,157512,14214,8.3
"01089",1,89,2012,170209,158399,11810,6.9
"01089",1,89,2013,171363,160551,10812,6.3
"01089",1,89,2014,170131,159637,10494,6.2
"01089",1,89,2015,170889,161516,9373,5.5
"01089",1,89,2016,173529,164614,8915,5.1
"01089",1,89,2017,175153,168412,6741,3.8
"01091",1,91,1990,9836,9178,658,6.7
"01091",1,91,1991,10165,9378,787,7.7
"01091",1,91,1992,10724,9629,1095,10.2
"01091",1,91,1993,10764,9586,1178,10.9
"01091",1,91,1994,10882,9824,1058,9.7
"01091",1,91,1995,10806,9898,908,8.4
"01091",1,91,1996,11134,10084,1050,9.4
"01091",1,91,1997,10991,9887,1104,10
"01091",1,91,1998,11072,10251,821,7.4
"01091",1,91,1999,11063,10481,582,5.3
"01091",1,91,2000,9012,8543,469,5.2
"01091",1,91,2001,8894,8365,529,5.9
"01091",1,91,2002,8975,8404,571,6.4
"01091",1,91,2003,8999,8431,568,6.3
"01091",1,91,2004,8848,8303,545,6.2
"01091",1,91,2005,8603,8109,494,5.7
"01091",1,91,2006,8592,8193,399,4.6
"01091",1,91,2007,8150,7718,432,5.3
"01091",1,91,2008,7979,7389,590,7.4
"01091",1,91,2009,8101,6950,1151,14.2
"01091",1,91,2010,8136,7021,1115,13.7
"01091",1,91,2011,7875,6884,991,12.6
"01091",1,91,2012,7650,6873,777,10.2
"01091",1,91,2013,7634,6955,679,8.9
"01091",1,91,2014,7626,7018,608,8
"01091",1,91,2015,7406,6839,567,7.7
"01091",1,91,2016,7670,7121,549,7.2
"01091",1,91,2017,7623,7192,431,5.7
"01093",1,93,1990,14401,12374,2027,14.1
"01093",1,93,1991,13882,12346,1536,11.1
"01093",1,93,1992,14165,12884,1281,9
"01093",1,93,1993,14458,13118,1340,9.3
"01093",1,93,1994,14794,13721,1073,7.3
"01093",1,93,1995,15634,14708,926,5.9
"01093",1,93,1996,15852,14668,1184,7.5
"01093",1,93,1997,16115,14820,1295,8
"01093",1,93,1998,16433,15283,1150,7
"01093",1,93,1999,16089,14799,1290,8
"01093",1,93,2000,14205,13260,945,6.7
"01093",1,93,2001,12911,11793,1118,8.7
"01093",1,93,2002,12647,11542,1105,8.7
"01093",1,93,2003,13071,12130,941,7.2
"01093",1,93,2004,13321,12468,853,6.4
"01093",1,93,2005,13536,12929,607,4.5
"01093",1,93,2006,13504,12913,591,4.4
"01093",1,93,2007,12974,12297,677,5.2
"01093",1,93,2008,12715,11701,1014,8
"01093",1,93,2009,12361,10311,2050,16.6
"01093",1,93,2010,13215,11423,1792,13.6
"01093",1,93,2011,12556,11149,1407,11.2
"01093",1,93,2012,12451,11340,1111,8.9
"01093",1,93,2013,12487,11499,988,7.9
"01093",1,93,2014,12293,11322,971,7.9
"01093",1,93,2015,12483,11615,868,7
"01093",1,93,2016,12494,11665,829,6.6
"01093",1,93,2017,12517,11918,599,4.8
"01095",1,95,1990,35256,32102,3154,8.9
"01095",1,95,1991,34989,31555,3434,9.8
"01095",1,95,1992,35799,32722,3077,8.6
"01095",1,95,1993,37679,34743,2936,7.8
"01095",1,95,1994,38160,35489,2671,7
"01095",1,95,1995,39458,36718,2740,6.9
"01095",1,95,1996,39540,37215,2325,5.9
"01095",1,95,1997,40409,38174,2235,5.5
"01095",1,95,1998,40162,37688,2474,6.2
"01095",1,95,1999,40030,37552,2478,6.2
"01095",1,95,2000,40543,38605,1938,4.8
"01095",1,95,2001,39900,37697,2203,5.5
"01095",1,95,2002,40340,37942,2398,5.9
"01095",1,95,2003,40587,38316,2271,5.6
"01095",1,95,2004,41572,39543,2029,4.9
"01095",1,95,2005,41954,40314,1640,3.9
"01095",1,95,2006,41986,40527,1459,3.5
"01095",1,95,2007,41311,39890,1421,3.4
"01095",1,95,2008,41700,39720,1980,4.7
"01095",1,95,2009,40743,36604,4139,10.2
"01095",1,95,2010,41637,37640,3997,9.6
"01095",1,95,2011,41085,37216,3869,9.4
"01095",1,95,2012,40686,37523,3163,7.8
"01095",1,95,2013,40614,37841,2773,6.8
"01095",1,95,2014,39915,37254,2661,6.7
"01095",1,95,2015,40382,38049,2333,5.8
"01095",1,95,2016,41572,39350,2222,5.3
"01095",1,95,2017,42108,40506,1602,3.8
"01097",1,97,1990,171019,159194,11825,6.9
"01097",1,97,1991,176318,163858,12460,7.1
"01097",1,97,1992,182397,167362,15035,8.2
"01097",1,97,1993,187868,172246,15622,8.3
"01097",1,97,1994,190220,176245,13975,7.3
"01097",1,97,1995,192697,178991,13706,7.1
"01097",1,97,1996,193284,182454,10830,5.6
"01097",1,97,1997,197965,187476,10489,5.3
"01097",1,97,1998,198026,189259,8767,4.4
"01097",1,97,1999,198920,188796,10124,5.1
"01097",1,97,2000,184951,175846,9105,4.9
"01097",1,97,2001,183762,173439,10323,5.6
"01097",1,97,2002,181590,169842,11748,6.5
"01097",1,97,2003,180242,167696,12546,7
"01097",1,97,2004,178915,167153,11762,6.6
"01097",1,97,2005,180384,171439,8945,5
"01097",1,97,2006,182019,174428,7591,4.2
"01097",1,97,2007,184490,177096,7394,4
"01097",1,97,2008,187266,176623,10643,5.7
"01097",1,97,2009,186825,165725,21100,11.3
"01097",1,97,2010,192730,170943,21787,11.3
"01097",1,97,2011,193851,172971,20880,10.8
"01097",1,97,2012,188626,171312,17314,9.2
"01097",1,97,2013,187046,171088,15958,8.5
"01097",1,97,2014,185382,171027,14355,7.7
"01097",1,97,2015,186910,174057,12853,6.9
"01097",1,97,2016,187740,175270,12470,6.6
"01097",1,97,2017,186239,176587,9652,5.2
"01099",1,99,1990,10320,9236,1084,10.5
"01099",1,99,1991,10807,9684,1123,10.4
"01099",1,99,1992,10685,8659,2026,19
"01099",1,99,1993,10211,8721,1490,14.6
"01099",1,99,1994,10211,8984,1227,12
"01099",1,99,1995,10557,9278,1279,12.1
"01099",1,99,1996,10625,9018,1607,15.1
"01099",1,99,1997,10231,8685,1546,15.1
"01099",1,99,1998,9526,8439,1087,11.4
"01099",1,99,1999,9644,8490,1154,12
"01099",1,99,2000,10273,9612,661,6.4
"01099",1,99,2001,9894,9180,714,7.2
"01099",1,99,2002,9708,8888,820,8.4
"01099",1,99,2003,9417,8627,790,8.4
"01099",1,99,2004,9706,8976,730,7.5
"01099",1,99,2005,9587,8996,591,6.2
"01099",1,99,2006,9323,8759,564,6
"01099",1,99,2007,8945,8369,576,6.4
"01099",1,99,2008,8789,7896,893,10.2
"01099",1,99,2009,8666,6978,1688,19.5
"01099",1,99,2010,8712,7131,1581,18.1
"01099",1,99,2011,8325,7017,1308,15.7
"01099",1,99,2012,7971,6971,1000,12.5
"01099",1,99,2013,7766,6843,923,11.9
"01099",1,99,2014,7617,6775,842,11.1
"01099",1,99,2015,7340,6601,739,10.1
"01099",1,99,2016,7314,6650,664,9.1
"01099",1,99,2017,7165,6682,483,6.7
"01101",1,101,1990,100926,94637,6289,6.2
"01101",1,101,1991,99765,93702,6063,6.1
"01101",1,101,1992,102742,96270,6472,6.3
"01101",1,101,1993,104515,98414,6101,5.8
"01101",1,101,1994,105245,99895,5350,5.1
"01101",1,101,1995,106867,101087,5780,5.4
"01101",1,101,1996,107670,103100,4570,4.2
"01101",1,101,1997,109850,105063,4787,4.4
"01101",1,101,1998,109888,106015,3873,3.5
"01101",1,101,1999,110193,106029,4164,3.8
"01101",1,101,2000,105729,101315,4414,4.2
"01101",1,101,2001,104949,100201,4748,4.5
"01101",1,101,2002,103870,98333,5537,5.3
"01101",1,101,2003,104505,98402,6103,5.8
"01101",1,101,2004,104751,98692,6059,5.8
"01101",1,101,2005,105148,100336,4812,4.6
"01101",1,101,2006,105711,101297,4414,4.2
"01101",1,101,2007,106156,101798,4358,4.1
"01101",1,101,2008,106155,99875,6280,5.9
"01101",1,101,2009,105106,94078,11028,10.5
"01101",1,101,2010,108753,97892,10861,10
"01101",1,101,2011,109092,98491,10601,9.7
"01101",1,101,2012,107320,98666,8654,8.1
"01101",1,101,2013,106360,98613,7747,7.3
"01101",1,101,2014,105042,97838,7204,6.9
"01101",1,101,2015,105051,98643,6408,6.1
"01101",1,101,2016,105737,99733,6004,5.7
"01101",1,101,2017,105505,100964,4541,4.3
"01103",1,103,1990,50464,47234,3230,6.4
"01103",1,103,1991,50777,47113,3664,7.2
"01103",1,103,1992,50944,47010,3934,7.7
"01103",1,103,1993,51774,48064,3710,7.2
"01103",1,103,1994,52210,48689,3521,6.7
"01103",1,103,1995,53398,50194,3204,6
"01103",1,103,1996,53682,51107,2575,4.8
"01103",1,103,1997,55021,52419,2602,4.7
"01103",1,103,1998,56054,53823,2231,4
"01103",1,103,1999,56569,54149,2420,4.3
"01103",1,103,2000,56248,53884,2364,4.2
"01103",1,103,2001,56248,53372,2876,5.1
"01103",1,103,2002,55311,51794,3517,6.4
"01103",1,103,2003,55227,51605,3622,6.6
"01103",1,103,2004,55996,52576,3420,6.1
"01103",1,103,2005,55700,53187,2513,4.5
"01103",1,103,2006,55887,53635,2252,4
"01103",1,103,2007,56642,54654,1988,3.5
"01103",1,103,2008,56997,54014,2983,5.2
"01103",1,103,2009,56388,50294,6094,10.8
"01103",1,103,2010,57817,51600,6217,10.8
"01103",1,103,2011,58319,52810,5509,9.4
"01103",1,103,2012,57410,52931,4479,7.8
"01103",1,103,2013,57001,53090,3911,6.9
"01103",1,103,2014,56053,52357,3696,6.6
"01103",1,103,2015,54904,51678,3226,5.9
"01103",1,103,2016,54852,51812,3040,5.5
"01103",1,103,2017,54840,52588,2252,4.1
"01105",1,105,1990,4860,4229,631,13
"01105",1,105,1991,4654,4028,626,13.5
"01105",1,105,1992,4906,4231,675,13.8
"01105",1,105,1993,4847,4123,724,14.9
"01105",1,105,1994,4915,4172,743,15.1
"01105",1,105,1995,4906,4059,847,17.3
"01105",1,105,1996,4501,3929,572,12.7
"01105",1,105,1997,4505,4045,460,10.2
"01105",1,105,1998,4443,4055,388,8.7
"01105",1,105,1999,4577,4154,423,9.2
"01105",1,105,2000,4103,3725,378,9.2
"01105",1,105,2001,3873,3448,425,11
"01105",1,105,2002,3847,3393,454,11.8
"01105",1,105,2003,3843,3432,411,10.7
"01105",1,105,2004,3697,3320,377,10.2
"01105",1,105,2005,3537,3215,322,9.1
"01105",1,105,2006,3586,3284,302,8.4
"01105",1,105,2007,3543,3244,299,8.4
"01105",1,105,2008,3592,3186,406,11.3
"01105",1,105,2009,3770,3021,749,19.9
"01105",1,105,2010,3891,3236,655,16.8
"01105",1,105,2011,3866,3227,639,16.5
"01105",1,105,2012,3683,3192,491,13.3
"01105",1,105,2013,3566,3083,483,13.5
"01105",1,105,2014,3490,3067,423,12.1
"01105",1,105,2015,3485,3137,348,10
"01105",1,105,2016,3466,3108,358,10.3
"01105",1,105,2017,3402,3132,270,7.9
"01107",1,107,1990,8606,7818,788,9.2
"01107",1,107,1991,8775,7906,869,9.9
"01107",1,107,1992,9052,8061,991,10.9
"01107",1,107,1993,9171,8110,1061,11.6
"01107",1,107,1994,9006,8237,769,8.5
"01107",1,107,1995,8938,8140,798,8.9
"01107",1,107,1996,8877,8041,836,9.4
"01107",1,107,1997,8824,8131,693,7.9
"01107",1,107,1998,8699,8002,697,8
"01107",1,107,1999,8577,7683,894,10.4
"01107",1,107,2000,8597,7952,645,7.5
"01107",1,107,2001,8440,7732,708,8.4
"01107",1,107,2002,8248,7569,679,8.2
"01107",1,107,2003,8138,7475,663,8.1
"01107",1,107,2004,8027,7416,611,7.6
"01107",1,107,2005,7960,7527,433,5.4
"01107",1,107,2006,8113,7703,410,5.1
"01107",1,107,2007,8015,7613,402,5
"01107",1,107,2008,7925,7359,566,7.1
"01107",1,107,2009,8042,6942,1100,13.7
"01107",1,107,2010,7699,6687,1012,13.1
"01107",1,107,2011,7570,6663,907,12
"01107",1,107,2012,7467,6709,758,10.2
"01107",1,107,2013,7420,6727,693,9.3
"01107",1,107,2014,7762,7126,636,8.2
"01107",1,107,2015,8007,7465,542,6.8
"01107",1,107,2016,7764,7230,534,6.9
"01107",1,107,2017,7783,7371,412,5.3
"01109",1,109,1990,12309,11564,745,6.1
"01109",1,109,1991,12308,11329,979,8
"01109",1,109,1992,12427,11474,953,7.7
"01109",1,109,1993,12976,12077,899,6.9
"01109",1,109,1994,13193,12433,760,5.8
"01109",1,109,1995,13364,12553,811,6.1
"01109",1,109,1996,13507,12609,898,6.6
"01109",1,109,1997,13437,12538,899,6.7
"01109",1,109,1998,13209,12530,679,5.1
"01109",1,109,1999,13667,12922,745,5.5
"01109",1,109,2000,14060,13285,775,5.5
"01109",1,109,2001,13524,12806,718,5.3
"01109",1,109,2002,13707,12888,819,6
"01109",1,109,2003,14397,13556,841,5.8
"01109",1,109,2004,15084,14268,816,5.4
"01109",1,109,2005,15013,14401,612,4.1
"01109",1,109,2006,15166,14557,609,4
"01109",1,109,2007,15575,14947,628,4
"01109",1,109,2008,15805,15034,771,4.9
"01109",1,109,2009,15803,14300,1503,9.5
"01109",1,109,2010,15677,14198,1479,9.4
"01109",1,109,2011,15438,14070,1368,8.9
"01109",1,109,2012,15017,13819,1198,8
"01109",1,109,2013,14924,13785,1139,7.6
"01109",1,109,2014,14953,13852,1101,7.4
"01109",1,109,2015,14939,13956,983,6.6
"01109",1,109,2016,14946,13973,973,6.5
"01109",1,109,2017,15238,14495,743,4.9
"01111",1,111,1990,9278,8561,717,7.7
"01111",1,111,1991,9329,8411,918,9.8
"01111",1,111,1992,9659,8915,744,7.7
"01111",1,111,1993,9715,8804,911,9.4
"01111",1,111,1994,9813,9132,681,6.9
"01111",1,111,1995,9814,9063,751,7.7
"01111",1,111,1996,9640,9064,576,6
"01111",1,111,1997,9517,9073,444,4.7
"01111",1,111,1998,9659,9159,500,5.2
"01111",1,111,1999,9286,8730,556,6
"01111",1,111,2000,9961,9478,483,4.8
"01111",1,111,2001,9927,9306,621,6.3
"01111",1,111,2002,9682,9025,657,6.8
"01111",1,111,2003,9791,9061,730,7.5
"01111",1,111,2004,10046,9367,679,6.8
"01111",1,111,2005,9823,9218,605,6.2
"01111",1,111,2006,9758,9237,521,5.3
"01111",1,111,2007,9487,9005,482,5.1
"01111",1,111,2008,9609,8905,704,7.3
"01111",1,111,2009,9415,8014,1401,14.9
"01111",1,111,2010,9706,8410,1296,13.4
"01111",1,111,2011,9447,8374,1073,11.4
"01111",1,111,2012,9143,8304,839,9.2
"01111",1,111,2013,9212,8498,714,7.8
"01111",1,111,2014,9277,8653,624,6.7
"01111",1,111,2015,9433,8876,557,5.9
"01111",1,111,2016,9426,8899,527,5.6
"01111",1,111,2017,9373,8961,412,4.4
"01113",1,113,1990,21686,19926,1760,8.1
"01113",1,113,1991,21871,20005,1866,8.5
"01113",1,113,1992,21785,20035,1750,8
"01113",1,113,1993,22536,20819,1717,7.6
"01113",1,113,1994,23314,21906,1408,6
"01113",1,113,1995,24049,22557,1492,6.2
"01113",1,113,1996,25020,23855,1165,4.7
"01113",1,113,1997,25219,24073,1146,4.5
"01113",1,113,1998,25404,24395,1009,4
"01113",1,113,1999,25607,24363,1244,4.9
"01113",1,113,2000,21998,20984,1014,4.6
"01113",1,113,2001,21461,20278,1183,5.5
"01113",1,113,2002,21454,19951,1503,7
"01113",1,113,2003,21870,20224,1646,7.5
"01113",1,113,2004,21356,19950,1406,6.6
"01113",1,113,2005,21501,20203,1298,6
"01113",1,113,2006,21467,20204,1263,5.9
"01113",1,113,2007,21734,20414,1320,6.1
"01113",1,113,2008,21693,19959,1734,8
"01113",1,113,2009,21566,18903,2663,12.3
"01113",1,113,2010,23814,21225,2589,10.9
"01113",1,113,2011,24604,22077,2527,10.3
"01113",1,113,2012,24911,22725,2186,8.8
"01113",1,113,2013,25018,23208,1810,7.2
"01113",1,113,2014,24774,23156,1618,6.5
"01113",1,113,2015,24104,22674,1430,5.9
"01113",1,113,2016,23524,22217,1307,5.6
"01113",1,113,2017,23457,22449,1008,4.3
"01115",1,115,1990,23395,22102,1293,5.5
"01115",1,115,1991,23970,22496,1474,6.1
"01115",1,115,1992,25075,23353,1722,6.9
"01115",1,115,1993,25874,24257,1617,6.2
"01115",1,115,1994,26475,25405,1070,4
"01115",1,115,1995,27322,26301,1021,3.7
"01115",1,115,1996,28507,27571,936,3.3
"01115",1,115,1997,29781,28786,995,3.3
"01115",1,115,1998,30519,29632,887,2.9
"01115",1,115,1999,31476,30387,1089,3.5
"01115",1,115,2000,31353,30179,1174,3.7
"01115",1,115,2001,31672,30347,1325,4.2
"01115",1,115,2002,31935,30304,1631,5.1
"01115",1,115,2003,32291,30607,1684,5.2
"01115",1,115,2004,33092,31429,1663,5
"01115",1,115,2005,33750,32407,1343,4
"01115",1,115,2006,35053,33819,1234,3.5
"01115",1,115,2007,36040,34813,1227,3.4
"01115",1,115,2008,36482,34651,1831,5
"01115",1,115,2009,36770,32765,4005,10.9
"01115",1,115,2010,38280,34397,3883,10.1
"01115",1,115,2011,38509,35135,3374,8.8
"01115",1,115,2012,38516,35871,2645,6.9
"01115",1,115,2013,38835,36455,2380,6.1
"01115",1,115,2014,38524,36302,2222,5.8
"01115",1,115,2015,38570,36552,2018,5.2
"01115",1,115,2016,39073,37043,2030,5.2
"01115",1,115,2017,38946,37400,1546,4
"01117",1,117,1990,53271,51538,1733,3.3
"01117",1,117,1991,54777,52612,2165,4
"01117",1,117,1992,57415,55039,2376,4.1
"01117",1,117,1993,60627,58503,2124,3.5
"01117",1,117,1994,64400,62539,1861,2.9
"01117",1,117,1995,68530,66813,1717,2.5
"01117",1,117,1996,71758,70350,1408,2
"01117",1,117,1997,76505,75104,1401,1.8
"01117",1,117,1998,79741,78506,1235,1.5
"01117",1,117,1999,82638,81267,1371,1.7
"01117",1,117,2000,82280,80035,2245,2.7
"01117",1,117,2001,84095,81644,2451,2.9
"01117",1,117,2002,85670,82640,3030,3.5
"01117",1,117,2003,88275,85144,3131,3.5
"01117",1,117,2004,91524,88411,3113,3.4
"01117",1,117,2005,94699,91783,2916,3.1
"01117",1,117,2006,98394,95698,2696,2.7
"01117",1,117,2007,99647,97043,2604,2.6
"01117",1,117,2008,101156,97375,3781,3.7
"01117",1,117,2009,99773,92015,7758,7.8
"01117",1,117,2010,102372,95110,7262,7.1
"01117",1,117,2011,104214,97727,6487,6.2
"01117",1,117,2012,105458,100158,5300,5
"01117",1,117,2013,107004,102054,4950,4.6
"01117",1,117,2014,107247,102440,4807,4.5
"01117",1,117,2015,108198,103643,4555,4.2
"01117",1,117,2016,109551,104831,4720,4.3
"01117",1,117,2017,109331,105804,3527,3.2
"01119",1,119,1990,5999,5416,583,9.7
"01119",1,119,1991,5913,5267,646,10.9
"01119",1,119,1992,6125,5346,779,12.7
"01119",1,119,1993,6170,5385,785,12.7
"01119",1,119,1994,6207,5425,782,12.6
"01119",1,119,1995,6307,5474,833,13.2
"01119",1,119,1996,6206,5424,782,12.6
"01119",1,119,1997,6088,5337,751,12.3
"01119",1,119,1998,5650,5105,545,9.6
"01119",1,119,1999,5501,4905,596,10.8
"01119",1,119,2000,5381,4893,488,9.1
"01119",1,119,2001,5121,4690,431,8.4
"01119",1,119,2002,5100,4642,458,9
"01119",1,119,2003,5110,4594,516,10.1
"01119",1,119,2004,4974,4498,476,9.6
"01119",1,119,2005,4865,4512,353,7.3
"01119",1,119,2006,4791,4465,326,6.8
"01119",1,119,2007,4778,4466,312,6.5
"01119",1,119,2008,4721,4308,413,8.7
"01119",1,119,2009,4761,4051,710,14.9
"01119",1,119,2010,5777,5006,771,13.3
"01119",1,119,2011,5560,4829,731,13.1
"01119",1,119,2012,5417,4848,569,10.5
"01119",1,119,2013,5463,4969,494,9
"01119",1,119,2014,5374,4918,456,8.5
"01119",1,119,2015,5107,4699,408,8
"01119",1,119,2016,5110,4716,394,7.7
"01119",1,119,2017,5016,4688,328,6.5
"01121",1,121,1990,33647,30550,3097,9.2
"01121",1,121,1991,33671,30515,3156,9.4
"01121",1,121,1992,34786,31305,3481,10
"01121",1,121,1993,34492,31496,2996,8.7
"01121",1,121,1994,34898,32123,2775,8
"01121",1,121,1995,35374,32760,2614,7.4
"01121",1,121,1996,35673,32826,2847,8
"01121",1,121,1997,35408,33008,2400,6.8
"01121",1,121,1998,34848,32945,1903,5.5
"01121",1,121,1999,34284,32215,2069,6
"01121",1,121,2000,35593,33753,1840,5.2
"01121",1,121,2001,35832,33489,2343,6.5
"01121",1,121,2002,37297,34552,2745,7.4
"01121",1,121,2003,38205,35246,2959,7.7
"01121",1,121,2004,38820,36178,2642,6.8
"01121",1,121,2005,39684,37777,1907,4.8
"01121",1,121,2006,39456,37413,2043,5.2
"01121",1,121,2007,38922,36898,2024,5.2
"01121",1,121,2008,38278,35519,2759,7.2
"01121",1,121,2009,37787,32348,5439,14.4
"01121",1,121,2010,35129,30389,4740,13.5
"01121",1,121,2011,35293,31192,4101,11.6
"01121",1,121,2012,35013,31731,3282,9.4
"01121",1,121,2013,35771,32700,3071,8.6
"01121",1,121,2014,35399,32651,2748,7.8
"01121",1,121,2015,35134,32824,2310,6.6
"01121",1,121,2016,34807,32507,2300,6.6
"01121",1,121,2017,34501,32789,1712,5
"01123",1,123,1990,19241,18006,1235,6.4
"01123",1,123,1991,19230,18033,1197,6.2
"01123",1,123,1992,19431,18433,998,5.1
"01123",1,123,1993,19906,18511,1395,7
"01123",1,123,1994,20105,18832,1273,6.3
"01123",1,123,1995,20240,19087,1153,5.7
"01123",1,123,1996,20479,19274,1205,5.9
"01123",1,123,1997,20501,19442,1059,5.2
"01123",1,123,1998,20305,19398,907,4.5
"01123",1,123,1999,19868,18832,1036,5.2
"01123",1,123,2000,19358,18412,946,4.9
"01123",1,123,2001,19257,18117,1140,5.9
"01123",1,123,2002,18860,17377,1483,7.9
"01123",1,123,2003,18456,17174,1282,6.9
"01123",1,123,2004,18367,17222,1145,6.2
"01123",1,123,2005,18587,17748,839,4.5
"01123",1,123,2006,18536,17595,941,5.1
"01123",1,123,2007,18311,17340,971,5.3
"01123",1,123,2008,18179,16875,1304,7.2
"01123",1,123,2009,18149,15687,2462,13.6
"01123",1,123,2010,19079,16579,2500,13.1
"01123",1,123,2011,18363,16266,2097,11.4
"01123",1,123,2012,18441,16850,1591,8.6
"01123",1,123,2013,18399,16909,1490,8.1
"01123",1,123,2014,18424,17041,1383,7.5
"01123",1,123,2015,18740,17598,1142,6.1
"01123",1,123,2016,18575,17537,1038,5.6
"01123",1,123,2017,18279,17519,760,4.2
"01125",1,125,1990,70025,66816,3209,4.6
"01125",1,125,1991,70361,66651,3710,5.3
"01125",1,125,1992,70606,66411,4195,5.9
"01125",1,125,1993,72694,68860,3834,5.3
"01125",1,125,1994,74717,71178,3539,4.7
"01125",1,125,1995,76368,72934,3434,4.5
"01125",1,125,1996,77962,75139,2823,3.6
"01125",1,125,1997,81348,78651,2697,3.3
"01125",1,125,1998,83083,80725,2358,2.8
"01125",1,125,1999,83605,81135,2470,3
"01125",1,125,2000,81655,78451,3204,3.9
"01125",1,125,2001,81357,77953,3404,4.2
"01125",1,125,2002,81553,77763,3790,4.6
"01125",1,125,2003,82091,78055,4036,4.9
"01125",1,125,2004,83274,79315,3959,4.8
"01125",1,125,2005,84810,81638,3172,3.7
"01125",1,125,2006,87495,84619,2876,3.3
"01125",1,125,2007,89008,86080,2928,3.3
"01125",1,125,2008,89185,84978,4207,4.7
"01125",1,125,2009,89100,80043,9057,10.2
"01125",1,125,2010,93915,85273,8642,9.2
"01125",1,125,2011,95463,87532,7931,8.3
"01125",1,125,2012,95340,88683,6657,7
"01125",1,125,2013,95678,89602,6076,6.4
"01125",1,125,2014,97092,91359,5733,5.9
"01125",1,125,2015,98867,93482,5385,5.4
"01125",1,125,2016,99232,93619,5613,5.7
"01125",1,125,2017,99237,95127,4110,4.1
"01127",1,127,1990,30210,27387,2823,9.3
"01127",1,127,1991,30059,26513,3546,11.8
"01127",1,127,1992,30465,26697,3768,12.4
"01127",1,127,1993,29919,26686,3233,10.8
"01127",1,127,1994,29656,27009,2647,8.9
"01127",1,127,1995,30309,28047,2262,7.5
"01127",1,127,1996,30303,28321,1982,6.5
"01127",1,127,1997,30162,27780,2382,7.9
"01127",1,127,1998,29375,27647,1728,5.9
"01127",1,127,1999,28653,26864,1789,6.2
"01127",1,127,2000,31502,29674,1828,5.8
"01127",1,127,2001,31227,29358,1869,6
"01127",1,127,2002,30684,28737,1947,6.3
"01127",1,127,2003,30327,28360,1967,6.5
"01127",1,127,2004,30156,28306,1850,6.1
"01127",1,127,2005,29772,28455,1317,4.4
"01127",1,127,2006,29877,28516,1361,4.6
"01127",1,127,2007,29056,27800,1256,4.3
"01127",1,127,2008,28758,27113,1645,5.7
"01127",1,127,2009,28190,24910,3280,11.6
"01127",1,127,2010,27279,23815,3464,12.7
"01127",1,127,2011,27092,24034,3058,11.3
"01127",1,127,2012,26574,24136,2438,9.2
"01127",1,127,2013,26364,24136,2228,8.5
"01127",1,127,2014,25761,23724,2037,7.9
"01127",1,127,2015,25560,23714,1846,7.2
"01127",1,127,2016,25561,23656,1905,7.5
"01127",1,127,2017,25145,23883,1262,5
"01129",1,129,1990,6598,5893,705,10.7
"01129",1,129,1991,6362,5505,857,13.5
"01129",1,129,1992,6430,5336,1094,17
"01129",1,129,1993,6705,5537,1168,17.4
"01129",1,129,1994,6468,5598,870,13.5
"01129",1,129,1995,6400,5521,879,13.7
"01129",1,129,1996,6183,5479,704,11.4
"01129",1,129,1997,6484,5621,863,13.3
"01129",1,129,1998,6226,5427,799,12.8
"01129",1,129,1999,5983,5257,726,12.1
"01129",1,129,2000,7728,7200,528,6.8
"01129",1,129,2001,7440,6776,664,8.9
"01129",1,129,2002,7167,6423,744,10.4
"01129",1,129,2003,7103,6362,741,10.4
"01129",1,129,2004,6937,6273,664,9.6
"01129",1,129,2005,6887,6458,429,6.2
"01129",1,129,2006,6901,6501,400,5.8
"01129",1,129,2007,7002,6586,416,5.9
"01129",1,129,2008,6883,6302,581,8.4
"01129",1,129,2009,6935,5889,1046,15.1
"01129",1,129,2010,7385,6335,1050,14.2
"01129",1,129,2011,7106,6070,1036,14.6
"01129",1,129,2012,6875,6054,821,11.9
"01129",1,129,2013,6714,5985,729,10.9
"01129",1,129,2014,6656,6017,639,9.6
"01129",1,129,2015,6699,6102,597,8.9
"01129",1,129,2016,6740,6158,582,8.6
"01129",1,129,2017,6656,6201,455,6.8
"01131",1,131,1990,4239,3714,525,12.4
"01131",1,131,1991,3981,3357,624,15.7
"01131",1,131,1992,4079,3346,733,18
"01131",1,131,1993,4030,3315,715,17.7
"01131",1,131,1994,3957,3348,609,15.4
"01131",1,131,1995,3949,3322,627,15.9
"01131",1,131,1996,3876,3326,550,14.2
"01131",1,131,1997,3908,3355,553,14.2
"01131",1,131,1998,3769,3265,504,13.4
"01131",1,131,1999,3810,3268,542,14.2
"01131",1,131,2000,3939,3595,344,8.7
"01131",1,131,2001,3835,3448,387,10.1
"01131",1,131,2002,3816,3380,436,11.4
"01131",1,131,2003,3818,3345,473,12.4
"01131",1,131,2004,3726,3276,450,12.1
"01131",1,131,2005,3626,3290,336,9.3
"01131",1,131,2006,3571,3260,311,8.7
"01131",1,131,2007,3438,3106,332,9.7
"01131",1,131,2008,3482,2996,486,14
"01131",1,131,2009,3648,2698,950,26
"01131",1,131,2010,3066,2261,805,26.3
"01131",1,131,2011,2979,2289,690,23.2
"01131",1,131,2012,2883,2308,575,19.9
"01131",1,131,2013,2780,2244,536,19.3
"01131",1,131,2014,2865,2380,485,16.9
"01131",1,131,2015,2824,2410,414,14.7
"01131",1,131,2016,2818,2411,407,14.4
"01131",1,131,2017,2808,2488,320,11.4
"01133",1,133,1990,10482,9241,1241,11.8
"01133",1,133,1991,10435,9113,1322,12.7
"01133",1,133,1992,10927,9895,1032,9.4
"01133",1,133,1993,11880,10978,902,7.6
"01133",1,133,1994,12306,11567,739,6
"01133",1,133,1995,12777,11981,796,6.2
"01133",1,133,1996,13038,12211,827,6.3
"01133",1,133,1997,13175,12175,1000,7.6
"01133",1,133,1998,12661,11934,727,5.7
"01133",1,133,1999,12410,11623,787,6.3
"01133",1,133,2000,11687,10776,911,7.8
"01133",1,133,2001,10737,9732,1005,9.4
"01133",1,133,2002,10478,9561,917,8.8
"01133",1,133,2003,10407,9418,989,9.5
"01133",1,133,2004,10337,9580,757,7.3
"01133",1,133,2005,10365,9840,525,5.1
"01133",1,133,2006,10591,10067,524,4.9
"01133",1,133,2007,10287,9712,575,5.6
"01133",1,133,2008,9984,9120,864,8.7
"01133",1,133,2009,9519,7832,1687,17.7
"01133",1,133,2010,9883,8304,1579,16
"01133",1,133,2011,9819,8492,1327,13.5
"01133",1,133,2012,9607,8647,960,10
"01133",1,133,2013,9644,8737,907,9.4
"01133",1,133,2014,9634,8806,828,8.6
"01133",1,133,2015,9375,8669,706,7.5
"01133",1,133,2016,9530,8853,677,7.1
"01133",1,133,2017,9646,9164,482,5
"02013",2,13,1990,1303,1298,5,.4
"02013",2,13,1991,1434,1417,17,1.2
"02013",2,13,1992,1590,1567,23,1.4
"02013",2,13,1993,1490,1460,30,2
"02013",2,13,1994,1502,1460,42,2.8
"02013",2,13,1995,1585,1530,55,3.5
"02013",2,13,1996,1608,1540,68,4.2
"02013",2,13,1997,1572,1515,57,3.6
"02013",2,13,1998,1571,1520,51,3.2
"02013",2,13,1999,1558,1501,57,3.7
"02013",2,13,2000,940,858,82,8.7
"02013",2,13,2001,1011,926,85,8.4
"02013",2,13,2002,969,883,86,8.9
"02013",2,13,2003,1010,911,99,9.8
"02013",2,13,2004,1112,1016,96,8.6
"02013",2,13,2005,1077,974,103,9.6
"02013",2,13,2006,1141,1044,97,8.5
"02013",2,13,2007,1094,1007,87,8
"02013",2,13,2008,1144,1045,99,8.7
"02013",2,13,2009,1133,1021,112,9.9
"02013",2,13,2010,2031,1917,114,5.6
"02013",2,13,2011,2183,2048,135,6.2
"02013",2,13,2012,2138,1993,145,6.8
"02013",2,13,2013,2217,2083,134,6
"02013",2,13,2014,2228,2127,101,4.5
"02013",2,13,2015,2479,2399,80,3.2
"02013",2,13,2016,2591,2521,70,2.7
"02013",2,13,2017,2584,2519,65,2.5
"02016",2,16,1990,3542,3525,17,.5
"02016",2,16,1991,3760,3724,36,1
"02016",2,16,1992,3900,3858,42,1.1
"02016",2,16,1993,4007,3958,49,1.2
"02016",2,16,1994,2911,2841,70,2.4
"02016",2,16,1995,2404,2339,65,2.7
"02016",2,16,1996,2327,2235,92,4
"02016",2,16,1997,2262,2134,128,5.7
"02016",2,16,1998,2037,1895,142,7
"02016",2,16,1999,2033,1895,138,6.8
"02016",2,16,2000,2735,2592,143,5.2
"02016",2,16,2001,2636,2478,158,6
"02016",2,16,2002,2733,2560,173,6.3
"02016",2,16,2003,2931,2743,188,6.4
"02016",2,16,2004,3069,2870,199,6.5
"02016",2,16,2005,3143,2963,180,5.7
"02016",2,16,2006,3214,3031,183,5.7
"02016",2,16,2007,3085,2917,168,5.4
"02016",2,16,2008,3061,2883,178,5.8
"02016",2,16,2009,3005,2794,211,7
"02016",2,16,2010,3955,3755,200,5.1
"02016",2,16,2011,4255,4007,248,5.8
"02016",2,16,2012,4268,3972,296,6.9
"02016",2,16,2013,4272,3976,296,6.9
"02016",2,16,2014,4480,4264,216,4.8
"02016",2,16,2015,4072,3914,158,3.9
"02016",2,16,2016,3986,3853,133,3.3
"02016",2,16,2017,3861,3721,140,3.6
"02020",2,20,1990,122065,115696,6369,5.2
"02020",2,20,1991,123222,115028,8194,6.6
"02020",2,20,1992,127755,118683,9072,7.1
"02020",2,20,1993,132440,124599,7841,5.9
"02020",2,20,1994,134131,126757,7374,5.5
"02020",2,20,1995,133751,126722,7029,5.3
"02020",2,20,1996,135338,128139,7199,5.3
"02020",2,20,1997,137585,130388,7197,5.2
"02020",2,20,1998,140781,134456,6325,4.5
"02020",2,20,1999,142144,135610,6534,4.6
"02020",2,20,2000,140602,133453,7149,5.1
"02020",2,20,2001,141933,134782,7151,5
"02020",2,20,2002,143887,135505,8382,5.8
"02020",2,20,2003,145428,136227,9201,6.3
"02020",2,20,2004,146277,137591,8686,5.9
"02020",2,20,2005,149028,140840,8188,5.5
"02020",2,20,2006,151530,143482,8048,5.3
"02020",2,20,2007,151051,143336,7715,5.1
"02020",2,20,2008,152111,143835,8276,5.4
"02020",2,20,2009,153834,143806,10028,6.5
"02020",2,20,2010,157923,147539,10384,6.6
"02020",2,20,2011,159006,149542,9464,6
"02020",2,20,2012,158380,149897,8483,5.4
"02020",2,20,2013,158401,150169,8232,5.2
"02020",2,20,2014,158213,149973,8240,5.2
"02020",2,20,2015,157011,149082,7929,5
"02020",2,20,2016,155798,147142,8656,5.6
"02020",2,20,2017,155462,146175,9287,6
"02050",2,50,1990,4041,3748,293,7.3
"02050",2,50,1991,4619,4226,393,8.5
"02050",2,50,1992,5154,4705,449,8.7
"02050",2,50,1993,5051,4699,352,7
"02050",2,50,1994,5426,5029,397,7.3
"02050",2,50,1995,5754,5292,462,8
"02050",2,50,1996,5942,5387,555,9.3
"02050",2,50,1997,5833,5358,475,8.1
"02050",2,50,1998,6177,5671,506,8.2
"02050",2,50,1999,6330,5786,544,8.6
"02050",2,50,2000,6401,5824,577,9
"02050",2,50,2001,6321,5688,633,10
"02050",2,50,2002,6835,6109,726,10.6
"02050",2,50,2003,7059,6192,867,12.3
"02050",2,50,2004,7004,6116,888,12.7
"02050",2,50,2005,7089,6182,907,12.8
"02050",2,50,2006,6980,6057,923,13.2
"02050",2,50,2007,6951,6062,889,12.8
"02050",2,50,2008,6935,5972,963,13.9
"02050",2,50,2009,7031,6039,992,14.1
"02050",2,50,2010,7161,6114,1047,14.6
"02050",2,50,2011,7221,6137,1084,15
"02050",2,50,2012,7211,6103,1108,15.4
"02050",2,50,2013,7424,6224,1200,16.2
"02050",2,50,2014,7312,6136,1176,16.1
"02050",2,50,2015,7377,6314,1063,14.4
"02050",2,50,2016,7267,6225,1042,14.3
"02050",2,50,2017,7445,6418,1027,13.8
"02060",2,60,1990,473,453,20,4.2
"02060",2,60,1991,533,505,28,5.3
"02060",2,60,1992,616,581,35,5.7
"02060",2,60,1993,636,598,38,6
"02060",2,60,1994,480,451,29,6
"02060",2,60,1995,564,528,36,6.4
"02060",2,60,1996,586,544,42,7.2
"02060",2,60,1997,597,552,45,7.5
"02060",2,60,1998,508,464,44,8.7
"02060",2,60,1999,503,456,47,9.3
"02060",2,60,2000,925,866,59,6.4
"02060",2,60,2001,947,895,52,5.5
"02060",2,60,2002,905,844,61,6.7
"02060",2,60,2003,971,910,61,6.3
"02060",2,60,2004,1040,974,66,6.3
"02060",2,60,2005,971,914,57,5.9
"02060",2,60,2006,1021,966,55,5.4
"02060",2,60,2007,1064,1014,50,4.7
"02060",2,60,2008,1009,960,49,4.9
"02060",2,60,2009,1045,995,50,4.8
"02060",2,60,2010,505,456,49,9.7
"02060",2,60,2011,518,472,46,8.9
"02060",2,60,2012,481,434,47,9.8
"02060",2,60,2013,491,448,43,8.8
"02060",2,60,2014,497,457,40,8
"02060",2,60,2015,382,346,36,9.4
"02060",2,60,2016,414,385,29,7
"02060",2,60,2017,426,399,27,6.3
"02068",2,68,1990,992,860,132,13.3
"02068",2,68,1991,1012,887,125,12.4
"02068",2,68,1992,1048,947,101,9.6
"02068",2,68,1993,1027,932,95,9.3
"02068",2,68,1994,1089,990,99,9.1
"02068",2,68,1995,1142,1037,105,9.2
"02068",2,68,1996,1211,1105,106,8.8
"02068",2,68,1997,1230,1102,128,10.4
"02068",2,68,1998,1181,1078,103,8.7
"02068",2,68,1999,1148,1049,99,8.6
"02068",2,68,2000,1342,1244,98,7.3
"02068",2,68,2001,1450,1355,95,6.6
"02068",2,68,2002,1523,1411,112,7.4
"02068",2,68,2003,1408,1283,125,8.9
"02068",2,68,2004,1516,1396,120,7.9
"02068",2,68,2005,1590,1486,104,6.5
"02068",2,68,2006,1648,1552,96,5.8
"02068",2,68,2007,1602,1502,100,6.2
"02068",2,68,2008,1606,1508,98,6.1
"02068",2,68,2009,1412,1295,117,8.3
"02068",2,68,2010,1011,891,120,11.9
"02068",2,68,2011,1018,879,139,13.7
"02068",2,68,2012,1047,903,144,13.8
"02068",2,68,2013,1078,943,135,12.5
"02068",2,68,2014,1073,962,111,10.3
"02068",2,68,2015,1072,978,94,8.8
"02068",2,68,2016,1096,996,100,9.1
"02068",2,68,2017,1130,1024,106,9.4
"02070",2,70,1990,1212,1131,81,6.7
"02070",2,70,1991,1374,1279,95,6.9
"02070",2,70,1992,1571,1443,128,8.1
"02070",2,70,1993,1551,1434,117,7.5
"02070",2,70,1994,1621,1506,115,7.1
"02070",2,70,1995,1654,1550,104,6.3
"02070",2,70,1996,1706,1575,131,7.7
"02070",2,70,1997,1671,1560,111,6.6
"02070",2,70,1998,1762,1637,125,7.1
"02070",2,70,1999,1811,1677,134,7.4
"02070",2,70,2000,1963,1818,145,7.4
"02070",2,70,2001,1914,1757,157,8.2
"02070",2,70,2002,1930,1734,196,10.2
"02070",2,70,2003,1923,1708,215,11.2
"02070",2,70,2004,2049,1826,223,10.9
"02070",2,70,2005,2062,1842,220,10.7
"02070",2,70,2006,2103,1902,201,9.6
"02070",2,70,2007,2045,1858,187,9.1
"02070",2,70,2008,2068,1875,193,9.3
"02070",2,70,2009,2152,1933,219,10.2
"02070",2,70,2010,2089,1878,211,10.1
"02070",2,70,2011,2106,1883,223,10.6
"02070",2,70,2012,2132,1921,211,9.9
"02070",2,70,2013,2134,1916,218,10.2
"02070",2,70,2014,2121,1908,213,10
"02070",2,70,2015,2044,1846,198,9.7
"02070",2,70,2016,2082,1880,202,9.7
"02070",2,70,2017,2055,1864,191,9.3
"02090",2,90,1990,35580,32503,3077,8.6
"02090",2,90,1991,36770,33154,3616,9.8
"02090",2,90,1992,38900,35210,3690,9.5
"02090",2,90,1993,39730,36413,3317,8.3
"02090",2,90,1994,40919,37628,3291,8
"02090",2,90,1995,41375,38263,3112,7.5
"02090",2,90,1996,42788,39606,3182,7.4
"02090",2,90,1997,43418,40445,2973,6.8
"02090",2,90,1998,43457,40792,2665,6.1
"02090",2,90,1999,43557,40924,2633,6
"02090",2,90,2000,41013,38486,2527,6.2
"02090",2,90,2001,41423,38910,2513,6.1
"02090",2,90,2002,41826,39065,2761,6.6
"02090",2,90,2003,42599,39603,2996,7
"02090",2,90,2004,44051,41206,2845,6.5
"02090",2,90,2005,45247,42606,2641,5.8
"02090",2,90,2006,45211,42634,2577,5.7
"02090",2,90,2007,45385,42858,2527,5.6
"02090",2,90,2008,45993,43198,2795,6.1
"02090",2,90,2009,46015,42756,3259,7.1
"02090",2,90,2010,48285,45083,3202,6.6
"02090",2,90,2011,48354,45238,3116,6.4
"02090",2,90,2012,48197,45264,2933,6.1
"02090",2,90,2013,47286,44514,2772,5.9
"02090",2,90,2014,46833,44129,2704,5.8
"02090",2,90,2015,46469,43929,2540,5.5
"02090",2,90,2016,46550,43792,2758,5.9
"02090",2,90,2017,46708,43768,2940,6.3
"02100",2,100,1990,1084,1006,78,7.2
"02100",2,100,1991,1163,991,172,14.8
"02100",2,100,1992,1117,983,134,12
"02100",2,100,1993,1098,997,101,9.2
"02100",2,100,1994,1165,1047,118,10.1
"02100",2,100,1995,1189,1058,131,11
"02100",2,100,1996,1180,1047,133,11.3
"02100",2,100,1997,1200,1072,128,10.7
"02100",2,100,1998,1232,1107,125,10.1
"02100",2,100,1999,1246,1110,136,10.9
"02100",2,100,2000,1397,1284,113,8.1
"02100",2,100,2001,1250,1125,125,10
"02100",2,100,2002,1277,1130,147,11.5
"02100",2,100,2003,1360,1200,160,11.8
"02100",2,100,2004,1410,1270,140,9.9
"02100",2,100,2005,1472,1340,132,9
"02100",2,100,2006,1453,1336,117,8.1
"02100",2,100,2007,1446,1339,107,7.4
"02100",2,100,2008,1358,1238,120,8.8
"02100",2,100,2009,1416,1288,128,9
"02100",2,100,2010,1150,1028,122,10.6
"02100",2,100,2011,1167,1050,117,10
"02100",2,100,2012,1108,997,111,10
"02100",2,100,2013,1142,1026,116,10.2
"02100",2,100,2014,1113,994,119,10.7
"02100",2,100,2015,1089,982,107,9.8
"02100",2,100,2016,1077,966,111,10.3
"02100",2,100,2017,1089,990,99,9.1
"02105",2,105,2010,1064,915,149,14
"02105",2,105,2011,1099,933,166,15.1
"02105",2,105,2012,1109,950,159,14.3
"02105",2,105,2013,1124,959,165,14.7
"02105",2,105,2014,1141,968,173,15.2
"02105",2,105,2015,1136,964,172,15.1
"02105",2,105,2016,1207,1063,144,11.9
"02105",2,105,2017,1140,996,144,12.6
"02110",2,110,1990,15089,14298,791,5.2
"02110",2,110,1991,15401,14438,963,6.3
"02110",2,110,1992,16101,14996,1105,6.9
"02110",2,110,1993,16233,15243,990,6.1
"02110",2,110,1994,16263,15309,954,5.9
"02110",2,110,1995,16739,15774,965,5.8
"02110",2,110,1996,17087,16065,1022,6
"02110",2,110,1997,17338,16349,989,5.7
"02110",2,110,1998,16950,15987,963,5.7
"02110",2,110,1999,17150,16283,867,5.1
"02110",2,110,2000,18021,17177,844,4.7
"02110",2,110,2001,17986,17130,856,4.8
"02110",2,110,2002,17963,16979,984,5.5
"02110",2,110,2003,18058,17005,1053,5.8
"02110",2,110,2004,17932,16882,1050,5.9
"02110",2,110,2005,18349,17370,979,5.3
"02110",2,110,2006,18544,17645,899,4.8
"02110",2,110,2007,18459,17626,833,4.5
"02110",2,110,2008,18784,17882,902,4.8
"02110",2,110,2009,18393,17309,1084,5.9
"02110",2,110,2010,17903,16848,1055,5.9
"02110",2,110,2011,17907,16913,994,5.6
"02110",2,110,2012,17904,16991,913,5.1
"02110",2,110,2013,17589,16702,887,5
"02110",2,110,2014,17475,16592,883,5.1
"02110",2,110,2015,17118,16309,809,4.7
"02110",2,110,2016,17372,16587,785,4.5
"02110",2,110,2017,17435,16607,828,4.7
"02122",2,122,1990,18799,16546,2253,12
"02122",2,122,1991,19685,17075,2610,13.3
"02122",2,122,1992,20178,17166,3012,14.9
"02122",2,122,1993,20536,17898,2638,12.8
"02122",2,122,1994,21120,18505,2615,12.4
"02122",2,122,1995,21593,18938,2655,12.3
"02122",2,122,1996,22226,19206,3020,13.6
"02122",2,122,1997,22062,19347,2715,12.3
"02122",2,122,1998,21668,19366,2302,10.6
"02122",2,122,1999,21981,19543,2438,11.1
"02122",2,122,2000,24598,22567,2031,8.3
"02122",2,122,2001,24340,22322,2018,8.3
"02122",2,122,2002,24790,22402,2388,9.6
"02122",2,122,2003,25039,22476,2563,10.2
"02122",2,122,2004,25312,22883,2429,9.6
"02122",2,122,2005,25321,23105,2216,8.8
"02122",2,122,2006,25460,23373,2087,8.2
"02122",2,122,2007,25700,23674,2026,7.9
"02122",2,122,2008,26330,24176,2154,8.2
"02122",2,122,2009,26909,24267,2642,9.8
"02122",2,122,2010,27001,24310,2691,10
"02122",2,122,2011,27273,24675,2598,9.5
"02122",2,122,2012,27367,25003,2364,8.6
"02122",2,122,2013,27831,25592,2239,8
"02122",2,122,2014,27979,25780,2199,7.9
"02122",2,122,2015,27685,25511,2174,7.9
"02122",2,122,2016,27227,24889,2338,8.6
"02122",2,122,2017,27095,24795,2300,8.5
"02130",2,130,1990,7432,6845,587,7.9
"02130",2,130,1991,7473,6777,696,9.3
"02130",2,130,1992,7654,6947,707,9.2
"02130",2,130,1993,7681,7015,666,8.7
"02130",2,130,1994,7702,7078,624,8.1
"02130",2,130,1995,7773,7181,592,7.6
"02130",2,130,1996,7924,7256,668,8.4
"02130",2,130,1997,7608,6954,654,8.6
"02130",2,130,1998,7579,6999,580,7.7
"02130",2,130,1999,7599,7051,548,7.2
"02130",2,130,2000,8294,7772,522,6.3
"02130",2,130,2001,8136,7585,551,6.8
"02130",2,130,2002,7768,7113,655,8.4
"02130",2,130,2003,7789,7156,633,8.1
"02130",2,130,2004,7876,7286,590,7.5
"02130",2,130,2005,7966,7430,536,6.7
"02130",2,130,2006,8100,7603,497,6.1
"02130",2,130,2007,8222,7757,465,5.7
"02130",2,130,2008,8297,7805,492,5.9
"02130",2,130,2009,8331,7738,593,7.1
"02130",2,130,2010,7123,6501,622,8.7
"02130",2,130,2011,7180,6560,620,8.6
"02130",2,130,2012,7177,6594,583,8.1
"02130",2,130,2013,7168,6606,562,7.8
"02130",2,130,2014,7112,6553,559,7.9
"02130",2,130,2015,6974,6493,481,6.9
"02130",2,130,2016,7040,6577,463,6.6
"02130",2,130,2017,7104,6656,448,6.3
"02150",2,150,1990,6300,5964,336,5.3
"02150",2,150,1991,6722,6184,538,8
"02150",2,150,1992,6917,6203,714,10.3
"02150",2,150,1993,7209,6497,712,9.9
"02150",2,150,1994,7703,6800,903,11.7
"02150",2,150,1995,7527,6783,744,9.9
"02150",2,150,1996,7452,6764,688,9.2
"02150",2,150,1997,7352,6690,662,9
"02150",2,150,1998,6966,6413,553,7.9
"02150",2,150,1999,6828,6327,501,7.3
"02150",2,150,2000,6544,5996,548,8.4
"02150",2,150,2001,6446,5869,577,9
"02150",2,150,2002,6294,5724,570,9.1
"02150",2,150,2003,5961,5377,584,9.8
"02150",2,150,2004,6171,5627,544,8.8
"02150",2,150,2005,6056,5556,500,8.3
"02150",2,150,2006,6148,5688,460,7.5
"02150",2,150,2007,6141,5756,385,6.3
"02150",2,150,2008,6399,5961,438,6.8
"02150",2,150,2009,6603,6131,472,7.1
"02150",2,150,2010,6470,5993,477,7.4
"02150",2,150,2011,6783,6281,502,7.4
"02150",2,150,2012,6717,6268,449,6.7
"02150",2,150,2013,6594,6183,411,6.2
"02150",2,150,2014,6587,6213,374,5.7
"02150",2,150,2015,6630,6310,320,4.8
"02150",2,150,2016,6430,6096,334,5.2
"02150",2,150,2017,6447,6118,329,5.1
"02158",2,158,1990,1365,1200,165,12.1
"02158",2,158,1991,1557,1361,196,12.6
"02158",2,158,1992,1712,1528,184,10.7
"02158",2,158,1993,1709,1529,180,10.5
"02158",2,158,1994,1825,1633,192,10.5
"02158",2,158,1995,1924,1699,225,11.7
"02158",2,158,1996,1935,1732,203,10.5
"02158",2,158,1997,1963,1740,223,11.4
"02158",2,158,1998,2141,1838,303,14.2
"02158",2,158,1999,2199,1876,323,14.7
"02158",2,158,2000,2237,1894,343,15.3
"02158",2,158,2001,2346,1978,368,15.7
"02158",2,158,2002,2486,2051,435,17.5
"02158",2,158,2003,2656,2176,480,18.1
"02158",2,158,2004,2501,1995,506,20.2
"02158",2,158,2005,2542,2011,531,20.9
"02158",2,158,2006,2539,2012,527,20.8
"02158",2,158,2007,2584,2057,527,20.4
"02158",2,158,2008,2616,2078,538,20.6
"02158",2,158,2009,2696,2135,561,20.8
"02158",2,158,2010,2658,2115,543,20.4
"02158",2,158,2011,2759,2177,582,21.1
"02158",2,158,2012,2768,2156,612,22.1
"02158",2,158,2013,2782,2124,658,23.7
"02158",2,158,2014,2831,2157,674,23.8
"02158",2,158,2015,2815,2163,652,23.2
"02158",2,158,2016,2734,2140,594,21.7
"02158",2,158,2017,2805,2242,563,20.1
"02164",2,164,1990,441,414,27,6.1
"02164",2,164,1991,498,462,36,7.2
"02164",2,164,1992,568,518,50,8.8
"02164",2,164,1993,535,495,40,7.5
"02164",2,164,1994,562,528,34,6
"02164",2,164,1995,593,551,42,7.1
"02164",2,164,1996,589,543,46,7.8
"02164",2,164,1997,568,530,38,6.7
"02164",2,164,1998,606,557,49,8.1
"02164",2,164,1999,611,565,46,7.5
"02164",2,164,2000,1036,982,54,5.2
"02164",2,164,2001,965,904,61,6.3
"02164",2,164,2002,917,847,70,7.6
"02164",2,164,2003,942,865,77,8.2
"02164",2,164,2004,915,825,90,9.8
"02164",2,164,2005,1040,964,76,7.3
"02164",2,164,2006,1081,1015,66,6.1
"02164",2,164,2007,1166,1102,64,5.5
"02164",2,164,2008,1137,1059,78,6.9
"02164",2,164,2009,1088,1000,88,8.1
"02164",2,164,2010,604,517,87,14.4
"02164",2,164,2011,638,542,96,15
"02164",2,164,2012,637,540,97,15.2
"02164",2,164,2013,638,539,99,15.5
"02164",2,164,2014,645,540,105,16.3
"02164",2,164,2015,647,566,81,12.5
"02164",2,164,2016,657,574,83,12.6
"02164",2,164,2017,723,637,86,11.9
"02170",2,170,1990,17861,15691,2170,12.1
"02170",2,170,1991,19977,17557,2420,12.1
"02170",2,170,1992,21128,18365,2763,13.1
"02170",2,170,1993,22496,20051,2445,10.9
"02170",2,170,1994,24956,22360,2596,10.4
"02170",2,170,1995,25555,22960,2595,10.2
"02170",2,170,1996,26802,23982,2820,10.5
"02170",2,170,1997,28173,25494,2679,9.5
"02170",2,170,1998,28936,26748,2188,7.6
"02170",2,170,1999,29721,27255,2466,8.3
"02170",2,170,2000,28873,26751,2122,7.3
"02170",2,170,2001,29867,27719,2148,7.2
"02170",2,170,2002,31314,28722,2592,8.3
"02170",2,170,2003,32820,29928,2892,8.8
"02170",2,170,2004,34464,31583,2881,8.4
"02170",2,170,2005,36728,33928,2800,7.6
"02170",2,170,2006,39042,36118,2924,7.5
"02170",2,170,2007,39800,36934,2866,7.2
"02170",2,170,2008,41532,38372,3160,7.6
"02170",2,170,2009,42490,38714,3776,8.9
"02170",2,170,2010,42314,38319,3995,9.4
"02170",2,170,2011,43368,39390,3978,9.2
"02170",2,170,2012,43757,39968,3789,8.7
"02170",2,170,2013,43925,40253,3672,8.4
"02170",2,170,2014,44926,41304,3622,8.1
"02170",2,170,2015,46260,42698,3562,7.7
"02170",2,170,2016,47520,43580,3940,8.3
"02170",2,170,2017,47397,43292,4105,8.7
"02180",2,180,1990,3157,2867,290,9.2
"02180",2,180,1991,3274,2912,362,11.1
"02180",2,180,1992,3157,2763,394,12.5
"02180",2,180,1993,3270,2885,385,11.8
"02180",2,180,1994,3459,3047,412,11.9
"02180",2,180,1995,3406,2966,440,12.9
"02180",2,180,1996,3415,2984,431,12.6
"02180",2,180,1997,3310,2955,355,10.7
"02180",2,180,1998,3413,3075,338,9.9
"02180",2,180,1999,3147,2779,368,11.7
"02180",2,180,2000,3703,3343,360,9.7
"02180",2,180,2001,3693,3329,364,9.9
"02180",2,180,2002,3857,3470,387,10
"02180",2,180,2003,3913,3486,427,10.9
"02180",2,180,2004,3948,3488,460,11.7
"02180",2,180,2005,3979,3486,493,12.4
"02180",2,180,2006,3897,3427,470,12.1
"02180",2,180,2007,3796,3374,422,11.1
"02180",2,180,2008,3991,3577,414,10.4
"02180",2,180,2009,3968,3505,463,11.7
"02180",2,180,2010,4111,3595,516,12.6
"02180",2,180,2011,4127,3619,508,12.3
"02180",2,180,2012,4178,3690,488,11.7
"02180",2,180,2013,4142,3631,511,12.3
"02180",2,180,2014,4128,3620,508,12.3
"02180",2,180,2015,4090,3601,489,12
"02180",2,180,2016,4095,3571,524,12.8
"02180",2,180,2017,4089,3575,514,12.6
"02185",2,185,1990,2797,2696,101,3.6
"02185",2,185,1991,2924,2794,130,4.4
"02185",2,185,1992,2850,2729,121,4.2
"02185",2,185,1993,2999,2862,137,4.6
"02185",2,185,1994,3197,3075,122,3.8
"02185",2,185,1995,3170,3052,118,3.7
"02185",2,185,1996,3243,3090,153,4.7
"02185",2,185,1997,3256,3094,162,5
"02185",2,185,1998,3293,3103,190,5.8
"02185",2,185,1999,3113,2863,250,8
"02185",2,185,2000,3404,3116,288,8.5
"02185",2,185,2001,3712,3430,282,7.6
"02185",2,185,2002,3765,3438,327,8.7
"02185",2,185,2003,3701,3318,383,10.3
"02185",2,185,2004,3666,3291,375,10.2
"02185",2,185,2005,3719,3384,335,9
"02185",2,185,2006,4144,3860,284,6.9
"02185",2,185,2007,4672,4420,252,5.4
"02185",2,185,2008,5145,4927,218,4.2
"02185",2,185,2009,5304,5053,251,4.7
"02185",2,185,2010,3968,3649,319,8
"02185",2,185,2011,3993,3690,303,7.6
"02185",2,185,2012,4027,3715,312,7.7
"02185",2,185,2013,4072,3772,300,7.4
"02185",2,185,2014,4354,4094,260,6
"02185",2,185,2015,4312,4065,247,5.7
"02185",2,185,2016,3962,3691,271,6.8
"02185",2,185,2017,3670,3397,273,7.4
"02188",2,188,1990,2105,1791,314,14.9
"02188",2,188,1991,2174,1827,347,16
"02188",2,188,1992,2175,1733,442,20.3
"02188",2,188,1993,2183,1815,368,16.9
"02188",2,188,1994,2273,1923,350,15.4
"02188",2,188,1995,2216,1856,360,16.2
"02188",2,188,1996,2261,1855,406,18
"02188",2,188,1997,2180,1860,320,14.7
"02188",2,188,1998,2209,1950,259,11.7
"02188",2,188,1999,2055,1770,285,13.9
"02188",2,188,2000,2946,2678,268,9.1
"02188",2,188,2001,3025,2722,303,10
"02188",2,188,2002,3064,2712,352,11.5
"02188",2,188,2003,2979,2584,395,13.3
"02188",2,188,2004,2869,2486,383,13.3
"02188",2,188,2005,3062,2698,364,11.9
"02188",2,188,2006,2963,2627,336,11.3
"02188",2,188,2007,2968,2646,322,10.8
"02188",2,188,2008,2982,2637,345,11.6
"02188",2,188,2009,2988,2632,356,11.9
"02188",2,188,2010,2957,2560,397,13.4
"02188",2,188,2011,2987,2524,463,15.5
"02188",2,188,2012,3031,2554,477,15.7
"02188",2,188,2013,3068,2564,504,16.4
"02188",2,188,2014,3010,2497,513,17
"02188",2,188,2015,2916,2448,468,16
"02188",2,188,2016,2973,2494,479,16.1
"02188",2,188,2017,2961,2463,498,16.8
"02195",2,195,2010,1844,1698,146,7.9
"02195",2,195,2011,1856,1701,155,8.4
"02195",2,195,2012,1878,1725,153,8.1
"02195",2,195,2013,1659,1515,144,8.7
"02195",2,195,2014,1584,1434,150,9.5
"02195",2,195,2015,1497,1363,134,9
"02195",2,195,2016,1453,1321,132,9.1
"02195",2,195,2017,1413,1281,132,9.3
"02198",2,198,2010,2543,2276,267,10.5
"02198",2,198,2011,2572,2254,318,12.4
"02198",2,198,2012,2591,2247,344,13.3
"02198",2,198,2013,2811,2468,343,12.2
"02198",2,198,2014,2838,2459,379,13.4
"02198",2,198,2015,2768,2419,349,12.6
"02198",2,198,2016,2775,2435,340,12.3
"02198",2,198,2017,2836,2512,324,11.4
"02201",2,201,1990,2883,2563,320,11.1
"02201",2,201,1991,2973,2567,406,13.7
"02201",2,201,1992,2984,2617,367,12.3
"02201",2,201,1993,3066,2769,297,9.7
"02201",2,201,1994,3209,2837,372,11.6
"02201",2,201,1995,3314,2956,358,10.8
"02201",2,201,1996,3429,2982,447,13
"02201",2,201,1997,3411,2980,431,12.6
"02201",2,201,1998,3231,2804,427,13.2
"02201",2,201,1999,3212,2780,432,13.4
"02201",2,201,2000,2667,2286,381,14.3
"02201",2,201,2001,2362,1998,364,15.4
"02201",2,201,2002,2352,1984,368,15.6
"02201",2,201,2003,2451,2092,359,14.6
"02201",2,201,2004,2553,2207,346,13.6
"02201",2,201,2005,2568,2232,336,13.1
"02201",2,201,2006,2353,2016,337,14.3
"02201",2,201,2007,2275,1966,309,13.6
"02201",2,201,2008,2338,2015,323,13.8
"02201",2,201,2009,2385,2022,363,15.2
"02220",2,220,1990,4463,4232,231,5.2
"02220",2,220,1991,4475,4214,261,5.8
"02220",2,220,1992,4627,4356,271,5.9
"02220",2,220,1993,4739,4451,288,6.1
"02220",2,220,1994,4831,4354,477,9.9
"02220",2,220,1995,4610,4324,286,6.2
"02220",2,220,1996,4523,4227,296,6.5
"02220",2,220,1997,4522,4253,269,5.9
"02220",2,220,1998,4326,4081,245,5.7
"02220",2,220,1999,4322,4093,229,5.3
"02220",2,220,2000,4454,4239,215,4.8
"02220",2,220,2001,4472,4257,215,4.8
"02220",2,220,2002,4610,4339,271,5.9
"02220",2,220,2003,4664,4373,291,6.2
"02220",2,220,2004,4578,4289,289,6.3
"02220",2,220,2005,4745,4481,264,5.6
"02220",2,220,2006,4684,4431,253,5.4
"02220",2,220,2007,4635,4398,237,5.1
"02220",2,220,2008,4621,4353,268,5.8
"02220",2,220,2009,4646,4357,289,6.2
"02220",2,220,2010,4561,4274,287,6.3
"02220",2,220,2011,4632,4348,284,6.1
"02220",2,220,2012,4647,4384,263,5.7
"02220",2,220,2013,4625,4371,254,5.5
"02220",2,220,2014,4686,4447,239,5.1
"02220",2,220,2015,4607,4395,212,4.6
"02220",2,220,2016,4380,4176,204,4.7
"02220",2,220,2017,4449,4241,208,4.7
"02230",2,230,2010,718,614,104,14.5
"02230",2,230,2011,716,600,116,16.2
"02230",2,230,2012,754,648,106,14.1
"02230",2,230,2013,794,695,99,12.5
"02230",2,230,2014,806,710,96,11.9
"02230",2,230,2015,814,720,94,11.5
"02230",2,230,2016,808,717,91,11.3
"02230",2,230,2017,824,737,87,10.6
"02232",2,232,1990,2506,2247,259,10.3
"02232",2,232,1991,2442,2190,252,10.3
"02232",2,232,1992,2502,2238,264,10.6
"02232",2,232,1993,2527,2289,238,9.4
"02232",2,232,1994,2323,2123,200,8.6
"02232",2,232,1995,2324,2145,179,7.7
"02232",2,232,1996,2262,2126,136,6
"02232",2,232,1997,2290,2136,154,6.7
"02232",2,232,1998,2166,1980,186,8.6
"02232",2,232,1999,2075,1922,153,7.4
"02232",2,232,2000,1831,1649,182,9.9
"02232",2,232,2001,1842,1624,218,11.8
"02232",2,232,2002,1797,1576,221,12.3
"02232",2,232,2003,1876,1651,225,12
"02232",2,232,2004,1764,1530,234,13.3
"02232",2,232,2005,1846,1601,245,13.3
"02232",2,232,2006,1898,1657,241,12.7
"02232",2,232,2007,1925,1685,240,12.5
"02232",2,232,2008,1921,1673,248,12.9
"02232",2,232,2009,1796,1532,264,14.7
"02240",2,240,1990,2228,1944,284,12.7
"02240",2,240,1991,2158,1864,294,13.6
"02240",2,240,1992,2222,1936,286,12.9
"02240",2,240,1993,2321,2025,296,12.8
"02240",2,240,1994,2465,2149,316,12.8
"02240",2,240,1995,2527,2211,316,12.5
"02240",2,240,1996,2507,2174,333,13.3
"02240",2,240,1997,2470,2189,281,11.4
"02240",2,240,1998,2616,2357,259,9.9
"02240",2,240,1999,2573,2311,262,10.2
"02240",2,240,2000,2270,1988,282,12.4
"02240",2,240,2001,2128,1849,279,13.1
"02240",2,240,2002,2266,1951,315,13.9
"02240",2,240,2003,2506,2180,326,13
"02240",2,240,2004,2764,2431,333,12
"02240",2,240,2005,3310,2963,347,10.5
"02240",2,240,2006,3344,2986,358,10.7
"02240",2,240,2007,3555,3246,309,8.7
"02240",2,240,2008,3555,3241,314,8.8
"02240",2,240,2009,3612,3264,348,9.6
"02240",2,240,2010,3196,2816,380,11.9
"02240",2,240,2011,3202,2804,398,12.4
"02240",2,240,2012,3038,2647,391,12.9
"02240",2,240,2013,3013,2617,396,13.1
"02240",2,240,2014,2924,2537,387,13.2
"02240",2,240,2015,3013,2692,321,10.7
"02240",2,240,2016,3004,2679,325,10.8
"02240",2,240,2017,2969,2659,310,10.4
"02261",2,261,1990,5170,4585,585,11.3
"02261",2,261,1991,5096,4611,485,9.5
"02261",2,261,1992,5086,4568,518,10.2
"02261",2,261,1993,5230,4743,487,9.3
"02261",2,261,1994,5312,4798,514,9.7
"02261",2,261,1995,5384,4857,527,9.8
"02261",2,261,1996,5331,4760,571,10.7
"02261",2,261,1997,5360,4822,538,10
"02261",2,261,1998,5113,4651,462,9
"02261",2,261,1999,5079,4618,461,9.1
"02261",2,261,2000,5224,4824,400,7.7
"02261",2,261,2001,5080,4635,445,8.8
"02261",2,261,2002,5196,4681,515,9.9
"02261",2,261,2003,5375,4829,546,10.2
"02261",2,261,2004,5380,4844,536,10
"02261",2,261,2005,5264,4764,500,9.5
"02261",2,261,2006,5192,4749,443,8.5
"02261",2,261,2007,5219,4778,441,8.4
"02261",2,261,2008,5259,4816,443,8.4
"02261",2,261,2009,5340,4887,453,8.5
"02261",2,261,2010,4875,4419,456,9.4
"02261",2,261,2011,4938,4449,489,9.9
"02261",2,261,2012,4894,4419,475,9.7
"02261",2,261,2013,4934,4444,490,9.9
"02261",2,261,2014,4888,4416,472,9.7
"02261",2,261,2015,4889,4465,424,8.7
"02261",2,261,2016,4821,4404,417,8.6
"02261",2,261,2017,4898,4508,390,8
"02275",2,275,2010,1027,945,82,8
"02275",2,275,2011,1051,972,79,7.5
"02275",2,275,2012,1026,942,84,8.2
"02275",2,275,2013,1059,974,85,8
"02275",2,275,2014,1061,972,89,8.4
"02275",2,275,2015,1033,951,82,7.9
"02275",2,275,2016,1056,976,80,7.6
"02275",2,275,2017,1050,969,81,7.7
"02280",2,280,1990,3589,3274,315,8.8
"02280",2,280,1991,3568,3210,358,10
"02280",2,280,1992,3637,3283,354,9.7
"02280",2,280,1993,3660,3343,317,8.7
"02280",2,280,1994,3686,3355,331,9
"02280",2,280,1995,3745,3352,393,10.5
"02280",2,280,1996,3706,3314,392,10.6
"02280",2,280,1997,3640,3304,336,9.2
"02280",2,280,1998,3511,3177,334,9.5
"02280",2,280,1999,3541,3226,315,8.9
"02280",2,280,2000,3078,2777,301,9.8
"02280",2,280,2001,3039,2725,314,10.3
"02280",2,280,2002,2993,2654,339,11.3
"02280",2,280,2003,3011,2642,369,12.3
"02280",2,280,2004,2917,2556,361,12.4
"02280",2,280,2005,2931,2635,296,10.1
"02280",2,280,2006,2907,2629,278,9.6
"02280",2,280,2007,2875,2598,277,9.6
"02280",2,280,2008,2813,2513,300,10.7
"02280",2,280,2009,2871,2572,299,10.4
"02282",2,282,1994,301,261,40,13.3
"02282",2,282,1995,305,283,22,7.2
"02282",2,282,1996,321,302,19,5.9
"02282",2,282,1997,327,299,28,8.6
"02282",2,282,1998,323,279,44,13.6
"02282",2,282,1999,302,276,26,8.6
"02282",2,282,2000,371,345,26,7
"02282",2,282,2001,329,300,29,8.8
"02282",2,282,2002,317,288,29,9.1
"02282",2,282,2003,302,268,34,11.3
"02282",2,282,2004,306,273,33,10.8
"02282",2,282,2005,320,286,34,10.6
"02282",2,282,2006,311,281,30,9.6
"02282",2,282,2007,308,287,21,6.8
"02282",2,282,2008,320,296,24,7.5
"02282",2,282,2009,314,278,36,11.5
"02282",2,282,2010,297,265,32,10.8
"02282",2,282,2011,301,269,32,10.6
"02282",2,282,2012,288,260,28,9.7
"02282",2,282,2013,285,258,27,9.5
"02282",2,282,2014,273,246,27,9.9
"02282",2,282,2015,259,237,22,8.5
"02282",2,282,2016,245,224,21,8.6
"02282",2,282,2017,235,213,22,9.4
"02290",2,290,1990,1945,1662,283,14.6
"02290",2,290,1991,1992,1666,326,16.4
"02290",2,290,1992,2071,1703,368,17.8
"02290",2,290,1993,2012,1710,302,15
"02290",2,290,1994,1943,1630,313,16.1
"02290",2,290,1995,2038,1682,356,17.5
"02290",2,290,1996,2078,1716,362,17.4
"02290",2,290,1997,2020,1726,294,14.6
"02290",2,290,1998,2122,1841,281,13.2
"02290",2,290,1999,2105,1808,297,14.1
"02290",2,290,2000,2644,2338,306,11.6
"02290",2,290,2001,2743,2439,304,11.1
"02290",2,290,2002,2767,2407,360,13
"02290",2,290,2003,2941,2542,399,13.6
"02290",2,290,2004,3298,2903,395,12
"02290",2,290,2005,3139,2772,367,11.7
"02290",2,290,2006,2790,2424,366,13.1
"02290",2,290,2007,2763,2382,381,13.8
"02290",2,290,2008,2786,2393,393,14.1
"02290",2,290,2009,2876,2471,405,14.1
"02290",2,290,2010,2567,2125,442,17.2
"02290",2,290,2011,2706,2208,498,18.4
"02290",2,290,2012,2773,2291,482,17.4
"02290",2,290,2013,2736,2234,502,18.3
"02290",2,290,2014,2588,2097,491,19
"02290",2,290,2015,2415,1971,444,18.4
"02290",2,290,2016,2430,1993,437,18
"02290",2,290,2017,2486,2032,454,18.3
"04001",4,1,1990,17290,15029,2261,13.1
"04001",4,1,1991,17565,15207,2358,13.4
"04001",4,1,1992,18713,15684,3029,16.2
"04001",4,1,1993,18348,15162,3186,17.4
"04001",4,1,1994,19729,16213,3516,17.8
"04001",4,1,1995,20627,17081,3546,17.2
"04001",4,1,1996,20627,16533,4094,19.8
"04001",4,1,1997,21639,17921,3718,17.2
"04001",4,1,1998,22414,18811,3603,16.1
"04001",4,1,1999,22687,19461,3226,14.2
"04001",4,1,2000,19028,17318,1710,9
"04001",4,1,2001,19191,17362,1829,9.5
"04001",4,1,2002,20401,18158,2243,11
"04001",4,1,2003,20638,18198,2440,11.8
"04001",4,1,2004,20403,18055,2348,11.5
"04001",4,1,2005,20054,17952,2102,10.5
"04001",4,1,2006,20365,18320,2045,10
"04001",4,1,2007,20200,18427,1773,8.8
"04001",4,1,2008,21264,18792,2472,11.6
"04001",4,1,2009,22938,19319,3619,15.8
"04001",4,1,2010,23438,19589,3849,16.4
"04001",4,1,2011,23040,18788,4252,18.5
"04001",4,1,2012,22806,18482,4324,19
"04001",4,1,2013,21829,17813,4016,18.4
"04001",4,1,2014,21129,17823,3306,15.6
"04001",4,1,2015,20518,17796,2722,13.3
"04001",4,1,2016,20223,17907,2316,11.5
"04001",4,1,2017,20419,18292,2127,10.4
"04003",4,3,1990,36825,34446,2379,6.5
"04003",4,3,1991,36973,34155,2818,7.6
"04003",4,3,1992,39068,35363,3705,9.5
"04003",4,3,1993,40875,36921,3954,9.7
"04003",4,3,1994,43352,38866,4486,10.3
"04003",4,3,1995,44404,40101,4303,9.7
"04003",4,3,1996,43706,39388,4318,9.9
"04003",4,3,1997,41467,38041,3426,8.3
"04003",4,3,1998,40987,38091,2896,7.1
"04003",4,3,1999,41615,39191,2424,5.8
"04003",4,3,2000,48643,46462,2181,4.5
"04003",4,3,2001,50293,47830,2463,4.9
"04003",4,3,2002,52540,49440,3100,5.9
"04003",4,3,2003,54049,50985,3064,5.7
"04003",4,3,2004,54664,51941,2723,5
"04003",4,3,2005,55774,53097,2677,4.8
"04003",4,3,2006,57210,54625,2585,4.5
"04003",4,3,2007,57271,54934,2337,4.1
"04003",4,3,2008,60278,56745,3533,5.9
"04003",4,3,2009,63049,58022,5027,8
"04003",4,3,2010,57023,51694,5329,9.3
"04003",4,3,2011,55917,50589,5328,9.5
"04003",4,3,2012,53898,49027,4871,9
"04003",4,3,2013,51308,46587,4721,9.2
"04003",4,3,2014,50772,46508,4264,8.4
"04003",4,3,2015,50087,46447,3640,7.3
"04003",4,3,2016,49369,46297,3072,6.2
"04003",4,3,2017,49373,46602,2771,5.6
"04005",4,5,1990,48124,44510,3614,7.5
"04005",4,5,1991,49310,45601,3709,7.5
"04005",4,5,1992,52622,47735,4887,9.3
"04005",4,5,1993,54076,49293,4783,8.8
"04005",4,5,1994,58321,53105,5216,8.9
"04005",4,5,1995,60854,55884,4970,8.2
"04005",4,5,1996,59159,53943,5216,8.8
"04005",4,5,1997,59214,54314,4900,8.3
"04005",4,5,1998,60309,55692,4617,7.7
"04005",4,5,1999,62604,58326,4278,6.8
"04005",4,5,2000,62612,59882,2730,4.4
"04005",4,5,2001,63573,60563,3010,4.7
"04005",4,5,2002,65749,62156,3593,5.5
"04005",4,5,2003,65739,61985,3754,5.7
"04005",4,5,2004,66968,63381,3587,5.4
"04005",4,5,2005,67883,64549,3334,4.9
"04005",4,5,2006,69512,66470,3042,4.4
"04005",4,5,2007,70736,68093,2643,3.7
"04005",4,5,2008,73208,69108,4100,5.6
"04005",4,5,2009,74805,68429,6376,8.5
"04005",4,5,2010,72846,65650,7196,9.9
"04005",4,5,2011,71682,64846,6836,9.5
"04005",4,5,2012,71032,64922,6110,8.6
"04005",4,5,2013,70877,65110,5767,8.1
"04005",4,5,2014,71960,66866,5094,7.1
"04005",4,5,2015,72942,68209,4733,6.5
"04005",4,5,2016,73841,69405,4436,6
"04005",4,5,2017,75381,71195,4186,5.6
"04007",4,7,1990,15555,14406,1149,7.4
"04007",4,7,1991,16478,15171,1307,7.9
"04007",4,7,1992,16881,15014,1867,11.1
"04007",4,7,1993,17784,16093,1691,9.5
"04007",4,7,1994,18951,17361,1590,8.4
"04007",4,7,1995,19613,17973,1640,8.4
"04007",4,7,1996,19319,17636,1683,8.7
"04007",4,7,1997,19538,18009,1529,7.8
"04007",4,7,1998,19621,18115,1506,7.7
"04007",4,7,1999,18836,17465,1371,7.3
"04007",4,7,2000,20334,19267,1067,5.2
"04007",4,7,2001,20408,19215,1193,5.8
"04007",4,7,2002,21006,19433,1573,7.5
"04007",4,7,2003,21039,19511,1528,7.3
"04007",4,7,2004,20754,19418,1336,6.4
"04007",4,7,2005,20667,19446,1221,5.9
"04007",4,7,2006,20972,19878,1094,5.2
"04007",4,7,2007,21166,20256,910,4.3
"04007",4,7,2008,22326,20882,1444,6.5
"04007",4,7,2009,23275,20629,2646,11.4
"04007",4,7,2010,21623,18914,2709,12.5
"04007",4,7,2011,21171,18725,2446,11.6
"04007",4,7,2012,20923,18786,2137,10.2
"04007",4,7,2013,20901,18890,2011,9.6
"04007",4,7,2014,21332,19562,1770,8.3
"04007",4,7,2015,21110,19447,1663,7.9
"04007",4,7,2016,20899,19390,1509,7.2
"04007",4,7,2017,21362,20067,1295,6.1
"04009",4,9,1990,8998,8366,632,7
"04009",4,9,1991,9311,8647,664,7.1
"04009",4,9,1992,9842,8847,995,10.1
"04009",4,9,1993,10495,9450,1045,10
"04009",4,9,1994,10732,9709,1023,9.5
"04009",4,9,1995,12238,11181,1057,8.6
"04009",4,9,1996,11423,10267,1156,10.1
"04009",4,9,1997,11165,10179,986,8.8
"04009",4,9,1998,10859,9896,963,8.9
"04009",4,9,1999,11203,10239,964,8.6
"04009",4,9,2000,12270,11604,666,5.4
"04009",4,9,2001,11910,11157,753,6.3
"04009",4,9,2002,12103,11174,929,7.7
"04009",4,9,2003,12170,11320,850,7
"04009",4,9,2004,12081,11273,808,6.7
"04009",4,9,2005,12261,11525,736,6
"04009",4,9,2006,13124,12456,668,5.1
"04009",4,9,2007,14294,13680,614,4.3
"04009",4,9,2008,16139,14997,1142,7.1
"04009",4,9,2009,15246,12952,2294,15
"04009",4,9,2010,14570,12687,1883,12.9
"04009",4,9,2011,14345,12916,1429,10
"04009",4,9,2012,14472,13242,1230,8.5
"04009",4,9,2013,14276,13173,1103,7.7
"04009",4,9,2014,14387,13320,1067,7.4
"04009",4,9,2015,14447,13388,1059,7.3
"04009",4,9,2016,14306,13344,962,6.7
"04009",4,9,2017,14423,13638,785,5.4
"04011",4,11,1990,3375,3154,221,6.5
"04011",4,11,1991,3922,3667,255,6.5
"04011",4,11,1992,3932,3536,396,10.1
"04011",4,11,1993,3995,3560,435,10.9
"04011",4,11,1994,4131,3749,382,9.2
"04011",4,11,1995,4878,4533,345,7.1
"04011",4,11,1996,4947,4552,395,8
"04011",4,11,1997,4868,4521,347,7.1
"04011",4,11,1998,4707,4311,396,8.4
"04011",4,11,1999,4391,4003,388,8.8
"04011",4,11,2000,3921,3756,165,4.2
"04011",4,11,2001,3821,3545,276,7.2
"04011",4,11,2002,3621,3349,272,7.5
"04011",4,11,2003,3531,3285,246,7
"04011",4,11,2004,3445,3267,178,5.2
"04011",4,11,2005,3493,3324,169,4.8
"04011",4,11,2006,3774,3631,143,3.8
"04011",4,11,2007,3998,3868,130,3.3
"04011",4,11,2008,4408,4174,234,5.3
"04011",4,11,2009,4396,3564,832,18.9
"04011",4,11,2010,3439,2875,564,16.4
"04011",4,11,2011,3352,2982,370,11
"04011",4,11,2012,3553,3261,292,8.2
"04011",4,11,2013,4580,4311,269,5.9
"04011",4,11,2014,4702,4397,305,6.5
"04011",4,11,2015,4027,3709,318,7.9
"04011",4,11,2016,3882,3588,294,7.6
"04011",4,11,2017,3992,3788,204,5.1
"04012",4,12,1990,5444,5074,370,6.8
"04012",4,12,1991,5311,4839,472,8.9
"04012",4,12,1992,5456,4697,759,13.9
"04012",4,12,1993,5390,4537,853,15.8
"04012",4,12,1994,6102,5277,825,13.5
"04012",4,12,1995,6631,5908,723,10.9
"04012",4,12,1996,7011,6204,807,11.5
"04012",4,12,1997,7246,6564,682,9.4
"04012",4,12,1998,7126,6510,616,8.6
"04012",4,12,1999,7234,6643,591,8.2
"04012",4,12,2000,7623,7140,483,6.3
"04012",4,12,2001,7026,6554,472,6.7
"04012",4,12,2002,7267,6768,499,6.9
"04012",4,12,2003,7451,6925,526,7.1
"04012",4,12,2004,7620,7106,514,6.7
"04012",4,12,2005,7703,7181,522,6.8
"04012",4,12,2006,7759,7311,448,5.8
"04012",4,12,2007,7655,7262,393,5.1
"04012",4,12,2008,7551,6968,583,7.7
"04012",4,12,2009,7702,6941,761,9.9
"04012",4,12,2010,7868,7063,805,10.2
"04012",4,12,2011,7827,7057,770,9.8
"04012",4,12,2012,8137,7441,696,8.6
"04012",4,12,2013,8028,7372,656,8.2
"04012",4,12,2014,7924,7324,600,7.6
"04012",4,12,2015,8135,7530,605,7.4
"04012",4,12,2016,8430,7922,508,6
"04012",4,12,2017,8681,8214,467,5.4
"04013",4,13,1990,1115127,1067092,48035,4.3
"04013",4,13,1991,1116919,1059433,57486,5.1
"04013",4,13,1992,1146457,1072627,73830,6.4
"04013",4,13,1993,1188830,1128558,60272,5.1
"04013",4,13,1994,1282482,1224312,58170,4.5
"04013",4,13,1995,1370734,1321421,49313,3.6
"04013",4,13,1996,1428288,1375721,52567,3.7
"04013",4,13,1997,1457594,1414994,42600,2.9
"04013",4,13,1998,1523284,1481060,42224,2.8
"04013",4,13,1999,1583933,1536576,47357,3
"04013",4,13,2000,1598108,1546411,51697,3.2
"04013",4,13,2001,1655742,1586141,69601,4.2
"04013",4,13,2002,1715246,1619099,96147,5.6
"04013",4,13,2003,1749197,1658323,90874,5.2
"04013",4,13,2004,1789725,1710158,79567,4.4
"04013",4,13,2005,1856076,1780954,75122,4
"04013",4,13,2006,1920575,1851719,68856,3.6
"04013",4,13,2007,1945290,1881907,63383,3.3
"04013",4,13,2008,1970741,1864614,106127,5.4
"04013",4,13,2009,1966607,1787374,179233,9.1
"04013",4,13,2010,1919590,1736764,182826,9.5
"04013",4,13,2011,1894633,1732510,162123,8.6
"04013",4,13,2012,1895634,1757601,138033,7.3
"04013",4,13,2013,1907171,1781737,125434,6.6
"04013",4,13,2014,1954459,1841230,113229,5.8
"04013",4,13,2015,2013552,1910598,102954,5.1
"04013",4,13,2016,2071011,1976440,94571,4.6
"04013",4,13,2017,2134987,2045885,89102,4.2
"04015",4,15,1990,44563,42396,2167,4.9
"04015",4,15,1991,45872,42800,3072,6.7
"04015",4,15,1992,48572,43988,4584,9.4
"04015",4,15,1993,52538,47504,5034,9.6
"04015",4,15,1994,57618,52768,4850,8.4
"04015",4,15,1995,60924,56592,4332,7.1
"04015",4,15,1996,63151,58527,4624,7.3
"04015",4,15,1997,61994,58735,3259,5.3
"04015",4,15,1998,62482,59667,2815,4.5
"04015",4,15,1999,65598,62490,3108,4.7
"04015",4,15,2000,68796,65744,3052,4.4
"04015",4,15,2001,72820,69294,3526,4.8
"04015",4,15,2002,77562,73185,4377,5.6
"04015",4,15,2003,82110,78073,4037,4.9
"04015",4,15,2004,84631,80882,3749,4.4
"04015",4,15,2005,89079,85271,3808,4.3
"04015",4,15,2006,92888,88852,4036,4.3
"04015",4,15,2007,91440,87174,4266,4.7
"04015",4,15,2008,92592,85485,7107,7.7
"04015",4,15,2009,91554,81120,10434,11.4
"04015",4,15,2010,82726,71999,10727,13
"04015",4,15,2011,79594,69823,9771,12.3
"04015",4,15,2012,77570,69021,8549,11
"04015",4,15,2013,76838,68888,7950,10.3
"04015",4,15,2014,78060,71264,6796,8.7
"04015",4,15,2015,79210,72935,6275,7.9
"04015",4,15,2016,80139,74844,5295,6.6
"04015",4,15,2017,82407,77579,4828,5.9
"04017",4,17,1990,26437,23572,2865,10.8
"04017",4,17,1991,26219,23109,3110,11.9
"04017",4,17,1992,28203,23895,4308,15.3
"04017",4,17,1993,29931,25801,4130,13.8
"04017",4,17,1994,32363,27558,4805,14.8
"04017",4,17,1995,33179,27949,5230,15.8
"04017",4,17,1996,33370,27993,5377,16.1
"04017",4,17,1997,32606,27687,4919,15.1
"04017",4,17,1998,33113,28420,4693,14.2
"04017",4,17,1999,33736,29228,4508,13.4
"04017",4,17,2000,34267,31791,2476,7.2
"04017",4,17,2001,35144,32444,2700,7.7
"04017",4,17,2002,36886,33744,3142,8.5
"04017",4,17,2003,38252,34962,3290,8.6
"04017",4,17,2004,37898,34656,3242,8.6
"04017",4,17,2005,37680,34646,3034,8.1
"04017",4,17,2006,38224,35396,2828,7.4
"04017",4,17,2007,38244,35783,2461,6.4
"04017",4,17,2008,39302,35328,3974,10.1
"04017",4,17,2009,41199,34893,6306,15.3
"04017",4,17,2010,43903,37450,6453,14.7
"04017",4,17,2011,43344,36914,6430,14.8
"04017",4,17,2012,42957,36890,6067,14.1
"04017",4,17,2013,41925,36283,5642,13.5
"04017",4,17,2014,41527,36937,4590,11.1
"04017",4,17,2015,40521,36613,3908,9.6
"04017",4,17,2016,41136,37744,3392,8.2
"04017",4,17,2017,41337,38206,3131,7.6
"04019",4,19,1990,314226,299908,14318,4.6
"04019",4,19,1991,321664,307634,14030,4.4
"04019",4,19,1992,337137,318843,18294,5.4
"04019",4,19,1993,350101,335703,14398,4.1
"04019",4,19,1994,375405,360995,14410,3.8
"04019",4,19,1995,390386,376786,13600,3.5
"04019",4,19,1996,385350,370664,14686,3.8
"04019",4,19,1997,383857,371420,12437,3.2
"04019",4,19,1998,390343,379186,11157,2.9
"04019",4,19,1999,403212,390493,12719,3.2
"04019",4,19,2000,409776,394635,15141,3.7
"04019",4,19,2001,414956,396750,18206,4.4
"04019",4,19,2002,423719,399541,24178,5.7
"04019",4,19,2003,429349,406481,22868,5.3
"04019",4,19,2004,438856,418266,20590,4.7
"04019",4,19,2005,441581,421815,19766,4.5
"04019",4,19,2006,451861,433523,18338,4.1
"04019",4,19,2007,458486,441553,16933,3.7
"04019",4,19,2008,474464,446795,27669,5.8
"04019",4,19,2009,485850,441837,44013,9.1
"04019",4,19,2010,478743,434106,44637,9.3
"04019",4,19,2011,466908,427335,39573,8.5
"04019",4,19,2012,462896,428796,34100,7.4
"04019",4,19,2013,456994,426120,30874,6.8
"04019",4,19,2014,461348,433561,27787,6
"04019",4,19,2015,463229,437916,25313,5.5
"04019",4,19,2016,467481,444339,23142,5
"04019",4,19,2017,475622,454292,21330,4.5
"04021",4,21,1990,45487,42655,2832,6.2
"04021",4,21,1991,45300,42157,3143,6.9
"04021",4,21,1992,46757,42690,4067,8.7
"04021",4,21,1993,47983,44823,3160,6.6
"04021",4,21,1994,51194,48341,2853,5.6
"04021",4,21,1995,52875,50216,2659,5
"04021",4,21,1996,57138,53723,3415,6
"04021",4,21,1997,57606,54766,2840,4.9
"04021",4,21,1998,59739,57140,2599,4.4
"04021",4,21,1999,63257,59775,3482,5.5
"04021",4,21,2000,69618,66450,3168,4.6
"04021",4,21,2001,71918,68013,3905,5.4
"04021",4,21,2002,75825,70253,5572,7.3
"04021",4,21,2003,78892,73375,5517,7
"04021",4,21,2004,81981,77037,4944,6
"04021",4,21,2005,87422,82541,4881,5.6
"04021",4,21,2006,102937,97775,5162,5
"04021",4,21,2007,111626,106534,5092,4.6
"04021",4,21,2008,122313,113278,9035,7.4
"04021",4,21,2009,126779,111192,15587,12.3
"04021",4,21,2010,153707,137242,16465,10.7
"04021",4,21,2011,149658,135043,14615,9.8
"04021",4,21,2012,148689,135995,12694,8.5
"04021",4,21,2013,148275,136324,11951,8.1
"04021",4,21,2014,153156,142463,10693,7
"04021",4,21,2015,156475,146677,9798,6.3
"04021",4,21,2016,163194,154165,9029,5.5
"04021",4,21,2017,168806,160333,8473,5
"04023",4,23,1990,12810,11080,1730,13.5
"04023",4,23,1991,13029,11195,1834,14.1
"04023",4,23,1992,13645,11271,2374,17.4
"04023",4,23,1993,14700,12171,2529,17.2
"04023",4,23,1994,15293,12113,3180,20.8
"04023",4,23,1995,15874,12606,3268,20.6
"04023",4,23,1996,15625,11575,4050,25.9
"04023",4,23,1997,14905,11851,3054,20.5
"04023",4,23,1998,14286,11652,2634,18.4
"04023",4,23,1999,14202,11813,2389,16.8
"04023",4,23,2000,14747,13538,1209,8.2
"04023",4,23,2001,15022,13693,1329,8.8
"04023",4,23,2002,15323,13769,1554,10.1
"04023",4,23,2003,15707,14208,1499,9.5
"04023",4,23,2004,15616,14124,1492,9.6
"04023",4,23,2005,16043,14663,1380,8.6
"04023",4,23,2006,16746,15468,1278,7.6
"04023",4,23,2007,17162,15893,1269,7.4
"04023",4,23,2008,17888,15916,1972,11
"04023",4,23,2009,18594,15655,2939,15.8
"04023",4,23,2010,20881,17697,3184,15.2
"04023",4,23,2011,20478,17311,3167,15.5
"04023",4,23,2012,20121,17014,3107,15.4
"04023",4,23,2013,20111,17023,3088,15.4
"04023",4,23,2014,20217,17608,2609,12.9
"04023",4,23,2015,19783,17520,2263,11.4
"04023",4,23,2016,19101,17187,1914,10
"04023",4,23,2017,19001,17194,1807,9.5
"04025",4,25,1990,44961,42926,2035,4.5
"04025",4,25,1991,47338,44833,2505,5.3
"04025",4,25,1992,51585,47910,3675,7.1
"04025",4,25,1993,56220,53144,3076,5.5
"04025",4,25,1994,61670,58445,3225,5.2
"04025",4,25,1995,65235,61946,3289,5
"04025",4,25,1996,65816,62634,3182,4.8
"04025",4,25,1997,67729,65072,2657,3.9
"04025",4,25,1998,69739,67321,2418,3.5
"04025",4,25,1999,70754,68321,2433,3.4
"04025",4,25,2000,75804,72766,3038,4
"04025",4,25,2001,78099,74599,3500,4.5
"04025",4,25,2002,83013,78534,4479,5.4
"04025",4,25,2003,85008,80664,4344,5.1
"04025",4,25,2004,87831,83750,4081,4.6
"04025",4,25,2005,91442,87403,4039,4.4
"04025",4,25,2006,96732,92833,3899,4
"04025",4,25,2007,97606,93996,3610,3.7
"04025",4,25,2008,98076,92011,6065,6.2
"04025",4,25,2009,98309,88034,10275,10.5
"04025",4,25,2010,96533,86224,10309,10.7
"04025",4,25,2011,93132,83953,9179,9.9
"04025",4,25,2012,92384,84442,7942,8.6
"04025",4,25,2013,91587,84500,7087,7.7
"04025",4,25,2014,93950,87992,5958,6.3
"04025",4,25,2015,95782,90422,5360,5.6
"04025",4,25,2016,99073,94201,4872,4.9
"04025",4,25,2017,101763,97180,4583,4.5
"04027",4,27,1990,46964,37263,9701,20.7
"04027",4,27,1991,49802,39227,10575,21.2
"04027",4,27,1992,54736,40228,14508,26.5
"04027",4,27,1993,57760,41530,16230,28.1
"04027",4,27,1994,66785,45969,20816,31.2
"04027",4,27,1995,70683,49725,20958,29.7
"04027",4,27,1996,70276,48606,21670,30.8
"04027",4,27,1997,67139,48835,18304,27.3
"04027",4,27,1998,68016,48451,19565,28.8
"04027",4,27,1999,69754,49062,20692,29.7
"04027",4,27,2000,64337,53817,10520,16.4
"04027",4,27,2001,65360,54338,11022,16.9
"04027",4,27,2002,69161,57405,11756,17
"04027",4,27,2003,72869,60560,12309,16.9
"04027",4,27,2004,73799,62116,11683,15.8
"04027",4,27,2005,76067,64004,12063,15.9
"04027",4,27,2006,77764,66129,11635,15
"04027",4,27,2007,78841,67756,11085,14.1
"04027",4,27,2008,84314,68812,15502,18.4
"04027",4,27,2009,87808,67617,20191,23
"04027",4,27,2010,92816,69500,23316,25.1
"04027",4,27,2011,91935,69677,22258,24.2
"04027",4,27,2012,93806,71429,22377,23.9
"04027",4,27,2013,94729,70567,24162,25.5
"04027",4,27,2014,93020,71756,21264,22.9
"04027",4,27,2015,93222,73038,20184,21.7
"04027",4,27,2016,93621,76016,17605,18.8
"04027",4,27,2017,95167,78942,16225,17
"05001",5,1,1990,10236,9754,482,4.7
"05001",5,1,1991,10158,9541,617,6.1
"05001",5,1,1992,10337,9641,696,6.7
"05001",5,1,1993,10537,9933,604,5.7
"05001",5,1,1994,10690,10048,642,6
"05001",5,1,1995,10928,10386,542,5
"05001",5,1,1996,10853,10255,598,5.5
"05001",5,1,1997,10535,9900,635,6
"05001",5,1,1998,10562,9953,609,5.8
"05001",5,1,1999,10836,10290,546,5
"05001",5,1,2000,10144,9678,466,4.6
"05001",5,1,2001,10244,9762,482,4.7
"05001",5,1,2002,10493,9841,652,6.2
"05001",5,1,2003,10716,10120,596,5.6
"05001",5,1,2004,10844,10195,649,6
"05001",5,1,2005,11321,10525,796,7
"05001",5,1,2006,11749,10860,889,7.6
"05001",5,1,2007,11988,10942,1046,8.7
"05001",5,1,2008,12161,10969,1192,9.8
"05001",5,1,2009,12305,10377,1928,15.7
"05001",5,1,2010,11332,9224,2108,18.6
"05001",5,1,2011,10589,9297,1292,12.2
"05001",5,1,2012,9913,9044,869,8.8
"05001",5,1,2013,9589,8884,705,7.4
"05001",5,1,2014,9466,8958,508,5.4
"05001",5,1,2015,9487,9092,395,4.2
"05001",5,1,2016,9284,8970,314,3.4
"05001",5,1,2017,9013,8719,294,3.3
"05003",5,3,1990,10961,10305,656,6
"05003",5,3,1991,10989,10184,805,7.3
"05003",5,3,1992,11132,10306,826,7.4
"05003",5,3,1993,10930,10168,762,7
"05003",5,3,1994,11396,10694,702,6.2
"05003",5,3,1995,11280,10617,663,5.9
"05003",5,3,1996,11480,10717,763,6.6
"05003",5,3,1997,11448,10587,861,7.5
"05003",5,3,1998,11285,10296,989,8.8
"05003",5,3,1999,11037,10125,912,8.3
"05003",5,3,2000,10491,9870,621,5.9
"05003",5,3,2001,10282,9504,778,7.6
"05003",5,3,2002,10205,9404,801,7.8
"05003",5,3,2003,9989,9040,949,9.5
"05003",5,3,2004,9682,8766,916,9.5
"05003",5,3,2005,9646,8844,802,8.3
"05003",5,3,2006,9798,9067,731,7.5
"05003",5,3,2007,9483,8712,771,8.1
"05003",5,3,2008,9465,8745,720,7.6
"05003",5,3,2009,9344,8359,985,10.5
"05003",5,3,2010,9745,8765,980,10.1
"05003",5,3,2011,9886,8780,1106,11.2
"05003",5,3,2012,9298,8158,1140,12.3
"05003",5,3,2013,8923,7953,970,10.9
"05003",5,3,2014,8476,7692,784,9.2
"05003",5,3,2015,8146,7515,631,7.7
"05003",5,3,2016,7748,7264,484,6.2
"05003",5,3,2017,7695,7254,441,5.7
"05005",5,5,1990,11933,11208,725,6.1
"05005",5,5,1991,11888,11193,695,5.8
"05005",5,5,1992,12481,11834,647,5.2
"05005",5,5,1993,13193,12556,637,4.8
"05005",5,5,1994,14146,13619,527,3.7
"05005",5,5,1995,14676,14194,482,3.3
"05005",5,5,1996,14682,14074,608,4.1
"05005",5,5,1997,14441,13832,609,4.2
"05005",5,5,1998,14272,13655,617,4.3
"05005",5,5,1999,14489,13921,568,3.9
"05005",5,5,2000,16266,15586,680,4.2
"05005",5,5,2001,16012,15126,886,5.5
"05005",5,5,2002,16160,15122,1038,6.4
"05005",5,5,2003,15939,14871,1068,6.7
"05005",5,5,2004,16428,15409,1019,6.2
"05005",5,5,2005,17214,16254,960,5.6
"05005",5,5,2006,17534,16604,930,5.3
"05005",5,5,2007,17748,16787,961,5.4
"05005",5,5,2008,17704,16635,1069,6
"05005",5,5,2009,17328,15715,1613,9.3
"05005",5,5,2010,16610,15050,1560,9.4
"05005",5,5,2011,16602,15061,1541,9.3
"05005",5,5,2012,16373,14994,1379,8.4
"05005",5,5,2013,16067,14775,1292,8
"05005",5,5,2014,15986,14919,1067,6.7
"05005",5,5,2015,16217,15329,888,5.5
"05005",5,5,2016,16127,15440,687,4.3
"05005",5,5,2017,16401,15707,694,4.2
"05007",5,7,1990,49044,47259,1785,3.6
"05007",5,7,1991,49988,48250,1738,3.5
"05007",5,7,1992,52118,50393,1725,3.3
"05007",5,7,1993,55466,53981,1485,2.7
"05007",5,7,1994,59767,58370,1397,2.3
"05007",5,7,1995,62956,61547,1409,2.2
"05007",5,7,1996,65165,63319,1846,2.8
"05007",5,7,1997,65887,64066,1821,2.8
"05007",5,7,1998,65555,63726,1829,2.8
"05007",5,7,1999,68697,67142,1555,2.3
"05007",5,7,2000,76753,74600,2153,2.8
"05007",5,7,2001,79685,77285,2400,3
"05007",5,7,2002,84828,82090,2738,3.2
"05007",5,7,2003,87883,84706,3177,3.6
"05007",5,7,2004,93006,89633,3373,3.6
"05007",5,7,2005,100203,96959,3244,3.2
"05007",5,7,2006,103728,100267,3461,3.3
"05007",5,7,2007,105064,101125,3939,3.7
"05007",5,7,2008,106704,102277,4427,4.1
"05007",5,7,2009,107694,100774,6920,6.4
"05007",5,7,2010,107121,99999,7122,6.6
"05007",5,7,2011,109574,102441,7133,6.5
"05007",5,7,2012,110768,104109,6659,6
"05007",5,7,2013,111857,105567,6290,5.6
"05007",5,7,2014,115420,110115,5305,4.6
"05007",5,7,2015,121826,117246,4580,3.8
"05007",5,7,2016,128180,124469,3711,2.9
"05007",5,7,2017,132496,128647,3849,2.9
"05009",5,9,1990,13887,13099,788,5.7
"05009",5,9,1991,13630,12795,835,6.1
"05009",5,9,1992,14041,13278,763,5.4
"05009",5,9,1993,14414,13810,604,4.2
"05009",5,9,1994,14855,14167,688,4.6
"05009",5,9,1995,15163,14538,625,4.1
"05009",5,9,1996,15099,14292,807,5.3
"05009",5,9,1997,14766,13938,828,5.6
"05009",5,9,1998,14855,13807,1048,7.1
"05009",5,9,1999,14876,14044,832,5.6
"05009",5,9,2000,16217,15537,680,4.2
"05009",5,9,2001,16006,15163,843,5.3
"05009",5,9,2002,16131,15219,912,5.7
"05009",5,9,2003,16050,15113,937,5.8
"05009",5,9,2004,16216,15254,962,5.9
"05009",5,9,2005,16729,15875,854,5.1
"05009",5,9,2006,17099,16256,843,4.9
"05009",5,9,2007,16987,16127,860,5.1
"05009",5,9,2008,17048,16116,932,5.5
"05009",5,9,2009,16987,15712,1275,7.5
"05009",5,9,2010,16519,15226,1293,7.8
"05009",5,9,2011,16697,15367,1330,8
"05009",5,9,2012,16523,15264,1259,7.6
"05009",5,9,2013,16048,14922,1126,7
"05009",5,9,2014,15664,14727,937,6
"05009",5,9,2015,15844,15072,772,4.9
"05009",5,9,2016,15961,15378,583,3.7
"05009",5,9,2017,15821,15278,543,3.4
"05011",5,11,1990,5202,4711,491,9.4
"05011",5,11,1991,5083,4461,622,12.2
"05011",5,11,1992,5016,4502,514,10.2
"05011",5,11,1993,4936,4495,441,8.9
"05011",5,11,1994,4988,4526,462,9.3
"05011",5,11,1995,5040,4617,423,8.4
"05011",5,11,1996,5091,4546,545,10.7
"05011",5,11,1997,5013,4442,571,11.4
"05011",5,11,1998,4751,4217,534,11.2
"05011",5,11,1999,4483,4074,409,9.1
"05011",5,11,2000,5096,4764,332,6.5
"05011",5,11,2001,5258,4875,383,7.3
"05011",5,11,2002,5440,5032,408,7.5
"05011",5,11,2003,5488,5089,399,7.3
"05011",5,11,2004,5545,5117,428,7.7
"05011",5,11,2005,5507,5074,433,7.9
"05011",5,11,2006,5719,5320,399,7
"05011",5,11,2007,5799,5446,353,6.1
"05011",5,11,2008,5622,5215,407,7.2
"05011",5,11,2009,5486,4951,535,9.8
"05011",5,11,2010,5002,4462,540,10.8
"05011",5,11,2011,4560,3988,572,12.5
"05011",5,11,2012,4371,3886,485,11.1
"05011",5,11,2013,4127,3722,405,9.8
"05011",5,11,2014,4153,3806,347,8.4
"05011",5,11,2015,4383,4117,266,6.1
"05011",5,11,2016,4300,4075,225,5.2
"05011",5,11,2017,4379,4174,205,4.7
"05013",5,13,1990,2641,2334,307,11.6
"05013",5,13,1991,2461,2200,261,10.6
"05013",5,13,1992,2414,2168,246,10.2
"05013",5,13,1993,2405,2177,228,9.5
"05013",5,13,1994,2415,2181,234,9.7
"05013",5,13,1995,2392,2164,228,9.5
"05013",5,13,1996,2294,2106,188,8.2
"05013",5,13,1997,2326,2126,200,8.6
"05013",5,13,1998,2362,2123,239,10.1
"05013",5,13,1999,2294,2080,214,9.3
"05013",5,13,2000,2553,2412,141,5.5
"05013",5,13,2001,2511,2367,144,5.7
"05013",5,13,2002,2574,2408,166,6.4
"05013",5,13,2003,2537,2336,201,7.9
"05013",5,13,2004,2586,2410,176,6.8
"05013",5,13,2005,2686,2502,184,6.9
"05013",5,13,2006,2672,2487,185,6.9
"05013",5,13,2007,2638,2461,177,6.7
"05013",5,13,2008,2613,2451,162,6.2
"05013",5,13,2009,2583,2365,218,8.4
"05013",5,13,2010,2681,2445,236,8.8
"05013",5,13,2011,2639,2385,254,9.6
"05013",5,13,2012,2511,2282,229,9.1
"05013",5,13,2013,2424,2226,198,8.2
"05013",5,13,2014,2367,2211,156,6.6
"05013",5,13,2015,2408,2277,131,5.4
"05013",5,13,2016,2381,2272,109,4.6
"05013",5,13,2017,2361,2268,93,3.9
"05015",5,15,1990,9949,9355,594,6
"05015",5,15,1991,10373,9759,614,5.9
"05015",5,15,1992,11065,10433,632,5.7
"05015",5,15,1993,11892,11283,609,5.1
"05015",5,15,1994,12339,11749,590,4.8
"05015",5,15,1995,12126,11534,592,4.9
"05015",5,15,1996,11947,11298,649,5.4
"05015",5,15,1997,11668,11003,665,5.7
"05015",5,15,1998,11756,11145,611,5.2
"05015",5,15,1999,11861,11325,536,4.5
"05015",5,15,2000,13015,12502,513,3.9
"05015",5,15,2001,12881,12347,534,4.1
"05015",5,15,2002,13332,12743,589,4.4
"05015",5,15,2003,13223,12581,642,4.9
"05015",5,15,2004,13353,12701,652,4.9
"05015",5,15,2005,13545,12929,616,4.5
"05015",5,15,2006,14034,13429,605,4.3
"05015",5,15,2007,14021,13416,605,4.3
"05015",5,15,2008,14261,13620,641,4.5
"05015",5,15,2009,14013,13160,853,6.1
"05015",5,15,2010,12611,11686,925,7.3
"05015",5,15,2011,12896,11964,932,7.2
"05015",5,15,2012,12479,11690,789,6.3
"05015",5,15,2013,12284,11548,736,6
"05015",5,15,2014,12542,11894,648,5.2
"05015",5,15,2015,12657,12080,577,4.6
"05015",5,15,2016,12894,12439,455,3.5
"05015",5,15,2017,13097,12666,431,3.3
"05017",5,17,1990,5992,5365,627,10.5
"05017",5,17,1991,6003,5370,633,10.5
"05017",5,17,1992,6319,5629,690,10.9
"05017",5,17,1993,6306,5734,572,9.1
"05017",5,17,1994,6562,6009,553,8.4
"05017",5,17,1995,6435,5880,555,8.6
"05017",5,17,1996,6553,5930,623,9.5
"05017",5,17,1997,6389,5836,553,8.7
"05017",5,17,1998,6386,5819,567,8.9
"05017",5,17,1999,6382,5787,595,9.3
"05017",5,17,2000,5428,5028,400,7.4
"05017",5,17,2001,5381,4901,480,8.9
"05017",5,17,2002,5307,4781,526,9.9
"05017",5,17,2003,5174,4626,548,10.6
"05017",5,17,2004,4913,4373,540,11
"05017",5,17,2005,4892,4403,489,10
"05017",5,17,2006,5031,4611,420,8.3
"05017",5,17,2007,4995,4583,412,8.2
"05017",5,17,2008,4967,4556,411,8.3
"05017",5,17,2009,4873,4331,542,11.1
"05017",5,17,2010,4272,3745,527,12.3
"05017",5,17,2011,4282,3718,564,13.2
"05017",5,17,2012,4062,3600,462,11.4
"05017",5,17,2013,3843,3397,446,11.6
"05017",5,17,2014,3850,3448,402,10.4
"05017",5,17,2015,3726,3388,338,9.1
"05017",5,17,2016,3588,3353,235,6.5
"05017",5,17,2017,3505,3276,229,6.5
"05019",5,19,1990,10017,9269,748,7.5
"05019",5,19,1991,10232,9575,657,6.4
"05019",5,19,1992,10404,9913,491,4.7
"05019",5,19,1993,11164,10675,489,4.4
"05019",5,19,1994,11605,11207,398,3.4
"05019",5,19,1995,11802,11469,333,2.8
"05019",5,19,1996,11992,11669,323,2.7
"05019",5,19,1997,12045,11607,438,3.6
"05019",5,19,1998,11767,11377,390,3.3
"05019",5,19,1999,11926,11572,354,3
"05019",5,19,2000,11208,10725,483,4.3
"05019",5,19,2001,11206,10679,527,4.7
"05019",5,19,2002,11247,10564,683,6.1
"05019",5,19,2003,11145,10428,717,6.4
"05019",5,19,2004,11081,10395,686,6.2
"05019",5,19,2005,11051,10375,676,6.1
"05019",5,19,2006,11021,10411,610,5.5
"05019",5,19,2007,11069,10451,618,5.6
"05019",5,19,2008,11054,10398,656,5.9
"05019",5,19,2009,10782,9910,872,8.1
"05019",5,19,2010,10212,9337,875,8.6
"05019",5,19,2011,10335,9261,1074,10.4
"05019",5,19,2012,10140,9118,1022,10.1
"05019",5,19,2013,9923,9030,893,9
"05019",5,19,2014,9522,8859,663,7
"05019",5,19,2015,9453,8928,525,5.6
"05019",5,19,2016,9402,8989,413,4.4
"05019",5,19,2017,9470,9093,377,4
"05021",5,21,1990,8146,7574,572,7
"05021",5,21,1991,8166,7448,718,8.8
"05021",5,21,1992,8151,7475,676,8.3
"05021",5,21,1993,8317,7575,742,8.9
"05021",5,21,1994,8452,7931,521,6.2
"05021",5,21,1995,8306,7716,590,7.1
"05021",5,21,1996,8181,7619,562,6.9
"05021",5,21,1997,8197,7732,465,5.7
"05021",5,21,1998,8161,7638,523,6.4
"05021",5,21,1999,8168,7634,534,6.5
"05021",5,21,2000,8064,7626,438,5.4
"05021",5,21,2001,7766,7215,551,7.1
"05021",5,21,2002,7747,7165,582,7.5
"05021",5,21,2003,7491,6882,609,8.1
"05021",5,21,2004,7309,6719,590,8.1
"05021",5,21,2005,7091,6497,594,8.4
"05021",5,21,2006,7138,6557,581,8.1
"05021",5,21,2007,6751,6125,626,9.3
"05021",5,21,2008,6685,6146,539,8.1
"05021",5,21,2009,6671,5914,757,11.3
"05021",5,21,2010,7479,6659,820,11
"05021",5,21,2011,7304,6419,885,12.1
"05021",5,21,2012,6869,6115,754,11
"05021",5,21,2013,6530,5895,635,9.7
"05021",5,21,2014,6414,5913,501,7.8
"05021",5,21,2015,6297,5882,415,6.6
"05021",5,21,2016,6048,5709,339,5.6
"05021",5,21,2017,5908,5639,269,4.6
"05023",5,23,1990,8755,8137,618,7.1
"05023",5,23,1991,8738,8023,715,8.2
"05023",5,23,1992,8794,7872,922,10.5
"05023",5,23,1993,8857,8201,656,7.4
"05023",5,23,1994,9216,8675,541,5.9
"05023",5,23,1995,9424,8959,465,4.9
"05023",5,23,1996,9262,8750,512,5.5
"05023",5,23,1997,9365,8942,423,4.5
"05023",5,23,1998,9499,9101,398,4.2
"05023",5,23,1999,9715,9332,383,3.9
"05023",5,23,2000,10719,10232,487,4.5
"05023",5,23,2001,10710,10196,514,4.8
"05023",5,23,2002,10927,10391,536,4.9
"05023",5,23,2003,10900,10278,622,5.7
"05023",5,23,2004,11093,10493,600,5.4
"05023",5,23,2005,11633,11063,570,4.9
"05023",5,23,2006,11643,11062,581,5
"05023",5,23,2007,11687,10977,710,6.1
"05023",5,23,2008,12111,11427,684,5.6
"05023",5,23,2009,11794,10911,883,7.5
"05023",5,23,2010,10336,9444,892,8.6
"05023",5,23,2011,10551,9579,972,9.2
"05023",5,23,2012,10390,9504,886,8.5
"05023",5,23,2013,10028,9172,856,8.5
"05023",5,23,2014,9745,8940,805,8.3
"05023",5,23,2015,9609,8944,665,6.9
"05023",5,23,2016,9491,8931,560,5.9
"05023",5,23,2017,9351,8893,458,4.9
"05025",5,25,1990,3511,3273,238,6.8
"05025",5,25,1991,3644,3354,290,8
"05025",5,25,1992,3885,3616,269,6.9
"05025",5,25,1993,3776,3542,234,6.2
"05025",5,25,1994,4023,3773,250,6.2
"05025",5,25,1995,4028,3830,198,4.9
"05025",5,25,1996,3906,3672,234,6
"05025",5,25,1997,3992,3766,226,5.7
"05025",5,25,1998,3697,3466,231,6.2
"05025",5,25,1999,3806,3589,217,5.7
"05025",5,25,2000,3896,3702,194,5
"05025",5,25,2001,3904,3679,225,5.8
"05025",5,25,2002,3907,3673,234,6
"05025",5,25,2003,3969,3721,248,6.2
"05025",5,25,2004,4151,3873,278,6.7
"05025",5,25,2005,4273,4023,250,5.9
"05025",5,25,2006,4238,3981,257,6.1
"05025",5,25,2007,4180,3942,238,5.7
"05025",5,25,2008,4135,3892,243,5.9
"05025",5,25,2009,4043,3715,328,8.1
"05025",5,25,2010,3888,3562,326,8.4
"05025",5,25,2011,3885,3554,331,8.5
"05025",5,25,2012,3751,3475,276,7.4
"05025",5,25,2013,3600,3328,272,7.6
"05025",5,25,2014,3455,3220,235,6.8
"05025",5,25,2015,3358,3169,189,5.6
"05025",5,25,2016,3349,3199,150,4.5
"05025",5,25,2017,3315,3170,145,4.4
"05027",5,27,1990,11840,10958,882,7.4
"05027",5,27,1991,11693,10822,871,7.4
"05027",5,27,1992,11818,10933,885,7.5
"05027",5,27,1993,11806,10905,901,7.6
"05027",5,27,1994,11977,11108,869,7.3
"05027",5,27,1995,11853,11062,791,6.7
"05027",5,27,1996,11803,11026,777,6.6
"05027",5,27,1997,11622,10757,865,7.4
"05027",5,27,1998,11500,10667,833,7.2
"05027",5,27,1999,11577,10856,721,6.2
"05027",5,27,2000,11261,10680,581,5.2
"05027",5,27,2001,11035,10454,581,5.3
"05027",5,27,2002,11031,10366,665,6
"05027",5,27,2003,10697,9970,727,6.8
"05027",5,27,2004,10781,10075,706,6.5
"05027",5,27,2005,11089,10385,704,6.3
"05027",5,27,2006,11148,10475,673,6
"05027",5,27,2007,11040,10320,720,6.5
"05027",5,27,2008,10929,10166,763,7
"05027",5,27,2009,10618,9584,1034,9.7
"05027",5,27,2010,10507,9458,1049,10
"05027",5,27,2011,10445,9401,1044,10
"05027",5,27,2012,10115,9205,910,9
"05027",5,27,2013,9679,8830,849,8.8
"05027",5,27,2014,9538,8857,681,7.1
"05027",5,27,2015,9537,8914,623,6.5
"05027",5,27,2016,9283,8756,527,5.7
"05027",5,27,2017,9115,8655,460,5
"05029",5,29,1990,8962,8400,562,6.3
"05029",5,29,1991,9110,8509,601,6.6
"05029",5,29,1992,9516,8712,804,8.4
"05029",5,29,1993,9244,8588,656,7.1
"05029",5,29,1994,9483,8969,514,5.4
"05029",5,29,1995,9614,9128,486,5.1
"05029",5,29,1996,9843,9343,500,5.1
"05029",5,29,1997,9847,9355,492,5
"05029",5,29,1998,9894,9410,484,4.9
"05029",5,29,1999,9322,8669,653,7
"05029",5,29,2000,9336,8764,572,6.1
"05029",5,29,2001,9334,8870,464,5
"05029",5,29,2002,9659,9101,558,5.8
"05029",5,29,2003,9596,8993,603,6.3
"05029",5,29,2004,9428,8883,545,5.8
"05029",5,29,2005,9660,9164,496,5.1
"05029",5,29,2006,9939,9451,488,4.9
"05029",5,29,2007,10073,9583,490,4.9
"05029",5,29,2008,10237,9671,566,5.5
"05029",5,29,2009,10265,9491,774,7.5
"05029",5,29,2010,9029,8156,873,9.7
"05029",5,29,2011,9038,8145,893,9.9
"05029",5,29,2012,8704,7902,802,9.2
"05029",5,29,2013,8647,7850,797,9.2
"05029",5,29,2014,8596,7982,614,7.1
"05029",5,29,2015,8639,8113,526,6.1
"05029",5,29,2016,8460,7979,481,5.7
"05029",5,29,2017,8281,7889,392,4.7
"05031",5,31,1990,37054,34882,2172,5.9
"05031",5,31,1991,36841,34143,2698,7.3
"05031",5,31,1992,37903,35541,2362,6.2
"05031",5,31,1993,38044,36148,1896,5
"05031",5,31,1994,39368,37913,1455,3.7
"05031",5,31,1995,41368,39899,1469,3.6
"05031",5,31,1996,41521,39865,1656,4
"05031",5,31,1997,41411,39778,1633,3.9
"05031",5,31,1998,42127,40564,1563,3.7
"05031",5,31,1999,43275,41838,1437,3.3
"05031",5,31,2000,42719,41012,1707,4
"05031",5,31,2001,41776,39812,1964,4.7
"05031",5,31,2002,42559,40310,2249,5.3
"05031",5,31,2003,42858,40458,2400,5.6
"05031",5,31,2004,44183,41771,2412,5.5
"05031",5,31,2005,45084,42935,2149,4.8
"05031",5,31,2006,45843,43648,2195,4.8
"05031",5,31,2007,45989,43687,2302,5
"05031",5,31,2008,46575,44307,2268,4.9
"05031",5,31,2009,46769,43482,3287,7
"05031",5,31,2010,47796,44249,3547,7.4
"05031",5,31,2011,49190,45556,3634,7.4
"05031",5,31,2012,49059,45688,3371,6.9
"05031",5,31,2013,49333,46104,3229,6.5
"05031",5,31,2014,49477,46789,2688,5.4
"05031",5,31,2015,50999,48745,2254,4.4
"05031",5,31,2016,52330,50644,1686,3.2
"05031",5,31,2017,53733,52132,1601,3
"05033",5,33,1990,21019,19264,1755,8.3
"05033",5,33,1991,21120,19192,1928,9.1
"05033",5,33,1992,21514,19734,1780,8.3
"05033",5,33,1993,22145,20671,1474,6.7
"05033",5,33,1994,23287,22052,1235,5.3
"05033",5,33,1995,23857,22648,1209,5.1
"05033",5,33,1996,23962,22785,1177,4.9
"05033",5,33,1997,24031,22922,1109,4.6
"05033",5,33,1998,24246,23218,1028,4.2
"05033",5,33,1999,25072,24173,899,3.6
"05033",5,33,2000,24738,23848,890,3.6
"05033",5,33,2001,24842,23801,1041,4.2
"05033",5,33,2002,25196,23990,1206,4.8
"05033",5,33,2003,25250,23893,1357,5.4
"05033",5,33,2004,26217,24865,1352,5.2
"05033",5,33,2005,27438,26244,1194,4.4
"05033",5,33,2006,28157,26886,1271,4.5
"05033",5,33,2007,28569,27174,1395,4.9
"05033",5,33,2008,28721,27327,1394,4.9
"05033",5,33,2009,27945,25758,2187,7.8
"05033",5,33,2010,28323,25996,2327,8.2
"05033",5,33,2011,28020,25539,2481,8.9
"05033",5,33,2012,27610,25412,2198,8
"05033",5,33,2013,27056,24989,2067,7.6
"05033",5,33,2014,26803,25200,1603,6
"05033",5,33,2015,26854,25460,1394,5.2
"05033",5,33,2016,27001,25956,1045,3.9
"05033",5,33,2017,26688,25743,945,3.5
"05035",5,35,1990,22821,21114,1707,7.5
"05035",5,35,1991,22242,20196,2046,9.2
"05035",5,35,1992,21819,20125,1694,7.8
"05035",5,35,1993,21921,20384,1537,7
"05035",5,35,1994,22326,21014,1312,5.9
"05035",5,35,1995,22679,21479,1200,5.3
"05035",5,35,1996,22620,21370,1250,5.5
"05035",5,35,1997,22665,21543,1122,5
"05035",5,35,1998,22736,21656,1080,4.8
"05035",5,35,1999,22952,21935,1017,4.4
"05035",5,35,2000,21929,21017,912,4.2
"05035",5,35,2001,21470,20337,1133,5.3
"05035",5,35,2002,21434,20147,1287,6
"05035",5,35,2003,21317,19869,1448,6.8
"05035",5,35,2004,21819,20309,1510,6.9
"05035",5,35,2005,22513,21044,1469,6.5
"05035",5,35,2006,22464,20939,1525,6.8
"05035",5,35,2007,22416,20955,1461,6.5
"05035",5,35,2008,22601,20807,1794,7.9
"05035",5,35,2009,22055,19652,2403,10.9
"05035",5,35,2010,22819,20433,2386,10.5
"05035",5,35,2011,22778,20293,2485,10.9
"05035",5,35,2012,22103,19987,2116,9.6
"05035",5,35,2013,21541,19737,1804,8.4
"05035",5,35,2014,21433,19853,1580,7.4
"05035",5,35,2015,21424,20102,1322,6.2
"05035",5,35,2016,21649,20676,973,4.5
"05035",5,35,2017,21807,20871,936,4.3
"05037",5,37,1990,8568,7848,720,8.4
"05037",5,37,1991,8543,7852,691,8.1
"05037",5,37,1992,8829,8042,787,8.9
"05037",5,37,1993,8918,8085,833,9.3
"05037",5,37,1994,9055,8413,642,7.1
"05037",5,37,1995,8892,8405,487,5.5
"05037",5,37,1996,8875,8375,500,5.6
"05037",5,37,1997,8613,8080,533,6.2
"05037",5,37,1998,8295,7693,602,7.3
"05037",5,37,1999,8193,7650,543,6.6
"05037",5,37,2000,8671,8262,409,4.7
"05037",5,37,2001,8498,7994,504,5.9
"05037",5,37,2002,8601,8066,535,6.2
"05037",5,37,2003,8681,8030,651,7.5
"05037",5,37,2004,8556,7859,697,8.1
"05037",5,37,2005,8502,7856,646,7.6
"05037",5,37,2006,8654,8030,624,7.2
"05037",5,37,2007,8457,7833,624,7.4
"05037",5,37,2008,8559,7974,585,6.8
"05037",5,37,2009,8537,7824,713,8.4
"05037",5,37,2010,8618,7903,715,8.3
"05037",5,37,2011,8832,8092,740,8.4
"05037",5,37,2012,8531,7854,677,7.9
"05037",5,37,2013,8207,7586,621,7.6
"05037",5,37,2014,8098,7584,514,6.3
"05037",5,37,2015,8101,7663,438,5.4
"05037",5,37,2016,7896,7549,347,4.4
"05037",5,37,2017,7724,7417,307,4
"05039",5,39,1990,4255,3897,358,8.4
"05039",5,39,1991,4064,3675,389,9.6
"05039",5,39,1992,3969,3647,322,8.1
"05039",5,39,1993,3906,3620,286,7.3
"05039",5,39,1994,3985,3616,369,9.3
"05039",5,39,1995,3851,3589,262,6.8
"05039",5,39,1996,3765,3471,294,7.8
"05039",5,39,1997,3717,3447,270,7.3
"05039",5,39,1998,3698,3422,276,7.5
"05039",5,39,1999,3607,3320,287,8
"05039",5,39,2000,3858,3643,215,5.6
"05039",5,39,2001,3776,3512,264,7
"05039",5,39,2002,3822,3510,312,8.2
"05039",5,39,2003,3821,3516,305,8
"05039",5,39,2004,3784,3501,283,7.5
"05039",5,39,2005,3868,3597,271,7
"05039",5,39,2006,3952,3694,258,6.5
"05039",5,39,2007,3881,3608,273,7
"05039",5,39,2008,3908,3625,283,7.2
"05039",5,39,2009,3940,3539,401,10.2
"05039",5,39,2010,3487,3057,430,12.3
"05039",5,39,2011,3322,2908,414,12.5
"05039",5,39,2012,3182,2815,367,11.5
"05039",5,39,2013,2934,2616,318,10.8
"05039",5,39,2014,2878,2610,268,9.3
"05039",5,39,2015,2873,2666,207,7.2
"05039",5,39,2016,2889,2745,144,5
"05039",5,39,2017,2881,2751,130,4.5
"05041",5,41,1990,6877,6156,721,10.5
"05041",5,41,1991,6947,6226,721,10.4
"05041",5,41,1992,7000,6212,788,11.3
"05041",5,41,1993,7129,6519,610,8.6
"05041",5,41,1994,7375,6742,633,8.6
"05041",5,41,1995,7427,6757,670,9
"05041",5,41,1996,7427,6634,793,10.7
"05041",5,41,1997,7216,6563,653,9
"05041",5,41,1998,7218,6535,683,9.5
"05041",5,41,1999,7166,6487,679,9.5
"05041",5,41,2000,6312,5795,517,8.2
"05041",5,41,2001,6217,5673,544,8.8
"05041",5,41,2002,6293,5734,559,8.9
"05041",5,41,2003,6162,5607,555,9
"05041",5,41,2004,6028,5481,547,9.1
"05041",5,41,2005,6089,5561,528,8.7
"05041",5,41,2006,6356,5778,578,9.1
"05041",5,41,2007,6177,5567,610,9.9
"05041",5,41,2008,5942,5422,520,8.8
"05041",5,41,2009,5593,4960,633,11.3
"05041",5,41,2010,5884,5229,655,11.1
"05041",5,41,2011,6151,5464,687,11.2
"05041",5,41,2012,5930,5343,587,9.9
"05041",5,41,2013,5644,5100,544,9.6
"05041",5,41,2014,5552,5104,448,8.1
"05041",5,41,2015,5547,5142,405,7.3
"05041",5,41,2016,5450,5155,295,5.4
"05041",5,41,2017,5453,5191,262,4.8
"05043",5,43,1990,8648,7883,765,8.8
"05043",5,43,1991,8621,7803,818,9.5
"05043",5,43,1992,9028,8322,706,7.8
"05043",5,43,1993,9379,8753,626,6.7
"05043",5,43,1994,10058,9435,623,6.2
"05043",5,43,1995,10398,9764,634,6.1
"05043",5,43,1996,10372,9585,787,7.6
"05043",5,43,1997,10033,9194,839,8.4
"05043",5,43,1998,9899,9022,877,8.9
"05043",5,43,1999,10016,9334,682,6.8
"05043",5,43,2000,8732,8211,521,6
"05043",5,43,2001,8436,7703,733,8.7
"05043",5,43,2002,8491,7812,679,8
"05043",5,43,2003,8514,7837,677,8
"05043",5,43,2004,8632,7946,686,7.9
"05043",5,43,2005,8680,7944,736,8.5
"05043",5,43,2006,8595,7911,684,8
"05043",5,43,2007,8501,7870,631,7.4
"05043",5,43,2008,8503,7831,672,7.9
"05043",5,43,2009,8224,7318,906,11
"05043",5,43,2010,8568,7633,935,10.9
"05043",5,43,2011,8656,7651,1005,11.6
"05043",5,43,2012,8369,7477,892,10.7
"05043",5,43,2013,8169,7370,799,9.8
"05043",5,43,2014,7985,7313,672,8.4
"05043",5,43,2015,7926,7374,552,7
"05043",5,43,2016,7824,7373,451,5.8
"05043",5,43,2017,7846,7441,405,5.2
"05045",5,45,1990,32081,29731,2350,7.3
"05045",5,45,1991,32300,30008,2292,7.1
"05045",5,45,1992,34197,31626,2571,7.5
"05045",5,45,1993,35162,33167,1995,5.7
"05045",5,45,1994,37320,35465,1855,5
"05045",5,45,1995,39006,37290,1716,4.4
"05045",5,45,1996,40529,38753,1776,4.4
"05045",5,45,1997,41785,39704,2081,5
"05045",5,45,1998,42350,40574,1776,4.2
"05045",5,45,1999,43257,41887,1370,3.2
"05045",5,45,2000,45405,43748,1657,3.6
"05045",5,45,2001,46067,43964,2103,4.6
"05045",5,45,2002,46674,44285,2389,5.1
"05045",5,45,2003,47763,45147,2616,5.5
"05045",5,45,2004,49854,47372,2482,5
"05045",5,45,2005,52018,49704,2314,4.4
"05045",5,45,2006,53586,51235,2351,4.4
"05045",5,45,2007,55212,52793,2419,4.4
"05045",5,45,2008,56244,53567,2677,4.8
"05045",5,45,2009,56404,52485,3919,6.9
"05045",5,45,2010,58711,54465,4246,7.2
"05045",5,45,2011,59482,55206,4276,7.2
"05045",5,45,2012,59723,55766,3957,6.6
"05045",5,45,2013,59300,55458,3842,6.5
"05045",5,45,2014,59046,55769,3277,5.5
"05045",5,45,2015,59915,57123,2792,4.7
"05045",5,45,2016,60671,58380,2291,3.8
"05045",5,45,2017,61288,59253,2035,3.3
"05047",5,47,1990,7181,6594,587,8.2
"05047",5,47,1991,7202,6650,552,7.7
"05047",5,47,1992,7326,6833,493,6.7
"05047",5,47,1993,7817,7373,444,5.7
"05047",5,47,1994,8067,7761,306,3.8
"05047",5,47,1995,8085,7776,309,3.8
"05047",5,47,1996,8449,8118,331,3.9
"05047",5,47,1997,8143,7856,287,3.5
"05047",5,47,1998,7795,7494,301,3.9
"05047",5,47,1999,7713,7442,271,3.5
"05047",5,47,2000,8061,7787,274,3.4
"05047",5,47,2001,8031,7723,308,3.8
"05047",5,47,2002,8073,7680,393,4.9
"05047",5,47,2003,7971,7581,390,4.9
"05047",5,47,2004,8172,7779,393,4.8
"05047",5,47,2005,8521,8156,365,4.3
"05047",5,47,2006,8586,8217,369,4.3
"05047",5,47,2007,8600,8215,385,4.5
"05047",5,47,2008,8566,8184,382,4.5
"05047",5,47,2009,8183,7589,594,7.3
"05047",5,47,2010,7800,7197,603,7.7
"05047",5,47,2011,7799,7201,598,7.7
"05047",5,47,2012,7669,7125,544,7.1
"05047",5,47,2013,7423,6913,510,6.9
"05047",5,47,2014,7287,6875,412,5.7
"05047",5,47,2015,7412,7047,365,4.9
"05047",5,47,2016,7376,7081,295,4
"05047",5,47,2017,7439,7181,258,3.5
"05049",5,49,1990,4048,3794,254,6.3
"05049",5,49,1991,4096,3854,242,5.9
"05049",5,49,1992,4257,4018,239,5.6
"05049",5,49,1993,4489,4215,274,6.1
"05049",5,49,1994,4504,4248,256,5.7
"05049",5,49,1995,4668,4456,212,4.5
"05049",5,49,1996,4585,4340,245,5.3
"05049",5,49,1997,4352,4152,200,4.6
"05049",5,49,1998,4275,4073,202,4.7
"05049",5,49,1999,4192,4023,169,4
"05049",5,49,2000,4962,4768,194,3.9
"05049",5,49,2001,4908,4656,252,5.1
"05049",5,49,2002,4851,4512,339,7
"05049",5,49,2003,4966,4654,312,6.3
"05049",5,49,2004,4977,4674,303,6.1
"05049",5,49,2005,5096,4825,271,5.3
"05049",5,49,2006,5128,4869,259,5.1
"05049",5,49,2007,5169,4912,257,5
"05049",5,49,2008,5245,4971,274,5.2
"05049",5,49,2009,5253,4861,392,7.5
"05049",5,49,2010,5172,4767,405,7.8
"05049",5,49,2011,5127,4729,398,7.8
"05049",5,49,2012,5110,4743,367,7.2
"05049",5,49,2013,4918,4579,339,6.9
"05049",5,49,2014,4801,4524,277,5.8
"05049",5,49,2015,4759,4511,248,5.2
"05049",5,49,2016,4674,4473,201,4.3
"05049",5,49,2017,4732,4533,199,4.2
"05051",5,51,1990,32255,30115,2140,6.6
"05051",5,51,1991,32163,29633,2530,7.9
"05051",5,51,1992,33498,30677,2821,8.4
"05051",5,51,1993,34629,32043,2586,7.5
"05051",5,51,1994,35454,33281,2173,6.1
"05051",5,51,1995,35907,34135,1772,4.9
"05051",5,51,1996,36084,34367,1717,4.8
"05051",5,51,1997,35961,34321,1640,4.6
"05051",5,51,1998,36055,34338,1717,4.8
"05051",5,51,1999,36444,34777,1667,4.6
"05051",5,51,2000,38407,36755,1652,4.3
"05051",5,51,2001,37795,35958,1837,4.9
"05051",5,51,2002,38420,36162,2258,5.9
"05051",5,51,2003,39209,36682,2527,6.4
"05051",5,51,2004,40617,38104,2513,6.2
"05051",5,51,2005,41936,39562,2374,5.7
"05051",5,51,2006,42313,40108,2205,5.2
"05051",5,51,2007,42727,40380,2347,5.5
"05051",5,51,2008,42783,40368,2415,5.6
"05051",5,51,2009,42565,39321,3244,7.6
"05051",5,51,2010,41563,38046,3517,8.5
"05051",5,51,2011,41787,38127,3660,8.8
"05051",5,51,2012,41203,37949,3254,7.9
"05051",5,51,2013,40834,37743,3091,7.6
"05051",5,51,2014,40339,37789,2550,6.3
"05051",5,51,2015,39950,37769,2181,5.5
"05051",5,51,2016,40159,38443,1716,4.3
"05051",5,51,2017,40424,38805,1619,4
"05053",5,53,1990,6859,6506,353,5.1
"05053",5,53,1991,6964,6475,489,7
"05053",5,53,1992,7118,6606,512,7.2
"05053",5,53,1993,7081,6710,371,5.2
"05053",5,53,1994,7138,6757,381,5.3
"05053",5,53,1995,7257,6915,342,4.7
"05053",5,53,1996,7313,6988,325,4.4
"05053",5,53,1997,7495,7139,356,4.7
"05053",5,53,1998,7692,7358,334,4.3
"05053",5,53,1999,7455,7119,336,4.5
"05053",5,53,2000,8083,7761,322,4
"05053",5,53,2001,8132,7707,425,5.2
"05053",5,53,2002,8081,7650,431,5.3
"05053",5,53,2003,8096,7641,455,5.6
"05053",5,53,2004,8416,7953,463,5.5
"05053",5,53,2005,8663,8242,421,4.9
"05053",5,53,2006,8689,8266,423,4.9
"05053",5,53,2007,8587,8162,425,4.9
"05053",5,53,2008,8691,8237,454,5.2
"05053",5,53,2009,8520,7913,607,7.1
"05053",5,53,2010,8567,7960,607,7.1
"05053",5,53,2011,8560,7928,632,7.4
"05053",5,53,2012,8425,7852,573,6.8
"05053",5,53,2013,8273,7733,540,6.5
"05053",5,53,2014,8222,7774,448,5.4
"05053",5,53,2015,8258,7883,375,4.5
"05053",5,53,2016,8290,7993,297,3.6
"05053",5,53,2017,8371,8104,267,3.2
"05055",5,55,1990,15650,14561,1089,7
"05055",5,55,1991,15620,14526,1094,7
"05055",5,55,1992,15907,14827,1080,6.8
"05055",5,55,1993,16221,15205,1016,6.3
"05055",5,55,1994,17493,16532,961,5.5
"05055",5,55,1995,18044,17166,878,4.9
"05055",5,55,1996,18314,17228,1086,5.9
"05055",5,55,1997,17921,16939,982,5.5
"05055",5,55,1998,18431,17454,977,5.3
"05055",5,55,1999,18771,17849,922,4.9
"05055",5,55,2000,18115,17239,876,4.8
"05055",5,55,2001,17411,16175,1236,7.1
"05055",5,55,2002,17120,15959,1161,6.8
"05055",5,55,2003,17113,15956,1157,6.8
"05055",5,55,2004,17815,16719,1096,6.2
"05055",5,55,2005,18769,17679,1090,5.8
"05055",5,55,2006,19060,17981,1079,5.7
"05055",5,55,2007,18678,17463,1215,6.5
"05055",5,55,2008,19127,17870,1257,6.6
"05055",5,55,2009,18767,16880,1887,10.1
"05055",5,55,2010,19683,17768,1915,9.7
"05055",5,55,2011,20147,18189,1958,9.7
"05055",5,55,2012,20006,18275,1731,8.7
"05055",5,55,2013,19420,17889,1531,7.9
"05055",5,55,2014,19627,18387,1240,6.3
"05055",5,55,2015,19950,18918,1032,5.2
"05055",5,55,2016,19838,18993,845,4.3
"05055",5,55,2017,19805,19082,723,3.7
"05057",5,57,1990,10269,9362,907,8.8
"05057",5,57,1991,10185,9278,907,8.9
"05057",5,57,1992,10610,9849,761,7.2
"05057",5,57,1993,10861,10037,824,7.6
"05057",5,57,1994,11293,10490,803,7.1
"05057",5,57,1995,11607,10810,797,6.9
"05057",5,57,1996,11908,10949,959,8.1
"05057",5,57,1997,11964,11058,906,7.6
"05057",5,57,1998,11544,10705,839,7.3
"05057",5,57,1999,11555,10894,661,5.7
"05057",5,57,2000,11062,10552,510,4.6
"05057",5,57,2001,10901,10386,515,4.7
"05057",5,57,2002,11188,10666,522,4.7
"05057",5,57,2003,11068,10473,595,5.4
"05057",5,57,2004,10838,10194,644,5.9
"05057",5,57,2005,10907,10278,629,5.8
"05057",5,57,2006,11097,10497,600,5.4
"05057",5,57,2007,10978,10332,646,5.9
"05057",5,57,2008,10733,10111,622,5.8
"05057",5,57,2009,10703,9819,884,8.3
"05057",5,57,2010,10674,9685,989,9.3
"05057",5,57,2011,11024,10049,975,8.8
"05057",5,57,2012,10851,10060,791,7.3
"05057",5,57,2013,10096,9365,731,7.2
"05057",5,57,2014,9927,9335,592,6
"05057",5,57,2015,9856,9369,487,4.9
"05057",5,57,2016,9948,9574,374,3.8
"05057",5,57,2017,9897,9555,342,3.5
"05059",5,59,1990,11496,10476,1020,8.9
"05059",5,59,1991,11349,10175,1174,10.3
"05059",5,59,1992,11586,10443,1143,9.9
"05059",5,59,1993,11853,10916,937,7.9
"05059",5,59,1994,11918,11238,680,5.7
"05059",5,59,1995,12078,11490,588,4.9
"05059",5,59,1996,12239,11642,597,4.9
"05059",5,59,1997,12314,11623,691,5.6
"05059",5,59,1998,12303,11608,695,5.6
"05059",5,59,1999,12304,11757,547,4.4
"05059",5,59,2000,14271,13663,608,4.3
"05059",5,59,2001,14092,13349,743,5.3
"05059",5,59,2002,14127,13211,916,6.5
"05059",5,59,2003,14214,13260,954,6.7
"05059",5,59,2004,14615,13724,891,6.1
"05059",5,59,2005,15158,14358,800,5.3
"05059",5,59,2006,15604,14798,806,5.2
"05059",5,59,2007,15477,14654,823,5.3
"05059",5,59,2008,15211,14207,1004,6.6
"05059",5,59,2009,15337,14017,1320,8.6
"05059",5,59,2010,14188,12969,1219,8.6
"05059",5,59,2011,14527,13320,1207,8.3
"05059",5,59,2012,14485,13441,1044,7.2
"05059",5,59,2013,14111,13084,1027,7.3
"05059",5,59,2014,13978,13171,807,5.8
"05059",5,59,2015,14158,13445,713,5
"05059",5,59,2016,14096,13544,552,3.9
"05059",5,59,2017,14188,13665,523,3.7
"05061",5,61,1990,6569,6041,528,8
"05061",5,61,1991,6500,6046,454,7
"05061",5,61,1992,6571,6140,431,6.6
"05061",5,61,1993,6785,6353,432,6.4
"05061",5,61,1994,7004,6667,337,4.8
"05061",5,61,1995,7153,6835,318,4.4
"05061",5,61,1996,7271,6853,418,5.7
"05061",5,61,1997,7141,6735,406,5.7
"05061",5,61,1998,7006,6611,395,5.6
"05061",5,61,1999,6963,6587,376,5.4
"05061",5,61,2000,6624,6340,284,4.3
"05061",5,61,2001,6405,6062,343,5.4
"05061",5,61,2002,6559,6199,360,5.5
"05061",5,61,2003,6528,6132,396,6.1
"05061",5,61,2004,6366,5981,385,6
"05061",5,61,2005,6252,5905,347,5.6
"05061",5,61,2006,6511,6160,351,5.4
"05061",5,61,2007,6452,6101,351,5.4
"05061",5,61,2008,6379,6025,354,5.5
"05061",5,61,2009,6227,5727,500,8
"05061",5,61,2010,6545,6037,508,7.8
"05061",5,61,2011,6746,6240,506,7.5
"05061",5,61,2012,6434,6003,431,6.7
"05061",5,61,2013,6235,5836,399,6.4
"05061",5,61,2014,6196,5837,359,5.8
"05061",5,61,2015,6057,5802,255,4.2
"05061",5,61,2016,5961,5767,194,3.3
"05061",5,61,2017,5952,5771,181,3
"05063",5,63,1990,15712,14569,1143,7.3
"05063",5,63,1991,15837,14596,1241,7.8
"05063",5,63,1992,16098,15017,1081,6.7
"05063",5,63,1993,16356,15396,960,5.9
"05063",5,63,1994,16685,15776,909,5.4
"05063",5,63,1995,16870,15853,1017,6
"05063",5,63,1996,16995,15927,1068,6.3
"05063",5,63,1997,17095,16100,995,5.8
"05063",5,63,1998,16862,16001,861,5.1
"05063",5,63,1999,17265,16439,826,4.8
"05063",5,63,2000,16692,15880,812,4.9
"05063",5,63,2001,16927,15984,943,5.6
"05063",5,63,2002,16904,15933,971,5.7
"05063",5,63,2003,17007,15905,1102,6.5
"05063",5,63,2004,17386,16284,1102,6.3
"05063",5,63,2005,17860,16770,1090,6.1
"05063",5,63,2006,17664,16695,969,5.5
"05063",5,63,2007,17393,16321,1072,6.2
"05063",5,63,2008,17121,15922,1199,7
"05063",5,63,2009,16876,15394,1482,8.8
"05063",5,63,2010,17059,15559,1500,8.8
"05063",5,63,2011,16711,15149,1562,9.3
"05063",5,63,2012,16041,14563,1478,9.2
"05063",5,63,2013,15805,14382,1423,9
"05063",5,63,2014,15482,14278,1204,7.8
"05063",5,63,2015,15667,14656,1011,6.5
"05063",5,63,2016,16036,15247,789,4.9
"05063",5,63,2017,16231,15546,685,4.2
"05065",5,65,1990,4551,4317,234,5.1
"05065",5,65,1991,4529,4272,257,5.7
"05065",5,65,1992,4227,3842,385,9.1
"05065",5,65,1993,4175,3807,368,8.8
"05065",5,65,1994,4093,3806,287,7
"05065",5,65,1995,4072,3803,269,6.6
"05065",5,65,1996,3981,3604,377,9.5
"05065",5,65,1997,4154,3880,274,6.6
"05065",5,65,1998,4219,3937,282,6.7
"05065",5,65,1999,4372,4189,183,4.2
"05065",5,65,2000,5217,4971,246,4.7
"05065",5,65,2001,5053,4755,298,5.9
"05065",5,65,2002,5190,4810,380,7.3
"05065",5,65,2003,5206,4794,412,7.9
"05065",5,65,2004,5206,4844,362,7
"05065",5,65,2005,5254,4917,337,6.4
"05065",5,65,2006,5416,5082,334,6.2
"05065",5,65,2007,5445,5125,320,5.9
"05065",5,65,2008,5476,5108,368,6.7
"05065",5,65,2009,5349,4859,490,9.2
"05065",5,65,2010,5139,4622,517,10.1
"05065",5,65,2011,5232,4713,519,9.9
"05065",5,65,2012,5163,4709,454,8.8
"05065",5,65,2013,5002,4570,432,8.6
"05065",5,65,2014,4917,4547,370,7.5
"05065",5,65,2015,4979,4650,329,6.6
"05065",5,65,2016,4973,4696,277,5.6
"05065",5,65,2017,4908,4640,268,5.5
"05067",5,67,1990,8438,7468,970,11.5
"05067",5,67,1991,8223,7167,1056,12.8
"05067",5,67,1992,8341,7292,1049,12.6
"05067",5,67,1993,8369,7412,957,11.4
"05067",5,67,1994,8257,7407,850,10.3
"05067",5,67,1995,8275,7519,756,9.1
"05067",5,67,1996,8296,7366,930,11.2
"05067",5,67,1997,7954,7104,850,10.7
"05067",5,67,1998,8128,7302,826,10.2
"05067",5,67,1999,8022,7235,787,9.8
"05067",5,67,2000,7695,7112,583,7.6
"05067",5,67,2001,7660,7077,583,7.6
"05067",5,67,2002,7760,7152,608,7.8
"05067",5,67,2003,7781,7080,701,9
"05067",5,67,2004,7800,7122,678,8.7
"05067",5,67,2005,7797,7148,649,8.3
"05067",5,67,2006,7925,7316,609,7.7
"05067",5,67,2007,7891,7297,594,7.5
"05067",5,67,2008,7928,7313,615,7.8
"05067",5,67,2009,7643,6807,836,10.9
"05067",5,67,2010,6734,5936,798,11.9
"05067",5,67,2011,6714,5935,779,11.6
"05067",5,67,2012,6470,5774,696,10.8
"05067",5,67,2013,6276,5593,683,10.9
"05067",5,67,2014,6191,5621,570,9.2
"05067",5,67,2015,6188,5723,465,7.5
"05067",5,67,2016,6068,5692,376,6.2
"05067",5,67,2017,5916,5570,346,5.8
"05069",5,69,1990,38254,34788,3466,9.1
"05069",5,69,1991,37785,33504,4281,11.3
"05069",5,69,1992,38036,33807,4229,11.1
"05069",5,69,1993,37506,33969,3537,9.4
"05069",5,69,1994,37595,34265,3330,8.9
"05069",5,69,1995,37539,34694,2845,7.6
"05069",5,69,1996,37623,34797,2826,7.5
"05069",5,69,1997,37154,34116,3038,8.2
"05069",5,69,1998,37067,33962,3105,8.4
"05069",5,69,1999,36987,34145,2842,7.7
"05069",5,69,2000,35900,33810,2090,5.8
"05069",5,69,2001,35534,33068,2466,6.9
"05069",5,69,2002,35641,32868,2773,7.8
"05069",5,69,2003,35724,32855,2869,8
"05069",5,69,2004,36496,33626,2870,7.9
"05069",5,69,2005,37037,34229,2808,7.6
"05069",5,69,2006,36465,33607,2858,7.8
"05069",5,69,2007,35578,32915,2663,7.5
"05069",5,69,2008,35341,32634,2707,7.7
"05069",5,69,2009,35629,32128,3501,9.8
"05069",5,69,2010,33973,30438,3535,10.4
"05069",5,69,2011,33727,29978,3749,11.1
"05069",5,69,2012,32469,29222,3247,10
"05069",5,69,2013,31027,27830,3197,10.3
"05069",5,69,2014,29502,26928,2574,8.7
"05069",5,69,2015,28769,26744,2025,7
"05069",5,69,2016,28373,26794,1579,5.6
"05069",5,69,2017,28059,26605,1454,5.2
"05071",5,71,1990,8227,7543,684,8.3
"05071",5,71,1991,8254,7573,681,8.3
"05071",5,71,1992,8476,7951,525,6.2
"05071",5,71,1993,9412,8905,507,5.4
"05071",5,71,1994,10192,9750,442,4.3
"05071",5,71,1995,10626,10202,424,4
"05071",5,71,1996,10750,10332,418,3.9
"05071",5,71,1997,10643,10203,440,4.1
"05071",5,71,1998,10704,10305,399,3.7
"05071",5,71,1999,10756,10356,400,3.7
"05071",5,71,2000,10184,9755,429,4.2
"05071",5,71,2001,10085,9600,485,4.8
"05071",5,71,2002,10480,9953,527,5
"05071",5,71,2003,10649,10064,585,5.5
"05071",5,71,2004,10826,10239,587,5.4
"05071",5,71,2005,10992,10455,537,4.9
"05071",5,71,2006,11184,10611,573,5.1
"05071",5,71,2007,11443,10892,551,4.8
"05071",5,71,2008,11631,11080,551,4.7
"05071",5,71,2009,11562,10731,831,7.2
"05071",5,71,2010,10977,10072,905,8.2
"05071",5,71,2011,11134,10256,878,7.9
"05071",5,71,2012,10807,10011,796,7.4
"05071",5,71,2013,10564,9756,808,7.6
"05071",5,71,2014,10297,9624,673,6.5
"05071",5,71,2015,10399,9801,598,5.8
"05071",5,71,2016,10547,10049,498,4.7
"05071",5,71,2017,10640,10189,451,4.2
"05073",5,73,1990,3713,3434,279,7.5
"05073",5,73,1991,3624,3269,355,9.8
"05073",5,73,1992,3581,3266,315,8.8
"05073",5,73,1993,3621,3335,286,7.9
"05073",5,73,1994,3671,3411,260,7.1
"05073",5,73,1995,3595,3342,253,7
"05073",5,73,1996,3543,3275,268,7.6
"05073",5,73,1997,3530,3283,247,7
"05073",5,73,1998,3476,3210,266,7.7
"05073",5,73,1999,3479,3214,265,7.6
"05073",5,73,2000,3450,3244,206,6
"05073",5,73,2001,3425,3247,178,5.2
"05073",5,73,2002,3456,3279,177,5.1
"05073",5,73,2003,3369,3167,202,6
"05073",5,73,2004,3293,3056,237,7.2
"05073",5,73,2005,3218,2979,239,7.4
"05073",5,73,2006,3158,2936,222,7
"05073",5,73,2007,3143,2908,235,7.5
"05073",5,73,2008,3070,2853,217,7.1
"05073",5,73,2009,2991,2706,285,9.5
"05073",5,73,2010,3041,2741,300,9.9
"05073",5,73,2011,3007,2716,291,9.7
"05073",5,73,2012,2886,2612,274,9.5
"05073",5,73,2013,2743,2479,264,9.6
"05073",5,73,2014,2663,2455,208,7.8
"05073",5,73,2015,2617,2418,199,7.6
"05073",5,73,2016,2552,2402,150,5.9
"05073",5,73,2017,2521,2393,128,5.1
"05075",5,75,1990,7789,6948,841,10.8
"05075",5,75,1991,7517,6786,731,9.7
"05075",5,75,1992,7661,7010,651,8.5
"05075",5,75,1993,7941,7369,572,7.2
"05075",5,75,1994,7982,7478,504,6.3
"05075",5,75,1995,7852,7398,454,5.8
"05075",5,75,1996,8027,7390,637,7.9
"05075",5,75,1997,7867,7330,537,6.8
"05075",5,75,1998,7674,7066,608,7.9
"05075",5,75,1999,7428,6936,492,6.6
"05075",5,75,2000,7857,7437,420,5.3
"05075",5,75,2001,7773,7253,520,6.7
"05075",5,75,2002,7868,7314,554,7
"05075",5,75,2003,7720,7060,660,8.5
"05075",5,75,2004,7549,6941,608,8.1
"05075",5,75,2005,7517,6955,562,7.5
"05075",5,75,2006,7479,6974,505,6.8
"05075",5,75,2007,7400,6894,506,6.8
"05075",5,75,2008,7307,6786,521,7.1
"05075",5,75,2009,7321,6648,673,9.2
"05075",5,75,2010,7445,6737,708,9.5
"05075",5,75,2011,7471,6731,740,9.9
"05075",5,75,2012,7235,6576,659,9.1
"05075",5,75,2013,7149,6515,634,8.9
"05075",5,75,2014,7085,6573,512,7.2
"05075",5,75,2015,7046,6623,423,6
"05075",5,75,2016,6929,6632,297,4.3
"05075",5,75,2017,6918,6657,261,3.8
"05077",5,77,1990,4629,4082,547,11.8
"05077",5,77,1991,4660,4027,633,13.6
"05077",5,77,1992,4720,4110,610,12.9
"05077",5,77,1993,4695,4176,519,11.1
"05077",5,77,1994,4915,4483,432,8.8
"05077",5,77,1995,4861,4408,453,9.3
"05077",5,77,1996,4742,4193,549,11.6
"05077",5,77,1997,4526,3976,550,12.2
"05077",5,77,1998,4420,4006,414,9.4
"05077",5,77,1999,4606,4257,349,7.6
"05077",5,77,2000,3892,3600,292,7.5
"05077",5,77,2001,3805,3452,353,9.3
"05077",5,77,2002,3728,3384,344,9.2
"05077",5,77,2003,3664,3237,427,11.7
"05077",5,77,2004,3448,3060,388,11.3
"05077",5,77,2005,3410,3051,359,10.5
"05077",5,77,2006,3618,3287,331,9.1
"05077",5,77,2007,3634,3294,340,9.4
"05077",5,77,2008,3618,3309,309,8.5
"05077",5,77,2009,3534,3209,325,9.2
"05077",5,77,2010,3704,3387,317,8.6
"05077",5,77,2011,3678,3326,352,9.6
"05077",5,77,2012,3521,3187,334,9.5
"05077",5,77,2013,3313,3005,308,9.3
"05077",5,77,2014,3252,3006,246,7.6
"05077",5,77,2015,3180,2968,212,6.7
"05077",5,77,2016,3097,2952,145,4.7
"05077",5,77,2017,2976,2832,144,4.8
"05079",5,79,1990,4682,4318,364,7.8
"05079",5,79,1991,4832,4400,432,8.9
"05079",5,79,1992,5052,4556,496,9.8
"05079",5,79,1993,5156,4777,379,7.4
"05079",5,79,1994,5376,5033,343,6.4
"05079",5,79,1995,5399,5079,320,5.9
"05079",5,79,1996,5399,5012,387,7.2
"05079",5,79,1997,5339,4966,373,7
"05079",5,79,1998,5348,4973,375,7
"05079",5,79,1999,5374,5089,285,5.3
"05079",5,79,2000,5032,4722,310,6.2
"05079",5,79,2001,5020,4656,364,7.3
"05079",5,79,2002,5034,4652,382,7.6
"05079",5,79,2003,5074,4660,414,8.2
"05079",5,79,2004,5150,4752,398,7.7
"05079",5,79,2005,5251,4854,397,7.6
"05079",5,79,2006,5196,4782,414,8
"05079",5,79,2007,5044,4649,395,7.8
"05079",5,79,2008,5009,4604,405,8.1
"05079",5,79,2009,4989,4495,494,9.9
"05079",5,79,2010,4699,4258,441,9.4
"05079",5,79,2011,4782,4335,447,9.3
"05079",5,79,2012,4586,4185,401,8.7
"05079",5,79,2013,4354,3993,361,8.3
"05079",5,79,2014,4214,3916,298,7.1
"05079",5,79,2015,4126,3873,253,6.1
"05079",5,79,2016,4102,3906,196,4.8
"05079",5,79,2017,4036,3867,169,4.2
"05081",5,81,1990,7186,6857,329,4.6
"05081",5,81,1991,6645,6026,619,9.3
"05081",5,81,1992,5650,5104,546,9.7
"05081",5,81,1993,5704,5247,457,8
"05081",5,81,1994,5795,5351,444,7.7
"05081",5,81,1995,5817,5405,412,7.1
"05081",5,81,1996,5819,5363,456,7.8
"05081",5,81,1997,5656,5205,451,8
"05081",5,81,1998,5513,5140,373,6.8
"05081",5,81,1999,5600,5260,340,6.1
"05081",5,81,2000,6384,6089,295,4.6
"05081",5,81,2001,6337,6073,264,4.2
"05081",5,81,2002,6506,6219,287,4.4
"05081",5,81,2003,6398,6084,314,4.9
"05081",5,81,2004,6439,6121,318,4.9
"05081",5,81,2005,6529,6223,306,4.7
"05081",5,81,2006,6535,6240,295,4.5
"05081",5,81,2007,6539,6267,272,4.2
"05081",5,81,2008,6747,6482,265,3.9
"05081",5,81,2009,6774,6366,408,6
"05081",5,81,2010,6220,5738,482,7.7
"05081",5,81,2011,6143,5662,481,7.8
"05081",5,81,2012,5979,5543,436,7.3
"05081",5,81,2013,5708,5275,433,7.6
"05081",5,81,2014,5543,5181,362,6.5
"05081",5,81,2015,5594,5289,305,5.5
"05081",5,81,2016,5603,5343,260,4.6
"05081",5,81,2017,5591,5323,268,4.8
"05083",5,83,1990,9293,8702,591,6.4
"05083",5,83,1991,9513,8700,813,8.5
"05083",5,83,1992,9753,9087,666,6.8
"05083",5,83,1993,10075,9583,492,4.9
"05083",5,83,1994,10377,9895,482,4.6
"05083",5,83,1995,10249,9752,497,4.8
"05083",5,83,1996,10356,9849,507,4.9
"05083",5,83,1997,10216,9717,499,4.9
"05083",5,83,1998,10082,9487,595,5.9
"05083",5,83,1999,9709,9195,514,5.3
"05083",5,83,2000,9854,9447,407,4.1
"05083",5,83,2001,9731,9233,498,5.1
"05083",5,83,2002,9843,9291,552,5.6
"05083",5,83,2003,9938,9372,566,5.7
"05083",5,83,2004,9928,9391,537,5.4
"05083",5,83,2005,10076,9580,496,4.9
"05083",5,83,2006,10322,9822,500,4.8
"05083",5,83,2007,10575,10048,527,5
"05083",5,83,2008,10435,9753,682,6.5
"05083",5,83,2009,10120,9186,934,9.2
"05083",5,83,2010,9805,8964,841,8.6
"05083",5,83,2011,9641,8790,851,8.8
"05083",5,83,2012,9627,8858,769,8
"05083",5,83,2013,9248,8530,718,7.8
"05083",5,83,2014,9079,8537,542,6
"05083",5,83,2015,9162,8636,526,5.7
"05083",5,83,2016,9138,8721,417,4.6
"05083",5,83,2017,8947,8604,343,3.8
"05085",5,85,1990,19736,18555,1181,6
"05085",5,85,1991,19598,18451,1147,5.9
"05085",5,85,1992,20312,19212,1100,5.4
"05085",5,85,1993,21242,20235,1007,4.7
"05085",5,85,1994,22538,21703,835,3.7
"05085",5,85,1995,23722,22913,809,3.4
"05085",5,85,1996,24765,23764,1001,4
"05085",5,85,1997,25273,24432,841,3.3
"05085",5,85,1998,25638,24780,858,3.3
"05085",5,85,1999,26397,25729,668,2.5
"05085",5,85,2000,26393,25512,881,3.3
"05085",5,85,2001,26515,25486,1029,3.9
"05085",5,85,2002,26979,25789,1190,4.4
"05085",5,85,2003,27489,26153,1336,4.9
"05085",5,85,2004,29046,27684,1362,4.7
"05085",5,85,2005,30788,29414,1374,4.5
"05085",5,85,2006,31679,30337,1342,4.2
"05085",5,85,2007,31711,30328,1383,4.4
"05085",5,85,2008,32460,31002,1458,4.5
"05085",5,85,2009,32345,30321,2024,6.3
"05085",5,85,2010,33287,31036,2251,6.8
"05085",5,85,2011,33448,31123,2325,7
"05085",5,85,2012,33083,30982,2101,6.4
"05085",5,85,2013,32797,30800,1997,6.1
"05085",5,85,2014,32747,31077,1670,5.1
"05085",5,85,2015,33000,31618,1382,4.2
"05085",5,85,2016,33453,32346,1107,3.3
"05085",5,85,2017,33887,32785,1102,3.3
"05087",5,87,1990,6041,5751,290,4.8
"05087",5,87,1991,6719,6393,326,4.9
"05087",5,87,1992,6810,6497,313,4.6
"05087",5,87,1993,6837,6602,235,3.4
"05087",5,87,1994,6848,6616,232,3.4
"05087",5,87,1995,6855,6649,206,3
"05087",5,87,1996,6782,6544,238,3.5
"05087",5,87,1997,6429,6174,255,4
"05087",5,87,1998,6559,6293,266,4.1
"05087",5,87,1999,6750,6510,240,3.6
"05087",5,87,2000,6911,6694,217,3.1
"05087",5,87,2001,7013,6771,242,3.5
"05087",5,87,2002,7173,6917,256,3.6
"05087",5,87,2003,7175,6890,285,4
"05087",5,87,2004,7422,7117,305,4.1
"05087",5,87,2005,7835,7544,291,3.7
"05087",5,87,2006,7923,7638,285,3.6
"05087",5,87,2007,7781,7464,317,4.1
"05087",5,87,2008,7760,7418,342,4.4
"05087",5,87,2009,7396,6896,500,6.8
"05087",5,87,2010,7270,6756,514,7.1
"05087",5,87,2011,7244,6753,491,6.8
"05087",5,87,2012,6971,6563,408,5.9
"05087",5,87,2013,6857,6461,396,5.8
"05087",5,87,2014,6967,6631,336,4.8
"05087",5,87,2015,7082,6810,272,3.8
"05087",5,87,2016,7299,7067,232,3.2
"05087",5,87,2017,7458,7249,209,2.8
"05089",5,89,1990,4938,4595,343,6.9
"05089",5,89,1991,4876,4564,312,6.4
"05089",5,89,1992,5091,4829,262,5.1
"05089",5,89,1993,5330,5146,184,3.5
"05089",5,89,1994,5731,5548,183,3.2
"05089",5,89,1995,6042,5853,189,3.1
"05089",5,89,1996,6241,5934,307,4.9
"05089",5,89,1997,6149,5905,244,4
"05089",5,89,1998,6209,5964,245,3.9
"05089",5,89,1999,6240,6040,200,3.2
"05089",5,89,2000,6645,6389,256,3.9
"05089",5,89,2001,6528,6162,366,5.6
"05089",5,89,2002,6486,6073,413,6.4
"05089",5,89,2003,6498,6075,423,6.5
"05089",5,89,2004,6551,6158,393,6
"05089",5,89,2005,6801,6450,351,5.2
"05089",5,89,2006,6995,6633,362,5.2
"05089",5,89,2007,7052,6671,381,5.4
"05089",5,89,2008,6963,6526,437,6.3
"05089",5,89,2009,6711,5917,794,11.8
"05089",5,89,2010,6716,6035,681,10.1
"05089",5,89,2011,6758,6120,638,9.4
"05089",5,89,2012,6608,6065,543,8.2
"05089",5,89,2013,6514,6013,501,7.7
"05089",5,89,2014,6536,6126,410,6.3
"05089",5,89,2015,6524,6187,337,5.2
"05089",5,89,2016,6533,6274,259,4
"05089",5,89,2017,6495,6239,256,3.9
"05091",5,91,1990,17158,16124,1034,6
"05091",5,91,1991,16922,15520,1402,8.3
"05091",5,91,1992,17067,15768,1299,7.6
"05091",5,91,1993,17126,15918,1208,7.1
"05091",5,91,1994,17368,16033,1335,7.7
"05091",5,91,1995,17394,16243,1151,6.6
"05091",5,91,1996,17509,16397,1112,6.4
"05091",5,91,1997,17363,16508,855,4.9
"05091",5,91,1998,17102,16285,817,4.8
"05091",5,91,1999,17602,16616,986,5.6
"05091",5,91,2000,18185,17368,817,4.5
"05091",5,91,2001,17989,17161,828,4.6
"05091",5,91,2002,18300,17421,879,4.8
"05091",5,91,2003,18224,17296,928,5.1
"05091",5,91,2004,18839,17916,923,4.9
"05091",5,91,2005,19724,18778,946,4.8
"05091",5,91,2006,19572,18662,910,4.6
"05091",5,91,2007,19792,18910,882,4.5
"05091",5,91,2008,20242,19423,819,4
"05091",5,91,2009,19952,18825,1127,5.6
"05091",5,91,2010,20560,19364,1196,5.8
"05091",5,91,2011,20808,19484,1324,6.4
"05091",5,91,2012,20260,19055,1205,5.9
"05091",5,91,2013,19556,18303,1253,6.4
"05091",5,91,2014,19372,18247,1125,5.8
"05091",5,91,2015,19910,18916,994,5
"05091",5,91,2016,19906,19077,829,4.2
"05091",5,91,2017,19862,19006,856,4.3
"05093",5,93,1990,24993,22622,2371,9.5
"05093",5,93,1991,25799,23200,2599,10.1
"05093",5,93,1992,26805,23986,2819,10.5
"05093",5,93,1993,27033,24212,2821,10.4
"05093",5,93,1994,27453,24283,3170,11.5
"05093",5,93,1995,27047,24455,2592,9.6
"05093",5,93,1996,27532,25080,2452,8.9
"05093",5,93,1997,27582,24792,2790,10.1
"05093",5,93,1998,26946,23921,3025,11.2
"05093",5,93,1999,27068,24080,2988,11
"05093",5,93,2000,22654,20888,1766,7.8
"05093",5,93,2001,22107,19623,2484,11.2
"05093",5,93,2002,21588,19029,2559,11.9
"05093",5,93,2003,20220,17797,2423,12
"05093",5,93,2004,19723,17741,1982,10
"05093",5,93,2005,20201,18456,1745,8.6
"05093",5,93,2006,21268,19610,1658,7.8
"05093",5,93,2007,21616,20044,1572,7.3
"05093",5,93,2008,22063,20367,1696,7.7
"05093",5,93,2009,21532,18532,3000,13.9
"05093",5,93,2010,20195,17667,2528,12.5
"05093",5,93,2011,20984,18454,2530,12.1
"05093",5,93,2012,20267,18046,2221,11
"05093",5,93,2013,19000,16852,2148,11.3
"05093",5,93,2014,19075,17320,1755,9.2
"05093",5,93,2015,18370,16720,1650,9
"05093",5,93,2016,18098,16879,1219,6.7
"05093",5,93,2017,17908,16845,1063,5.9
"05095",5,95,1990,4466,4123,343,7.7
"05095",5,95,1991,4404,3955,449,10.2
"05095",5,95,1992,4413,3902,511,11.6
"05095",5,95,1993,4397,4055,342,7.8
"05095",5,95,1994,4499,4187,312,6.9
"05095",5,95,1995,4394,4112,282,6.4
"05095",5,95,1996,4400,4018,382,8.7
"05095",5,95,1997,4305,3944,361,8.4
"05095",5,95,1998,4111,3786,325,7.9
"05095",5,95,1999,4085,3798,287,7
"05095",5,95,2000,4070,3861,209,5.1
"05095",5,95,2001,3992,3738,254,6.4
"05095",5,95,2002,4018,3725,293,7.3
"05095",5,95,2003,3968,3668,300,7.6
"05095",5,95,2004,3826,3555,271,7.1
"05095",5,95,2005,3864,3607,257,6.7
"05095",5,95,2006,3892,3613,279,7.2
"05095",5,95,2007,3897,3636,261,6.7
"05095",5,95,2008,3860,3613,247,6.4
"05095",5,95,2009,3717,3415,302,8.1
"05095",5,95,2010,3413,3098,315,9.2
"05095",5,95,2011,3390,3067,323,9.5
"05095",5,95,2012,3270,2974,296,9.1
"05095",5,95,2013,3121,2847,274,8.8
"05095",5,95,2014,3093,2885,208,6.7
"05095",5,95,2015,2973,2793,180,6.1
"05095",5,95,2016,2885,2747,138,4.8
"05095",5,95,2017,2820,2700,120,4.3
"05097",5,97,1990,3395,3268,127,3.7
"05097",5,97,1991,3542,3358,184,5.2
"05097",5,97,1992,3639,3464,175,4.8
"05097",5,97,1993,3804,3647,157,4.1
"05097",5,97,1994,3874,3721,153,3.9
"05097",5,97,1995,3928,3780,148,3.8
"05097",5,97,1996,4085,3917,168,4.1
"05097",5,97,1997,4058,3904,154,3.8
"05097",5,97,1998,3979,3819,160,4
"05097",5,97,1999,4034,3886,148,3.7
"05097",5,97,2000,4073,3905,168,4.1
"05097",5,97,2001,4070,3878,192,4.7
"05097",5,97,2002,4142,3912,230,5.6
"05097",5,97,2003,4249,4010,239,5.6
"05097",5,97,2004,4224,3995,229,5.4
"05097",5,97,2005,4343,4130,213,4.9
"05097",5,97,2006,4401,4195,206,4.7
"05097",5,97,2007,4263,4038,225,5.3
"05097",5,97,2008,4203,3965,238,5.7
"05097",5,97,2009,4168,3874,294,7.1
"05097",5,97,2010,3904,3562,342,8.8
"05097",5,97,2011,3826,3470,356,9.3
"05097",5,97,2012,3586,3282,304,8.5
"05097",5,97,2013,3418,3131,287,8.4
"05097",5,97,2014,3349,3082,267,8
"05097",5,97,2015,3227,3008,219,6.8
"05097",5,97,2016,3105,2945,160,5.2
"05097",5,97,2017,3069,2921,148,4.8
"05099",5,99,1990,4627,4145,482,10.4
"05099",5,99,1991,4493,4074,419,9.3
"05099",5,99,1992,4568,4260,308,6.7
"05099",5,99,1993,4586,4309,277,6
"05099",5,99,1994,4842,4543,299,6.2
"05099",5,99,1995,4955,4677,278,5.6
"05099",5,99,1996,5136,4743,393,7.7
"05099",5,99,1997,5175,4815,360,7
"05099",5,99,1998,4987,4614,373,7.5
"05099",5,99,1999,5004,4702,302,6
"05099",5,99,2000,4603,4383,220,4.8
"05099",5,99,2001,4515,4296,219,4.9
"05099",5,99,2002,4580,4351,229,5
"05099",5,99,2003,4493,4265,228,5.1
"05099",5,99,2004,4369,4105,264,6
"05099",5,99,2005,4396,4142,254,5.8
"05099",5,99,2006,4446,4201,245,5.5
"05099",5,99,2007,4363,4115,248,5.7
"05099",5,99,2008,4280,3989,291,6.8
"05099",5,99,2009,4250,3855,395,9.3
"05099",5,99,2010,4016,3614,402,10
"05099",5,99,2011,4180,3784,396,9.5
"05099",5,99,2012,4129,3808,321,7.8
"05099",5,99,2013,3779,3488,291,7.7
"05099",5,99,2014,3684,3461,223,6.1
"05099",5,99,2015,3633,3452,181,5
"05099",5,99,2016,3623,3489,134,3.7
"05099",5,99,2017,3615,3487,128,3.5
"05101",5,101,1990,2986,2746,240,8
"05101",5,101,1991,2932,2670,262,8.9
"05101",5,101,1992,2853,2677,176,6.2
"05101",5,101,1993,2955,2782,173,5.9
"05101",5,101,1994,3009,2815,194,6.4
"05101",5,101,1995,3040,2872,168,5.5
"05101",5,101,1996,2954,2759,195,6.6
"05101",5,101,1997,3048,2780,268,8.8
"05101",5,101,1998,2967,2740,227,7.7
"05101",5,101,1999,2983,2804,179,6
"05101",5,101,2000,3754,3591,163,4.3
"05101",5,101,2001,3623,3424,199,5.5
"05101",5,101,2002,3606,3403,203,5.6
"05101",5,101,2003,3615,3404,211,5.8
"05101",5,101,2004,3573,3353,220,6.2
"05101",5,101,2005,3598,3415,183,5.1
"05101",5,101,2006,3608,3422,186,5.2
"05101",5,101,2007,3520,3342,178,5.1
"05101",5,101,2008,3504,3304,200,5.7
"05101",5,101,2009,3459,3184,275,8
"05101",5,101,2010,3790,3528,262,6.9
"05101",5,101,2011,3803,3518,285,7.5
"05101",5,101,2012,3628,3362,266,7.3
"05101",5,101,2013,3490,3249,241,6.9
"05101",5,101,2014,3363,3167,196,5.8
"05101",5,101,2015,3394,3230,164,4.8
"05101",5,101,2016,3418,3286,132,3.9
"05101",5,101,2017,3380,3259,121,3.6
"05103",5,103,1990,14675,12637,2038,13.9
"05103",5,103,1991,13443,11744,1699,12.6
"05103",5,103,1992,13082,11577,1505,11.5
"05103",5,103,1993,12905,11389,1516,11.7
"05103",5,103,1994,12967,11353,1614,12.4
"05103",5,103,1995,12363,11040,1323,10.7
"05103",5,103,1996,12054,10810,1244,10.3
"05103",5,103,1997,11960,10806,1154,9.6
"05103",5,103,1998,11986,10756,1230,10.3
"05103",5,103,1999,11511,10475,1036,9
"05103",5,103,2000,12385,11652,733,5.9
"05103",5,103,2001,12315,11398,917,7.4
"05103",5,103,2002,12261,11409,852,6.9
"05103",5,103,2003,12085,11122,963,8
"05103",5,103,2004,12299,11456,843,6.9
"05103",5,103,2005,12590,11705,885,7
"05103",5,103,2006,12531,11525,1006,8
"05103",5,103,2007,12054,11178,876,7.3
"05103",5,103,2008,11979,11212,767,6.4
"05103",5,103,2009,12136,11162,974,8
"05103",5,103,2010,11294,10214,1080,9.6
"05103",5,103,2011,11066,9900,1166,10.5
"05103",5,103,2012,10498,9395,1103,10.5
"05103",5,103,2013,10253,9261,992,9.7
"05103",5,103,2014,9954,9160,794,8
"05103",5,103,2015,9882,9256,626,6.3
"05103",5,103,2016,9834,9339,495,5
"05103",5,103,2017,9795,9347,448,4.6
"05105",5,105,1990,3789,3477,312,8.2
"05105",5,105,1991,3662,3334,328,9
"05105",5,105,1992,3657,3278,379,10.4
"05105",5,105,1993,3544,3226,318,9
"05105",5,105,1994,3665,3367,298,8.1
"05105",5,105,1995,3899,3650,249,6.4
"05105",5,105,1996,4074,3816,258,6.3
"05105",5,105,1997,3794,3525,269,7.1
"05105",5,105,1998,3547,3290,257,7.2
"05105",5,105,1999,3640,3413,227,6.2
"05105",5,105,2000,4803,4564,239,5
"05105",5,105,2001,4776,4516,260,5.4
"05105",5,105,2002,4802,4512,290,6
"05105",5,105,2003,4778,4446,332,6.9
"05105",5,105,2004,4851,4574,277,5.7
"05105",5,105,2005,4966,4712,254,5.1
"05105",5,105,2006,4905,4661,244,5
"05105",5,105,2007,4835,4601,234,4.8
"05105",5,105,2008,4822,4551,271,5.6
"05105",5,105,2009,4724,4353,371,7.9
"05105",5,105,2010,4560,4154,406,8.9
"05105",5,105,2011,4520,4098,422,9.3
"05105",5,105,2012,4416,4015,401,9.1
"05105",5,105,2013,4364,3956,408,9.3
"05105",5,105,2014,4231,3905,326,7.7
"05105",5,105,2015,4201,3944,257,6.1
"05105",5,105,2016,4174,3976,198,4.7
"05105",5,105,2017,4202,4027,175,4.2
"05107",5,107,1990,10678,9487,1191,11.2
"05107",5,107,1991,10624,9519,1105,10.4
"05107",5,107,1992,10878,9692,1186,10.9
"05107",5,107,1993,11032,9806,1226,11.1
"05107",5,107,1994,11132,10001,1131,10.2
"05107",5,107,1995,11036,9864,1172,10.6
"05107",5,107,1996,10727,9617,1110,10.3
"05107",5,107,1997,10256,9239,1017,9.9
"05107",5,107,1998,9944,9058,886,8.9
"05107",5,107,1999,9630,8876,754,7.8
"05107",5,107,2000,9693,9091,602,6.2
"05107",5,107,2001,9395,8660,735,7.8
"05107",5,107,2002,9342,8554,788,8.4
"05107",5,107,2003,9175,8367,808,8.8
"05107",5,107,2004,9015,8193,822,9.1
"05107",5,107,2005,8837,8033,804,9.1
"05107",5,107,2006,9148,8404,744,8.1
"05107",5,107,2007,9060,8403,657,7.3
"05107",5,107,2008,9047,8398,649,7.2
"05107",5,107,2009,8841,8001,840,9.5
"05107",5,107,2010,8585,7681,904,10.5
"05107",5,107,2011,8447,7421,1026,12.1
"05107",5,107,2012,7970,7048,922,11.6
"05107",5,107,2013,7595,6732,863,11.4
"05107",5,107,2014,7228,6535,693,9.6
"05107",5,107,2015,6995,6466,529,7.6
"05107",5,107,2016,6667,6277,390,5.8
"05107",5,107,2017,6574,6192,382,5.8
"05109",5,109,1990,4640,4192,448,9.7
"05109",5,109,1991,4521,4118,403,8.9
"05109",5,109,1992,4561,4193,368,8.1
"05109",5,109,1993,4644,4350,294,6.3
"05109",5,109,1994,4881,4591,290,5.9
"05109",5,109,1995,5103,4851,252,4.9
"05109",5,109,1996,5093,4801,292,5.7
"05109",5,109,1997,5071,4800,271,5.3
"05109",5,109,1998,5007,4766,241,4.8
"05109",5,109,1999,4944,4707,237,4.8
"05109",5,109,2000,5429,5202,227,4.2
"05109",5,109,2001,5343,5092,251,4.7
"05109",5,109,2002,5180,4892,288,5.6
"05109",5,109,2003,5189,4904,285,5.5
"05109",5,109,2004,5110,4831,279,5.5
"05109",5,109,2005,5156,4907,249,4.8
"05109",5,109,2006,5375,5104,271,5
"05109",5,109,2007,5240,4944,296,5.6
"05109",5,109,2008,5121,4811,310,6.1
"05109",5,109,2009,5051,4664,387,7.7
"05109",5,109,2010,4843,4400,443,9.1
"05109",5,109,2011,4654,4186,468,10.1
"05109",5,109,2012,4366,3969,397,9.1
"05109",5,109,2013,4202,3831,371,8.8
"05109",5,109,2014,4207,3898,309,7.3
"05109",5,109,2015,4168,3922,246,5.9
"05109",5,109,2016,4177,3999,178,4.3
"05109",5,109,2017,4285,4111,174,4.1
"05111",5,111,1990,11278,10181,1097,9.7
"05111",5,111,1991,10796,9794,1002,9.3
"05111",5,111,1992,10874,10022,852,7.8
"05111",5,111,1993,11043,10026,1017,9.2
"05111",5,111,1994,11167,10407,760,6.8
"05111",5,111,1995,11210,10547,663,5.9
"05111",5,111,1996,11313,10554,759,6.7
"05111",5,111,1997,10996,10292,704,6.4
"05111",5,111,1998,10668,9846,822,7.7
"05111",5,111,1999,10663,10009,654,6.1
"05111",5,111,2000,11432,10886,546,4.8
"05111",5,111,2001,11318,10489,829,7.3
"05111",5,111,2002,11294,10451,843,7.5
"05111",5,111,2003,11200,10370,830,7.4
"05111",5,111,2004,11234,10514,720,6.4
"05111",5,111,2005,11483,10722,761,6.6
"05111",5,111,2006,11359,10603,756,6.7
"05111",5,111,2007,10923,10132,791,7.2
"05111",5,111,2008,10796,10103,693,6.4
"05111",5,111,2009,10542,9607,935,8.9
"05111",5,111,2010,10737,9736,1001,9.3
"05111",5,111,2011,10817,9783,1034,9.6
"05111",5,111,2012,10387,9486,901,8.7
"05111",5,111,2013,10147,9289,858,8.5
"05111",5,111,2014,10103,9404,699,6.9
"05111",5,111,2015,10064,9502,562,5.6
"05111",5,111,2016,10112,9681,431,4.3
"05111",5,111,2017,10347,9921,426,4.1
"05113",5,113,1990,7730,7366,364,4.7
"05113",5,113,1991,7639,7165,474,6.2
"05113",5,113,1992,7715,7244,471,6.1
"05113",5,113,1993,8111,7742,369,4.5
"05113",5,113,1994,8523,8189,334,3.9
"05113",5,113,1995,8919,8586,333,3.7
"05113",5,113,1996,9137,8725,412,4.5
"05113",5,113,1997,9055,8630,425,4.7
"05113",5,113,1998,9184,8837,347,3.8
"05113",5,113,1999,9400,9032,368,3.9
"05113",5,113,2000,8976,8607,369,4.1
"05113",5,113,2001,8934,8506,428,4.8
"05113",5,113,2002,8824,8046,778,8.8
"05113",5,113,2003,8587,7925,662,7.7
"05113",5,113,2004,8420,7912,508,6
"05113",5,113,2005,8701,8264,437,5
"05113",5,113,2006,8928,8504,424,4.7
"05113",5,113,2007,8904,8467,437,4.9
"05113",5,113,2008,8919,8459,460,5.2
"05113",5,113,2009,8797,8125,672,7.6
"05113",5,113,2010,8981,8311,670,7.5
"05113",5,113,2011,8947,8226,721,8.1
"05113",5,113,2012,8701,8054,647,7.4
"05113",5,113,2013,8455,7850,605,7.2
"05113",5,113,2014,8457,7928,529,6.3
"05113",5,113,2015,8295,7815,480,5.8
"05113",5,113,2016,8165,7768,397,4.9
"05113",5,113,2017,8033,7672,361,4.5
"05115",5,115,1990,23707,22176,1531,6.5
"05115",5,115,1991,24178,22679,1499,6.2
"05115",5,115,1992,25085,23589,1496,6
"05115",5,115,1993,25526,24234,1292,5.1
"05115",5,115,1994,26372,25176,1196,4.5
"05115",5,115,1995,26961,25692,1269,4.7
"05115",5,115,1996,27063,25880,1183,4.4
"05115",5,115,1997,26917,25679,1238,4.6
"05115",5,115,1998,27017,25736,1281,4.7
"05115",5,115,1999,27485,26267,1218,4.4
"05115",5,115,2000,26758,25616,1142,4.3
"05115",5,115,2001,26523,25341,1182,4.5
"05115",5,115,2002,26668,25272,1396,5.2
"05115",5,115,2003,26555,25020,1535,5.8
"05115",5,115,2004,27467,25989,1478,5.4
"05115",5,115,2005,29572,28246,1326,4.5
"05115",5,115,2006,30229,28796,1433,4.7
"05115",5,115,2007,30274,28835,1439,4.8
"05115",5,115,2008,30504,29008,1496,4.9
"05115",5,115,2009,29573,27343,2230,7.5
"05115",5,115,2010,30054,27706,2348,7.8
"05115",5,115,2011,30517,28125,2392,7.8
"05115",5,115,2012,29999,27815,2184,7.3
"05115",5,115,2013,29650,27479,2171,7.3
"05115",5,115,2014,29615,27764,1851,6.3
"05115",5,115,2015,29676,28110,1566,5.3
"05115",5,115,2016,29272,27932,1340,4.6
"05115",5,115,2017,29336,28044,1292,4.4
"05117",5,117,1990,4380,4096,284,6.5
"05117",5,117,1991,4350,3938,412,9.5
"05117",5,117,1992,3977,3443,534,13.4
"05117",5,117,1993,3916,3515,401,10.2
"05117",5,117,1994,4228,3945,283,6.7
"05117",5,117,1995,4246,3999,247,5.8
"05117",5,117,1996,4065,3687,378,9.3
"05117",5,117,1997,3849,3503,346,9
"05117",5,117,1998,3820,3535,285,7.5
"05117",5,117,1999,3998,3770,228,5.7
"05117",5,117,2000,4399,4205,194,4.4
"05117",5,117,2001,4354,4152,202,4.6
"05117",5,117,2002,4473,4242,231,5.2
"05117",5,117,2003,4457,4221,236,5.3
"05117",5,117,2004,4362,4130,232,5.3
"05117",5,117,2005,4310,4053,257,6
"05117",5,117,2006,4517,4263,254,5.6
"05117",5,117,2007,4436,4182,254,5.7
"05117",5,117,2008,4425,4173,252,5.7
"05117",5,117,2009,4294,3956,338,7.9
"05117",5,117,2010,3967,3602,365,9.2
"05117",5,117,2011,3937,3596,341,8.7
"05117",5,117,2012,3825,3536,289,7.6
"05117",5,117,2013,3803,3535,268,7
"05117",5,117,2014,3813,3593,220,5.8
"05117",5,117,2015,3728,3553,175,4.7
"05117",5,117,2016,3657,3518,139,3.8
"05117",5,117,2017,3732,3581,151,4
"05119",5,119,1990,187172,176954,10218,5.5
"05119",5,119,1991,185764,174765,10999,5.9
"05119",5,119,1992,189270,178500,10770,5.7
"05119",5,119,1993,190153,181014,9139,4.8
"05119",5,119,1994,194319,186232,8087,4.2
"05119",5,119,1995,195545,188534,7011,3.6
"05119",5,119,1996,196389,189021,7368,3.8
"05119",5,119,1997,194304,186631,7673,3.9
"05119",5,119,1998,193558,185982,7576,3.9
"05119",5,119,1999,194703,187912,6791,3.5
"05119",5,119,2000,184110,177186,6924,3.8
"05119",5,119,2001,182147,174258,7889,4.3
"05119",5,119,2002,182112,173090,9022,5
"05119",5,119,2003,181174,171643,9531,5.3
"05119",5,119,2004,185731,176064,9667,5.2
"05119",5,119,2005,190594,181400,9194,4.8
"05119",5,119,2006,189922,180838,9084,4.8
"05119",5,119,2007,191162,182117,9045,4.7
"05119",5,119,2008,191923,182801,9122,4.8
"05119",5,119,2009,189945,177280,12665,6.7
"05119",5,119,2010,189321,175512,13809,7.3
"05119",5,119,2011,190083,175884,14199,7.5
"05119",5,119,2012,188484,175552,12932,6.9
"05119",5,119,2013,186725,174559,12166,6.5
"05119",5,119,2014,184549,174401,10148,5.5
"05119",5,119,2015,186061,177567,8494,4.6
"05119",5,119,2016,187474,180862,6612,3.5
"05119",5,119,2017,190086,183669,6417,3.4
"05121",5,121,1990,7311,6620,691,9.5
"05121",5,121,1991,7224,6436,788,10.9
"05121",5,121,1992,7272,6512,760,10.5
"05121",5,121,1993,7714,7078,636,8.2
"05121",5,121,1994,7878,7354,524,6.7
"05121",5,121,1995,8012,7436,576,7.2
"05121",5,121,1996,8044,6924,1120,13.9
"05121",5,121,1997,7791,6947,844,10.8
"05121",5,121,1998,7874,7089,785,10
"05121",5,121,1999,7960,7411,549,6.9
"05121",5,121,2000,8280,7841,439,5.3
"05121",5,121,2001,8157,7569,588,7.2
"05121",5,121,2002,8285,7662,623,7.5
"05121",5,121,2003,7838,7087,751,9.6
"05121",5,121,2004,7713,7074,639,8.3
"05121",5,121,2005,7872,7256,616,7.8
"05121",5,121,2006,7829,7268,561,7.2
"05121",5,121,2007,7666,6956,710,9.3
"05121",5,121,2008,7596,6974,622,8.2
"05121",5,121,2009,7664,6956,708,9.2
"05121",5,121,2010,7260,6516,744,10.2
"05121",5,121,2011,7186,6375,811,11.3
"05121",5,121,2012,6867,6124,743,10.8
"05121",5,121,2013,6692,6055,637,9.5
"05121",5,121,2014,6551,6034,517,7.9
"05121",5,121,2015,6184,5742,442,7.1
"05121",5,121,2016,6533,6234,299,4.6
"05121",5,121,2017,6936,6648,288,4.2
"05123",5,123,1990,11533,10176,1357,11.8
"05123",5,123,1991,11440,10022,1418,12.4
"05123",5,123,1992,11671,10289,1382,11.8
"05123",5,123,1993,12013,10417,1596,13.3
"05123",5,123,1994,12621,11317,1304,10.3
"05123",5,123,1995,12909,11751,1158,9
"05123",5,123,1996,12724,11336,1388,10.9
"05123",5,123,1997,12784,11485,1299,10.2
"05123",5,123,1998,13003,11811,1192,9.2
"05123",5,123,1999,12461,11317,1144,9.2
"05123",5,123,2000,10906,10144,762,7
"05123",5,123,2001,10726,9883,843,7.9
"05123",5,123,2002,10847,9967,880,8.1
"05123",5,123,2003,10823,9805,1018,9.4
"05123",5,123,2004,10638,9652,986,9.3
"05123",5,123,2005,10805,9882,923,8.5
"05123",5,123,2006,10814,9847,967,8.9
"05123",5,123,2007,10561,9546,1015,9.6
"05123",5,123,2008,10429,9450,979,9.4
"05123",5,123,2009,10389,9308,1081,10.4
"05123",5,123,2010,9830,8784,1046,10.6
"05123",5,123,2011,9824,8729,1095,11.1
"05123",5,123,2012,9498,8471,1027,10.8
"05123",5,123,2013,9173,8220,953,10.4
"05123",5,123,2014,8978,8198,780,8.7
"05123",5,123,2015,8948,8302,646,7.2
"05123",5,123,2016,8846,8389,457,5.2
"05123",5,123,2017,8410,7983,427,5.1
"05125",5,125,1990,33735,31839,1896,5.6
"05125",5,125,1991,34082,31940,2142,6.3
"05125",5,125,1992,35245,33149,2096,5.9
"05125",5,125,1993,36052,34452,1600,4.4
"05125",5,125,1994,38016,36682,1334,3.5
"05125",5,125,1995,39596,38586,1010,2.6
"05125",5,125,1996,40172,39053,1119,2.8
"05125",5,125,1997,40880,39630,1250,3.1
"05125",5,125,1998,41389,40209,1180,2.9
"05125",5,125,1999,42321,41211,1110,2.6
"05125",5,125,2000,42665,41261,1404,3.3
"05125",5,125,2001,42614,41027,1587,3.7
"05125",5,125,2002,43054,41176,1878,4.4
"05125",5,125,2003,43406,41275,2131,4.9
"05125",5,125,2004,45251,43152,2099,4.6
"05125",5,125,2005,47337,45291,2046,4.3
"05125",5,125,2006,48576,46446,2130,4.4
"05125",5,125,2007,49069,47019,2050,4.2
"05125",5,125,2008,50037,47807,2230,4.5
"05125",5,125,2009,49591,46320,3271,6.6
"05125",5,125,2010,53382,49824,3558,6.7
"05125",5,125,2011,54212,50604,3608,6.7
"05125",5,125,2012,54388,51067,3321,6.1
"05125",5,125,2013,54784,51620,3164,5.8
"05125",5,125,2014,54611,51972,2639,4.8
"05125",5,125,2015,55992,53714,2278,4.1
"05125",5,125,2016,56969,55203,1766,3.1
"05125",5,125,2017,57787,56056,1731,3
"05127",5,127,1990,4745,4417,328,6.9
"05127",5,127,1991,4780,4535,245,5.1
"05127",5,127,1992,4865,4667,198,4.1
"05127",5,127,1993,5042,4853,189,3.7
"05127",5,127,1994,5050,4886,164,3.2
"05127",5,127,1995,5022,4865,157,3.1
"05127",5,127,1996,5042,4873,169,3.4
"05127",5,127,1997,4983,4837,146,2.9
"05127",5,127,1998,4922,4759,163,3.3
"05127",5,127,1999,4985,4850,135,2.7
"05127",5,127,2000,4927,4754,173,3.5
"05127",5,127,2001,4774,4575,199,4.2
"05127",5,127,2002,4866,4649,217,4.5
"05127",5,127,2003,4706,4477,229,4.9
"05127",5,127,2004,4575,4339,236,5.2
"05127",5,127,2005,4688,4476,212,4.5
"05127",5,127,2006,4938,4720,218,4.4
"05127",5,127,2007,4880,4655,225,4.6
"05127",5,127,2008,4889,4656,233,4.8
"05127",5,127,2009,4913,4577,336,6.8
"05127",5,127,2010,4721,4386,335,7.1
"05127",5,127,2011,4832,4489,343,7.1
"05127",5,127,2012,4647,4335,312,6.7
"05127",5,127,2013,4591,4303,288,6.3
"05127",5,127,2014,4543,4315,228,5
"05127",5,127,2015,4486,4271,215,4.8
"05127",5,127,2016,4429,4265,164,3.7
"05127",5,127,2017,4423,4272,151,3.4
"05129",5,129,1990,3195,2915,280,8.8
"05129",5,129,1991,2996,2753,243,8.1
"05129",5,129,1992,3019,2778,241,8
"05129",5,129,1993,2982,2821,161,5.4
"05129",5,129,1994,2987,2824,163,5.5
"05129",5,129,1995,3035,2882,153,5
"05129",5,129,1996,2979,2785,194,6.5
"05129",5,129,1997,3030,2757,273,9
"05129",5,129,1998,2957,2710,247,8.4
"05129",5,129,1999,2997,2773,224,7.5
"05129",5,129,2000,3304,3140,164,5
"05129",5,129,2001,3225,3059,166,5.1
"05129",5,129,2002,3329,3166,163,4.9
"05129",5,129,2003,3373,3184,189,5.6
"05129",5,129,2004,3330,3139,191,5.7
"05129",5,129,2005,3422,3251,171,5
"05129",5,129,2006,3559,3390,169,4.7
"05129",5,129,2007,3628,3451,177,4.9
"05129",5,129,2008,3638,3441,197,5.4
"05129",5,129,2009,3569,3294,275,7.7
"05129",5,129,2010,3393,3081,312,9.2
"05129",5,129,2011,3336,3030,306,9.2
"05129",5,129,2012,3219,2955,264,8.2
"05129",5,129,2013,3125,2877,248,7.9
"05129",5,129,2014,2994,2804,190,6.3
"05129",5,129,2015,3027,2856,171,5.6
"05129",5,129,2016,2995,2859,136,4.5
"05129",5,129,2017,2946,2812,134,4.5
"05131",5,131,1990,52748,48914,3834,7.3
"05131",5,131,1991,52134,48211,3923,7.5
"05131",5,131,1992,53052,49245,3807,7.2
"05131",5,131,1993,54263,50966,3297,6.1
"05131",5,131,1994,56009,53327,2682,4.8
"05131",5,131,1995,56359,53770,2589,4.6
"05131",5,131,1996,56291,53557,2734,4.9
"05131",5,131,1997,55995,53497,2498,4.5
"05131",5,131,1998,55590,53316,2274,4.1
"05131",5,131,1999,56409,54455,1954,3.5
"05131",5,131,2000,56415,54505,1910,3.4
"05131",5,131,2001,56227,53960,2267,4
"05131",5,131,2002,56372,53857,2515,4.5
"05131",5,131,2003,56011,53227,2784,5
"05131",5,131,2004,57291,54544,2747,4.8
"05131",5,131,2005,59664,57117,2547,4.3
"05131",5,131,2006,60935,58127,2808,4.6
"05131",5,131,2007,62414,59205,3209,5.1
"05131",5,131,2008,62219,59133,3086,5
"05131",5,131,2009,60582,55949,4633,7.6
"05131",5,131,2010,59543,54760,4783,8
"05131",5,131,2011,59600,54442,5158,8.7
"05131",5,131,2012,59025,54392,4633,7.8
"05131",5,131,2013,58153,53824,4329,7.4
"05131",5,131,2014,57183,53940,3243,5.7
"05131",5,131,2015,57731,54961,2770,4.8
"05131",5,131,2016,57711,55576,2135,3.7
"05131",5,131,2017,57210,55146,2064,3.6
"05133",5,133,1990,6465,6184,281,4.3
"05133",5,133,1991,6786,6379,407,6
"05133",5,133,1992,6970,6550,420,6
"05133",5,133,1993,7070,6733,337,4.8
"05133",5,133,1994,7047,6734,313,4.4
"05133",5,133,1995,7128,6789,339,4.8
"05133",5,133,1996,6924,6488,436,6.3
"05133",5,133,1997,7008,6587,421,6
"05133",5,133,1998,7021,6644,377,5.4
"05133",5,133,1999,6942,6623,319,4.6
"05133",5,133,2000,7230,6953,277,3.8
"05133",5,133,2001,7284,6971,313,4.3
"05133",5,133,2002,7364,7042,322,4.4
"05133",5,133,2003,7396,7048,348,4.7
"05133",5,133,2004,7511,7162,349,4.6
"05133",5,133,2005,7655,7330,325,4.2
"05133",5,133,2006,7781,7467,314,4
"05133",5,133,2007,7801,7480,321,4.1
"05133",5,133,2008,7640,7330,310,4.1
"05133",5,133,2009,7570,7126,444,5.9
"05133",5,133,2010,7059,6563,496,7
"05133",5,133,2011,6402,5812,590,9.2
"05133",5,133,2012,6131,5593,538,8.8
"05133",5,133,2013,5926,5431,495,8.4
"05133",5,133,2014,5793,5388,405,7
"05133",5,133,2015,5603,5260,343,6.1
"05133",5,133,2016,5638,5363,275,4.9
"05133",5,133,2017,5650,5395,255,4.5
"05135",5,135,1990,5031,4651,380,7.6
"05135",5,135,1991,5132,4725,407,7.9
"05135",5,135,1992,5441,5016,425,7.8
"05135",5,135,1993,5628,5218,410,7.3
"05135",5,135,1994,5828,5431,397,6.8
"05135",5,135,1995,5848,5485,363,6.2
"05135",5,135,1996,6017,5615,402,6.7
"05135",5,135,1997,6157,5764,393,6.4
"05135",5,135,1998,6141,5784,357,5.8
"05135",5,135,1999,6302,5978,324,5.1
"05135",5,135,2000,6556,6211,345,5.3
"05135",5,135,2001,6480,6074,406,6.3
"05135",5,135,2002,6418,5931,487,7.6
"05135",5,135,2003,6401,5845,556,8.7
"05135",5,135,2004,6473,5961,512,7.9
"05135",5,135,2005,6565,6092,473,7.2
"05135",5,135,2006,6557,6117,440,6.7
"05135",5,135,2007,6448,6015,433,6.7
"05135",5,135,2008,6319,5842,477,7.5
"05135",5,135,2009,6248,5673,575,9.2
"05135",5,135,2010,6309,5690,619,9.8
"05135",5,135,2011,6294,5619,675,10.7
"05135",5,135,2012,6105,5486,619,10.1
"05135",5,135,2013,6019,5433,586,9.7
"05135",5,135,2014,5969,5465,504,8.4
"05135",5,135,2015,6004,5591,413,6.9
"05135",5,135,2016,6061,5734,327,5.4
"05135",5,135,2017,6054,5756,298,4.9
"05137",5,137,1990,4376,4069,307,7
"05137",5,137,1991,4444,4150,294,6.6
"05137",5,137,1992,4585,4277,308,6.7
"05137",5,137,1993,4863,4568,295,6.1
"05137",5,137,1994,5090,4829,261,5.1
"05137",5,137,1995,5072,4798,274,5.4
"05137",5,137,1996,5075,4795,280,5.5
"05137",5,137,1997,4921,4665,256,5.2
"05137",5,137,1998,4999,4742,257,5.1
"05137",5,137,1999,5230,4974,256,4.9
"05137",5,137,2000,4659,4453,206,4.4
"05137",5,137,2001,4470,4216,254,5.7
"05137",5,137,2002,4501,4205,296,6.6
"05137",5,137,2003,4479,4138,341,7.6
"05137",5,137,2004,4464,4127,337,7.5
"05137",5,137,2005,4514,4220,294,6.5
"05137",5,137,2006,4767,4503,264,5.5
"05137",5,137,2007,4804,4531,273,5.7
"05137",5,137,2008,4744,4432,312,6.6
"05137",5,137,2009,4597,4191,406,8.8
"05137",5,137,2010,5522,5103,419,7.6
"05137",5,137,2011,5402,4919,483,8.9
"05137",5,137,2012,5052,4636,416,8.2
"05137",5,137,2013,4803,4400,403,8.4
"05137",5,137,2014,4701,4343,358,7.6
"05137",5,137,2015,4705,4411,294,6.2
"05137",5,137,2016,4750,4507,243,5.1
"05137",5,137,2017,4827,4598,229,4.7
"05139",5,139,1990,20893,19437,1456,7
"05139",5,139,1991,20591,18989,1602,7.8
"05139",5,139,1992,21034,19492,1542,7.3
"05139",5,139,1993,21164,19633,1531,7.2
"05139",5,139,1994,21587,20096,1491,6.9
"05139",5,139,1995,21499,20199,1300,6
"05139",5,139,1996,21394,19873,1521,7.1
"05139",5,139,1997,21162,19672,1490,7
"05139",5,139,1998,21045,19652,1393,6.6
"05139",5,139,1999,21108,19818,1290,6.1
"05139",5,139,2000,20172,19213,959,4.8
"05139",5,139,2001,20173,19126,1047,5.2
"05139",5,139,2002,21334,20122,1212,5.7
"05139",5,139,2003,19714,18137,1577,8
"05139",5,139,2004,19742,18284,1458,7.4
"05139",5,139,2005,20130,18747,1383,6.9
"05139",5,139,2006,19852,18532,1320,6.6
"05139",5,139,2007,19462,18130,1332,6.8
"05139",5,139,2008,19294,18065,1229,6.4
"05139",5,139,2009,19175,17192,1983,10.3
"05139",5,139,2010,17164,15222,1942,11.3
"05139",5,139,2011,16977,15187,1790,10.5
"05139",5,139,2012,16755,15211,1544,9.2
"05139",5,139,2013,16600,15174,1426,8.6
"05139",5,139,2014,16579,15355,1224,7.4
"05139",5,139,2015,16871,15837,1034,6.1
"05139",5,139,2016,16342,15453,889,5.4
"05139",5,139,2017,16138,15285,853,5.3
"05141",5,141,1990,5596,5087,509,9.1
"05141",5,141,1991,5606,5038,568,10.1
"05141",5,141,1992,5818,5246,572,9.8
"05141",5,141,1993,5929,5436,493,8.3
"05141",5,141,1994,6160,5659,501,8.1
"05141",5,141,1995,6186,5769,417,6.7
"05141",5,141,1996,6404,5991,413,6.4
"05141",5,141,1997,6369,5895,474,7.4
"05141",5,141,1998,6229,5734,495,7.9
"05141",5,141,1999,6209,5848,361,5.8
"05141",5,141,2000,6619,6264,355,5.4
"05141",5,141,2001,6758,6332,426,6.3
"05141",5,141,2002,6887,6432,455,6.6
"05141",5,141,2003,6812,6320,492,7.2
"05141",5,141,2004,6923,6437,486,7
"05141",5,141,2005,7018,6585,433,6.2
"05141",5,141,2006,7118,6690,428,6
"05141",5,141,2007,7058,6640,418,5.9
"05141",5,141,2008,7083,6614,469,6.6
"05141",5,141,2009,7029,6294,735,10.5
"05141",5,141,2010,6476,5752,724,11.2
"05141",5,141,2011,6756,6010,746,11
"05141",5,141,2012,6604,5935,669,10.1
"05141",5,141,2013,6494,5865,629,9.7
"05141",5,141,2014,6454,5933,521,8.1
"05141",5,141,2015,6427,5996,431,6.7
"05141",5,141,2016,6112,5694,418,6.8
"05141",5,141,2017,6089,5759,330,5.4
"05143",5,143,1990,61413,59077,2336,3.8
"05143",5,143,1991,62260,59795,2465,4
"05143",5,143,1992,64071,61685,2386,3.7
"05143",5,143,1993,67151,65112,2039,3
"05143",5,143,1994,71302,69480,1822,2.6
"05143",5,143,1995,74020,72195,1825,2.5
"05143",5,143,1996,74953,72786,2167,2.9
"05143",5,143,1997,75023,72611,2412,3.2
"05143",5,143,1998,76763,74305,2458,3.2
"05143",5,143,1999,78589,76553,2036,2.6
"05143",5,143,2000,82117,79670,2447,3
"05143",5,143,2001,84685,82066,2619,3.1
"05143",5,143,2002,88671,85687,2984,3.4
"05143",5,143,2003,90430,86944,3486,3.9
"05143",5,143,2004,94255,90635,3620,3.8
"05143",5,143,2005,100890,97492,3398,3.4
"05143",5,143,2006,103155,99421,3734,3.6
"05143",5,143,2007,104859,100817,4042,3.9
"05143",5,143,2008,103877,99485,4392,4.2
"05143",5,143,2009,99482,93231,6251,6.3
"05143",5,143,2010,102865,96162,6703,6.5
"05143",5,143,2011,104823,98216,6607,6.3
"05143",5,143,2012,105383,99464,5919,5.6
"05143",5,143,2013,106852,101138,5714,5.3
"05143",5,143,2014,110157,105355,4802,4.4
"05143",5,143,2015,115236,111175,4061,3.5
"05143",5,143,2016,118617,115373,3244,2.7
"05143",5,143,2017,122329,119232,3097,2.5
"05145",5,145,1990,26461,23862,2599,9.8
"05145",5,145,1991,26733,24136,2597,9.7
"05145",5,145,1992,27624,25128,2496,9
"05145",5,145,1993,28084,25905,2179,7.8
"05145",5,145,1994,29511,27725,1786,6.1
"05145",5,145,1995,30244,28449,1795,5.9
"05145",5,145,1996,30497,28666,1831,6
"05145",5,145,1997,30621,28897,1724,5.6
"05145",5,145,1998,31169,29555,1614,5.2
"05145",5,145,1999,32011,30475,1536,4.8
"05145",5,145,2000,30946,29464,1482,4.8
"05145",5,145,2001,30498,28850,1648,5.4
"05145",5,145,2002,30572,28732,1840,6
"05145",5,145,2003,30761,28791,1970,6.4
"05145",5,145,2004,31818,29770,2048,6.4
"05145",5,145,2005,32508,30453,2055,6.3
"05145",5,145,2006,32299,30463,1836,5.7
"05145",5,145,2007,32094,29988,2106,6.6
"05145",5,145,2008,33288,31300,1988,6
"05145",5,145,2009,34059,31269,2790,8.2
"05145",5,145,2010,36442,33437,3005,8.2
"05145",5,145,2011,36768,33580,3188,8.7
"05145",5,145,2012,36246,33396,2850,7.9
"05145",5,145,2013,35094,32359,2735,7.8
"05145",5,145,2014,34474,32053,2421,7
"05145",5,145,2015,34536,32391,2145,6.2
"05145",5,145,2016,34087,32325,1762,5.2
"05145",5,145,2017,33810,32280,1530,4.5
"05147",5,147,1990,4065,3637,428,10.5
"05147",5,147,1991,4027,3412,615,15.3
"05147",5,147,1992,4010,3435,575,14.3
"05147",5,147,1993,4033,3602,431,10.7
"05147",5,147,1994,4121,3806,315,7.6
"05147",5,147,1995,4262,3927,335,7.9
"05147",5,147,1996,4349,3954,395,9.1
"05147",5,147,1997,4258,3897,361,8.5
"05147",5,147,1998,4117,3665,452,11
"05147",5,147,1999,3946,3534,412,10.4
"05147",5,147,2000,3771,3535,236,6.3
"05147",5,147,2001,3847,3595,252,6.6
"05147",5,147,2002,3991,3709,282,7.1
"05147",5,147,2003,3774,3408,366,9.7
"05147",5,147,2004,3490,3140,350,10
"05147",5,147,2005,3462,3145,317,9.2
"05147",5,147,2006,3581,3285,296,8.3
"05147",5,147,2007,3539,3231,308,8.7
"05147",5,147,2008,3520,3238,282,8
"05147",5,147,2009,3368,2997,371,11
"05147",5,147,2010,3630,3251,379,10.4
"05147",5,147,2011,3571,3179,392,11
"05147",5,147,2012,3383,3038,345,10.2
"05147",5,147,2013,3237,2930,307,9.5
"05147",5,147,2014,3166,2926,240,7.6
"05147",5,147,2015,3031,2837,194,6.4
"05147",5,147,2016,2974,2812,162,5.4
"05147",5,147,2017,2950,2807,143,4.8
"05149",5,149,1990,8680,8204,476,5.5
"05149",5,149,1991,8687,8229,458,5.3
"05149",5,149,1992,8984,8519,465,5.2
"05149",5,149,1993,9175,8748,427,4.7
"05149",5,149,1994,9307,8940,367,3.9
"05149",5,149,1995,9446,9110,336,3.6
"05149",5,149,1996,9581,9245,336,3.5
"05149",5,149,1997,9603,9199,404,4.2
"05149",5,149,1998,9443,9027,416,4.4
"05149",5,149,1999,9433,9051,382,4
"05149",5,149,2000,9921,9522,399,4
"05149",5,149,2001,9765,9392,373,3.8
"05149",5,149,2002,9799,9353,446,4.6
"05149",5,149,2003,9793,9273,520,5.3
"05149",5,149,2004,9963,9459,504,5.1
"05149",5,149,2005,10659,10213,446,4.2
"05149",5,149,2006,10914,10425,489,4.5
"05149",5,149,2007,10645,10189,456,4.3
"05149",5,149,2008,10652,10169,483,4.5
"05149",5,149,2009,10643,9769,874,8.2
"05149",5,149,2010,9714,8928,786,8.1
"05149",5,149,2011,9605,8886,719,7.5
"05149",5,149,2012,9266,8642,624,6.7
"05149",5,149,2013,9065,8471,594,6.6
"05149",5,149,2014,9036,8528,508,5.6
"05149",5,149,2015,8941,8486,455,5.1
"05149",5,149,2016,8684,8298,386,4.4
"05149",5,149,2017,8650,8304,346,4
"06001",6,1,1990,677363,649906,27457,4.1
"06001",6,1,1991,671839,635540,36299,5.4
"06001",6,1,1992,677362,633098,44264,6.5
"06001",6,1,1993,678119,633025,45094,6.6
"06001",6,1,1994,679850,638236,41614,6.1
"06001",6,1,1995,676198,637485,38713,5.7
"06001",6,1,1996,678335,644062,34273,5.1
"06001",6,1,1997,693332,662383,30949,4.5
"06001",6,1,1998,703077,673952,29125,4.1
"06001",6,1,1999,714059,689186,24873,3.5
"06001",6,1,2000,769669,741850,27819,3.6
"06001",6,1,2001,777742,740590,37152,4.8
"06001",6,1,2002,771442,720116,51326,6.7
"06001",6,1,2003,754375,702984,51391,6.8
"06001",6,1,2004,741617,698223,43394,5.9
"06001",6,1,2005,734258,696792,37466,5.1
"06001",6,1,2006,733836,701275,32561,4.4
"06001",6,1,2007,745198,710144,35054,4.7
"06001",6,1,2008,756411,709426,46985,6.2
"06001",6,1,2009,760888,682852,78036,10.3
"06001",6,1,2010,782522,697112,85410,10.9
"06001",6,1,2011,786756,707381,79375,10.1
"06001",6,1,2012,798416,729049,69367,8.7
"06001",6,1,2013,802813,744764,58049,7.2
"06001",6,1,2014,809983,762878,47105,5.8
"06001",6,1,2015,823130,784217,38913,4.7
"06001",6,1,2016,837583,801774,35809,4.3
"06001",6,1,2017,848335,817433,30902,3.6
"06003",6,3,1990,375,339,36,9.6
"06003",6,3,1991,356,309,47,13.2
"06003",6,3,1992,347,290,57,16.4
"06003",6,3,1993,360,313,47,13.1
"06003",6,3,1994,447,401,46,10.3
"06003",6,3,1995,483,432,51,10.6
"06003",6,3,1996,489,440,49,10
"06003",6,3,1997,496,450,46,9.3
"06003",6,3,1998,483,436,47,9.7
"06003",6,3,1999,492,447,45,9.1
"06003",6,3,2000,555,520,35,6.3
"06003",6,3,2001,574,532,42,7.3
"06003",6,3,2002,562,520,42,7.5
"06003",6,3,2003,554,508,46,8.3
"06003",6,3,2004,534,491,43,8.1
"06003",6,3,2005,526,484,42,8
"06003",6,3,2006,482,451,31,6.4
"06003",6,3,2007,493,454,39,7.9
"06003",6,3,2008,465,416,49,10.5
"06003",6,3,2009,446,383,63,14.1
"06003",6,3,2010,542,472,70,12.9
"06003",6,3,2011,593,517,76,12.8
"06003",6,3,2012,544,483,61,11.2
"06003",6,3,2013,526,475,51,9.7
"06003",6,3,2014,512,470,42,8.2
"06003",6,3,2015,546,506,40,7.3
"06003",6,3,2016,557,521,36,6.5
"06003",6,3,2017,538,505,33,6.1
"06005",6,5,1990,11454,10860,594,5.2
"06005",6,5,1991,11984,11153,831,6.9
"06005",6,5,1992,12715,11552,1163,9.1
"06005",6,5,1993,12828,11639,1189,9.3
"06005",6,5,1994,12737,11701,1036,8.1
"06005",6,5,1995,13073,12031,1042,8
"06005",6,5,1996,13232,12339,893,6.7
"06005",6,5,1997,13191,12382,809,6.1
"06005",6,5,1998,13303,12573,730,5.5
"06005",6,5,1999,13519,12891,628,4.6
"06005",6,5,2000,15284,14489,795,5.2
"06005",6,5,2001,16133,15317,816,5.1
"06005",6,5,2002,16514,15569,945,5.7
"06005",6,5,2003,16389,15384,1005,6.1
"06005",6,5,2004,16906,15932,974,5.8
"06005",6,5,2005,17199,16237,962,5.6
"06005",6,5,2006,17236,16315,921,5.3
"06005",6,5,2007,17703,16675,1028,5.8
"06005",6,5,2008,17797,16428,1369,7.7
"06005",6,5,2009,17817,15781,2036,11.4
"06005",6,5,2010,15507,13326,2181,14.1
"06005",6,5,2011,15095,13040,2055,13.6
"06005",6,5,2012,14672,12873,1799,12.3
"06005",6,5,2013,14449,12959,1490,10.3
"06005",6,5,2014,14382,13188,1194,8.3
"06005",6,5,2015,14343,13396,947,6.6
"06005",6,5,2016,14574,13706,868,6
"06005",6,5,2017,14783,14059,724,4.9
"06007",6,7,1990,78802,72166,6636,8.4
"06007",6,7,1991,79279,71560,7719,9.7
"06007",6,7,1992,81986,72333,9653,11.8
"06007",6,7,1993,82520,72685,9835,11.9
"06007",6,7,1994,82847,74341,8506,10.3
"06007",6,7,1995,82161,73988,8173,9.9
"06007",6,7,1996,82683,75181,7502,9.1
"06007",6,7,1997,83854,76584,7270,8.7
"06007",6,7,1998,85024,77930,7094,8.3
"06007",6,7,1999,85499,79671,5828,6.8
"06007",6,7,2000,93228,87431,5797,6.2
"06007",6,7,2001,95129,88866,6263,6.6
"06007",6,7,2002,97097,89968,7129,7.3
"06007",6,7,2003,98296,90885,7411,7.5
"06007",6,7,2004,97434,90271,7163,7.4
"06007",6,7,2005,98309,91677,6632,6.7
"06007",6,7,2006,99752,93557,6195,6.2
"06007",6,7,2007,101228,94489,6739,6.7
"06007",6,7,2008,102816,94116,8700,8.5
"06007",6,7,2009,103739,91000,12739,12.3
"06007",6,7,2010,102568,88322,14246,13.9
"06007",6,7,2011,100647,86891,13756,13.7
"06007",6,7,2012,100990,88718,12272,12.2
"06007",6,7,2013,101748,91263,10485,10.3
"06007",6,7,2014,101483,92708,8775,8.6
"06007",6,7,2015,101337,94074,7263,7.2
"06007",6,7,2016,101987,95246,6741,6.6
"06007",6,7,2017,102982,97066,5916,5.7
"06009",6,9,1990,13447,12530,917,6.8
"06009",6,9,1991,13962,12670,1292,9.3
"06009",6,9,1992,15028,13233,1795,11.9
"06009",6,9,1993,14950,13145,1805,12.1
"06009",6,9,1994,14634,12997,1637,11.2
"06009",6,9,1995,14092,12538,1554,11
"06009",6,9,1996,14072,12762,1310,9.3
"06009",6,9,1997,14034,12759,1275,9.1
"06009",6,9,1998,14120,12873,1247,8.8
"06009",6,9,1999,14462,13450,1012,7
"06009",6,9,2000,18161,17147,1014,5.6
"06009",6,9,2001,19027,17987,1040,5.5
"06009",6,9,2002,19681,18411,1270,6.5
"06009",6,9,2003,19854,18398,1456,7.3
"06009",6,9,2004,19956,18606,1350,6.8
"06009",6,9,2005,20528,19247,1281,6.2
"06009",6,9,2006,20596,19390,1206,5.9
"06009",6,9,2007,20725,19394,1331,6.4
"06009",6,9,2008,20621,18831,1790,8.7
"06009",6,9,2009,20327,17563,2764,13.6
"06009",6,9,2010,21012,17977,3035,14.4
"06009",6,9,2011,20668,17769,2899,14
"06009",6,9,2012,20201,17705,2496,12.4
"06009",6,9,2013,20255,18243,2012,9.9
"06009",6,9,2014,20292,18668,1624,8
"06009",6,9,2015,20586,19272,1314,6.4
"06009",6,9,2016,20868,19684,1184,5.7
"06009",6,9,2017,21184,20183,1001,4.7
"06011",6,11,1990,8007,6863,1144,14.3
"06011",6,11,1991,8089,6638,1451,17.9
"06011",6,11,1992,8222,6454,1768,21.5
"06011",6,11,1993,8474,6643,1831,21.6
"06011",6,11,1994,8194,6639,1555,19
"06011",6,11,1995,8548,6864,1684,19.7
"06011",6,11,1996,8599,6893,1706,19.8
"06011",6,11,1997,9090,7374,1716,18.9
"06011",6,11,1998,8829,7053,1776,20.1
"06011",6,11,1999,8715,7324,1391,16
"06011",6,11,2000,9274,8200,1074,11.6
"06011",6,11,2001,9122,7954,1168,12.8
"06011",6,11,2002,9396,8104,1292,13.8
"06011",6,11,2003,9433,8086,1347,14.3
"06011",6,11,2004,9513,8216,1297,13.6
"06011",6,11,2005,9880,8627,1253,12.7
"06011",6,11,2006,9915,8701,1214,12.2
"06011",6,11,2007,10217,9015,1202,11.8
"06011",6,11,2008,10495,9042,1453,13.8
"06011",6,11,2009,11516,9490,2026,17.6
"06011",6,11,2010,11519,9118,2401,20.8
"06011",6,11,2011,11376,8959,2417,21.2
"06011",6,11,2012,11272,8935,2337,20.7
"06011",6,11,2013,11292,9156,2136,18.9
"06011",6,11,2014,11112,9180,1932,17.4
"06011",6,11,2015,11070,9367,1703,15.4
"06011",6,11,2016,10943,9238,1705,15.6
"06011",6,11,2017,10759,9216,1543,14.3
"06013",6,13,1990,435286,417800,17486,4
"06013",6,13,1991,434514,410896,23618,5.4
"06013",6,13,1992,442248,413319,28929,6.5
"06013",6,13,1993,442474,413271,29203,6.6
"06013",6,13,1994,451803,423891,27912,6.2
"06013",6,13,1995,452166,426417,25749,5.7
"06013",6,13,1996,457849,435054,22795,5
"06013",6,13,1997,469099,449450,19649,4.2
"06013",6,13,1998,476735,459460,17275,3.6
"06013",6,13,1999,486202,471358,14844,3.1
"06013",6,13,2000,501337,483535,17802,3.6
"06013",6,13,2001,508270,487694,20576,4
"06013",6,13,2002,510937,481984,28953,5.7
"06013",6,13,2003,508420,477620,30800,6.1
"06013",6,13,2004,507762,480274,27488,5.4
"06013",6,13,2005,509864,485198,24666,4.8
"06013",6,13,2006,510424,488580,21844,4.3
"06013",6,13,2007,514317,490220,24097,4.7
"06013",6,13,2008,523720,491147,32573,6.2
"06013",6,13,2009,524795,472577,52218,10
"06013",6,13,2010,525547,467914,57633,11
"06013",6,13,2011,529551,475011,54540,10.3
"06013",6,13,2012,535786,487887,47899,8.9
"06013",6,13,2013,538002,497661,40341,7.5
"06013",6,13,2014,540891,507521,33370,6.2
"06013",6,13,2015,547455,519999,27456,5
"06013",6,13,2016,557042,532200,24842,4.5
"06013",6,13,2017,563863,542445,21418,3.8
"06015",6,15,1990,9609,8451,1158,12.1
"06015",6,15,1991,9767,8580,1187,12.2
"06015",6,15,1992,9844,8329,1515,15.4
"06015",6,15,1993,9756,8377,1379,14.1
"06015",6,15,1994,10032,8823,1209,12.1
"06015",6,15,1995,10071,8834,1237,12.3
"06015",6,15,1996,10162,9108,1054,10.4
"06015",6,15,1997,10157,9123,1034,10.2
"06015",6,15,1998,9953,8926,1027,10.3
"06015",6,15,1999,9867,9074,793,8
"06015",6,15,2000,10247,9486,761,7.4
"06015",6,15,2001,10213,9395,818,8
"06015",6,15,2002,10217,9332,885,8.7
"06015",6,15,2003,10313,9440,873,8.5
"06015",6,15,2004,10626,9772,854,8
"06015",6,15,2005,10736,9940,796,7.4
"06015",6,15,2006,10793,10053,740,6.9
"06015",6,15,2007,11029,10199,830,7.5
"06015",6,15,2008,11361,10358,1003,8.8
"06015",6,15,2009,11679,10303,1376,11.8
"06015",6,15,2010,10931,9489,1442,13.2
"06015",6,15,2011,10895,9446,1449,13.3
"06015",6,15,2012,10496,9076,1420,13.5
"06015",6,15,2013,10330,9107,1223,11.8
"06015",6,15,2014,9954,8952,1002,10.1
"06015",6,15,2015,9876,9033,843,8.5
"06015",6,15,2016,9788,9051,737,7.5
"06015",6,15,2017,9780,9151,629,6.4
"06017",6,17,1990,63836,60985,2851,4.5
"06017",6,17,1991,65535,61183,4352,6.6
"06017",6,17,1992,67263,61568,5695,8.5
"06017",6,17,1993,67474,61626,5848,8.7
"06017",6,17,1994,70455,65403,5052,7.2
"06017",6,17,1995,72108,67146,4962,6.9
"06017",6,17,1996,73986,69293,4693,6.3
"06017",6,17,1997,75705,71543,4162,5.5
"06017",6,17,1998,76889,73065,3824,5
"06017",6,17,1999,79215,76117,3098,3.9
"06017",6,17,2000,82237,78825,3412,4.1
"06017",6,17,2001,83987,80378,3609,4.3
"06017",6,17,2002,86166,81692,4474,5.2
"06017",6,17,2003,87468,82631,4837,5.5
"06017",6,17,2004,88838,84174,4664,5.3
"06017",6,17,2005,91050,86697,4353,4.8
"06017",6,17,2006,91558,87339,4219,4.6
"06017",6,17,2007,90382,85707,4675,5.2
"06017",6,17,2008,90600,84259,6341,7
"06017",6,17,2009,91670,81716,9954,10.9
"06017",6,17,2010,91129,80002,11127,12.2
"06017",6,17,2011,89690,79188,10502,11.7
"06017",6,17,2012,89051,79958,9093,10.2
"06017",6,17,2013,88598,81063,7535,8.5
"06017",6,17,2014,88114,81968,6146,7
"06017",6,17,2015,88350,83326,5024,5.7
"06017",6,17,2016,89088,84512,4576,5.1
"06017",6,17,2017,89886,85966,3920,4.4
"06019",6,19,1990,328726,290446,38280,11.6
"06019",6,19,1991,336788,291777,45011,13.4
"06019",6,19,1992,352625,298060,54565,15.5
"06019",6,19,1993,361739,305983,55756,15.4
"06019",6,19,1994,356154,305416,50738,14.2
"06019",6,19,1995,369904,317959,51945,14
"06019",6,19,1996,369910,320771,49139,13.3
"06019",6,19,1997,371910,321722,50188,13.5
"06019",6,19,1998,375882,322301,53581,14.3
"06019",6,19,1999,377383,326276,51107,13.5
"06019",6,19,2000,388673,348153,40520,10.4
"06019",6,19,2001,389457,347906,41551,10.7
"06019",6,19,2002,401121,355193,45928,11.4
"06019",6,19,2003,403733,356645,47088,11.7
"06019",6,19,2004,404288,362204,42084,10.4
"06019",6,19,2005,407163,370589,36574,9
"06019",6,19,2006,410430,377532,32898,8
"06019",6,19,2007,418579,382789,35790,8.6
"06019",6,19,2008,429670,384317,45353,10.6
"06019",6,19,2009,434044,370321,63723,14.7
"06019",6,19,2010,439593,366221,73372,16.7
"06019",6,19,2011,443509,370224,73285,16.5
"06019",6,19,2012,440031,373457,66574,15.1
"06019",6,19,2013,437908,379850,58058,13.3
"06019",6,19,2014,439300,388435,50865,11.6
"06019",6,19,2015,441364,396410,44954,10.2
"06019",6,19,2016,446128,403719,42409,9.5
"06019",6,19,2017,449595,411525,38070,8.5
"06021",6,21,1990,11251,9846,1405,12.5
"06021",6,21,1991,11076,9341,1735,15.7
"06021",6,21,1992,11395,9245,2150,18.9
"06021",6,21,1993,11357,9394,1963,17.3
"06021",6,21,1994,11511,9664,1847,16
"06021",6,21,1995,11461,9679,1782,15.5
"06021",6,21,1996,11386,9655,1731,15.2
"06021",6,21,1997,10955,9486,1469,13.4
"06021",6,21,1998,10487,9080,1407,13.4
"06021",6,21,1999,10384,9214,1170,11.3
"06021",6,21,2000,11298,10342,956,8.5
"06021",6,21,2001,11229,10245,984,8.8
"06021",6,21,2002,11216,10145,1071,9.5
"06021",6,21,2003,11124,9992,1132,10.2
"06021",6,21,2004,11451,10385,1066,9.3
"06021",6,21,2005,11535,10565,970,8.4
"06021",6,21,2006,11612,10681,931,8
"06021",6,21,2007,11975,10921,1054,8.8
"06021",6,21,2008,12182,10904,1278,10.5
"06021",6,21,2009,12579,10800,1779,14.1
"06021",6,21,2010,13218,11180,2038,15.4
"06021",6,21,2011,13167,11124,2043,15.5
"06021",6,21,2012,13148,11283,1865,14.2
"06021",6,21,2013,12990,11418,1572,12.1
"06021",6,21,2014,12834,11466,1368,10.7
"06021",6,21,2015,12988,11856,1132,8.7
"06021",6,21,2016,12992,11909,1083,8.3
"06021",6,21,2017,12915,11952,963,7.5
"06023",6,23,1990,56261,51806,4455,7.9
"06023",6,23,1991,56681,51733,4948,8.7
"06023",6,23,1992,58927,53065,5862,9.9
"06023",6,23,1993,59615,53732,5883,9.9
"06023",6,23,1994,59856,54701,5155,8.6
"06023",6,23,1995,59699,54741,4958,8.3
"06023",6,23,1996,60018,55421,4597,7.7
"06023",6,23,1997,60333,55901,4432,7.3
"06023",6,23,1998,60633,56243,4390,7.2
"06023",6,23,1999,59772,55904,3868,6.5
"06023",6,23,2000,60172,56679,3493,5.8
"06023",6,23,2001,60390,56771,3619,6
"06023",6,23,2002,60748,56697,4051,6.7
"06023",6,23,2003,60584,56464,4120,6.8
"06023",6,23,2004,60401,56493,3908,6.5
"06023",6,23,2005,59523,55891,3632,6.1
"06023",6,23,2006,59404,56124,3280,5.5
"06023",6,23,2007,59282,55775,3507,5.9
"06023",6,23,2008,59953,55580,4373,7.3
"06023",6,23,2009,60835,54333,6502,10.7
"06023",6,23,2010,66061,59084,6977,10.6
"06023",6,23,2011,65106,58228,6878,10.6
"06023",6,23,2012,64279,58120,6159,9.6
"06023",6,23,2013,63055,57947,5108,8.1
"06023",6,23,2014,62505,58346,4159,6.7
"06023",6,23,2015,62454,58964,3490,5.6
"06023",6,23,2016,62635,59548,3087,4.9
"06023",6,23,2017,63019,60380,2639,4.2
"06025",6,25,1990,47316,35250,12066,25.5
"06025",6,25,1991,48827,36175,12652,25.9
"06025",6,25,1992,53870,37337,16533,30.7
"06025",6,25,1993,55262,39084,16178,29.3
"06025",6,25,1994,57473,42375,15098,26.3
"06025",6,25,1995,57885,40983,16902,29.2
"06025",6,25,1996,57403,40305,17098,29.8
"06025",6,25,1997,56108,41053,15055,26.8
"06025",6,25,1998,55863,41348,14515,26
"06025",6,25,1999,55154,42127,13027,23.6
"06025",6,25,2000,56129,46328,9801,17.5
"06025",6,25,2001,55538,46696,8842,15.9
"06025",6,25,2002,57222,48710,8512,14.9
"06025",6,25,2003,58642,49550,9092,15.5
"06025",6,25,2004,59427,49334,10093,17
"06025",6,25,2005,60592,50920,9672,16
"06025",6,25,2006,63023,53304,9719,15.4
"06025",6,25,2007,65967,54052,11915,18.1
"06025",6,25,2008,72434,56097,16337,22.6
"06025",6,25,2009,75569,54889,20680,27.4
"06025",6,25,2010,78665,55978,22687,28.8
"06025",6,25,2011,79456,56524,22932,28.9
"06025",6,25,2012,79265,57586,21679,27.4
"06025",6,25,2013,78271,58670,19601,25
"06025",6,25,2014,78445,59598,18847,24
"06025",6,25,2015,78162,59351,18811,24.1
"06025",6,25,2016,76993,58789,18204,23.6
"06025",6,25,2017,73980,59875,14105,19.1
"06027",6,27,1990,7011,6510,501,7.1
"06027",6,27,1991,7167,6472,695,9.7
"06027",6,27,1992,7166,6345,821,11.5
"06027",6,27,1993,7110,6321,789,11.1
"06027",6,27,1994,7175,6421,754,10.5
"06027",6,27,1995,7091,6427,664,9.4
"06027",6,27,1996,7259,6637,622,8.6
"06027",6,27,1997,7284,6686,598,8.2
"06027",6,27,1998,7257,6729,528,7.3
"06027",6,27,1999,7131,6723,408,5.7
"06027",6,27,2000,8861,8447,414,4.7
"06027",6,27,2001,9027,8618,409,4.5
"06027",6,27,2002,9205,8711,494,5.4
"06027",6,27,2003,9097,8576,521,5.7
"06027",6,27,2004,9247,8756,491,5.3
"06027",6,27,2005,9282,8828,454,4.9
"06027",6,27,2006,9010,8599,411,4.6
"06027",6,27,2007,8885,8447,438,4.9
"06027",6,27,2008,9087,8486,601,6.6
"06027",6,27,2009,9388,8547,841,9
"06027",6,27,2010,9753,8806,947,9.7
"06027",6,27,2011,9682,8741,941,9.7
"06027",6,27,2012,9557,8690,867,9.1
"06027",6,27,2013,9390,8654,736,7.8
"06027",6,27,2014,9234,8604,630,6.8
"06027",6,27,2015,9107,8580,527,5.8
"06027",6,27,2016,8889,8419,470,5.3
"06027",6,27,2017,8682,8301,381,4.4
"06029",6,29,1990,256820,228826,27994,10.9
"06029",6,29,1991,264585,232453,32132,12.1
"06029",6,29,1992,272911,230201,42710,15.6
"06029",6,29,1993,273376,230356,43020,15.7
"06029",6,29,1994,265444,225478,39966,15.1
"06029",6,29,1995,270736,233443,37293,13.8
"06029",6,29,1996,277332,241537,35795,12.9
"06029",6,29,1997,278070,243609,34461,12.4
"06029",6,29,1998,278516,244697,33819,12.1
"06029",6,29,1999,278596,246709,31887,11.4
"06029",6,29,2000,293919,269613,24306,8.3
"06029",6,29,2001,297710,272215,25495,8.6
"06029",6,29,2002,305334,275644,29690,9.7
"06029",6,29,2003,311344,279400,31944,10.3
"06029",6,29,2004,314447,283402,31045,9.9
"06029",6,29,2005,326748,299406,27342,8.4
"06029",6,29,2006,336093,310742,25351,7.5
"06029",6,29,2007,345187,316959,28228,8.2
"06029",6,29,2008,359141,323808,35333,9.8
"06029",6,29,2009,362714,311707,51007,14.1
"06029",6,29,2010,371515,313361,58154,15.7
"06029",6,29,2011,382367,325712,56655,14.8
"06029",6,29,2012,391888,340355,51533,13.1
"06029",6,29,2013,393440,347213,46227,11.7
"06029",6,29,2014,393459,352504,40955,10.4
"06029",6,29,2015,390873,350944,39929,10.2
"06029",6,29,2016,388445,347996,40449,10.4
"06029",6,29,2017,384944,349502,35442,9.2
"06031",6,31,1990,37576,33354,4222,11.2
"06031",6,31,1991,38615,33732,4883,12.6
"06031",6,31,1992,40595,34444,6151,15.2
"06031",6,31,1993,40941,34716,6225,15.2
"06031",6,31,1994,40915,35117,5798,14.2
"06031",6,31,1995,41797,35718,6079,14.5
"06031",6,31,1996,42948,37289,5659,13.2
"06031",6,31,1997,43609,37845,5764,13.2
"06031",6,31,1998,43189,37197,5992,13.9
"06031",6,31,1999,42836,37193,5643,13.2
"06031",6,31,2000,49264,44333,4931,10
"06031",6,31,2001,50187,44823,5364,10.7
"06031",6,31,2002,51695,45685,6010,11.6
"06031",6,31,2003,53114,46796,6318,11.9
"06031",6,31,2004,53159,47322,5837,11
"06031",6,31,2005,53840,48757,5083,9.4
"06031",6,31,2006,54995,50355,4640,8.4
"06031",6,31,2007,57327,52353,4974,8.7
"06031",6,31,2008,58735,52511,6224,10.6
"06031",6,31,2009,60489,51876,8613,14.2
"06031",6,31,2010,59440,49857,9583,16.1
"06031",6,31,2011,59123,49718,9405,15.9
"06031",6,31,2012,58807,50049,8758,14.9
"06031",6,31,2013,58198,50387,7811,13.4
"06031",6,31,2014,57578,50717,6861,11.9
"06031",6,31,2015,57873,51797,6076,10.5
"06031",6,31,2016,57348,51628,5720,10
"06031",6,31,2017,57714,52595,5119,8.9
"06033",6,33,1990,19974,18201,1773,8.9
"06033",6,33,1991,20905,18693,2212,10.6
"06033",6,33,1992,22342,19483,2859,12.8
"06033",6,33,1993,22882,19837,3045,13.3
"06033",6,33,1994,22444,19655,2789,12.4
"06033",6,33,1995,23667,20893,2774,11.7
"06033",6,33,1996,23584,20839,2745,11.6
"06033",6,33,1997,22996,20527,2469,10.7
"06033",6,33,1998,23134,20905,2229,9.6
"06033",6,33,1999,23534,21696,1838,7.8
"06033",6,33,2000,23101,21419,1682,7.3
"06033",6,33,2001,24768,23026,1742,7
"06033",6,33,2002,25694,23571,2123,8.3
"06033",6,33,2003,25856,23508,2348,9.1
"06033",6,33,2004,25764,23442,2322,9
"06033",6,33,2005,25985,23927,2058,7.9
"06033",6,33,2006,24273,22410,1863,7.7
"06033",6,33,2007,24041,22010,2031,8.4
"06033",6,33,2008,24525,21910,2615,10.7
"06033",6,33,2009,25372,21565,3807,15
"06033",6,33,2010,29847,25343,4504,15.1
"06033",6,33,2011,29611,25310,4301,14.5
"06033",6,33,2012,29509,25738,3771,12.8
"06033",6,33,2013,29259,26068,3191,10.9
"06033",6,33,2014,29352,26727,2625,8.9
"06033",6,33,2015,29060,26852,2208,7.6
"06033",6,33,2016,29165,27205,1960,6.7
"06033",6,33,2017,29714,28008,1706,5.7
"06035",6,35,1990,9981,9000,981,9.8
"06035",6,35,1991,10240,9177,1063,10.4
"06035",6,35,1992,10771,9545,1226,11.4
"06035",6,35,1993,10936,9584,1352,12.4
"06035",6,35,1994,11174,9910,1264,11.3
"06035",6,35,1995,10982,9769,1213,11
"06035",6,35,1996,11729,10460,1269,10.8
"06035",6,35,1997,11645,10524,1121,9.6
"06035",6,35,1998,11286,10222,1064,9.4
"06035",6,35,1999,11055,10275,780,7.1
"06035",6,35,2000,11363,10550,813,7.2
"06035",6,35,2001,11665,10810,855,7.3
"06035",6,35,2002,12193,11259,934,7.7
"06035",6,35,2003,12313,11373,940,7.6
"06035",6,35,2004,12181,11259,922,7.6
"06035",6,35,2005,12247,11265,982,8
"06035",6,35,2006,12217,11253,964,7.9
"06035",6,35,2007,12436,11422,1014,8.2
"06035",6,35,2008,12820,11592,1228,9.6
"06035",6,35,2009,13564,11893,1671,12.3
"06035",6,35,2010,12100,10401,1699,14
"06035",6,35,2011,11785,10190,1595,13.5
"06035",6,35,2012,11471,10042,1429,12.5
"06035",6,35,2013,11005,9838,1167,10.6
"06035",6,35,2014,10843,9856,987,9.1
"06035",6,35,2015,10783,10004,779,7.2
"06035",6,35,2016,10397,9676,721,6.9
"06035",6,35,2017,10005,9447,558,5.6
"06037",6,37,1990,4498714,4233137,265577,5.9
"06037",6,37,1991,4471689,4114757,356932,8
"06037",6,37,1992,4441197,4002563,438634,9.9
"06037",6,37,1993,4340467,3908826,431641,9.9
"06037",6,37,1994,4290790,3893251,397539,9.3
"06037",6,37,1995,4279534,3935618,343916,8
"06037",6,37,1996,4323561,3971474,352087,8.1
"06037",6,37,1997,4420856,4116772,304084,6.9
"06037",6,37,1998,4533337,4235401,297936,6.6
"06037",6,37,1999,4576413,4307045,269368,5.9
"06037",6,37,2000,4677389,4425623,251766,5.4
"06037",6,37,2001,4740529,4471537,268992,5.7
"06037",6,37,2002,4751584,4430944,320640,6.7
"06037",6,37,2003,4739472,4409913,329559,7
"06037",6,37,2004,4753481,4445361,308120,6.5
"06037",6,37,2005,4781604,4525223,256381,5.4
"06037",6,37,2006,4807873,4577565,230308,4.8
"06037",6,37,2007,4864160,4614776,249384,5.1
"06037",6,37,2008,4928959,4555103,373856,7.6
"06037",6,37,2009,4914702,4345182,569520,11.6
"06037",6,37,2010,4917375,4302274,615101,12.5
"06037",6,37,2011,4928464,4327923,600541,12.2
"06037",6,37,2012,4915263,4378392,536871,10.9
"06037",6,37,2013,4967167,4482594,484573,9.8
"06037",6,37,2014,5004087,4591068,413019,8.3
"06037",6,37,2015,5002332,4671098,331234,6.6
"06037",6,37,2016,5054938,4789505,265433,5.3
"06037",6,37,2017,5123933,4883640,240293,4.7
"06039",6,39,1990,41555,35949,5606,13.5
"06039",6,39,1991,44212,37617,6595,14.9
"06039",6,39,1992,46867,39072,7795,16.6
"06039",6,39,1993,47871,40110,7761,16.2
"06039",6,39,1994,48427,41021,7406,15.3
"06039",6,39,1995,50627,43073,7554,14.9
"06039",6,39,1996,52015,44653,7362,14.2
"06039",6,39,1997,52037,44999,7038,13.5
"06039",6,39,1998,52353,45664,6689,12.8
"06039",6,39,1999,52774,46635,6139,11.6
"06039",6,39,2000,54963,50174,4789,8.7
"06039",6,39,2001,53905,48751,5154,9.6
"06039",6,39,2002,55534,49681,5853,10.5
"06039",6,39,2003,58971,52916,6055,10.3
"06039",6,39,2004,61102,55523,5579,9.1
"06039",6,39,2005,61881,57015,4866,7.9
"06039",6,39,2006,62732,58352,4380,7
"06039",6,39,2007,63365,58620,4745,7.5
"06039",6,39,2008,65020,58861,6159,9.5
"06039",6,39,2009,66473,57597,8876,13.4
"06039",6,39,2010,61607,51366,10241,16.6
"06039",6,39,2011,62014,51990,10024,16.2
"06039",6,39,2012,62530,53495,9035,14.4
"06039",6,39,2013,62263,54428,7835,12.6
"06039",6,39,2014,61953,55013,6940,11.2
"06039",6,39,2015,60021,53719,6302,10.5
"06039",6,39,2016,61311,55648,5663,9.2
"06039",6,39,2017,61443,56494,4949,8.1
"06041",6,41,1990,131883,128558,3325,2.5
"06041",6,41,1991,130625,125664,4961,3.8
"06041",6,41,1992,130537,123977,6560,5
"06041",6,41,1993,130799,124103,6696,5.1
"06041",6,41,1994,129276,123318,5958,4.6
"06041",6,41,1995,127528,122050,5478,4.3
"06041",6,41,1996,128669,124237,4432,3.4
"06041",6,41,1997,130842,127076,3766,2.9
"06041",6,41,1998,132742,129628,3114,2.3
"06041",6,41,1999,134113,131495,2618,2
"06041",6,41,2000,141919,137867,4052,2.9
"06041",6,41,2001,139992,135077,4915,3.5
"06041",6,41,2002,134540,128032,6508,4.8
"06041",6,41,2003,130647,124287,6360,4.9
"06041",6,41,2004,129155,123465,5690,4.4
"06041",6,41,2005,129095,124094,5001,3.9
"06041",6,41,2006,130575,125967,4608,3.5
"06041",6,41,2007,131904,127083,4821,3.7
"06041",6,41,2008,132204,125973,6231,4.7
"06041",6,41,2009,131981,122061,9920,7.5
"06041",6,41,2010,133012,122570,10442,7.9
"06041",6,41,2011,134576,124801,9775,7.3
"06041",6,41,2012,136911,128310,8601,6.3
"06041",6,41,2013,138367,131216,7151,5.2
"06041",6,41,2014,139122,133186,5936,4.3
"06041",6,41,2015,139512,134572,4940,3.5
"06041",6,41,2016,140306,135710,4596,3.3
"06041",6,41,2017,141308,137270,4038,2.9
"06043",6,43,1990,6775,6391,384,5.7
"06043",6,43,1991,6949,6453,496,7.1
"06043",6,43,1992,7163,6539,624,8.7
"06043",6,43,1993,7245,6519,726,10
"06043",6,43,1994,7242,6553,689,9.5
"06043",6,43,1995,7435,6741,694,9.3
"06043",6,43,1996,7484,6815,669,8.9
"06043",6,43,1997,6856,6166,690,10.1
"06043",6,43,1998,6888,6357,531,7.7
"06043",6,43,1999,6641,6147,494,7.4
"06043",6,43,2000,7984,7490,494,6.2
"06043",6,43,2001,8475,7989,486,5.7
"06043",6,43,2002,8717,8159,558,6.4
"06043",6,43,2003,8416,7839,577,6.9
"06043",6,43,2004,8570,7997,573,6.7
"06043",6,43,2005,8790,8231,559,6.4
"06043",6,43,2006,9008,8499,509,5.7
"06043",6,43,2007,9061,8515,546,6
"06043",6,43,2008,9273,8574,699,7.5
"06043",6,43,2009,9397,8431,966,10.3
"06043",6,43,2010,8709,7582,1127,12.9
"06043",6,43,2011,8661,7520,1141,13.2
"06043",6,43,2012,8375,7352,1023,12.2
"06043",6,43,2013,8229,7363,866,10.5
"06043",6,43,2014,8110,7398,712,8.8
"06043",6,43,2015,8027,7454,573,7.1
"06043",6,43,2016,7594,7073,521,6.9
"06043",6,43,2017,7647,7196,451,5.9
"06045",6,45,1990,38746,35789,2957,7.6
"06045",6,45,1991,38776,34676,4100,10.6
"06045",6,45,1992,39784,34920,4864,12.2
"06045",6,45,1993,40369,35837,4532,11.2
"06045",6,45,1994,40445,36567,3878,9.6
"06045",6,45,1995,40964,37073,3891,9.5
"06045",6,45,1996,41967,38333,3634,8.7
"06045",6,45,1997,42411,39007,3404,8
"06045",6,45,1998,42324,38983,3341,7.9
"06045",6,45,1999,41530,38710,2820,6.8
"06045",6,45,2000,43614,41182,2432,5.6
"06045",6,45,2001,44626,41977,2649,5.9
"06045",6,45,2002,45730,42707,3023,6.6
"06045",6,45,2003,44970,41898,3072,6.8
"06045",6,45,2004,43861,41053,2808,6.4
"06045",6,45,2005,43841,41325,2516,5.7
"06045",6,45,2006,43242,40993,2249,5.2
"06045",6,45,2007,43115,40744,2371,5.5
"06045",6,45,2008,43213,40230,2983,6.9
"06045",6,45,2009,43306,38955,4351,10
"06045",6,45,2010,41601,36772,4829,11.6
"06045",6,45,2011,40953,36284,4669,11.4
"06045",6,45,2012,40953,36841,4112,10
"06045",6,45,2013,40837,37425,3412,8.4
"06045",6,45,2014,40479,37647,2832,7
"06045",6,45,2015,39930,37609,2321,5.8
"06045",6,45,2016,39752,37655,2097,5.3
"06045",6,45,2017,40003,38210,1793,4.5
"06047",6,47,1990,76906,67023,9883,12.9
"06047",6,47,1991,77227,65218,12009,15.6
"06047",6,47,1992,82987,68637,14350,17.3
"06047",6,47,1993,83238,68858,14380,17.3
"06047",6,47,1994,83582,70111,13471,16.1
"06047",6,47,1995,82705,68609,14096,17
"06047",6,47,1996,81743,68203,13540,16.6
"06047",6,47,1997,83243,70217,13026,15.6
"06047",6,47,1998,85091,72205,12886,15.1
"06047",6,47,1999,83648,72425,11223,13.4
"06047",6,47,2000,90390,81691,8699,9.6
"06047",6,47,2001,91744,82427,9317,10.2
"06047",6,47,2002,95700,85269,10431,10.9
"06047",6,47,2003,96839,85757,11082,11.4
"06047",6,47,2004,97625,86994,10631,10.9
"06047",6,47,2005,98738,88880,9858,10
"06047",6,47,2006,97919,88681,9238,9.4
"06047",6,47,2007,99843,89797,10046,10.1
"06047",6,47,2008,102153,89245,12908,12.6
"06047",6,47,2009,105373,87863,17510,16.6
"06047",6,47,2010,113579,93191,20388,18
"06047",6,47,2011,114735,94500,20235,17.6
"06047",6,47,2012,115016,96236,18780,16.3
"06047",6,47,2013,114628,98009,16619,14.5
"06047",6,47,2014,114589,99887,14702,12.8
"06047",6,47,2015,114340,101362,12978,11.4
"06047",6,47,2016,114612,102474,12138,10.6
"06047",6,47,2017,116088,105287,10801,9.3
"06049",6,49,1990,3763,3400,363,9.6
"06049",6,49,1991,3882,3400,482,12.4
"06049",6,49,1992,4011,3500,511,12.7
"06049",6,49,1993,3928,3396,532,13.5
"06049",6,49,1994,4268,3759,509,11.9
"06049",6,49,1995,4212,3655,557,13.2
"06049",6,49,1996,4147,3645,502,12.1
"06049",6,49,1997,3905,3449,456,11.7
"06049",6,49,1998,3966,3521,445,11.2
"06049",6,49,1999,3989,3647,342,8.6
"06049",6,49,2000,3757,3474,283,7.5
"06049",6,49,2001,3906,3635,271,6.9
"06049",6,49,2002,4094,3775,319,7.8
"06049",6,49,2003,4203,3839,364,8.7
"06049",6,49,2004,4049,3695,354,8.7
"06049",6,49,2005,4001,3683,318,7.9
"06049",6,49,2006,3981,3672,309,7.8
"06049",6,49,2007,3896,3582,314,8.1
"06049",6,49,2008,3937,3555,382,9.7
"06049",6,49,2009,4044,3555,489,12.1
"06049",6,49,2010,3818,3237,581,15.2
"06049",6,49,2011,3620,3042,578,16
"06049",6,49,2012,3612,3092,520,14.4
"06049",6,49,2013,3503,3073,430,12.3
"06049",6,49,2014,3374,3028,346,10.3
"06049",6,49,2015,3305,3022,283,8.6
"06049",6,49,2016,3303,3045,258,7.8
"06049",6,49,2017,3230,2970,260,8
"06051",6,51,1990,5719,5380,339,5.9
"06051",6,51,1991,5454,4801,653,12
"06051",6,51,1992,5819,5206,613,10.5
"06051",6,51,1993,5978,5418,560,9.4
"06051",6,51,1994,6158,5524,634,10.3
"06051",6,51,1995,6131,5470,661,10.8
"06051",6,51,1996,6052,5400,652,10.8
"06051",6,51,1997,6060,5432,628,10.4
"06051",6,51,1998,6121,5618,503,8.2
"06051",6,51,1999,6134,5721,413,6.7
"06051",6,51,2000,7403,7058,345,4.7
"06051",6,51,2001,7609,7253,356,4.7
"06051",6,51,2002,7876,7476,400,5.1
"06051",6,51,2003,8271,7856,415,5
"06051",6,51,2004,8286,7869,417,5
"06051",6,51,2005,8340,7937,403,4.8
"06051",6,51,2006,8238,7874,364,4.4
"06051",6,51,2007,8132,7741,391,4.8
"06051",6,51,2008,8605,8096,509,5.9
"06051",6,51,2009,8736,7969,767,8.8
"06051",6,51,2010,8890,7984,906,10.2
"06051",6,51,2011,8832,7944,888,10.1
"06051",6,51,2012,8401,7532,869,10.3
"06051",6,51,2013,8368,7655,713,8.5
"06051",6,51,2014,8260,7678,582,7
"06051",6,51,2015,8262,7757,505,6.1
"06051",6,51,2016,8394,7944,450,5.4
"06051",6,51,2017,8568,8188,380,4.4
"06053",6,53,1990,172728,156047,16681,9.7
"06053",6,53,1991,171305,151950,19355,11.3
"06053",6,53,1992,177112,155240,21872,12.3
"06053",6,53,1993,176787,153828,22959,13
"06053",6,53,1994,174833,153268,21565,12.3
"06053",6,53,1995,174373,152879,21494,12.3
"06053",6,53,1996,177765,157727,20038,11.3
"06053",6,53,1997,181766,161873,19893,10.9
"06053",6,53,1998,184068,164271,19797,10.8
"06053",6,53,1999,187423,169338,18085,9.6
"06053",6,53,2000,203392,188378,15014,7.4
"06053",6,53,2001,204638,188666,15972,7.8
"06053",6,53,2002,207756,189317,18439,8.9
"06053",6,53,2003,208693,190091,18602,8.9
"06053",6,53,2004,207233,190103,17130,8.3
"06053",6,53,2005,206565,191535,15030,7.3
"06053",6,53,2006,203070,189023,14047,6.9
"06053",6,53,2007,205460,190781,14679,7.1
"06053",6,53,2008,212064,194121,17943,8.5
"06053",6,53,2009,215363,190585,24778,11.5
"06053",6,53,2010,215788,188339,27449,12.7
"06053",6,53,2011,216558,189146,27412,12.7
"06053",6,53,2012,217796,192600,25196,11.6
"06053",6,53,2013,216380,194075,22305,10.3
"06053",6,53,2014,218226,198499,19727,9
"06053",6,53,2015,218811,201110,17701,8.1
"06053",6,53,2016,219506,202695,16811,7.7
"06053",6,53,2017,220120,204309,15811,7.2
"06055",6,55,1990,56419,54087,2332,4.1
"06055",6,55,1991,55209,52030,3179,5.8
"06055",6,55,1992,57546,53426,4120,7.2
"06055",6,55,1993,58012,53450,4562,7.9
"06055",6,55,1994,57778,53801,3977,6.9
"06055",6,55,1995,57235,53687,3548,6.2
"06055",6,55,1996,58051,54546,3505,6
"06055",6,55,1997,59156,56110,3046,5.1
"06055",6,55,1998,60485,58048,2437,4
"06055",6,55,1999,62158,60102,2056,3.3
"06055",6,55,2000,66678,64275,2403,3.6
"06055",6,55,2001,70381,67829,2552,3.6
"06055",6,55,2002,71138,67927,3211,4.5
"06055",6,55,2003,70670,67261,3409,4.8
"06055",6,55,2004,71171,67804,3367,4.7
"06055",6,55,2005,71328,68214,3114,4.4
"06055",6,55,2006,71692,68927,2765,3.9
"06055",6,55,2007,73232,70286,2946,4
"06055",6,55,2008,75546,71677,3869,5.1
"06055",6,55,2009,75560,69240,6320,8.4
"06055",6,55,2010,70216,62989,7227,10.3
"06055",6,55,2011,70760,63846,6914,9.8
"06055",6,55,2012,71816,65755,6061,8.4
"06055",6,55,2013,72809,67766,5043,6.9
"06055",6,55,2014,73592,69417,4175,5.7
"06055",6,55,2015,73937,70523,3414,4.6
"06055",6,55,2016,73190,70047,3143,4.3
"06055",6,55,2017,73873,71172,2701,3.7
"06057",6,57,1990,36028,34296,1732,4.8
"06057",6,57,1991,38380,35900,2480,6.5
"06057",6,57,1992,39597,36263,3334,8.4
"06057",6,57,1993,40230,36847,3383,8.4
"06057",6,57,1994,40975,37925,3050,7.4
"06057",6,57,1995,40097,37071,3026,7.5
"06057",6,57,1996,40193,37412,2781,6.9
"06057",6,57,1997,40767,38250,2517,6.2
"06057",6,57,1998,42658,40340,2318,5.4
"06057",6,57,1999,43505,41726,1779,4.1
"06057",6,57,2000,45500,43609,1891,4.2
"06057",6,57,2001,46904,44847,2057,4.4
"06057",6,57,2002,48351,45812,2539,5.3
"06057",6,57,2003,48277,45602,2675,5.5
"06057",6,57,2004,48697,46122,2575,5.3
"06057",6,57,2005,49237,46884,2353,4.8
"06057",6,57,2006,49610,47443,2167,4.4
"06057",6,57,2007,50125,47719,2406,4.8
"06057",6,57,2008,50353,47033,3320,6.6
"06057",6,57,2009,50379,45205,5174,10.3
"06057",6,57,2010,48915,43178,5737,11.7
"06057",6,57,2011,49021,43590,5431,11.1
"06057",6,57,2012,48363,43649,4714,9.7
"06057",6,57,2013,48169,44267,3902,8.1
"06057",6,57,2014,47961,44820,3141,6.5
"06057",6,57,2015,48140,45532,2608,5.4
"06057",6,57,2016,48312,46001,2311,4.8
"06057",6,57,2017,48659,46661,1998,4.1
"06059",6,59,1990,1352949,1305680,47269,3.5
"06059",6,59,1991,1318918,1249776,69142,5.2
"06059",6,59,1992,1331315,1242865,88450,6.6
"06059",6,59,1993,1327926,1237815,90111,6.8
"06059",6,59,1994,1333220,1257071,76149,5.7
"06059",6,59,1995,1319744,1253037,66707,5.1
"06059",6,59,1996,1335185,1279567,55618,4.2
"06059",6,59,1997,1374084,1328708,45376,3.3
"06059",6,59,1998,1425475,1384234,41241,2.9
"06059",6,59,1999,1459901,1420878,39023,2.7
"06059",6,59,2000,1482303,1430102,52201,3.5
"06059",6,59,2001,1511855,1452100,59755,4
"06059",6,59,2002,1524786,1449509,75277,4.9
"06059",6,59,2003,1545768,1472492,73276,4.7
"06059",6,59,2004,1569114,1502719,66395,4.2
"06059",6,59,2005,1585916,1526586,59330,3.7
"06059",6,59,2006,1597788,1543471,54317,3.4
"06059",6,59,2007,1606177,1543703,62474,3.9
"06059",6,59,2008,1615488,1529661,85827,5.3
"06059",6,59,2009,1589259,1451687,137572,8.7
"06059",6,59,2010,1537187,1387438,149749,9.7
"06059",6,59,2011,1546389,1406411,139978,9.1
"06059",6,59,2012,1562136,1439270,122866,7.9
"06059",6,59,2013,1565334,1462270,103064,6.6
"06059",6,59,2014,1572653,1486383,86270,5.5
"06059",6,59,2015,1588764,1517820,70944,4.5
"06059",6,59,2016,1602461,1537686,64775,4
"06059",6,59,2017,1618828,1562201,56627,3.5
"06061",6,61,1990,89541,85760,3781,4.2
"06061",6,61,1991,91093,85224,5869,6.4
"06061",6,61,1992,93474,85610,7864,8.4
"06061",6,61,1993,93210,85691,7519,8.1
"06061",6,61,1994,98527,92011,6516,6.6
"06061",6,61,1995,101945,95683,6262,6.1
"06061",6,61,1996,105943,100220,5723,5.4
"06061",6,61,1997,109772,104673,5099,4.6
"06061",6,61,1998,113240,108600,4640,4.1
"06061",6,61,1999,119867,115981,3886,3.2
"06061",6,61,2000,132217,127450,4767,3.6
"06061",6,61,2001,138976,133402,5574,4
"06061",6,61,2002,146214,139052,7162,4.9
"06061",6,61,2003,152740,145004,7736,5.1
"06061",6,61,2004,158523,150962,7561,4.8
"06061",6,61,2005,164249,157181,7068,4.3
"06061",6,61,2006,168855,161825,7030,4.2
"06061",6,61,2007,172478,164247,8231,4.8
"06061",6,61,2008,176976,165485,11491,6.5
"06061",6,61,2009,179718,161416,18302,10.2
"06061",6,61,2010,173338,153236,20102,11.6
"06061",6,61,2011,173744,154923,18821,10.8
"06061",6,61,2012,174919,158545,16374,9.4
"06061",6,61,2013,175833,162264,13569,7.7
"06061",6,61,2014,175888,164871,11017,6.3
"06061",6,61,2015,176855,167923,8932,5.1
"06061",6,61,2016,180212,172126,8086,4.5
"06061",6,61,2017,182169,175165,7004,3.8
"06063",6,63,1990,9470,8530,940,9.9
"06063",6,63,1991,9657,8594,1063,11
"06063",6,63,1992,9677,8331,1346,13.9
"06063",6,63,1993,9680,8222,1458,15.1
"06063",6,63,1994,9981,8555,1426,14.3
"06063",6,63,1995,9732,8448,1284,13.2
"06063",6,63,1996,9910,8705,1205,12.2
"06063",6,63,1997,9842,8800,1042,10.6
"06063",6,63,1998,9675,8677,998,10.3
"06063",6,63,1999,9426,8573,853,9
"06063",6,63,2000,9770,9073,697,7.1
"06063",6,63,2001,9949,9194,755,7.6
"06063",6,63,2002,10203,9352,851,8.3
"06063",6,63,2003,10443,9420,1023,9.8
"06063",6,63,2004,10397,9380,1017,9.8
"06063",6,63,2005,10131,9278,853,8.4
"06063",6,63,2006,10086,9314,772,7.7
"06063",6,63,2007,9948,9099,849,8.5
"06063",6,63,2008,9812,8774,1038,10.6
"06063",6,63,2009,10016,8475,1541,15.4
"06063",6,63,2010,9147,7479,1668,18.2
"06063",6,63,2011,8890,7326,1564,17.6
"06063",6,63,2012,8485,7115,1370,16.1
"06063",6,63,2013,8256,7114,1142,13.8
"06063",6,63,2014,8118,7182,936,11.5
"06063",6,63,2015,7900,7088,812,10.3
"06063",6,63,2016,7876,7110,766,9.7
"06063",6,63,2017,7803,7111,692,8.9
"06065",6,65,1990,536605,498129,38476,7.2
"06065",6,65,1991,549767,494559,55208,10
"06065",6,65,1992,576178,508164,68014,11.8
"06065",6,65,1993,582296,512030,70266,12.1
"06065",6,65,1994,596943,533814,63129,10.6
"06065",6,65,1995,606575,549306,57269,9.4
"06065",6,65,1996,613725,562716,51009,8.3
"06065",6,65,1997,638087,589819,48268,7.6
"06065",6,65,1998,659313,615400,43913,6.7
"06065",6,65,1999,690877,653014,37863,5.5
"06065",6,65,2000,681290,644661,36629,5.4
"06065",6,65,2001,710475,671436,39039,5.5
"06065",6,65,2002,746343,698489,47854,6.4
"06065",6,65,2003,775966,725702,50264,6.5
"06065",6,65,2004,817683,768869,48814,6
"06065",6,65,2005,852578,806877,45701,5.4
"06065",6,65,2006,881248,836872,44376,5
"06065",6,65,2007,902047,847618,54429,6
"06065",6,65,2008,911507,833309,78198,8.6
"06065",6,65,2009,915787,795813,119974,13.1
"06065",6,65,2010,976444,841285,135159,13.8
"06065",6,65,2011,978514,849635,128879,13.2
"06065",6,65,2012,987076,872251,114825,11.6
"06065",6,65,2013,996411,897722,98689,9.9
"06065",6,65,2014,1013481,930412,83069,8.2
"06065",6,65,2015,1035694,966338,69356,6.7
"06065",6,65,2016,1052648,988171,64477,6.1
"06065",6,65,2017,1073843,1017591,56252,5.2
"06067",6,67,1990,522264,498324,23940,4.6
"06067",6,67,1991,527293,492452,34841,6.6
"06067",6,67,1992,529085,485492,43593,8.2
"06067",6,67,1993,529965,485946,44019,8.3
"06067",6,67,1994,532615,494203,38412,7.2
"06067",6,67,1995,534232,497960,36272,6.8
"06067",6,67,1996,539817,506518,33299,6.2
"06067",6,67,1997,550537,519895,30642,5.6
"06067",6,67,1998,564917,536633,28284,5
"06067",6,67,1999,581617,556937,24680,4.2
"06067",6,67,2000,609256,582785,26471,4.3
"06067",6,67,2001,624116,595878,28238,4.5
"06067",6,67,2002,642116,606097,36019,5.6
"06067",6,67,2003,652166,614089,38077,5.8
"06067",6,67,2004,659062,622197,36865,5.6
"06067",6,67,2005,664327,631504,32823,4.9
"06067",6,67,2006,668817,637010,31807,4.8
"06067",6,67,2007,675800,639075,36725,5.4
"06067",6,67,2008,679394,630283,49111,7.2
"06067",6,67,2009,681094,606070,75024,11
"06067",6,67,2010,683127,596992,86135,12.6
"06067",6,67,2011,679995,597683,82312,12.1
"06067",6,67,2012,681281,609691,71590,10.5
"06067",6,67,2013,680241,619835,60406,8.9
"06067",6,67,2014,680676,630973,49703,7.3
"06067",6,67,2015,685987,644870,41117,6
"06067",6,67,2016,695243,657592,37651,5.4
"06067",6,67,2017,702049,669469,32580,4.6
"06069",6,69,1990,20941,18391,2550,12.2
"06069",6,69,1991,21221,17821,3400,16
"06069",6,69,1992,21899,18119,3780,17.3
"06069",6,69,1993,22257,18698,3559,16
"06069",6,69,1994,22298,19192,3106,13.9
"06069",6,69,1995,22897,19786,3111,13.6
"06069",6,69,1996,24723,21794,2929,11.8
"06069",6,69,1997,26115,23203,2912,11.2
"06069",6,69,1998,26115,23352,2763,10.6
"06069",6,69,1999,26220,24100,2120,8.1
"06069",6,69,2000,27476,25822,1654,6
"06069",6,69,2001,27439,25697,1742,6.3
"06069",6,69,2002,26270,23954,2316,8.8
"06069",6,69,2003,25500,22974,2526,9.9
"06069",6,69,2004,25076,22682,2394,9.5
"06069",6,69,2005,24499,22526,1973,8.1
"06069",6,69,2006,24164,22433,1731,7.2
"06069",6,69,2007,24005,22269,1736,7.2
"06069",6,69,2008,24840,22435,2405,9.7
"06069",6,69,2009,24864,21392,3472,14
"06069",6,69,2010,27906,23691,4215,15.1
"06069",6,69,2011,28281,24179,4102,14.5
"06069",6,69,2012,28677,24936,3741,13
"06069",6,69,2013,28904,25696,3208,11.1
"06069",6,69,2014,29241,26513,2728,9.3
"06069",6,69,2015,29342,27087,2255,7.7
"06069",6,69,2016,29835,27798,2037,6.8
"06069",6,69,2017,30317,28552,1765,5.8
"06071",6,71,1990,635154,599384,35770,5.6
"06071",6,71,1991,644321,591358,52963,8.2
"06071",6,71,1992,668755,604814,63941,9.6
"06071",6,71,1993,676255,609415,66840,9.9
"06071",6,71,1994,670565,612658,57907,8.6
"06071",6,71,1995,674915,621837,53078,7.9
"06071",6,71,1996,684337,633924,50413,7.4
"06071",6,71,1997,704083,658842,45241,6.4
"06071",6,71,1998,720246,679548,40698,5.7
"06071",6,71,1999,748372,712037,36335,4.9
"06071",6,71,2000,740001,704481,35520,4.8
"06071",6,71,2001,762524,723879,38645,5.1
"06071",6,71,2002,786783,739621,47162,6
"06071",6,71,2003,802230,752340,49890,6.2
"06071",6,71,2004,829185,781585,47600,5.7
"06071",6,71,2005,851470,807163,44307,5.2
"06071",6,71,2006,860020,818622,41398,4.8
"06071",6,71,2007,862191,813867,48324,5.6
"06071",6,71,2008,862104,792836,69268,8
"06071",6,71,2009,857696,749142,108554,12.7
"06071",6,71,2010,890278,769890,120388,13.5
"06071",6,71,2011,888513,774166,114347,12.9
"06071",6,71,2012,892212,790420,101792,11.4
"06071",6,71,2013,896673,809057,87616,9.8
"06071",6,71,2014,907537,834901,72636,8
"06071",6,71,2015,921170,861894,59276,6.4
"06071",6,71,2016,932257,878388,53869,5.8
"06071",6,71,2017,950765,904183,46582,4.9
"06073",6,73,1990,1215062,1158861,56201,4.6
"06073",6,73,1991,1207018,1131580,75438,6.2
"06073",6,73,1992,1213964,1126344,87620,7.2
"06073",6,73,1993,1218925,1123927,94998,7.8
"06073",6,73,1994,1226492,1139889,86603,7.1
"06073",6,73,1995,1223371,1145883,77488,6.3
"06073",6,73,1996,1236928,1170788,66140,5.3
"06073",6,73,1997,1275071,1220537,54534,4.3
"06073",6,73,1998,1312222,1265969,46253,3.5
"06073",6,73,1999,1350741,1308725,42016,3.1
"06073",6,73,2000,1377101,1323166,53935,3.9
"06073",6,73,2001,1408427,1349524,58903,4.2
"06073",6,73,2002,1442866,1369228,73638,5.1
"06073",6,73,2003,1457538,1382273,75265,5.2
"06073",6,73,2004,1478541,1408922,69619,4.7
"06073",6,73,2005,1489799,1425706,64093,4.3
"06073",6,73,2006,1496145,1436821,59324,4
"06073",6,73,2007,1515351,1446347,69004,4.6
"06073",6,73,2008,1545849,1452608,93241,6
"06073",6,73,2009,1554333,1408347,145986,9.4
"06073",6,73,2010,1515198,1352266,162932,10.8
"06073",6,73,2011,1524582,1367250,157332,10.3
"06073",6,73,2012,1540441,1399879,140562,9.1
"06073",6,73,2013,1543189,1422391,120798,7.8
"06073",6,73,2014,1544314,1445086,99228,6.4
"06073",6,73,2015,1554903,1474197,80706,5.2
"06073",6,73,2016,1570270,1496156,74114,4.7
"06073",6,73,2017,1584655,1521190,63465,4
"06075",6,75,1990,409356,393929,15427,3.8
"06075",6,75,1991,405045,383499,21546,5.3
"06075",6,75,1992,404975,377432,27543,6.8
"06075",6,75,1993,406433,377812,28621,7
"06075",6,75,1994,401892,376172,25720,6.4
"06075",6,75,1995,394782,370958,23824,6
"06075",6,75,1996,398053,378960,19093,4.8
"06075",6,75,1997,408365,391639,16726,4.1
"06075",6,75,1998,414339,399111,15228,3.7
"06075",6,75,1999,417554,404744,12810,3.1
"06075",6,75,2000,473130,456993,16137,3.4
"06075",6,75,2001,469037,445193,23844,5.1
"06075",6,75,2002,448114,417259,30855,6.9
"06075",6,75,2003,429292,400587,28705,6.7
"06075",6,75,2004,418507,394397,24110,5.8
"06075",6,75,2005,413337,392747,20590,5
"06075",6,75,2006,415749,398293,17456,4.2
"06075",6,75,2007,432564,414199,18365,4.2
"06075",6,75,2008,456989,432981,24008,5.3
"06075",6,75,2009,459432,419546,39886,8.7
"06075",6,75,2010,486019,442695,43324,8.9
"06075",6,75,2011,494760,454861,39899,8.1
"06075",6,75,2012,509444,474933,34511,6.8
"06075",6,75,2013,516300,488121,28179,5.5
"06075",6,75,2014,529839,506679,23160,4.4
"06075",6,75,2015,545704,525939,19765,3.6
"06075",6,75,2016,560067,541709,18358,3.3
"06075",6,75,2017,568722,552223,16499,2.9
"06077",6,77,1990,227060,204547,22513,9.9
"06077",6,77,1991,231287,203608,27679,12
"06077",6,77,1992,239435,205764,33671,14.1
"06077",6,77,1993,241912,207848,34064,14.1
"06077",6,77,1994,239968,209282,30686,12.8
"06077",6,77,1995,239900,210482,29418,12.3
"06077",6,77,1996,240169,212933,27236,11.3
"06077",6,77,1997,244436,218085,26351,10.8
"06077",6,77,1998,247064,220876,26188,10.6
"06077",6,77,1999,250051,227938,22113,8.8
"06077",6,77,2000,259158,241091,18067,7
"06077",6,77,2001,266043,246169,19874,7.5
"06077",6,77,2002,274127,250023,24104,8.8
"06077",6,77,2003,278846,253418,25428,9.1
"06077",6,77,2004,281401,256891,24510,8.7
"06077",6,77,2005,283588,261289,22299,7.9
"06077",6,77,2006,283597,262552,21045,7.4
"06077",6,77,2007,288638,265279,23359,8.1
"06077",6,77,2008,292848,262271,30577,10.4
"06077",6,77,2009,297806,253310,44496,14.9
"06077",6,77,2010,311437,259995,51442,16.5
"06077",6,77,2011,311363,260997,50366,16.2
"06077",6,77,2012,311818,267059,44759,14.4
"06077",6,77,2013,313101,274562,38539,12.3
"06077",6,77,2014,312782,279832,32950,10.5
"06077",6,77,2015,315286,287278,28008,8.9
"06077",6,77,2016,319513,293543,25970,8.1
"06077",6,77,2017,324788,302176,22612,7
"06079",6,79,1990,99766,95144,4622,4.6
"06079",6,79,1991,96171,90389,5782,6
"06079",6,79,1992,99632,92215,7417,7.4
"06079",6,79,1993,101308,93063,8245,8.1
"06079",6,79,1994,99783,92616,7167,7.2
"06079",6,79,1995,100730,94127,6603,6.6
"06079",6,79,1996,102096,96354,5742,5.6
"06079",6,79,1997,105351,100339,5012,4.8
"06079",6,79,1998,108119,103600,4519,4.2
"06079",6,79,1999,111163,107542,3621,3.3
"06079",6,79,2000,122563,117613,4950,4
"06079",6,79,2001,126060,120987,5073,4
"06079",6,79,2002,128360,122426,5934,4.6
"06079",6,79,2003,127924,121939,5985,4.7
"06079",6,79,2004,129550,123650,5900,4.6
"06079",6,79,2005,131479,125879,5600,4.3
"06079",6,79,2006,132376,127166,5210,3.9
"06079",6,79,2007,134026,128276,5750,4.3
"06079",6,79,2008,136402,128522,7880,5.8
"06079",6,79,2009,136378,124372,12006,8.8
"06079",6,79,2010,133651,120209,13442,10.1
"06079",6,79,2011,134374,121509,12865,9.6
"06079",6,79,2012,137362,126037,11325,8.2
"06079",6,79,2013,138258,128819,9439,6.8
"06079",6,79,2014,140565,132727,7838,5.6
"06079",6,79,2015,139613,133029,6584,4.7
"06079",6,79,2016,140300,134257,6043,4.3
"06079",6,79,2017,142066,136977,5089,3.6
"06081",6,81,1990,370206,360492,9714,2.6
"06081",6,81,1991,366679,352198,14481,3.9
"06081",6,81,1992,368319,349639,18680,5.1
"06081",6,81,1993,368686,349992,18694,5.1
"06081",6,81,1994,369675,352362,17313,4.7
"06081",6,81,1995,366720,351317,15403,4.2
"06081",6,81,1996,374628,361865,12763,3.4
"06081",6,81,1997,384193,373781,10412,2.7
"06081",6,81,1998,391427,381824,9603,2.5
"06081",6,81,1999,395072,387248,7824,2
"06081",6,81,2000,398478,387032,11446,2.9
"06081",6,81,2001,392488,377527,14961,3.8
"06081",6,81,2002,377758,356509,21249,5.6
"06081",6,81,2003,366878,345638,21240,5.8
"06081",6,81,2004,361489,343993,17496,4.8
"06081",6,81,2005,360298,345017,15281,4.2
"06081",6,81,2006,364007,350645,13362,3.7
"06081",6,81,2007,369503,355415,14088,3.8
"06081",6,81,2008,372360,354161,18199,4.9
"06081",6,81,2009,374199,343493,30706,8.2
"06081",6,81,2010,393004,360163,32841,8.4
"06081",6,81,2011,399859,369827,30032,7.5
"06081",6,81,2012,412056,385661,26395,6.4
"06081",6,81,2013,418085,396092,21993,5.3
"06081",6,81,2014,427907,409873,18034,4.2
"06081",6,81,2015,437690,422826,14864,3.4
"06081",6,81,2016,445445,431923,13522,3
"06081",6,81,2017,452445,440324,12121,2.7
"06083",6,83,1990,192547,183121,9426,4.9
"06083",6,83,1991,194875,183348,11527,5.9
"06083",6,83,1992,193117,178836,14281,7.4
"06083",6,83,1993,193043,178161,14882,7.7
"06083",6,83,1994,195233,181154,14079,7.2
"06083",6,83,1995,191470,178672,12798,6.7
"06083",6,83,1996,190415,179369,11046,5.8
"06083",6,83,1997,194103,184300,9803,5.1
"06083",6,83,1998,194611,185989,8622,4.4
"06083",6,83,1999,197532,189812,7720,3.9
"06083",6,83,2000,202556,193699,8857,4.4
"06083",6,83,2001,202857,193916,8941,4.4
"06083",6,83,2002,205148,194615,10533,5.1
"06083",6,83,2003,207876,197443,10433,5
"06083",6,83,2004,210987,201038,9949,4.7
"06083",6,83,2005,213206,203962,9244,4.3
"06083",6,83,2006,210884,202365,8519,4
"06083",6,83,2007,213473,204163,9310,4.4
"06083",6,83,2008,218082,206131,11951,5.5
"06083",6,83,2009,219990,201872,18118,8.2
"06083",6,83,2010,212267,191680,20587,9.7
"06083",6,83,2011,213005,193023,19982,9.4
"06083",6,83,2012,216005,197919,18086,8.4
"06083",6,83,2013,217331,201680,15651,7.2
"06083",6,83,2014,218314,204973,13341,6.1
"06083",6,83,2015,217769,206250,11519,5.3
"06083",6,83,2016,216113,205177,10936,5.1
"06083",6,83,2017,216954,207213,9741,4.5
"06085",6,85,1990,852348,818551,33797,4
"06085",6,85,1991,841771,793935,47836,5.7
"06085",6,85,1992,847030,789295,57735,6.8
"06085",6,85,1993,847518,788965,58553,6.9
"06085",6,85,1994,851768,798295,53473,6.3
"06085",6,85,1995,859592,817464,42128,4.9
"06085",6,85,1996,891646,859046,32600,3.7
"06085",6,85,1997,930075,901592,28483,3.1
"06085",6,85,1998,952455,921608,30847,3.2
"06085",6,85,1999,957792,928555,29237,3.1
"06085",6,85,2000,941470,912217,29253,3.1
"06085",6,85,2001,938612,891097,47515,5.1
"06085",6,85,2002,886631,813016,73615,8.3
"06085",6,85,2003,843720,773878,69842,8.3
"06085",6,85,2004,821616,768970,52646,6.4
"06085",6,85,2005,815361,772046,43315,5.3
"06085",6,85,2006,821565,784773,36792,4.5
"06085",6,85,2007,843437,803877,39560,4.7
"06085",6,85,2008,868908,816618,52290,6
"06085",6,85,2009,874982,782384,92598,10.6
"06085",6,85,2010,926525,830114,96411,10.4
"06085",6,85,2011,939851,852426,87425,9.3
"06085",6,85,2012,958281,882982,75299,7.9
"06085",6,85,2013,971862,909039,62823,6.5
"06085",6,85,2014,992221,941097,51124,5.2
"06085",6,85,2015,1009804,967710,42094,4.2
"06085",6,85,2016,1023975,985073,38902,3.8
"06085",6,85,2017,1040558,1007143,33415,3.2
"06087",6,87,1990,135694,125920,9774,7.2
"06087",6,87,1991,137204,125073,12131,8.8
"06087",6,87,1992,139029,125610,13419,9.7
"06087",6,87,1993,140410,125798,14612,10.4
"06087",6,87,1994,140618,126918,13700,9.7
"06087",6,87,1995,138504,125651,12853,9.3
"06087",6,87,1996,138304,126557,11747,8.5
"06087",6,87,1997,140657,129593,11064,7.9
"06087",6,87,1998,140350,130047,10303,7.3
"06087",6,87,1999,138703,129873,8830,6.4
"06087",6,87,2000,148485,140881,7604,5.1
"06087",6,87,2001,150211,141618,8593,5.7
"06087",6,87,2002,147450,136639,10811,7.3
"06087",6,87,2003,144155,133052,11103,7.7
"06087",6,87,2004,143470,133430,10040,7
"06087",6,87,2005,142992,134029,8963,6.3
"06087",6,87,2006,143053,134990,8063,5.6
"06087",6,87,2007,144713,136158,8555,5.9
"06087",6,87,2008,146119,135342,10777,7.4
"06087",6,87,2009,147664,131302,16362,11.1
"06087",6,87,2010,141717,122872,18845,13.3
"06087",6,87,2011,141335,122865,18470,13.1
"06087",6,87,2012,142063,125257,16806,11.8
"06087",6,87,2013,142067,127466,14601,10.3
"06087",6,87,2014,142647,130163,12484,8.8
"06087",6,87,2015,143426,132675,10751,7.5
"06087",6,87,2016,143995,133952,10043,7
"06087",6,87,2017,143802,135648,8154,5.7
"06089",6,89,1990,67692,61850,5842,8.6
"06089",6,89,1991,68194,60781,7413,10.9
"06089",6,89,1992,72896,63400,9496,13
"06089",6,89,1993,73197,63998,9199,12.6
"06089",6,89,1994,72499,63754,8745,12.1
"06089",6,89,1995,72010,63878,8132,11.3
"06089",6,89,1996,71873,64674,7199,10
"06089",6,89,1997,72617,65934,6683,9.2
"06089",6,89,1998,72088,65558,6530,9.1
"06089",6,89,1999,72119,67012,5107,7.1
"06089",6,89,2000,74906,70353,4553,6.1
"06089",6,89,2001,77576,72656,4920,6.3
"06089",6,89,2002,81260,75490,5770,7.1
"06089",6,89,2003,82380,76198,6182,7.5
"06089",6,89,2004,82432,76182,6250,7.6
"06089",6,89,2005,81748,75826,5922,7.2
"06089",6,89,2006,82446,77008,5438,6.6
"06089",6,89,2007,82540,76350,6190,7.5
"06089",6,89,2008,82577,74257,8320,10.1
"06089",6,89,2009,83960,71919,12041,14.3
"06089",6,89,2010,78503,65334,13169,16.8
"06089",6,89,2011,77044,64762,12282,15.9
"06089",6,89,2012,76009,65229,10780,14.2
"06089",6,89,2013,75285,66385,8900,11.8
"06089",6,89,2014,75047,67830,7217,9.6
"06089",6,89,2015,74324,68550,5774,7.8
"06089",6,89,2016,74457,69265,5192,7
"06089",6,89,2017,74476,70155,4321,5.8
"06091",6,91,1990,1628,1451,177,10.9
"06091",6,91,1991,1648,1470,178,10.8
"06091",6,91,1992,1710,1520,190,11.1
"06091",6,91,1993,1808,1609,199,11
"06091",6,91,1994,1777,1598,179,10.1
"06091",6,91,1995,1689,1526,163,9.7
"06091",6,91,1996,1729,1535,194,11.2
"06091",6,91,1997,1722,1542,180,10.5
"06091",6,91,1998,1633,1441,192,11.8
"06091",6,91,1999,1621,1472,149,9.2
"06091",6,91,2000,1803,1697,106,5.9
"06091",6,91,2001,1668,1542,126,7.6
"06091",6,91,2002,1641,1500,141,8.6
"06091",6,91,2003,1635,1483,152,9.3
"06091",6,91,2004,1581,1428,153,9.7
"06091",6,91,2005,1580,1449,131,8.3
"06091",6,91,2006,1587,1469,118,7.4
"06091",6,91,2007,1610,1482,128,8
"06091",6,91,2008,1589,1421,168,10.6
"06091",6,91,2009,1595,1357,238,14.9
"06091",6,91,2010,1611,1364,247,15.3
"06091",6,91,2011,1601,1363,238,14.9
"06091",6,91,2012,1469,1258,211,14.4
"06091",6,91,2013,1452,1267,185,12.7
"06091",6,91,2014,1416,1273,143,10.1
"06091",6,91,2015,1356,1237,119,8.8
"06091",6,91,2016,1338,1236,102,7.6
"06091",6,91,2017,1301,1216,85,6.5
"06093",6,93,1990,19437,17066,2371,12.2
"06093",6,93,1991,19117,16608,2509,13.1
"06093",6,93,1992,19400,16368,3032,15.6
"06093",6,93,1993,19310,16324,2986,15.5
"06093",6,93,1994,19387,16681,2706,14
"06093",6,93,1995,18827,16138,2689,14.3
"06093",6,93,1996,18609,16065,2544,13.7
"06093",6,93,1997,18529,16278,2251,12.1
"06093",6,93,1998,18318,16009,2309,12.6
"06093",6,93,1999,17575,15750,1825,10.4
"06093",6,93,2000,19162,17716,1446,7.5
"06093",6,93,2001,18959,17430,1529,8.1
"06093",6,93,2002,18990,17304,1686,8.9
"06093",6,93,2003,19216,17399,1817,9.5
"06093",6,93,2004,18972,17182,1790,9.4
"06093",6,93,2005,18648,16970,1678,9
"06093",6,93,2006,18596,17107,1489,8
"06093",6,93,2007,18786,17192,1594,8.5
"06093",6,93,2008,19204,17242,1962,10.2
"06093",6,93,2009,19631,16835,2796,14.2
"06093",6,93,2010,19628,16325,3303,16.8
"06093",6,93,2011,19435,16134,3301,17
"06093",6,93,2012,18876,15929,2947,15.6
"06093",6,93,2013,18293,15888,2405,13.1
"06093",6,93,2014,18046,16046,2000,11.1
"06093",6,93,2015,17920,16242,1678,9.4
"06093",6,93,2016,17955,16428,1527,8.5
"06093",6,93,2017,17963,16662,1301,7.2
"06095",6,95,1990,164884,156976,7908,4.8
"06095",6,95,1991,166468,156090,10378,6.2
"06095",6,95,1992,173207,160491,12716,7.3
"06095",6,95,1993,174820,160562,14258,8.2
"06095",6,95,1994,174989,161659,13330,7.6
"06095",6,95,1995,171536,157979,13557,7.9
"06095",6,95,1996,173379,160015,13364,7.7
"06095",6,95,1997,177823,166217,11606,6.5
"06095",6,95,1998,182048,171933,10115,5.6
"06095",6,95,1999,188845,180117,8728,4.6
"06095",6,95,2000,194370,185345,9025,4.6
"06095",6,95,2001,196996,187928,9068,4.6
"06095",6,95,2002,202180,190547,11633,5.8
"06095",6,95,2003,205399,192560,12839,6.3
"06095",6,95,2004,206294,194329,11965,5.8
"06095",6,95,2005,208486,197341,11145,5.3
"06095",6,95,2006,207849,197727,10122,4.9
"06095",6,95,2007,208196,197214,10982,5.3
"06095",6,95,2008,211059,196503,14556,6.9
"06095",6,95,2009,214520,192225,22295,10.4
"06095",6,95,2010,202407,176969,25438,12.6
"06095",6,95,2011,202241,177619,24622,12.2
"06095",6,95,2012,202661,180984,21677,10.7
"06095",6,95,2013,203055,184630,18425,9.1
"06095",6,95,2014,203266,187972,15294,7.5
"06095",6,95,2015,205325,192736,12589,6.1
"06095",6,95,2016,207909,196460,11449,5.5
"06095",6,95,2017,209199,199257,9942,4.8
"06097",6,97,1990,206269,198268,8001,3.9
"06097",6,97,1991,211891,200154,11737,5.5
"06097",6,97,1992,217280,202024,15256,7
"06097",6,97,1993,220235,205710,14525,6.6
"06097",6,97,1994,223883,210800,13083,5.8
"06097",6,97,1995,223400,211091,12309,5.5
"06097",6,97,1996,229155,218918,10237,4.5
"06097",6,97,1997,237722,228638,9084,3.8
"06097",6,97,1998,245387,237217,8170,3.3
"06097",6,97,1999,248820,242079,6741,2.7
"06097",6,97,2000,253460,244927,8533,3.4
"06097",6,97,2001,257645,248179,9466,3.7
"06097",6,97,2002,256699,243765,12934,5
"06097",6,97,2003,252912,239225,13687,5.4
"06097",6,97,2004,253992,241462,12530,4.9
"06097",6,97,2005,253410,242205,11205,4.4
"06097",6,97,2006,253990,243840,10150,4
"06097",6,97,2007,257316,246143,11173,4.3
"06097",6,97,2008,259633,244654,14979,5.8
"06097",6,97,2009,256523,232398,24125,9.4
"06097",6,97,2010,244634,218100,26534,10.8
"06097",6,97,2011,246171,220958,25213,10.2
"06097",6,97,2012,246281,224462,21819,8.9
"06097",6,97,2013,249962,232197,17765,7.1
"06097",6,97,2014,256742,242339,14403,5.6
"06097",6,97,2015,258426,246837,11589,4.5
"06097",6,97,2016,260108,249760,10348,4
"06097",6,97,2017,262807,253972,8835,3.4
"06099",6,99,1990,180443,159054,21389,11.9
"06099",6,99,1991,183210,156290,26920,14.7
"06099",6,99,1992,191747,160303,31444,16.4
"06099",6,99,1993,194152,161604,32548,16.8
"06099",6,99,1994,193324,162734,30590,15.8
"06099",6,99,1995,192015,162419,29596,15.4
"06099",6,99,1996,194610,166751,27859,14.3
"06099",6,99,1997,197783,171652,26131,13.2
"06099",6,99,1998,201270,176598,24672,12.3
"06099",6,99,1999,201992,180565,21427,10.6
"06099",6,99,2000,207963,191746,16217,7.8
"06099",6,99,2001,214093,196211,17882,8.4
"06099",6,99,2002,219057,198034,21023,9.6
"06099",6,99,2003,221714,199975,21739,9.8
"06099",6,99,2004,223664,203101,20563,9.2
"06099",6,99,2005,226627,207585,19042,8.4
"06099",6,99,2006,224294,206447,17847,8
"06099",6,99,2007,226889,207202,19687,8.7
"06099",6,99,2008,231707,206012,25695,11.1
"06099",6,99,2009,234462,198102,36360,15.5
"06099",6,99,2010,243274,202182,41092,16.9
"06099",6,99,2011,242320,202360,39960,16.5
"06099",6,99,2012,241965,205940,36025,14.9
"06099",6,99,2013,240987,209781,31206,12.9
"06099",6,99,2014,241157,214219,26938,11.2
"06099",6,99,2015,241609,218687,22922,9.5
"06099",6,99,2016,243542,222557,20985,8.6
"06099",6,99,2017,243235,225070,18165,7.5
"06101",6,101,1990,33135,28457,4678,14.1
"06101",6,101,1991,34522,28680,5842,16.9
"06101",6,101,1992,34109,27441,6668,19.5
"06101",6,101,1993,34681,28185,6496,18.7
"06101",6,101,1994,34001,28349,5652,16.6
"06101",6,101,1995,34233,28368,5865,17.1
"06101",6,101,1996,34237,28765,5472,16
"06101",6,101,1997,35293,29943,5350,15.2
"06101",6,101,1998,35384,29863,5521,15.6
"06101",6,101,1999,35570,30915,4655,13.1
"06101",6,101,2000,37899,34331,3568,9.4
"06101",6,101,2001,38423,34675,3748,9.8
"06101",6,101,2002,39035,34763,4272,10.9
"06101",6,101,2003,39403,35017,4386,11.1
"06101",6,101,2004,40049,35817,4232,10.6
"06101",6,101,2005,39999,36145,3854,9.6
"06101",6,101,2006,40363,36753,3610,8.9
"06101",6,101,2007,40987,37022,3965,9.7
"06101",6,101,2008,41058,35980,5078,12.4
"06101",6,101,2009,41882,34991,6891,16.5
"06101",6,101,2010,45965,37528,8437,18.4
"06101",6,101,2011,45939,37596,8343,18.2
"06101",6,101,2012,45557,37901,7656,16.8
"06101",6,101,2013,44792,38243,6549,14.6
"06101",6,101,2014,44394,38781,5613,12.6
"06101",6,101,2015,44704,39914,4790,10.7
"06101",6,101,2016,44571,40196,4375,9.8
"06101",6,101,2017,45739,41804,3935,8.6
"06103",6,103,1990,19924,17930,1994,10
"06103",6,103,1991,21173,18744,2429,11.5
"06103",6,103,1992,23026,20081,2945,12.8
"06103",6,103,1993,23315,20259,3056,13.1
"06103",6,103,1994,23881,21191,2690,11.3
"06103",6,103,1995,23037,20443,2594,11.3
"06103",6,103,1996,22869,20429,2440,10.7
"06103",6,103,1997,23995,21784,2211,9.2
"06103",6,103,1998,23938,21848,2090,8.7
"06103",6,103,1999,24146,22514,1632,6.8
"06103",6,103,2000,23634,22089,1545,6.5
"06103",6,103,2001,24552,22945,1607,6.5
"06103",6,103,2002,25491,23671,1820,7.1
"06103",6,103,2003,25613,23658,1955,7.6
"06103",6,103,2004,25289,23424,1865,7.4
"06103",6,103,2005,25199,23470,1729,6.9
"06103",6,103,2006,25054,23432,1622,6.5
"06103",6,103,2007,24859,23061,1798,7.2
"06103",6,103,2008,25153,22832,2321,9.2
"06103",6,103,2009,25344,21887,3457,13.6
"06103",6,103,2010,25714,21754,3960,15.4
"06103",6,103,2011,25574,21744,3830,15
"06103",6,103,2012,25248,21780,3468,13.7
"06103",6,103,2013,25086,22171,2915,11.6
"06103",6,103,2014,25144,22726,2418,9.6
"06103",6,103,2015,25076,23094,1982,7.9
"06103",6,103,2016,25155,23363,1792,7.1
"06103",6,103,2017,25598,23968,1630,6.4
"06105",6,105,1990,5344,4677,667,12.5
"06105",6,105,1991,5127,4386,741,14.5
"06105",6,105,1992,5266,4384,882,16.7
"06105",6,105,1993,5184,4321,863,16.6
"06105",6,105,1994,5271,4488,783,14.9
"06105",6,105,1995,5273,4502,771,14.6
"06105",6,105,1996,5152,4398,754,14.6
"06105",6,105,1997,5150,4446,704,13.7
"06105",6,105,1998,4989,4322,667,13.4
"06105",6,105,1999,4849,4287,562,11.6
"06105",6,105,2000,5115,4613,502,9.8
"06105",6,105,2001,5389,4888,501,9.3
"06105",6,105,2002,5389,4848,541,10
"06105",6,105,2003,5376,4815,561,10.4
"06105",6,105,2004,5237,4664,573,10.9
"06105",6,105,2005,5170,4642,528,10.2
"06105",6,105,2006,5058,4558,500,9.9
"06105",6,105,2007,5024,4499,525,10.4
"06105",6,105,2008,4850,4228,622,12.8
"06105",6,105,2009,4985,4148,837,16.8
"06105",6,105,2010,5423,4501,922,17
"06105",6,105,2011,5385,4486,899,16.7
"06105",6,105,2012,5330,4550,780,14.6
"06105",6,105,2013,5192,4572,620,11.9
"06105",6,105,2014,5182,4693,489,9.4
"06105",6,105,2015,5142,4742,400,7.8
"06105",6,105,2016,5010,4655,355,7.1
"06105",6,105,2017,4991,4690,301,6
"06107",6,107,1990,145783,127785,17998,12.3
"06107",6,107,1991,152736,125114,27622,18.1
"06107",6,107,1992,154121,127292,26829,17.4
"06107",6,107,1993,157669,129149,28520,18.1
"06107",6,107,1994,161325,134982,26343,16.3
"06107",6,107,1995,159505,132943,26562,16.7
"06107",6,107,1996,159259,133527,25732,16.2
"06107",6,107,1997,160005,135409,24596,15.4
"06107",6,107,1998,162555,137069,25486,15.7
"06107",6,107,1999,164680,137363,27317,16.6
"06107",6,107,2000,172016,154107,17909,10.4
"06107",6,107,2001,175201,155174,20027,11.4
"06107",6,107,2002,180460,159037,21423,11.9
"06107",6,107,2003,181161,159083,22078,12.2
"06107",6,107,2004,179763,158989,20774,11.6
"06107",6,107,2005,183305,166019,17286,9.4
"06107",6,107,2006,187407,171467,15940,8.5
"06107",6,107,2007,191568,173855,17713,9.2
"06107",6,107,2008,198899,177353,21546,10.8
"06107",6,107,2009,203168,172996,30172,14.9
"06107",6,107,2010,203021,168110,34911,17.2
"06107",6,107,2011,203474,168687,34787,17.1
"06107",6,107,2012,201287,168764,32523,16.2
"06107",6,107,2013,201053,172171,28882,14.4
"06107",6,107,2014,198635,172550,26085,13.1
"06107",6,107,2015,204111,180569,23542,11.5
"06107",6,107,2016,203955,181145,22810,11.2
"06107",6,107,2017,205423,184022,21401,10.4
"06109",6,109,1990,19871,18532,1339,6.7
"06109",6,109,1991,20008,18281,1727,8.6
"06109",6,109,1992,20757,18426,2331,11.2
"06109",6,109,1993,20624,18177,2447,11.9
"06109",6,109,1994,20979,18662,2317,11
"06109",6,109,1995,20105,17925,2180,10.8
"06109",6,109,1996,19541,17541,2000,10.2
"06109",6,109,1997,19701,17971,1730,8.8
"06109",6,109,1998,19529,17969,1560,8
"06109",6,109,1999,19813,18509,1304,6.6
"06109",6,109,2000,22909,21557,1352,5.9
"06109",6,109,2001,23939,22537,1402,5.9
"06109",6,109,2002,24751,23121,1630,6.6
"06109",6,109,2003,25295,23527,1768,7
"06109",6,109,2004,25551,23788,1763,6.9
"06109",6,109,2005,25983,24312,1671,6.4
"06109",6,109,2006,25806,24316,1490,5.8
"06109",6,109,2007,25775,24176,1599,6.2
"06109",6,109,2008,25767,23703,2064,8
"06109",6,109,2009,25724,22594,3130,12.2
"06109",6,109,2010,22617,19173,3444,15.2
"06109",6,109,2011,22725,19440,3285,14.5
"06109",6,109,2012,22315,19419,2896,13
"06109",6,109,2013,21749,19406,2343,10.8
"06109",6,109,2014,21628,19757,1871,8.7
"06109",6,109,2015,21578,20058,1520,7
"06109",6,109,2016,21640,20293,1347,6.2
"06109",6,109,2017,21477,20319,1158,5.4
"06111",6,111,1990,366564,345433,21131,5.8
"06111",6,111,1991,366484,338934,27550,7.5
"06111",6,111,1992,373120,339796,33324,8.9
"06111",6,111,1993,375542,341706,33836,9
"06111",6,111,1994,380190,350230,29960,7.9
"06111",6,111,1995,378845,350722,28123,7.4
"06111",6,111,1996,376580,349388,27192,7.2
"06111",6,111,1997,378591,353526,25065,6.6
"06111",6,111,1998,385739,364251,21488,5.6
"06111",6,111,1999,394297,375297,19000,4.8
"06111",6,111,2000,392984,375180,17804,4.5
"06111",6,111,2001,398957,379622,19335,4.8
"06111",6,111,2002,406073,382801,23272,5.7
"06111",6,111,2003,409668,386156,23512,5.7
"06111",6,111,2004,412278,390262,22016,5.3
"06111",6,111,2005,415958,396225,19733,4.7
"06111",6,111,2006,419562,401509,18053,4.3
"06111",6,111,2007,423062,402396,20666,4.9
"06111",6,111,2008,428792,401777,27015,6.3
"06111",6,111,2009,430294,388824,41470,9.6
"06111",6,111,2010,430010,383424,46586,10.8
"06111",6,111,2011,431718,387495,44223,10.2
"06111",6,111,2012,434681,395158,39523,9.1
"06111",6,111,2013,433914,399769,34145,7.9
"06111",6,111,2014,431107,402455,28652,6.6
"06111",6,111,2015,428437,404239,24198,5.6
"06111",6,111,2016,426660,404382,22278,5.2
"06111",6,111,2017,426116,406976,19140,4.5
"06113",6,113,1990,74016,68936,5080,6.9
"06113",6,113,1991,77051,71016,6035,7.8
"06113",6,113,1992,81882,75147,6735,8.2
"06113",6,113,1993,82746,76125,6621,8
"06113",6,113,1994,86570,80674,5896,6.8
"06113",6,113,1995,86521,80591,5930,6.9
"06113",6,113,1996,86231,80690,5541,6.4
"06113",6,113,1997,85707,80622,5085,5.9
"06113",6,113,1998,86751,82029,4722,5.4
"06113",6,113,1999,90710,86740,3970,4.4
"06113",6,113,2000,86259,81906,4353,5
"06113",6,113,2001,88252,83734,4518,5.1
"06113",6,113,2002,90459,85056,5403,6
"06113",6,113,2003,91289,85500,5789,6.3
"06113",6,113,2004,91911,86345,5566,6.1
"06113",6,113,2005,92358,87237,5121,5.5
"06113",6,113,2006,93606,88766,4840,5.2
"06113",6,113,2007,97518,91928,5590,5.7
"06113",6,113,2008,98299,91012,7287,7.4
"06113",6,113,2009,98742,87862,10880,11
"06113",6,113,2010,102188,89834,12354,12.1
"06113",6,113,2011,101806,89818,11988,11.8
"06113",6,113,2012,102610,91689,10921,10.6
"06113",6,113,2013,101835,92660,9175,9
"06113",6,113,2014,102474,94763,7711,7.5
"06113",6,113,2015,104706,97963,6743,6.4
"06113",6,113,2016,106367,100096,6271,5.9
"06113",6,113,2017,107775,102373,5402,5
"06115",6,115,1990,22146,19785,2361,10.7
"06115",6,115,1991,22624,19498,3126,13.8
"06115",6,115,1992,22358,18496,3862,17.3
"06115",6,115,1993,23003,18997,4006,17.4
"06115",6,115,1994,21958,18482,3476,15.8
"06115",6,115,1995,20950,17818,3132,14.9
"06115",6,115,1996,20894,17942,2952,14.1
"06115",6,115,1997,20887,18118,2769,13.3
"06115",6,115,1998,20679,17870,2809,13.6
"06115",6,115,1999,20474,18076,2398,11.7
"06115",6,115,2000,24316,22379,1937,8
"06115",6,115,2001,24839,22723,2116,8.5
"06115",6,115,2002,24987,22550,2437,9.8
"06115",6,115,2003,25183,22497,2686,10.7
"06115",6,115,2004,25235,22795,2440,9.7
"06115",6,115,2005,25684,23368,2316,9
"06115",6,115,2006,26551,24218,2333,8.8
"06115",6,115,2007,27345,24813,2532,9.3
"06115",6,115,2008,27700,24396,3304,11.9
"06115",6,115,2009,28348,23574,4774,16.8
"06115",6,115,2010,29064,23902,5162,17.8
"06115",6,115,2011,28948,24035,4913,17
"06115",6,115,2012,28832,24395,4437,15.4
"06115",6,115,2013,28250,24531,3719,13.2
"06115",6,115,2014,27962,24829,3133,11.2
"06115",6,115,2015,27881,25301,2580,9.3
"06115",6,115,2016,28148,25715,2433,8.6
"06115",6,115,2017,28546,26421,2125,7.4
"08001",8,1,1990,140544,132385,8159,5.8
"08001",8,1,1991,142002,134516,7486,5.3
"08001",8,1,1992,145671,137195,8476,5.8
"08001",8,1,1993,150890,142831,8059,5.3
"08001",8,1,1994,158763,151849,6914,4.4
"08001",8,1,1995,165592,159031,6561,4
"08001",8,1,1996,167915,160800,7115,4.2
"08001",8,1,1997,172650,166897,5753,3.3
"08001",8,1,1998,180916,174701,6215,3.4
"08001",8,1,1999,183841,178606,5235,2.8
"08001",8,1,2000,186727,181535,5192,2.8
"08001",8,1,2001,187343,179822,7521,4
"08001",8,1,2002,193149,181364,11785,6.1
"08001",8,1,2003,200583,186573,14010,7
"08001",8,1,2004,205154,192092,13062,6.4
"08001",8,1,2005,209927,197954,11973,5.7
"08001",8,1,2006,217152,206644,10508,4.8
"08001",8,1,2007,219560,210306,9254,4.2
"08001",8,1,2008,225880,213688,12192,5.4
"08001",8,1,2009,228327,209001,19326,8.5
"08001",8,1,2010,234221,210728,23493,10
"08001",8,1,2011,236385,212931,23454,9.9
"08001",8,1,2012,239471,216923,22548,9.4
"08001",8,1,2013,241765,222106,19659,8.1
"08001",8,1,2014,244862,230839,14023,5.7
"08001",8,1,2015,247717,236940,10777,4.4
"08001",8,1,2016,253559,244503,9056,3.6
"08001",8,1,2017,261302,253318,7984,3.1
"08003",8,3,1990,6736,6243,493,7.3
"08003",8,3,1991,6791,6311,480,7.1
"08003",8,3,1992,6960,6394,566,8.1
"08003",8,3,1993,7221,6706,515,7.1
"08003",8,3,1994,7558,7115,443,5.9
"08003",8,3,1995,8004,7515,489,6.1
"08003",8,3,1996,8174,7681,493,6
"08003",8,3,1997,8353,7904,449,5.4
"08003",8,3,1998,8611,8044,567,6.6
"08003",8,3,1999,8345,7895,450,5.4
"08003",8,3,2000,7210,6947,263,3.6
"08003",8,3,2001,7740,7413,327,4.2
"08003",8,3,2002,8211,7810,401,4.9
"08003",8,3,2003,8190,7724,466,5.7
"08003",8,3,2004,8256,7774,482,5.8
"08003",8,3,2005,8138,7694,444,5.5
"08003",8,3,2006,8231,7849,382,4.6
"08003",8,3,2007,8352,8022,330,4
"08003",8,3,2008,8356,7919,437,5.2
"08003",8,3,2009,8936,8373,563,6.3
"08003",8,3,2010,7702,7010,692,9
"08003",8,3,2011,7684,6942,742,9.7
"08003",8,3,2012,7753,6943,810,10.4
"08003",8,3,2013,7562,6827,735,9.7
"08003",8,3,2014,7507,6966,541,7.2
"08003",8,3,2015,7649,7254,395,5.2
"08003",8,3,2016,7967,7645,322,4
"08003",8,3,2017,8230,7948,282,3.4
"08005",8,5,1990,224903,216329,8574,3.8
"08005",8,5,1991,230581,221522,9059,3.9
"08005",8,5,1992,237574,226500,11074,4.7
"08005",8,5,1993,247718,237306,10412,4.2
"08005",8,5,1994,261374,252300,9074,3.5
"08005",8,5,1995,268365,259960,8405,3.1
"08005",8,5,1996,269494,260840,8654,3.2
"08005",8,5,1997,277214,270208,7006,2.5
"08005",8,5,1998,289435,282039,7396,2.6
"08005",8,5,1999,294004,287376,6628,2.3
"08005",8,5,2000,281811,274923,6888,2.4
"08005",8,5,2001,282082,271785,10297,3.7
"08005",8,5,2002,285222,269132,16090,5.6
"08005",8,5,2003,291896,274121,17775,6.1
"08005",8,5,2004,296059,279684,16375,5.5
"08005",8,5,2005,298738,283637,15101,5.1
"08005",8,5,2006,302717,289805,12912,4.3
"08005",8,5,2007,304913,293497,11416,3.7
"08005",8,5,2008,312650,297374,15276,4.9
"08005",8,5,2009,312497,289832,22665,7.3
"08005",8,5,2010,316886,289715,27171,8.6
"08005",8,5,2011,319253,292867,26386,8.3
"08005",8,5,2012,322881,297947,24934,7.7
"08005",8,5,2013,326280,304753,21527,6.6
"08005",8,5,2014,330982,314763,16219,4.9
"08005",8,5,2015,334230,321794,12436,3.7
"08005",8,5,2016,340486,329992,10494,3.1
"08005",8,5,2017,351417,341647,9770,2.8
"08007",8,7,1990,2681,2542,139,5.2
"08007",8,7,1991,2736,2529,207,7.6
"08007",8,7,1992,2816,2583,233,8.3
"08007",8,7,1993,3018,2789,229,7.6
"08007",8,7,1994,3297,3131,166,5
"08007",8,7,1995,3643,3475,168,4.6
"08007",8,7,1996,3864,3657,207,5.4
"08007",8,7,1997,4083,3865,218,5.3
"08007",8,7,1998,4487,4253,234,5.2
"08007",8,7,1999,4765,4569,196,4.1
"08007",8,7,2000,5015,4854,161,3.2
"08007",8,7,2001,5310,5100,210,4
"08007",8,7,2002,5662,5361,301,5.3
"08007",8,7,2003,5589,5268,321,5.7
"08007",8,7,2004,5785,5470,315,5.4
"08007",8,7,2005,5984,5676,308,5.1
"08007",8,7,2006,6452,6186,266,4.1
"08007",8,7,2007,6604,6354,250,3.8
"08007",8,7,2008,6524,6194,330,5.1
"08007",8,7,2009,6334,5862,472,7.5
"08007",8,7,2010,5785,5169,616,10.6
"08007",8,7,2011,5748,5169,579,10.1
"08007",8,7,2012,5736,5160,576,10
"08007",8,7,2013,5699,5200,499,8.8
"08007",8,7,2014,5721,5378,343,6
"08007",8,7,2015,6010,5767,243,4
"08007",8,7,2016,6363,6156,207,3.3
"08007",8,7,2017,6593,6395,198,3
"08009",8,9,1990,2024,1985,39,1.9
"08009",8,9,1991,2018,1951,67,3.3
"08009",8,9,1992,2049,1979,70,3.4
"08009",8,9,1993,2088,2032,56,2.7
"08009",8,9,1994,2057,2004,53,2.6
"08009",8,9,1995,2226,2171,55,2.5
"08009",8,9,1996,2273,2224,49,2.2
"08009",8,9,1997,2375,2335,40,1.7
"08009",8,9,1998,2456,2406,50,2
"08009",8,9,1999,2388,2327,61,2.6
"08009",8,9,2000,2106,2044,62,2.9
"08009",8,9,2001,2444,2371,73,3
"08009",8,9,2002,2539,2456,83,3.3
"08009",8,9,2003,2374,2287,87,3.7
"08009",8,9,2004,2358,2274,84,3.6
"08009",8,9,2005,2268,2181,87,3.8
"08009",8,9,2006,2423,2348,75,3.1
"08009",8,9,2007,2398,2338,60,2.5
"08009",8,9,2008,2241,2165,76,3.4
"08009",8,9,2009,2593,2498,95,3.7
"08009",8,9,2010,2084,1982,102,4.9
"08009",8,9,2011,2068,1969,99,4.8
"08009",8,9,2012,2015,1924,91,4.5
"08009",8,9,2013,1895,1817,78,4.1
"08009",8,9,2014,1924,1871,53,2.8
"08009",8,9,2015,1969,1929,40,2
"08009",8,9,2016,2091,2056,35,1.7
"08009",8,9,2017,2138,2103,35,1.6
"08011",8,11,1990,2072,2002,70,3.4
"08011",8,11,1991,2045,1953,92,4.5
"08011",8,11,1992,2064,1945,119,5.8
"08011",8,11,1993,2182,2093,89,4.1
"08011",8,11,1994,2252,2183,69,3.1
"08011",8,11,1995,2307,2240,67,2.9
"08011",8,11,1996,2242,2151,91,4.1
"08011",8,11,1997,2269,2202,67,3
"08011",8,11,1998,2365,2276,89,3.8
"08011",8,11,1999,2253,2174,79,3.5
"08011",8,11,2000,2274,2185,89,3.9
"08011",8,11,2001,2507,2399,108,4.3
"08011",8,11,2002,2525,2361,164,6.5
"08011",8,11,2003,2413,2230,183,7.6
"08011",8,11,2004,2400,2249,151,6.3
"08011",8,11,2005,2380,2231,149,6.3
"08011",8,11,2006,2409,2274,135,5.6
"08011",8,11,2007,2424,2307,117,4.8
"08011",8,11,2008,2342,2196,146,6.2
"08011",8,11,2009,2680,2506,174,6.5
"08011",8,11,2010,2006,1843,163,8.1
"08011",8,11,2011,1929,1770,159,8.2
"08011",8,11,2012,1722,1578,144,8.4
"08011",8,11,2013,1646,1519,127,7.7
"08011",8,11,2014,1650,1563,87,5.3
"08011",8,11,2015,1731,1663,68,3.9
"08011",8,11,2016,1850,1794,56,3
"08011",8,11,2017,1925,1873,52,2.7
"08013",8,13,1990,124316,118199,6117,4.9
"08013",8,13,1991,128009,122095,5914,4.6
"08013",8,13,1992,132545,125927,6618,5
"08013",8,13,1993,139978,133548,6430,4.6
"08013",8,13,1994,148622,142955,5667,3.8
"08013",8,13,1995,153017,146918,6099,4
"08013",8,13,1996,153389,147450,5939,3.9
"08013",8,13,1997,158573,153774,4799,3
"08013",8,13,1998,164988,159733,5255,3.2
"08013",8,13,1999,170041,165215,4826,2.8
"08013",8,13,2000,160011,156146,3865,2.4
"08013",8,13,2001,162354,156395,5959,3.7
"08013",8,13,2002,163623,154419,9204,5.6
"08013",8,13,2003,164483,155291,9192,5.6
"08013",8,13,2004,166606,158571,8035,4.8
"08013",8,13,2005,168036,160654,7382,4.4
"08013",8,13,2006,170598,164263,6335,3.7
"08013",8,13,2007,173647,167953,5694,3.3
"08013",8,13,2008,177472,170108,7364,4.1
"08013",8,13,2009,175518,164765,10753,6.1
"08013",8,13,2010,170293,158308,11985,7
"08013",8,13,2011,172002,160904,11098,6.5
"08013",8,13,2012,174313,163471,10842,6.2
"08013",8,13,2013,174782,165184,9598,5.5
"08013",8,13,2014,176045,168845,7200,4.1
"08013",8,13,2015,176707,171102,5605,3.2
"08013",8,13,2016,180799,175997,4802,2.7
"08013",8,13,2017,186852,182316,4536,2.4
"08014",8,14,1990,14229,13705,524,3.7
"08014",8,14,1991,14577,14074,503,3.5
"08014",8,14,1992,15021,14454,567,3.8
"08014",8,14,1993,15790,15243,547,3.5
"08014",8,14,1994,16756,16279,477,2.8
"08014",8,14,1995,17315,16820,495,2.9
"08014",8,14,1996,17410,16911,499,2.9
"08014",8,14,1997,18002,17601,401,2.2
"08014",8,14,1998,18750,18314,436,2.3
"08014",8,14,1999,19259,18866,393,2
"08014",8,14,2000,22562,22017,545,2.4
"08014",8,14,2001,22350,21541,809,3.6
"08014",8,14,2002,22600,21327,1273,5.6
"08014",8,14,2003,23707,22230,1477,6.2
"08014",8,14,2004,24110,22747,1363,5.7
"08014",8,14,2005,24506,23324,1182,4.8
"08014",8,14,2006,25442,24355,1087,4.3
"08014",8,14,2007,29984,28928,1056,3.5
"08014",8,14,2008,30844,29451,1393,4.5
"08014",8,14,2009,30845,28722,2123,6.9
"08014",8,14,2010,31538,29198,2340,7.4
"08014",8,14,2011,31768,29539,2229,7
"08014",8,14,2012,32275,30129,2146,6.6
"08014",8,14,2013,32776,30871,1905,5.8
"08014",8,14,2014,34151,32707,1444,4.2
"08014",8,14,2015,35527,34353,1174,3.3
"08014",8,14,2016,36767,35709,1058,2.9
"08014",8,14,2017,37971,36974,997,2.6
"08015",8,15,1990,5838,5436,402,6.9
"08015",8,15,1991,6068,5711,357,5.9
"08015",8,15,1992,6143,5720,423,6.9
"08015",8,15,1993,6404,6021,383,6
"08015",8,15,1994,6819,6509,310,4.5
"08015",8,15,1995,7217,6932,285,3.9
"08015",8,15,1996,7417,7069,348,4.7
"08015",8,15,1997,7612,7328,284,3.7
"08015",8,15,1998,7930,7598,332,4.2
"08015",8,15,1999,7931,7666,265,3.3
"08015",8,15,2000,7349,7103,246,3.3
"08015",8,15,2001,7508,7208,300,4
"08015",8,15,2002,7827,7434,393,5
"08015",8,15,2003,7813,7373,440,5.6
"08015",8,15,2004,8084,7613,471,5.8
"08015",8,15,2005,8179,7744,435,5.3
"08015",8,15,2006,8148,7795,353,4.3
"08015",8,15,2007,8211,7918,293,3.6
"08015",8,15,2008,8362,7986,376,4.5
"08015",8,15,2009,8576,8038,538,6.3
"08015",8,15,2010,8270,7634,636,7.7
"08015",8,15,2011,8301,7702,599,7.2
"08015",8,15,2012,8367,7796,571,6.8
"08015",8,15,2013,8301,7790,511,6.2
"08015",8,15,2014,8378,8012,366,4.4
"08015",8,15,2015,8491,8201,290,3.4
"08015",8,15,2016,8839,8606,233,2.6
"08015",8,15,2017,9318,9101,217,2.3
"08017",8,17,1990,1177,1162,15,1.3
"08017",8,17,1991,1209,1184,25,2.1
"08017",8,17,1992,1241,1196,45,3.6
"08017",8,17,1993,1144,1105,39,3.4
"08017",8,17,1994,1134,1109,25,2.2
"08017",8,17,1995,1208,1171,37,3.1
"08017",8,17,1996,1229,1197,32,2.6
"08017",8,17,1997,1315,1281,34,2.6
"08017",8,17,1998,1423,1371,52,3.7
"08017",8,17,1999,1294,1245,49,3.8
"08017",8,17,2000,1121,1092,29,2.6
"08017",8,17,2001,1282,1252,30,2.3
"08017",8,17,2002,1344,1303,41,3.1
"08017",8,17,2003,1287,1243,44,3.4
"08017",8,17,2004,1329,1289,40,3
"08017",8,17,2005,1349,1308,41,3
"08017",8,17,2006,1349,1313,36,2.7
"08017",8,17,2007,1366,1332,34,2.5
"08017",8,17,2008,1257,1223,34,2.7
"08017",8,17,2009,1372,1337,35,2.6
"08017",8,17,2010,1047,1004,43,4.1
"08017",8,17,2011,1050,1006,44,4.2
"08017",8,17,2012,1010,964,46,4.6
"08017",8,17,2013,969,928,41,4.2
"08017",8,17,2014,971,943,28,2.9
"08017",8,17,2015,1010,983,27,2.7
"08017",8,17,2016,1081,1057,24,2.2
"08017",8,17,2017,1145,1125,20,1.7
"08019",8,19,1990,4436,4258,178,4
"08019",8,19,1991,4517,4326,191,4.2
"08019",8,19,1992,4624,4377,247,5.3
"08019",8,19,1993,4964,4609,355,7.2
"08019",8,19,1994,4925,4686,239,4.9
"08019",8,19,1995,5272,5056,216,4.1
"08019",8,19,1996,5205,4996,209,4
"08019",8,19,1997,5269,5086,183,3.5
"08019",8,19,1998,5494,5336,158,2.9
"08019",8,19,1999,5378,5217,161,3
"08019",8,19,2000,6045,5879,166,2.7
"08019",8,19,2001,5937,5738,199,3.4
"08019",8,19,2002,5984,5682,302,5
"08019",8,19,2003,6012,5682,330,5.5
"08019",8,19,2004,5870,5542,328,5.6
"08019",8,19,2005,5837,5563,274,4.7
"08019",8,19,2006,5791,5557,234,4
"08019",8,19,2007,5648,5441,207,3.7
"08019",8,19,2008,5652,5393,259,4.6
"08019",8,19,2009,5426,5036,390,7.2
"08019",8,19,2010,5623,5167,456,8.1
"08019",8,19,2011,5500,5094,406,7.4
"08019",8,19,2012,5486,5100,386,7
"08019",8,19,2013,5440,5099,341,6.3
"08019",8,19,2014,5513,5257,256,4.6
"08019",8,19,2015,5542,5339,203,3.7
"08019",8,19,2016,5684,5504,180,3.2
"08019",8,19,2017,5853,5700,153,2.6
"08021",8,21,1990,3120,2747,373,12
"08021",8,21,1991,3063,2745,318,10.4
"08021",8,21,1992,3129,2743,386,12.3
"08021",8,21,1993,3226,2912,314,9.7
"08021",8,21,1994,3462,3163,299,8.6
"08021",8,21,1995,3609,3299,310,8.6
"08021",8,21,1996,3699,3375,324,8.8
"08021",8,21,1997,3795,3461,334,8.8
"08021",8,21,1998,3895,3538,357,9.2
"08021",8,21,1999,3786,3502,284,7.5
"08021",8,21,2000,3342,3172,170,5.1
"08021",8,21,2001,3597,3372,225,6.3
"08021",8,21,2002,3781,3520,261,6.9
"08021",8,21,2003,3759,3499,260,6.9
"08021",8,21,2004,3806,3508,298,7.8
"08021",8,21,2005,3777,3484,293,7.8
"08021",8,21,2006,3770,3523,247,6.6
"08021",8,21,2007,3640,3438,202,5.5
"08021",8,21,2008,3634,3369,265,7.3
"08021",8,21,2009,3738,3461,277,7.4
"08021",8,21,2010,3753,3394,359,9.6
"08021",8,21,2011,3728,3338,390,10.5
"08021",8,21,2012,3711,3317,394,10.6
"08021",8,21,2013,3610,3226,384,10.6
"08021",8,21,2014,3605,3325,280,7.8
"08021",8,21,2015,3597,3392,205,5.7
"08021",8,21,2016,3771,3588,183,4.9
"08021",8,21,2017,3920,3755,165,4.2
"08023",8,23,1990,1409,1258,151,10.7
"08023",8,23,1991,1610,1401,209,13
"08023",8,23,1992,1602,1439,163,10.2
"08023",8,23,1993,1732,1538,194,11.2
"08023",8,23,1994,1545,1371,174,11.3
"08023",8,23,1995,1583,1407,176,11.1
"08023",8,23,1996,1596,1422,174,10.9
"08023",8,23,1997,1457,1227,230,15.8
"08023",8,23,1998,1507,1281,226,15
"08023",8,23,1999,1403,1236,167,11.9
"08023",8,23,2000,1248,1155,93,7.5
"08023",8,23,2001,1311,1202,109,8.3
"08023",8,23,2002,1352,1226,126,9.3
"08023",8,23,2003,1333,1198,135,10.1
"08023",8,23,2004,1358,1214,144,10.6
"08023",8,23,2005,1346,1210,136,10.1
"08023",8,23,2006,1326,1214,112,8.4
"08023",8,23,2007,1303,1211,92,7.1
"08023",8,23,2008,1280,1181,99,7.7
"08023",8,23,2009,1379,1254,125,9.1
"08023",8,23,2010,1553,1388,165,10.6
"08023",8,23,2011,1582,1397,185,11.7
"08023",8,23,2012,1603,1420,183,11.4
"08023",8,23,2013,1596,1417,179,11.2
"08023",8,23,2014,1608,1462,146,9.1
"08023",8,23,2015,1622,1518,104,6.4
"08023",8,23,2016,1728,1645,83,4.8
"08023",8,23,2017,1832,1767,65,3.5
"08025",8,25,1990,1140,1094,46,4
"08025",8,25,1991,1167,1106,61,5.2
"08025",8,25,1992,1157,1086,71,6.1
"08025",8,25,1993,1186,1118,68,5.7
"08025",8,25,1994,1257,1199,58,4.6
"08025",8,25,1995,1256,1210,46,3.7
"08025",8,25,1996,1344,1272,72,5.4
"08025",8,25,1997,1324,1274,50,3.8
"08025",8,25,1998,1362,1303,59,4.3
"08025",8,25,1999,1385,1323,62,4.5
"08025",8,25,2000,1489,1409,80,5.4
"08025",8,25,2001,1532,1443,89,5.8
"08025",8,25,2002,1638,1522,116,7.1
"08025",8,25,2003,1604,1467,137,8.5
"08025",8,25,2004,1626,1496,130,8
"08025",8,25,2005,1604,1478,126,7.9
"08025",8,25,2006,1590,1482,108,6.8
"08025",8,25,2007,1923,1802,121,6.3
"08025",8,25,2008,1821,1687,134,7.4
"08025",8,25,2009,1987,1816,171,8.6
"08025",8,25,2010,1522,1383,139,9.1
"08025",8,25,2011,1488,1356,132,8.9
"08025",8,25,2012,1362,1252,110,8.1
"08025",8,25,2013,1322,1227,95,7.2
"08025",8,25,2014,1314,1237,77,5.9
"08025",8,25,2015,1353,1293,60,4.4
"08025",8,25,2016,1422,1372,50,3.5
"08025",8,25,2017,1458,1413,45,3.1
"08027",8,27,1990,892,851,41,4.6
"08027",8,27,1991,998,949,49,4.9
"08027",8,27,1992,1141,1065,76,6.7
"08027",8,27,1993,1276,1205,71,5.6
"08027",8,27,1994,1332,1278,54,4.1
"08027",8,27,1995,1548,1485,63,4.1
"08027",8,27,1996,1701,1622,79,4.6
"08027",8,27,1997,1817,1740,77,4.2
"08027",8,27,1998,1892,1813,79,4.2
"08027",8,27,1999,1824,1778,46,2.5
"08027",8,27,2000,1665,1608,57,3.4
"08027",8,27,2001,1791,1717,74,4.1
"08027",8,27,2002,2008,1924,84,4.2
"08027",8,27,2003,1967,1868,99,5
"08027",8,27,2004,2024,1920,104,5.1
"08027",8,27,2005,2015,1920,95,4.7
"08027",8,27,2006,1949,1866,83,4.3
"08027",8,27,2007,1994,1915,79,4
"08027",8,27,2008,1912,1815,97,5.1
"08027",8,27,2009,2039,1912,127,6.2
"08027",8,27,2010,2078,1940,138,6.6
"08027",8,27,2011,2017,1889,128,6.3
"08027",8,27,2012,1986,1860,126,6.3
"08027",8,27,2013,1919,1797,122,6.4
"08027",8,27,2014,1978,1886,92,4.7
"08027",8,27,2015,1988,1918,70,3.5
"08027",8,27,2016,2018,1955,63,3.1
"08027",8,27,2017,2015,1954,61,3
"08029",8,29,1990,8534,7929,605,7.1
"08029",8,29,1991,8601,7730,871,10.1
"08029",8,29,1992,8741,7948,793,9.1
"08029",8,29,1993,9214,8561,653,7.1
"08029",8,29,1994,10038,9449,589,5.9
"08029",8,29,1995,10160,9564,596,5.9
"08029",8,29,1996,10338,9654,684,6.6
"08029",8,29,1997,10672,10141,531,5
"08029",8,29,1998,11269,10681,588,5.2
"08029",8,29,1999,11233,10691,542,4.8
"08029",8,29,2000,12337,11877,460,3.7
"08029",8,29,2001,13324,12774,550,4.1
"08029",8,29,2002,14265,13545,720,5
"08029",8,29,2003,14094,13273,821,5.8
"08029",8,29,2004,14604,13822,782,5.4
"08029",8,29,2005,15256,14492,764,5
"08029",8,29,2006,15873,15240,633,4
"08029",8,29,2007,16412,15871,541,3.3
"08029",8,29,2008,16501,15778,723,4.4
"08029",8,29,2009,16973,15760,1213,7.1
"08029",8,29,2010,14510,12961,1549,10.7
"08029",8,29,2011,14409,12905,1504,10.4
"08029",8,29,2012,14406,13010,1396,9.7
"08029",8,29,2013,13852,12617,1235,8.9
"08029",8,29,2014,13587,12630,957,7
"08029",8,29,2015,13438,12670,768,5.7
"08029",8,29,2016,13956,13272,684,4.9
"08029",8,29,2017,14357,13798,559,3.9
"08031",8,31,1990,252157,237926,14231,5.6
"08031",8,31,1991,252944,238602,14342,5.7
"08031",8,31,1992,258573,241441,17132,6.6
"08031",8,31,1993,266899,250685,16214,6.1
"08031",8,31,1994,274434,260641,13793,5
"08031",8,31,1995,279282,266257,13025,4.7
"08031",8,31,1996,278159,264256,13903,5
"08031",8,31,1997,281852,270456,11396,4
"08031",8,31,1998,287036,275806,11230,3.9
"08031",8,31,1999,285676,276241,9435,3.3
"08031",8,31,2000,305202,295908,9294,3
"08031",8,31,2001,302235,288890,13345,4.4
"08031",8,31,2002,299999,280297,19702,6.6
"08031",8,31,2003,302578,281272,21306,7
"08031",8,31,2004,303137,283567,19570,6.5
"08031",8,31,2005,302009,284892,17117,5.7
"08031",8,31,2006,306021,291349,14672,4.8
"08031",8,31,2007,314781,301750,13031,4.1
"08031",8,31,2008,323342,305960,17382,5.4
"08031",8,31,2009,324332,298039,26293,8.1
"08031",8,31,2010,347590,315922,31668,9.1
"08031",8,31,2011,352226,321953,30273,8.6
"08031",8,31,2012,357670,329577,28093,7.9
"08031",8,31,2013,362752,338686,24066,6.6
"08031",8,31,2014,368465,350792,17673,4.8
"08031",8,31,2015,375443,361592,13851,3.7
"08031",8,31,2016,384939,373035,11904,3.1
"08031",8,31,2017,397166,386225,10941,2.8
"08033",8,33,1990,668,636,32,4.8
"08033",8,33,1991,715,629,86,12
"08033",8,33,1992,723,605,118,16.3
"08033",8,33,1993,718,622,96,13.4
"08033",8,33,1994,691,632,59,8.5
"08033",8,33,1995,640,584,56,8.8
"08033",8,33,1996,660,580,80,12.1
"08033",8,33,1997,648,556,92,14.2
"08033",8,33,1998,680,606,74,10.9
"08033",8,33,1999,725,662,63,8.7
"08033",8,33,2000,904,853,51,5.6
"08033",8,33,2001,937,889,48,5.1
"08033",8,33,2002,990,912,78,7.9
"08033",8,33,2003,987,907,80,8.1
"08033",8,33,2004,976,912,64,6.6
"08033",8,33,2005,978,910,68,7
"08033",8,33,2006,985,921,64,6.5
"08033",8,33,2007,1030,979,51,5
"08033",8,33,2008,985,914,71,7.2
"08033",8,33,2009,1044,907,137,13.1
"08033",8,33,2010,1000,823,177,17.7
"08033",8,33,2011,947,826,121,12.8
"08033",8,33,2012,949,852,97,10.2
"08033",8,33,2013,1014,930,84,8.3
"08033",8,33,2014,1328,1276,52,3.9
"08033",8,33,2015,1322,1281,41,3.1
"08033",8,33,2016,1072,1030,42,3.9
"08033",8,33,2017,1138,1104,34,3
"08035",8,35,1990,35396,34277,1119,3.2
"08035",8,35,1991,38000,36848,1152,3
"08035",8,35,1992,41535,39944,1591,3.8
"08035",8,35,1993,46219,44677,1542,3.3
"08035",8,35,1994,52340,51025,1315,2.5
"08035",8,35,1995,60187,58806,1381,2.3
"08035",8,35,1996,66454,65011,1443,2.2
"08035",8,35,1997,76185,74907,1278,1.7
"08035",8,35,1998,86865,85472,1393,1.6
"08035",8,35,1999,96048,94672,1376,1.4
"08035",8,35,2000,105589,103403,2186,2.1
"08035",8,35,2001,113280,109647,3633,3.2
"08035",8,35,2002,120707,114415,6292,5.2
"08035",8,35,2003,128710,122091,6619,5.1
"08035",8,35,2004,136547,130326,6221,4.6
"08035",8,35,2005,142904,137000,5904,4.1
"08035",8,35,2006,151085,145720,5365,3.6
"08035",8,35,2007,154953,150126,4827,3.1
"08035",8,35,2008,160990,154263,6727,4.2
"08035",8,35,2009,161345,151397,9948,6.2
"08035",8,35,2010,157522,146562,10960,7
"08035",8,35,2011,158279,148154,10125,6.4
"08035",8,35,2012,160907,151248,9659,6
"08035",8,35,2013,164441,155708,8733,5.3
"08035",8,35,2014,169078,162294,6784,4
"08035",8,35,2015,172093,166762,5331,3.1
"08035",8,35,2016,177471,172760,4711,2.7
"08035",8,35,2017,183263,178882,4381,2.4
"08037",8,37,1990,12519,12065,454,3.6
"08037",8,37,1991,13281,12640,641,4.8
"08037",8,37,1992,14070,13131,939,6.7
"08037",8,37,1993,14891,14107,784,5.3
"08037",8,37,1994,16626,16021,605,3.6
"08037",8,37,1995,17775,17227,548,3.1
"08037",8,37,1996,18477,17907,570,3.1
"08037",8,37,1997,19716,19153,563,2.9
"08037",8,37,1998,21151,20521,630,3
"08037",8,37,1999,21519,20950,569,2.6
"08037",8,37,2000,25631,25014,617,2.4
"08037",8,37,2001,26096,25294,802,3.1
"08037",8,37,2002,26693,25561,1132,4.2
"08037",8,37,2003,26188,24960,1228,4.7
"08037",8,37,2004,27314,26136,1178,4.3
"08037",8,37,2005,28407,27325,1082,3.8
"08037",8,37,2006,29827,28823,1004,3.4
"08037",8,37,2007,30929,30053,876,2.8
"08037",8,37,2008,31666,30535,1131,3.6
"08037",8,37,2009,30521,28382,2139,7
"08037",8,37,2010,32447,29697,2750,8.5
"08037",8,37,2011,32147,29624,2523,7.8
"08037",8,37,2012,32349,30032,2317,7.2
"08037",8,37,2013,31874,29947,1927,6
"08037",8,37,2014,32369,31017,1352,4.2
"08037",8,37,2015,32734,31707,1027,3.1
"08037",8,37,2016,33715,32793,922,2.7
"08037",8,37,2017,35052,34240,812,2.3
"08039",8,39,1990,5509,5285,224,4.1
"08039",8,39,1991,5825,5537,288,4.9
"08039",8,39,1992,6239,5891,348,5.6
"08039",8,39,1993,6982,6637,345,4.9
"08039",8,39,1994,7469,7137,332,4.4
"08039",8,39,1995,8940,8583,357,4
"08039",8,39,1996,9468,9098,370,3.9
"08039",8,39,1997,10144,9793,351,3.5
"08039",8,39,1998,11170,10800,370,3.3
"08039",8,39,1999,12475,12111,364,2.9
"08039",8,39,2000,11604,11341,263,2.3
"08039",8,39,2001,11951,11569,382,3.2
"08039",8,39,2002,12331,11709,622,5
"08039",8,39,2003,12572,11894,678,5.4
"08039",8,39,2004,12726,12115,611,4.8
"08039",8,39,2005,12895,12309,586,4.5
"08039",8,39,2006,13123,12602,521,4
"08039",8,39,2007,12798,12327,471,3.7
"08039",8,39,2008,13020,12396,624,4.8
"08039",8,39,2009,12933,12029,904,7
"08039",8,39,2010,12755,11727,1028,8.1
"08039",8,39,2011,12674,11724,950,7.5
"08039",8,39,2012,12692,11789,903,7.1
"08039",8,39,2013,12693,11946,747,5.9
"08039",8,39,2014,12948,12396,552,4.3
"08039",8,39,2015,13256,12839,417,3.1
"08039",8,39,2016,13794,13438,356,2.6
"08039",8,39,2017,14330,13981,349,2.4
"08041",8,41,1990,190940,177214,13726,7.2
"08041",8,41,1991,192725,179421,13304,6.9
"08041",8,41,1992,199311,185087,14224,7.1
"08041",8,41,1993,209021,196036,12985,6.2
"08041",8,41,1994,224673,213723,10950,4.9
"08041",8,41,1995,237452,226972,10480,4.4
"08041",8,41,1996,245468,234043,11425,4.7
"08041",8,41,1997,252800,243074,9726,3.8
"08041",8,41,1998,261438,250427,11011,4.2
"08041",8,41,1999,268032,258648,9384,3.5
"08041",8,41,2000,264680,256914,7766,2.9
"08041",8,41,2001,268692,257415,11277,4.2
"08041",8,41,2002,274923,258447,16476,6
"08041",8,41,2003,279948,262889,17059,6.1
"08041",8,41,2004,285556,269440,16116,5.6
"08041",8,41,2005,289307,274069,15238,5.3
"08041",8,41,2006,295570,281919,13651,4.6
"08041",8,41,2007,297494,284858,12636,4.2
"08041",8,41,2008,300206,283214,16992,5.7
"08041",8,41,2009,300226,276585,23641,7.9
"08041",8,41,2010,306308,277678,28630,9.3
"08041",8,41,2011,307563,279542,28021,9.1
"08041",8,41,2012,307002,279826,27176,8.9
"08041",8,41,2013,306761,282583,24178,7.9
"08041",8,41,2014,306425,288041,18384,6
"08041",8,41,2015,307567,293453,14114,4.6
"08041",8,41,2016,314615,302857,11758,3.7
"08041",8,41,2017,326663,315997,10666,3.3
"08043",8,43,1990,12933,12089,844,6.5
"08043",8,43,1991,13029,12128,901,6.9
"08043",8,43,1992,14288,13040,1248,8.7
"08043",8,43,1993,15206,14002,1204,7.9
"08043",8,43,1994,16098,15176,922,5.7
"08043",8,43,1995,16468,15605,863,5.2
"08043",8,43,1996,16617,15776,841,5.1
"08043",8,43,1997,17080,16381,699,4.1
"08043",8,43,1998,18029,17229,800,4.4
"08043",8,43,1999,17970,17229,741,4.1
"08043",8,43,2000,17856,17151,705,3.9
"08043",8,43,2001,18245,17328,917,5
"08043",8,43,2002,18707,17481,1226,6.6
"08043",8,43,2003,18572,17202,1370,7.4
"08043",8,43,2004,18890,17622,1268,6.7
"08043",8,43,2005,19249,18067,1182,6.1
"08043",8,43,2006,19440,18362,1078,5.5
"08043",8,43,2007,19646,18720,926,4.7
"08043",8,43,2008,19738,18487,1251,6.3
"08043",8,43,2009,19981,18279,1702,8.5
"08043",8,43,2010,15825,13973,1852,11.7
"08043",8,43,2011,15916,14005,1911,12
"08043",8,43,2012,15633,13810,1823,11.7
"08043",8,43,2013,14946,13349,1597,10.7
"08043",8,43,2014,14520,13328,1192,8.2
"08043",8,43,2015,14497,13602,895,6.2
"08043",8,43,2016,14704,13946,758,5.2
"08043",8,43,2017,15084,14437,647,4.3
"08045",8,45,1990,16707,16016,691,4.1
"08045",8,45,1991,17147,15939,1208,7
"08045",8,45,1992,17149,15627,1522,8.9
"08045",8,45,1993,18223,17059,1164,6.4
"08045",8,45,1994,19825,19019,806,4.1
"08045",8,45,1995,20714,19904,810,3.9
"08045",8,45,1996,21040,20073,967,4.6
"08045",8,45,1997,21610,20764,846,3.9
"08045",8,45,1998,22900,22021,879,3.8
"08045",8,45,1999,23719,23019,700,3
"08045",8,45,2000,24755,24087,668,2.7
"08045",8,45,2001,25581,24767,814,3.2
"08045",8,45,2002,26784,25594,1190,4.4
"08045",8,45,2003,26980,25668,1312,4.9
"08045",8,45,2004,28216,27034,1182,4.2
"08045",8,45,2005,29793,28683,1110,3.7
"08045",8,45,2006,33227,32244,983,3
"08045",8,45,2007,34945,34088,857,2.5
"08045",8,45,2008,36753,35610,1143,3.1
"08045",8,45,2009,34688,32275,2413,7
"08045",8,45,2010,31357,28115,3242,10.3
"08045",8,45,2011,31376,28404,2972,9.5
"08045",8,45,2012,31490,28813,2677,8.5
"08045",8,45,2013,30944,28635,2309,7.5
"08045",8,45,2014,31148,29508,1640,5.3
"08045",8,45,2015,30458,29194,1264,4.1
"08045",8,45,2016,30987,29909,1078,3.5
"08045",8,45,2017,31778,30863,915,2.9
"08047",8,47,1990,2391,2332,59,2.5
"08047",8,47,1991,2753,2666,87,3.2
"08047",8,47,1992,2815,2676,139,4.9
"08047",8,47,1993,3280,3148,132,4
"08047",8,47,1994,3067,2986,81,2.6
"08047",8,47,1995,3477,3394,83,2.4
"08047",8,47,1996,3256,3162,94,2.9
"08047",8,47,1997,3186,3111,75,2.4
"08047",8,47,1998,3230,3118,112,3.5
"08047",8,47,1999,3374,3296,78,2.3
"08047",8,47,2000,3308,3225,83,2.5
"08047",8,47,2001,3235,3123,112,3.5
"08047",8,47,2002,3245,3084,161,5
"08047",8,47,2003,3297,3107,190,5.8
"08047",8,47,2004,3310,3132,178,5.4
"08047",8,47,2005,3337,3177,160,4.8
"08047",8,47,2006,3406,3269,137,4
"08047",8,47,2007,3414,3295,119,3.5
"08047",8,47,2008,3469,3323,146,4.2
"08047",8,47,2009,3675,3453,222,6
"08047",8,47,2010,3327,3060,267,8
"08047",8,47,2011,3269,3033,236,7.2
"08047",8,47,2012,3267,3049,218,6.7
"08047",8,47,2013,3314,3115,199,6
"08047",8,47,2014,3447,3296,151,4.4
"08047",8,47,2015,3397,3291,106,3.1
"08047",8,47,2016,3483,3400,83,2.4
"08047",8,47,2017,3594,3521,73,2
"08049",8,49,1990,4317,4182,135,3.1
"08049",8,49,1991,4488,4317,171,3.8
"08049",8,49,1992,4676,4398,278,5.9
"08049",8,49,1993,4936,4683,253,5.1
"08049",8,49,1994,5120,4954,166,3.2
"08049",8,49,1995,5483,5321,162,3
"08049",8,49,1996,5656,5474,182,3.2
"08049",8,49,1997,5776,5605,171,3
"08049",8,49,1998,6137,5970,167,2.7
"08049",8,49,1999,6196,6048,148,2.4
"08049",8,49,2000,7627,7438,189,2.5
"08049",8,49,2001,8035,7797,238,3
"08049",8,49,2002,8432,8126,306,3.6
"08049",8,49,2003,8417,8072,345,4.1
"08049",8,49,2004,8491,8142,349,4.1
"08049",8,49,2005,8387,8047,340,4.1
"08049",8,49,2006,8773,8488,285,3.2
"08049",8,49,2007,9158,8920,238,2.6
"08049",8,49,2008,9147,8809,338,3.7
"08049",8,49,2009,9052,8448,604,6.7
"08049",8,49,2010,8950,8165,785,8.8
"08049",8,49,2011,8795,8087,708,8.1
"08049",8,49,2012,8747,8113,634,7.2
"08049",8,49,2013,8769,8257,512,5.8
"08049",8,49,2014,8923,8564,359,4
"08049",8,49,2015,9051,8759,292,3.2
"08049",8,49,2016,9186,8940,246,2.7
"08049",8,49,2017,9598,9383,215,2.2
"08051",8,51,1990,6007,5562,445,7.4
"08051",8,51,1991,5932,5484,448,7.6
"08051",8,51,1992,6402,5895,507,7.9
"08051",8,51,1993,6935,6500,435,6.3
"08051",8,51,1994,7587,7152,435,5.7
"08051",8,51,1995,7885,7404,481,6.1
"08051",8,51,1996,7787,7304,483,6.2
"08051",8,51,1997,8002,7591,411,5.1
"08051",8,51,1998,8423,7950,473,5.6
"08051",8,51,1999,8310,7894,416,5
"08051",8,51,2000,8183,7957,226,2.8
"08051",8,51,2001,8333,8061,272,3.3
"08051",8,51,2002,8548,8196,352,4.1
"08051",8,51,2003,8357,7964,393,4.7
"08051",8,51,2004,8716,8358,358,4.1
"08051",8,51,2005,9008,8655,353,3.9
"08051",8,51,2006,9514,9215,299,3.1
"08051",8,51,2007,9522,9254,268,2.8
"08051",8,51,2008,9503,9162,341,3.6
"08051",8,51,2009,9427,8915,512,5.4
"08051",8,51,2010,10087,9439,648,6.4
"08051",8,51,2011,9935,9336,599,6
"08051",8,51,2012,9832,9244,588,6
"08051",8,51,2013,9635,9108,527,5.5
"08051",8,51,2014,9667,9276,391,4
"08051",8,51,2015,9787,9498,289,3
"08051",8,51,2016,10133,9901,232,2.3
"08051",8,51,2017,10714,10500,214,2
"08053",8,53,1990,404,394,10,2.5
"08053",8,53,1991,422,413,9,2.1
"08053",8,53,1992,466,435,31,6.7
"08053",8,53,1993,525,502,23,4.4
"08053",8,53,1994,563,546,17,3
"08053",8,53,1995,611,601,10,1.6
"08053",8,53,1996,587,578,9,1.5
"08053",8,53,1997,611,598,13,2.1
"08053",8,53,1998,641,630,11,1.7
"08053",8,53,1999,640,624,16,2.5
"08053",8,53,2000,651,638,13,2
"08053",8,53,2001,649,627,22,3.4
"08053",8,53,2002,626,603,23,3.7
"08053",8,53,2003,610,585,25,4.1
"08053",8,53,2004,603,583,20,3.3
"08053",8,53,2005,597,580,17,2.8
"08053",8,53,2006,618,599,19,3.1
"08053",8,53,2007,608,591,17,2.8
"08053",8,53,2008,643,622,21,3.3
"08053",8,53,2009,665,644,21,3.2
"08053",8,53,2010,470,443,27,5.7
"08053",8,53,2011,473,449,24,5.1
"08053",8,53,2012,436,415,21,4.8
"08053",8,53,2013,432,412,20,4.6
"08053",8,53,2014,434,418,16,3.7
"08053",8,53,2015,440,427,13,3
"08053",8,53,2016,447,436,11,2.5
"08053",8,53,2017,492,481,11,2.2
"08055",8,55,1990,2532,2327,205,8.1
"08055",8,55,1991,2520,2322,198,7.9
"08055",8,55,1992,2626,2367,259,9.9
"08055",8,55,1993,2850,2603,247,8.7
"08055",8,55,1994,3040,2832,208,6.8
"08055",8,55,1995,3195,2982,213,6.7
"08055",8,55,1996,3371,3148,223,6.6
"08055",8,55,1997,3748,3546,202,5.4
"08055",8,55,1998,4143,3877,266,6.4
"08055",8,55,1999,3785,3569,216,5.7
"08055",8,55,2000,3079,2906,173,5.6
"08055",8,55,2001,3198,2995,203,6.3
"08055",8,55,2002,3527,3276,251,7.1
"08055",8,55,2003,3354,3073,281,8.4
"08055",8,55,2004,3287,3021,266,8.1
"08055",8,55,2005,3257,3005,252,7.7
"08055",8,55,2006,3371,3168,203,6
"08055",8,55,2007,3353,3194,159,4.7
"08055",8,55,2008,3435,3215,220,6.4
"08055",8,55,2009,3489,3185,304,8.7
"08055",8,55,2010,2705,2327,378,14
"08055",8,55,2011,2659,2298,361,13.6
"08055",8,55,2012,2634,2259,375,14.2
"08055",8,55,2013,2541,2193,348,13.7
"08055",8,55,2014,2409,2168,241,10
"08055",8,55,2015,2369,2186,183,7.7
"08055",8,55,2016,2501,2343,158,6.3
"08055",8,55,2017,2580,2432,148,5.7
"08057",8,57,1990,886,860,26,2.9
"08057",8,57,1991,903,853,50,5.5
"08057",8,57,1992,966,904,62,6.4
"08057",8,57,1993,1103,1031,72,6.5
"08057",8,57,1994,987,915,72,7.3
"08057",8,57,1995,923,859,64,6.9
"08057",8,57,1996,899,839,60,6.7
"08057",8,57,1997,918,861,57,6.2
"08057",8,57,1998,950,896,54,5.7
"08057",8,57,1999,923,877,46,5
"08057",8,57,2000,885,860,25,2.8
"08057",8,57,2001,1037,1001,36,3.5
"08057",8,57,2002,1094,1044,50,4.6
"08057",8,57,2003,1074,1020,54,5
"08057",8,57,2004,1111,1072,39,3.5
"08057",8,57,2005,1135,1090,45,4
"08057",8,57,2006,1108,1076,32,2.9
"08057",8,57,2007,1103,1075,28,2.5
"08057",8,57,2008,1082,1047,35,3.2
"08057",8,57,2009,1293,1240,53,4.1
"08057",8,57,2010,919,838,81,8.8
"08057",8,57,2011,893,839,54,6
"08057",8,57,2012,826,783,43,5.2
"08057",8,57,2013,793,755,38,4.8
"08057",8,57,2014,834,804,30,3.6
"08057",8,57,2015,834,803,31,3.7
"08057",8,57,2016,891,867,24,2.7
"08057",8,57,2017,963,946,17,1.8
"08059",8,59,1990,255424,245533,9891,3.9
"08059",8,59,1991,257348,247267,10081,3.9
"08059",8,59,1992,261372,249252,12120,4.6
"08059",8,59,1993,272607,261038,11569,4.2
"08059",8,59,1994,286429,276717,9712,3.4
"08059",8,59,1995,295754,286558,9196,3.1
"08059",8,59,1996,296417,286197,10220,3.4
"08059",8,59,1997,302505,294630,7875,2.6
"08059",8,59,1998,312052,303872,8180,2.6
"08059",8,59,1999,315872,308617,7255,2.3
"08059",8,59,2000,309348,302024,7324,2.4
"08059",8,59,2001,304238,293787,10451,3.4
"08059",8,59,2002,303309,287269,16040,5.3
"08059",8,59,2003,305664,288127,17537,5.7
"08059",8,59,2004,305347,289174,16173,5.3
"08059",8,59,2005,304514,289606,14908,4.9
"08059",8,59,2006,304252,291546,12706,4.2
"08059",8,59,2007,303357,292287,11070,3.6
"08059",8,59,2008,307854,293431,14423,4.7
"08059",8,59,2009,303936,282267,21669,7.1
"08059",8,59,2010,304252,278790,25462,8.4
"08059",8,59,2011,302402,278353,24049,8
"08059",8,59,2012,304298,281809,22489,7.4
"08059",8,59,2013,305200,286109,19091,6.3
"08059",8,59,2014,307385,293395,13990,4.6
"08059",8,59,2015,308750,297859,10891,3.5
"08059",8,59,2016,315268,305993,9275,2.9
"08059",8,59,2017,325390,316839,8551,2.6
"08061",8,61,1990,798,777,21,2.6
"08061",8,61,1991,793,760,33,4.2
"08061",8,61,1992,815,778,37,4.5
"08061",8,61,1993,830,814,16,1.9
"08061",8,61,1994,852,838,14,1.6
"08061",8,61,1995,883,864,19,2.2
"08061",8,61,1996,842,823,19,2.3
"08061",8,61,1997,881,866,15,1.7
"08061",8,61,1998,901,880,21,2.3
"08061",8,61,1999,859,822,37,4.3
"08061",8,61,2000,782,758,24,3.1
"08061",8,61,2001,936,910,26,2.8
"08061",8,61,2002,959,921,38,4
"08061",8,61,2003,865,821,44,5.1
"08061",8,61,2004,901,855,46,5.1
"08061",8,61,2005,877,841,36,4.1
"08061",8,61,2006,888,858,30,3.4
"08061",8,61,2007,911,887,24,2.6
"08061",8,61,2008,849,818,31,3.7
"08061",8,61,2009,1001,959,42,4.2
"08061",8,61,2010,779,729,50,6.4
"08061",8,61,2011,836,794,42,5
"08061",8,61,2012,817,780,37,4.5
"08061",8,61,2013,764,730,34,4.5
"08061",8,61,2014,751,726,25,3.3
"08061",8,61,2015,791,770,21,2.7
"08061",8,61,2016,846,829,17,2
"08061",8,61,2017,942,925,17,1.8
"08063",8,63,1990,3320,3279,41,1.2
"08063",8,63,1991,3227,3156,71,2.2
"08063",8,63,1992,3259,3114,145,4.4
"08063",8,63,1993,3272,3150,122,3.7
"08063",8,63,1994,3320,3224,96,2.9
"08063",8,63,1995,3435,3334,101,2.9
"08063",8,63,1996,3528,3402,126,3.6
"08063",8,63,1997,3582,3491,91,2.5
"08063",8,63,1998,3762,3674,88,2.3
"08063",8,63,1999,3786,3698,88,2.3
"08063",8,63,2000,3846,3747,99,2.6
"08063",8,63,2001,4307,4201,106,2.5
"08063",8,63,2002,4528,4385,143,3.2
"08063",8,63,2003,4241,4060,181,4.3
"08063",8,63,2004,4300,4151,149,3.5
"08063",8,63,2005,4341,4193,148,3.4
"08063",8,63,2006,4485,4349,136,3
"08063",8,63,2007,4475,4355,120,2.7
"08063",8,63,2008,4348,4202,146,3.4
"08063",8,63,2009,4860,4670,190,3.9
"08063",8,63,2010,4389,4190,199,4.5
"08063",8,63,2011,4265,4065,200,4.7
"08063",8,63,2012,4229,4041,188,4.4
"08063",8,63,2013,4081,3921,160,3.9
"08063",8,63,2014,4309,4178,131,3
"08063",8,63,2015,4319,4215,104,2.4
"08063",8,63,2016,4537,4441,96,2.1
"08063",8,63,2017,4606,4522,84,1.8
"08065",8,65,1990,2826,2651,175,6.2
"08065",8,65,1991,2876,2673,203,7.1
"08065",8,65,1992,2962,2658,304,10.3
"08065",8,65,1993,3022,2684,338,11.2
"08065",8,65,1994,3086,2896,190,6.2
"08065",8,65,1995,3131,2980,151,4.8
"08065",8,65,1996,3173,2968,205,6.5
"08065",8,65,1997,3240,3081,159,4.9
"08065",8,65,1998,3311,3126,185,5.6
"08065",8,65,1999,3265,3094,171,5.2
"08065",8,65,2000,4043,3907,136,3.4
"08065",8,65,2001,3991,3832,159,4
"08065",8,65,2002,4010,3777,233,5.8
"08065",8,65,2003,3791,3562,229,6
"08065",8,65,2004,3889,3672,217,5.6
"08065",8,65,2005,3925,3732,193,4.9
"08065",8,65,2006,4019,3849,170,4.2
"08065",8,65,2007,4028,3884,144,3.6
"08065",8,65,2008,4101,3913,188,4.6
"08065",8,65,2009,3904,3570,334,8.6
"08065",8,65,2010,4372,3891,481,11
"08065",8,65,2011,4377,3936,441,10.1
"08065",8,65,2012,4523,4133,390,8.6
"08065",8,65,2013,4440,4120,320,7.2
"08065",8,65,2014,4503,4294,209,4.6
"08065",8,65,2015,4566,4389,177,3.9
"08065",8,65,2016,4615,4484,131,2.8
"08065",8,65,2017,4731,4629,102,2.2
"08067",8,67,1990,17396,16358,1038,6
"08067",8,67,1991,18294,17156,1138,6.2
"08067",8,67,1992,19230,17919,1311,6.8
"08067",8,67,1993,20434,19225,1209,5.9
"08067",8,67,1994,22250,21298,952,4.3
"08067",8,67,1995,23531,22477,1054,4.5
"08067",8,67,1996,24108,22933,1175,4.9
"08067",8,67,1997,24461,23311,1150,4.7
"08067",8,67,1998,25212,23984,1228,4.9
"08067",8,67,1999,25083,24069,1014,4
"08067",8,67,2000,24459,23753,706,2.9
"08067",8,67,2001,25039,24235,804,3.2
"08067",8,67,2002,26356,25320,1036,3.9
"08067",8,67,2003,26612,25447,1165,4.4
"08067",8,67,2004,28238,27094,1144,4.1
"08067",8,67,2005,29763,28637,1126,3.8
"08067",8,67,2006,30309,29290,1019,3.4
"08067",8,67,2007,31007,30143,864,2.8
"08067",8,67,2008,31427,30294,1133,3.6
"08067",8,67,2009,31317,29632,1685,5.4
"08067",8,67,2010,29874,27744,2130,7.1
"08067",8,67,2011,29476,27408,2068,7
"08067",8,67,2012,29663,27693,1970,6.6
"08067",8,67,2013,29559,27873,1686,5.7
"08067",8,67,2014,29894,28634,1260,4.2
"08067",8,67,2015,29848,28819,1029,3.4
"08067",8,67,2016,30979,30093,886,2.9
"08067",8,67,2017,31713,30936,777,2.5
"08069",8,69,1990,103854,98713,5141,5
"08069",8,69,1991,106820,101691,5129,4.8
"08069",8,69,1992,109692,104070,5622,5.1
"08069",8,69,1993,116475,111237,5238,4.5
"08069",8,69,1994,123408,118921,4487,3.6
"08069",8,69,1995,129548,124664,4884,3.8
"08069",8,69,1996,134869,129675,5194,3.9
"08069",8,69,1997,137688,133031,4657,3.4
"08069",8,69,1998,144665,139454,5211,3.6
"08069",8,69,1999,145724,140987,4737,3.3
"08069",8,69,2000,146317,142656,3661,2.5
"08069",8,69,2001,149756,144961,4795,3.2
"08069",8,69,2002,154430,147361,7069,4.6
"08069",8,69,2003,159187,151297,7890,5
"08069",8,69,2004,163742,156259,7483,4.6
"08069",8,69,2005,165944,158693,7251,4.4
"08069",8,69,2006,169350,162695,6655,3.9
"08069",8,69,2007,172024,166224,5800,3.4
"08069",8,69,2008,175517,168090,7427,4.2
"08069",8,69,2009,176900,165822,11078,6.3
"08069",8,69,2010,170001,157025,12976,7.6
"08069",8,69,2011,170942,158704,12238,7.2
"08069",8,69,2012,172883,161287,11596,6.7
"08069",8,69,2013,174165,164046,10119,5.8
"08069",8,69,2014,176951,169412,7539,4.3
"08069",8,69,2015,180520,174549,5971,3.3
"08069",8,69,2016,187311,182079,5232,2.8
"08069",8,69,2017,195084,190337,4747,2.4
"08071",8,71,1990,5508,5050,458,8.3
"08071",8,71,1991,5443,5059,384,7.1
"08071",8,71,1992,5522,4939,583,10.6
"08071",8,71,1993,5751,5289,462,8
"08071",8,71,1994,6162,5855,307,5
"08071",8,71,1995,6497,6168,329,5.1
"08071",8,71,1996,6581,5942,639,9.7
"08071",8,71,1997,6547,6100,447,6.8
"08071",8,71,1998,7030,6611,419,6
"08071",8,71,1999,6899,6522,377,5.5
"08071",8,71,2000,6680,6401,279,4.2
"08071",8,71,2001,7151,6825,326,4.6
"08071",8,71,2002,7824,7435,389,5
"08071",8,71,2003,7847,7385,462,5.9
"08071",8,71,2004,7980,7551,429,5.4
"08071",8,71,2005,8121,7713,408,5
"08071",8,71,2006,8456,8114,342,4
"08071",8,71,2007,8695,8381,314,3.6
"08071",8,71,2008,8795,8399,396,4.5
"08071",8,71,2009,8618,7917,701,8.1
"08071",8,71,2010,7195,6432,763,10.6
"08071",8,71,2011,6977,6208,769,11
"08071",8,71,2012,6963,6127,836,12
"08071",8,71,2013,6734,5983,751,11.2
"08071",8,71,2014,6420,5936,484,7.5
"08071",8,71,2015,6126,5782,344,5.6
"08071",8,71,2016,6186,5874,312,5
"08071",8,71,2017,6277,6023,254,4
"08073",8,73,1990,2212,2152,60,2.7
"08073",8,73,1991,2445,2367,78,3.2
"08073",8,73,1992,2519,2414,105,4.2
"08073",8,73,1993,2499,2397,102,4.1
"08073",8,73,1994,2529,2465,64,2.5
"08073",8,73,1995,2595,2533,62,2.4
"08073",8,73,1996,2581,2523,58,2.2
"08073",8,73,1997,2647,2597,50,1.9
"08073",8,73,1998,2674,2629,45,1.7
"08073",8,73,1999,2714,2671,43,1.6
"08073",8,73,2000,2625,2552,73,2.8
"08073",8,73,2001,2901,2814,87,3
"08073",8,73,2002,3065,2949,116,3.8
"08073",8,73,2003,3001,2870,131,4.4
"08073",8,73,2004,3040,2914,126,4.1
"08073",8,73,2005,3025,2902,123,4.1
"08073",8,73,2006,3059,2950,109,3.6
"08073",8,73,2007,3014,2922,92,3.1
"08073",8,73,2008,2890,2783,107,3.7
"08073",8,73,2009,3108,2980,128,4.1
"08073",8,73,2010,2153,2024,129,6
"08073",8,73,2011,2193,2054,139,6.3
"08073",8,73,2012,2157,2017,140,6.5
"08073",8,73,2013,2105,1982,123,5.8
"08073",8,73,2014,2132,2045,87,4.1
"08073",8,73,2015,2169,2095,74,3.4
"08073",8,73,2016,2279,2221,58,2.5
"08073",8,73,2017,2404,2353,51,2.1
"08075",8,75,1990,8765,8456,309,3.5
"08075",8,75,1991,8454,7998,456,5.4
"08075",8,75,1992,8405,7948,457,5.4
"08075",8,75,1993,8555,8210,345,4
"08075",8,75,1994,9243,8963,280,3
"08075",8,75,1995,10037,9714,323,3.2
"08075",8,75,1996,10008,9638,370,3.7
"08075",8,75,1997,10025,9656,369,3.7
"08075",8,75,1998,10251,9682,569,5.6
"08075",8,75,1999,10222,9868,354,3.5
"08075",8,75,2000,10004,9718,286,2.9
"08075",8,75,2001,10725,10387,338,3.2
"08075",8,75,2002,11206,10795,411,3.7
"08075",8,75,2003,10886,10433,453,4.2
"08075",8,75,2004,10748,10289,459,4.3
"08075",8,75,2005,10613,10189,424,4
"08075",8,75,2006,11129,10745,384,3.5
"08075",8,75,2007,11321,10975,346,3.1
"08075",8,75,2008,11200,10767,433,3.9
"08075",8,75,2009,12031,11434,597,5
"08075",8,75,2010,11261,10551,710,6.3
"08075",8,75,2011,11081,10388,693,6.3
"08075",8,75,2012,11067,10405,662,6
"08075",8,75,2013,10798,10245,553,5.1
"08075",8,75,2014,10988,10571,417,3.8
"08075",8,75,2015,10928,10595,333,3
"08075",8,75,2016,11012,10690,322,2.9
"08075",8,75,2017,11213,10950,263,2.3
"08077",8,77,1990,44712,42012,2700,6
"08077",8,77,1991,46428,43273,3155,6.8
"08077",8,77,1992,48028,44268,3760,7.8
"08077",8,77,1993,49874,46379,3495,7
"08077",8,77,1994,51864,48950,2914,5.6
"08077",8,77,1995,54526,51622,2904,5.3
"08077",8,77,1996,55748,52724,3024,5.4
"08077",8,77,1997,57738,55069,2669,4.6
"08077",8,77,1998,60136,57305,2831,4.7
"08077",8,77,1999,60750,58335,2415,4
"08077",8,77,2000,58884,56921,1963,3.3
"08077",8,77,2001,60299,57983,2316,3.8
"08077",8,77,2002,63796,60717,3079,4.8
"08077",8,77,2003,66826,63199,3627,5.4
"08077",8,77,2004,69349,65636,3713,5.4
"08077",8,77,2005,70811,67350,3461,4.9
"08077",8,77,2006,74156,71219,2937,4
"08077",8,77,2007,77873,75412,2461,3.2
"08077",8,77,2008,81800,78618,3182,3.9
"08077",8,77,2009,82067,75199,6868,8.4
"08077",8,77,2010,76113,67776,8337,11
"08077",8,77,2011,75475,67738,7737,10.3
"08077",8,77,2012,74945,67680,7265,9.7
"08077",8,77,2013,73542,67108,6434,8.7
"08077",8,77,2014,73160,68598,4562,6.2
"08077",8,77,2015,71779,67806,3973,5.5
"08077",8,77,2016,72087,68263,3824,5.3
"08077",8,77,2017,73877,70937,2940,4
"08079",8,79,1990,299,278,21,7
"08079",8,79,1991,316,303,13,4.1
"08079",8,79,1992,355,330,25,7
"08079",8,79,1993,379,355,24,6.3
"08079",8,79,1994,379,344,35,9.2
"08079",8,79,1995,397,364,33,8.3
"08079",8,79,1996,405,372,33,8.1
"08079",8,79,1997,422,403,19,4.5
"08079",8,79,1998,452,432,20,4.4
"08079",8,79,1999,436,423,13,3
"08079",8,79,2000,419,404,15,3.6
"08079",8,79,2001,428,412,16,3.7
"08079",8,79,2002,433,414,19,4.4
"08079",8,79,2003,445,423,22,4.9
"08079",8,79,2004,470,448,22,4.7
"08079",8,79,2005,459,436,23,5
"08079",8,79,2006,453,431,22,4.9
"08079",8,79,2007,471,451,20,4.2
"08079",8,79,2008,475,449,26,5.5
"08079",8,79,2009,479,447,32,6.7
"08079",8,79,2010,416,387,29,7
"08079",8,79,2011,426,403,23,5.4
"08079",8,79,2012,444,420,24,5.4
"08079",8,79,2013,425,400,25,5.9
"08079",8,79,2014,424,403,21,5
"08079",8,79,2015,445,429,16,3.6
"08079",8,79,2016,463,453,10,2.2
"08079",8,79,2017,453,444,9,2
"08081",8,81,1990,5930,5589,341,5.8
"08081",8,81,1991,5983,5569,414,6.9
"08081",8,81,1992,6180,5657,523,8.5
"08081",8,81,1993,6247,5786,461,7.4
"08081",8,81,1994,6370,5986,384,6
"08081",8,81,1995,6857,6463,394,5.7
"08081",8,81,1996,6703,6283,420,6.3
"08081",8,81,1997,6682,6309,373,5.6
"08081",8,81,1998,6599,6215,384,5.8
"08081",8,81,1999,6465,6090,375,5.8
"08081",8,81,2000,7000,6750,250,3.6
"08081",8,81,2001,7298,7014,284,3.9
"08081",8,81,2002,7665,7298,367,4.8
"08081",8,81,2003,7545,7116,429,5.7
"08081",8,81,2004,7697,7320,377,4.9
"08081",8,81,2005,7832,7484,348,4.4
"08081",8,81,2006,8350,8036,314,3.8
"08081",8,81,2007,8521,8260,261,3.1
"08081",8,81,2008,8726,8394,332,3.8
"08081",8,81,2009,9077,8513,564,6.2
"08081",8,81,2010,8078,7277,801,9.9
"08081",8,81,2011,7861,7130,731,9.3
"08081",8,81,2012,7743,7104,639,8.3
"08081",8,81,2013,7535,7013,522,6.9
"08081",8,81,2014,7301,6880,421,5.8
"08081",8,81,2015,7104,6781,323,4.5
"08081",8,81,2016,7180,6896,284,4
"08081",8,81,2017,7375,7130,245,3.3
"08083",8,83,1990,9239,8554,685,7.4
"08083",8,83,1991,9387,8603,784,8.4
"08083",8,83,1992,9938,8964,974,9.8
"08083",8,83,1993,10669,9851,818,7.7
"08083",8,83,1994,11032,10281,751,6.8
"08083",8,83,1995,11411,10636,775,6.8
"08083",8,83,1996,11530,10721,809,7
"08083",8,83,1997,11453,10645,808,7.1
"08083",8,83,1998,12095,11307,788,6.5
"08083",8,83,1999,12125,11488,637,5.3
"08083",8,83,2000,11807,11311,496,4.2
"08083",8,83,2001,11863,11342,521,4.4
"08083",8,83,2002,12435,11763,672,5.4
"08083",8,83,2003,12283,11577,706,5.7
"08083",8,83,2004,12587,11900,687,5.5
"08083",8,83,2005,12859,12188,671,5.2
"08083",8,83,2006,13163,12582,581,4.4
"08083",8,83,2007,13172,12664,508,3.9
"08083",8,83,2008,12902,12228,674,5.2
"08083",8,83,2009,13270,12297,973,7.3
"08083",8,83,2010,13057,11867,1190,9.1
"08083",8,83,2011,12986,11850,1136,8.7
"08083",8,83,2012,12917,11813,1104,8.5
"08083",8,83,2013,12713,11730,983,7.7
"08083",8,83,2014,12646,11876,770,6.1
"08083",8,83,2015,12335,11634,701,5.7
"08083",8,83,2016,12723,12093,630,5
"08083",8,83,2017,12998,12478,520,4
"08085",8,85,1990,11664,10916,748,6.4
"08085",8,85,1991,11992,11064,928,7.7
"08085",8,85,1992,12462,11463,999,8
"08085",8,85,1993,12941,12178,763,5.9
"08085",8,85,1994,14166,13451,715,5
"08085",8,85,1995,14899,14059,840,5.6
"08085",8,85,1996,15081,13986,1095,7.3
"08085",8,85,1997,15649,14759,890,5.7
"08085",8,85,1998,16026,15015,1011,6.3
"08085",8,85,1999,15980,15083,897,5.6
"08085",8,85,2000,16215,15615,600,3.7
"08085",8,85,2001,16922,16180,742,4.4
"08085",8,85,2002,17835,16882,953,5.3
"08085",8,85,2003,18219,17168,1051,5.8
"08085",8,85,2004,19104,18100,1004,5.3
"08085",8,85,2005,19741,18813,928,4.7
"08085",8,85,2006,20286,19474,812,4
"08085",8,85,2007,20744,20003,741,3.6
"08085",8,85,2008,20767,19728,1039,5
"08085",8,85,2009,21101,19391,1710,8.1
"08085",8,85,2010,20624,18360,2264,11
"08085",8,85,2011,20017,17805,2212,11.1
"08085",8,85,2012,19836,17787,2049,10.3
"08085",8,85,2013,19297,17474,1823,9.4
"08085",8,85,2014,19254,17947,1307,6.8
"08085",8,85,2015,19321,18346,975,5
"08085",8,85,2016,20064,19237,827,4.1
"08085",8,85,2017,20925,20234,691,3.3
"08087",8,87,1990,10313,9845,468,4.5
"08087",8,87,1991,10929,10431,498,4.6
"08087",8,87,1992,11261,10684,577,5.1
"08087",8,87,1993,11811,11353,458,3.9
"08087",8,87,1994,12487,11980,507,4.1
"08087",8,87,1995,13101,12652,449,3.4
"08087",8,87,1996,12957,12460,497,3.8
"08087",8,87,1997,13414,12974,440,3.3
"08087",8,87,1998,13609,13070,539,4
"08087",8,87,1999,13157,12728,429,3.3
"08087",8,87,2000,12549,12168,381,3
"08087",8,87,2001,13313,12888,425,3.2
"08087",8,87,2002,14043,13471,572,4.1
"08087",8,87,2003,14134,13472,662,4.7
"08087",8,87,2004,14304,13663,641,4.5
"08087",8,87,2005,14282,13675,607,4.3
"08087",8,87,2006,14345,13789,556,3.9
"08087",8,87,2007,14221,13746,475,3.3
"08087",8,87,2008,14083,13485,598,4.2
"08087",8,87,2009,15084,14272,812,5.4
"08087",8,87,2010,14436,13423,1013,7
"08087",8,87,2011,15043,14040,1003,6.7
"08087",8,87,2012,14981,13967,1014,6.8
"08087",8,87,2013,14659,13702,957,6.5
"08087",8,87,2014,14796,14116,680,4.6
"08087",8,87,2015,14663,14106,557,3.8
"08087",8,87,2016,15035,14518,517,3.4
"08087",8,87,2017,15716,15332,384,2.4
"08089",8,89,1990,8468,7857,611,7.2
"08089",8,89,1991,8473,7899,574,6.8
"08089",8,89,1992,8355,7734,621,7.4
"08089",8,89,1993,8387,7874,513,6.1
"08089",8,89,1994,8634,8144,490,5.7
"08089",8,89,1995,9052,8571,481,5.3
"08089",8,89,1996,9170,8617,553,6
"08089",8,89,1997,9161,8689,472,5.2
"08089",8,89,1998,9269,8757,512,5.5
"08089",8,89,1999,9091,8639,452,5
"08089",8,89,2000,8821,8437,384,4.4
"08089",8,89,2001,9069,8648,421,4.6
"08089",8,89,2002,9549,8992,557,5.8
"08089",8,89,2003,9267,8675,592,6.4
"08089",8,89,2004,9318,8756,562,6
"08089",8,89,2005,9323,8730,593,6.4
"08089",8,89,2006,9326,8761,565,6.1
"08089",8,89,2007,8813,8374,439,5
"08089",8,89,2008,8705,8189,516,5.9
"08089",8,89,2009,9306,8670,636,6.8
"08089",8,89,2010,8489,7710,779,9.2
"08089",8,89,2011,8473,7629,844,10
"08089",8,89,2012,8401,7538,863,10.3
"08089",8,89,2013,8207,7399,808,9.8
"08089",8,89,2014,7963,7355,608,7.6
"08089",8,89,2015,7880,7423,457,5.8
"08089",8,89,2016,8113,7732,381,4.7
"08089",8,89,2017,8352,8006,346,4.1
"08091",8,91,1990,1234,1112,122,9.9
"08091",8,91,1991,1252,1160,92,7.3
"08091",8,91,1992,1314,1213,101,7.7
"08091",8,91,1993,1392,1325,67,4.8
"08091",8,91,1994,1563,1498,65,4.2
"08091",8,91,1995,1692,1609,83,4.9
"08091",8,91,1996,1706,1602,104,6.1
"08091",8,91,1997,1785,1694,91,5.1
"08091",8,91,1998,1844,1749,95,5.2
"08091",8,91,1999,1874,1802,72,3.8
"08091",8,91,2000,2198,2140,58,2.6
"08091",8,91,2001,2335,2266,69,3
"08091",8,91,2002,2444,2347,97,4
"08091",8,91,2003,2442,2335,107,4.4
"08091",8,91,2004,2677,2571,106,4
"08091",8,91,2005,2934,2833,101,3.4
"08091",8,91,2006,3009,2915,94,3.1
"08091",8,91,2007,3051,2962,89,2.9
"08091",8,91,2008,3017,2906,111,3.7
"08091",8,91,2009,2902,2739,163,5.6
"08091",8,91,2010,2151,1940,211,9.8
"08091",8,91,2011,2023,1817,206,10.2
"08091",8,91,2012,2085,1890,195,9.4
"08091",8,91,2013,2128,1966,162,7.6
"08091",8,91,2014,2132,2009,123,5.8
"08091",8,91,2015,2153,2060,93,4.3
"08091",8,91,2016,2165,2084,81,3.7
"08091",8,91,2017,2291,2225,66,2.9
"08093",8,93,1990,4529,4356,173,3.8
"08093",8,93,1991,4705,4503,202,4.3
"08093",8,93,1992,4939,4603,336,6.8
"08093",8,93,1993,5613,5286,327,5.8
"08093",8,93,1994,6578,6299,279,4.2
"08093",8,93,1995,7630,7332,298,3.9
"08093",8,93,1996,7584,7240,344,4.5
"08093",8,93,1997,7688,7418,270,3.5
"08093",8,93,1998,8194,7901,293,3.6
"08093",8,93,1999,8303,8041,262,3.2
"08093",8,93,2000,8528,8310,218,2.6
"08093",8,93,2001,8711,8410,301,3.5
"08093",8,93,2002,9061,8595,466,5.1
"08093",8,93,2003,9363,8860,503,5.4
"08093",8,93,2004,9582,9072,510,5.3
"08093",8,93,2005,9638,9186,452,4.7
"08093",8,93,2006,9741,9357,384,3.9
"08093",8,93,2007,9602,9256,346,3.6
"08093",8,93,2008,9678,9217,461,4.8
"08093",8,93,2009,9336,8687,649,7
"08093",8,93,2010,9641,8856,785,8.1
"08093",8,93,2011,9406,8683,723,7.7
"08093",8,93,2012,9302,8662,640,6.9
"08093",8,93,2013,9252,8691,561,6.1
"08093",8,93,2014,9348,8918,430,4.6
"08093",8,93,2015,9365,9043,322,3.4
"08093",8,93,2016,9831,9558,273,2.8
"08093",8,93,2017,10153,9909,244,2.4
"08095",8,95,1990,1836,1808,28,1.5
"08095",8,95,1991,1726,1690,36,2.1
"08095",8,95,1992,1728,1667,61,3.5
"08095",8,95,1993,1796,1757,39,2.2
"08095",8,95,1994,1870,1838,32,1.7
"08095",8,95,1995,1980,1950,30,1.5
"08095",8,95,1996,1986,1944,42,2.1
"08095",8,95,1997,2054,2015,39,1.9
"08095",8,95,1998,2113,2063,50,2.4
"08095",8,95,1999,2105,2069,36,1.7
"08095",8,95,2000,2053,1999,54,2.6
"08095",8,95,2001,2377,2311,66,2.8
"08095",8,95,2002,2518,2439,79,3.1
"08095",8,95,2003,2352,2263,89,3.8
"08095",8,95,2004,2351,2267,84,3.6
"08095",8,95,2005,2277,2198,79,3.5
"08095",8,95,2006,2395,2314,81,3.4
"08095",8,95,2007,2420,2354,66,2.7
"08095",8,95,2008,2238,2162,76,3.4
"08095",8,95,2009,2607,2514,93,3.6
"08095",8,95,2010,2197,2081,116,5.3
"08095",8,95,2011,2154,2039,115,5.3
"08095",8,95,2012,2141,2031,110,5.1
"08095",8,95,2013,2124,2026,98,4.6
"08095",8,95,2014,2251,2177,74,3.3
"08095",8,95,2015,2356,2300,56,2.4
"08095",8,95,2016,2472,2423,49,2
"08095",8,95,2017,2597,2554,43,1.7
"08097",8,97,1990,8125,7688,437,5.4
"08097",8,97,1991,7653,7094,559,7.3
"08097",8,97,1992,7921,7230,691,8.7
"08097",8,97,1993,8572,8025,547,6.4
"08097",8,97,1994,9050,8623,427,4.7
"08097",8,97,1995,9082,8669,413,4.5
"08097",8,97,1996,9155,8740,415,4.5
"08097",8,97,1997,9438,9048,390,4.1
"08097",8,97,1998,9592,9197,395,4.1
"08097",8,97,1999,9271,8951,320,3.5
"08097",8,97,2000,9925,9651,274,2.8
"08097",8,97,2001,10195,9831,364,3.6
"08097",8,97,2002,10390,9921,469,4.5
"08097",8,97,2003,10192,9672,520,5.1
"08097",8,97,2004,10684,10164,520,4.9
"08097",8,97,2005,11083,10641,442,4
"08097",8,97,2006,11262,10909,353,3.1
"08097",8,97,2007,11271,10967,304,2.7
"08097",8,97,2008,11570,11188,382,3.3
"08097",8,97,2009,11141,10471,670,6
"08097",8,97,2010,10879,10000,879,8.1
"08097",8,97,2011,10926,10072,854,7.8
"08097",8,97,2012,10911,10126,785,7.2
"08097",8,97,2013,10782,10084,698,6.5
"08097",8,97,2014,11017,10480,537,4.9
"08097",8,97,2015,10734,10319,415,3.9
"08097",8,97,2016,10733,10373,360,3.4
"08097",8,97,2017,11032,10691,341,3.1
"08099",8,99,1990,6159,5816,343,5.6
"08099",8,99,1991,5917,5566,351,5.9
"08099",8,99,1992,5939,5568,371,6.2
"08099",8,99,1993,6024,5725,299,5
"08099",8,99,1994,6237,5995,242,3.9
"08099",8,99,1995,6496,6223,273,4.2
"08099",8,99,1996,6615,6335,280,4.2
"08099",8,99,1997,6868,6655,213,3.1
"08099",8,99,1998,7282,7015,267,3.7
"08099",8,99,1999,7266,7041,225,3.1
"08099",8,99,2000,6930,6729,201,2.9
"08099",8,99,2001,7212,6982,230,3.2
"08099",8,99,2002,7575,7280,295,3.9
"08099",8,99,2003,7221,6867,354,4.9
"08099",8,99,2004,7396,7072,324,4.4
"08099",8,99,2005,7437,7086,351,4.7
"08099",8,99,2006,6938,6535,403,5.8
"08099",8,99,2007,6790,6556,234,3.4
"08099",8,99,2008,6529,6236,293,4.5
"08099",8,99,2009,7008,6601,407,5.8
"08099",8,99,2010,6166,5736,430,7
"08099",8,99,2011,6242,5829,413,6.6
"08099",8,99,2012,6097,5671,426,7
"08099",8,99,2013,5857,5489,368,6.3
"08099",8,99,2014,5722,5454,268,4.7
"08099",8,99,2015,5811,5576,235,4
"08099",8,99,2016,6003,5810,193,3.2
"08099",8,99,2017,6216,6053,163,2.6
"08101",8,101,1990,52373,48542,3831,7.3
"08101",8,101,1991,52364,48257,4107,7.8
"08101",8,101,1992,53061,48116,4945,9.3
"08101",8,101,1993,53750,49285,4465,8.3
"08101",8,101,1994,55885,52621,3264,5.8
"08101",8,101,1995,57922,54588,3334,5.8
"08101",8,101,1996,58674,55168,3506,6
"08101",8,101,1997,60667,57618,3049,5
"08101",8,101,1998,64080,59464,4616,7.2
"08101",8,101,1999,62350,59183,3167,5.1
"08101",8,101,2000,63956,61428,2528,4
"08101",8,101,2001,64114,60806,3308,5.2
"08101",8,101,2002,66093,61506,4587,6.9
"08101",8,101,2003,68640,63637,5003,7.3
"08101",8,101,2004,69123,64060,5063,7.3
"08101",8,101,2005,69326,64606,4720,6.8
"08101",8,101,2006,70426,66466,3960,5.6
"08101",8,101,2007,71808,68431,3377,4.7
"08101",8,101,2008,73280,68823,4457,6.1
"08101",8,101,2009,74643,68533,6110,8.2
"08101",8,101,2010,74396,66667,7729,10.4
"08101",8,101,2011,75117,67211,7906,10.5
"08101",8,101,2012,74490,66523,7967,10.7
"08101",8,101,2013,73335,66114,7221,9.8
"08101",8,101,2014,72251,66970,5281,7.3
"08101",8,101,2015,71679,67632,4047,5.6
"08101",8,101,2016,73081,69600,3481,4.8
"08101",8,101,2017,74580,71353,3227,4.3
"08103",8,103,1990,3175,3039,136,4.3
"08103",8,103,1991,3298,3131,167,5.1
"08103",8,103,1992,3507,3288,219,6.2
"08103",8,103,1993,3458,3287,171,4.9
"08103",8,103,1994,3543,3388,155,4.4
"08103",8,103,1995,3459,3224,235,6.8
"08103",8,103,1996,3284,3098,186,5.7
"08103",8,103,1997,3268,3134,134,4.1
"08103",8,103,1998,3229,3094,135,4.2
"08103",8,103,1999,3170,3037,133,4.2
"08103",8,103,2000,3237,3143,94,2.9
"08103",8,103,2001,3483,3389,94,2.7
"08103",8,103,2002,3691,3580,111,3
"08103",8,103,2003,3554,3416,138,3.9
"08103",8,103,2004,3768,3625,143,3.8
"08103",8,103,2005,3979,3840,139,3.5
"08103",8,103,2006,4735,4607,128,2.7
"08103",8,103,2007,5344,5234,110,2.1
"08103",8,103,2008,5114,4981,133,2.6
"08103",8,103,2009,4659,4432,227,4.9
"08103",8,103,2010,3146,2866,280,8.9
"08103",8,103,2011,3119,2874,245,7.9
"08103",8,103,2012,3091,2833,258,8.3
"08103",8,103,2013,3072,2831,241,7.8
"08103",8,103,2014,2937,2763,174,5.9
"08103",8,103,2015,2805,2658,147,5.2
"08103",8,103,2016,2736,2599,137,5
"08103",8,103,2017,2822,2713,109,3.9
"08105",8,105,1990,5025,4518,507,10.1
"08105",8,105,1991,5052,4538,514,10.2
"08105",8,105,1992,5059,4441,618,12.2
"08105",8,105,1993,4950,4522,428,8.6
"08105",8,105,1994,5126,4709,417,8.1
"08105",8,105,1995,5249,4807,442,8.4
"08105",8,105,1996,5285,4754,531,10
"08105",8,105,1997,5282,4855,427,8.1
"08105",8,105,1998,5462,5000,462,8.5
"08105",8,105,1999,5171,4789,382,7.4
"08105",8,105,2000,5821,5558,263,4.5
"08105",8,105,2001,6204,5869,335,5.4
"08105",8,105,2002,6523,6144,379,5.8
"08105",8,105,2003,6432,6053,379,5.9
"08105",8,105,2004,6552,6158,394,6
"08105",8,105,2005,6520,6141,379,5.8
"08105",8,105,2006,6616,6309,307,4.6
"08105",8,105,2007,6543,6284,259,4
"08105",8,105,2008,6423,6060,363,5.7
"08105",8,105,2009,6788,6375,413,6.1
"08105",8,105,2010,5209,4655,554,10.6
"08105",8,105,2011,5152,4519,633,12.3
"08105",8,105,2012,5104,4481,623,12.2
"08105",8,105,2013,4878,4313,565,11.6
"08105",8,105,2014,4816,4373,443,9.2
"08105",8,105,2015,4865,4558,307,6.3
"08105",8,105,2016,5155,4901,254,4.9
"08105",8,105,2017,5445,5209,236,4.3
"08107",8,107,1990,8244,7892,352,4.3
"08107",8,107,1991,8540,8111,429,5
"08107",8,107,1992,8871,8259,612,6.9
"08107",8,107,1993,9508,8975,533,5.6
"08107",8,107,1994,10028,9638,390,3.9
"08107",8,107,1995,10358,9939,419,4
"08107",8,107,1996,10594,10172,422,4
"08107",8,107,1997,10774,10376,398,3.7
"08107",8,107,1998,11480,11088,392,3.4
"08107",8,107,1999,11611,11279,332,2.9
"08107",8,107,2000,12511,12195,316,2.5
"08107",8,107,2001,13273,12893,380,2.9
"08107",8,107,2002,13995,13481,514,3.7
"08107",8,107,2003,13712,13103,609,4.4
"08107",8,107,2004,14124,13578,546,3.9
"08107",8,107,2005,14515,13984,531,3.7
"08107",8,107,2006,14986,14508,478,3.2
"08107",8,107,2007,15692,15285,407,2.6
"08107",8,107,2008,15589,15060,529,3.4
"08107",8,107,2009,15238,14246,992,6.5
"08107",8,107,2010,14541,13192,1349,9.3
"08107",8,107,2011,14288,13111,1177,8.2
"08107",8,107,2012,14373,13338,1035,7.2
"08107",8,107,2013,14494,13632,862,5.9
"08107",8,107,2014,14373,13774,599,4.2
"08107",8,107,2015,14274,13810,464,3.3
"08107",8,107,2016,14902,14514,388,2.6
"08107",8,107,2017,15577,15206,371,2.4
"08109",8,109,1990,2259,1986,273,12.1
"08109",8,109,1991,2286,2044,242,10.6
"08109",8,109,1992,2359,2037,322,13.6
"08109",8,109,1993,2358,2087,271,11.5
"08109",8,109,1994,2485,2220,265,10.7
"08109",8,109,1995,2677,2402,275,10.3
"08109",8,109,1996,2783,2463,320,11.5
"08109",8,109,1997,2804,2569,235,8.4
"08109",8,109,1998,2969,2683,286,9.6
"08109",8,109,1999,2867,2615,252,8.8
"08109",8,109,2000,2708,2557,151,5.6
"08109",8,109,2001,3040,2857,183,6
"08109",8,109,2002,3198,2983,215,6.7
"08109",8,109,2003,3043,2838,205,6.7
"08109",8,109,2004,3095,2880,215,6.9
"08109",8,109,2005,3074,2844,230,7.5
"08109",8,109,2006,3198,2999,199,6.2
"08109",8,109,2007,3158,2993,165,5.2
"08109",8,109,2008,3040,2821,219,7.2
"08109",8,109,2009,3422,3147,275,8
"08109",8,109,2010,3066,2755,311,10.1
"08109",8,109,2011,3015,2679,336,11.1
"08109",8,109,2012,3055,2716,339,11.1
"08109",8,109,2013,2953,2620,333,11.3
"08109",8,109,2014,3002,2740,262,8.7
"08109",8,109,2015,3077,2888,189,6.1
"08109",8,109,2016,3227,3070,157,4.9
"08109",8,109,2017,3404,3253,151,4.4
"08111",8,111,1990,465,428,37,8
"08111",8,111,1991,436,340,96,22
"08111",8,111,1992,366,238,128,35
"08111",8,111,1993,331,261,70,21.1
"08111",8,111,1994,317,271,46,14.5
"08111",8,111,1995,280,235,45,16.1
"08111",8,111,1996,273,231,42,15.4
"08111",8,111,1997,261,231,30,11.5
"08111",8,111,1998,310,264,46,14.8
"08111",8,111,1999,298,262,36,12.1
"08111",8,111,2000,515,491,24,4.7
"08111",8,111,2001,515,480,35,6.8
"08111",8,111,2002,570,529,41,7.2
"08111",8,111,2003,609,570,39,6.4
"08111",8,111,2004,538,505,33,6.1
"08111",8,111,2005,508,471,37,7.3
"08111",8,111,2006,551,524,27,4.9
"08111",8,111,2007,563,540,23,4.1
"08111",8,111,2008,568,536,32,5.6
"08111",8,111,2009,556,515,41,7.4
"08111",8,111,2010,505,442,63,12.5
"08111",8,111,2011,522,461,61,11.7
"08111",8,111,2012,535,482,53,9.9
"08111",8,111,2013,477,436,41,8.6
"08111",8,111,2014,475,450,25,5.3
"08111",8,111,2015,470,450,20,4.3
"08111",8,111,2016,479,462,17,3.5
"08111",8,111,2017,538,526,12,2.2
"08113",8,113,1990,2449,2323,126,5.1
"08113",8,113,1991,2745,2565,180,6.6
"08113",8,113,1992,3179,2954,225,7.1
"08113",8,113,1993,3653,3481,172,4.7
"08113",8,113,1994,4126,3980,146,3.5
"08113",8,113,1995,4473,4293,180,4
"08113",8,113,1996,4325,4110,215,5
"08113",8,113,1997,4368,4170,198,4.5
"08113",8,113,1998,4515,4287,228,5
"08113",8,113,1999,4771,4561,210,4.4
"08113",8,113,2000,4724,4580,144,3
"08113",8,113,2001,4921,4735,186,3.8
"08113",8,113,2002,5043,4794,249,4.9
"08113",8,113,2003,4918,4648,270,5.5
"08113",8,113,2004,5036,4800,236,4.7
"08113",8,113,2005,5210,4989,221,4.2
"08113",8,113,2006,5445,5261,184,3.4
"08113",8,113,2007,5652,5477,175,3.1
"08113",8,113,2008,5519,5305,214,3.9
"08113",8,113,2009,5220,4911,309,5.9
"08113",8,113,2010,4892,4508,384,7.8
"08113",8,113,2011,4885,4492,393,8
"08113",8,113,2012,4856,4475,381,7.8
"08113",8,113,2013,4777,4459,318,6.7
"08113",8,113,2014,4918,4684,234,4.8
"08113",8,113,2015,5071,4879,192,3.8
"08113",8,113,2016,5184,5016,168,3.2
"08113",8,113,2017,5397,5243,154,2.9
"08115",8,115,1990,1276,1253,23,1.8
"08115",8,115,1991,1236,1195,41,3.3
"08115",8,115,1992,1197,1149,48,4
"08115",8,115,1993,1207,1157,50,4.1
"08115",8,115,1994,1195,1147,48,4
"08115",8,115,1995,1241,1200,41,3.3
"08115",8,115,1996,1229,1182,47,3.8
"08115",8,115,1997,1277,1245,32,2.5
"08115",8,115,1998,1300,1252,48,3.7
"08115",8,115,1999,1233,1201,32,2.6
"08115",8,115,2000,1399,1361,38,2.7
"08115",8,115,2001,1545,1501,44,2.8
"08115",8,115,2002,1638,1582,56,3.4
"08115",8,115,2003,1516,1451,65,4.3
"08115",8,115,2004,1581,1530,51,3.2
"08115",8,115,2005,1617,1567,50,3.1
"08115",8,115,2006,1628,1578,50,3.1
"08115",8,115,2007,1826,1786,40,2.2
"08115",8,115,2008,1533,1484,49,3.2
"08115",8,115,2009,1719,1655,64,3.7
"08115",8,115,2010,1101,1019,82,7.4
"08115",8,115,2011,1096,1009,87,7.9
"08115",8,115,2012,1119,1041,78,7
"08115",8,115,2013,1090,1022,68,6.2
"08115",8,115,2014,1085,1035,50,4.6
"08115",8,115,2015,1146,1107,39,3.4
"08115",8,115,2016,1177,1150,27,2.3
"08115",8,115,2017,1214,1187,27,2.2
"08117",8,117,1990,8110,7812,298,3.7
"08117",8,117,1991,8496,8122,374,4.4
"08117",8,117,1992,9053,8544,509,5.6
"08117",8,117,1993,9593,9193,400,4.2
"08117",8,117,1994,10767,10456,311,2.9
"08117",8,117,1995,11500,11178,322,2.8
"08117",8,117,1996,11840,11552,288,2.4
"08117",8,117,1997,12477,12195,282,2.3
"08117",8,117,1998,12894,12574,320,2.5
"08117",8,117,1999,13233,12927,306,2.3
"08117",8,117,2000,16070,15706,364,2.3
"08117",8,117,2001,16139,15662,477,3
"08117",8,117,2002,16572,15903,669,4
"08117",8,117,2003,15881,15133,748,4.7
"08117",8,117,2004,16054,15380,674,4.2
"08117",8,117,2005,16264,15649,615,3.8
"08117",8,117,2006,16845,16324,521,3.1
"08117",8,117,2007,17129,16663,466,2.7
"08117",8,117,2008,16996,16359,637,3.7
"08117",8,117,2009,16641,15631,1010,6.1
"08117",8,117,2010,19126,17837,1289,6.7
"08117",8,117,2011,19255,18003,1252,6.5
"08117",8,117,2012,19325,18158,1167,6
"08117",8,117,2013,19350,18379,971,5
"08117",8,117,2014,20062,19386,676,3.4
"08117",8,117,2015,20553,20034,519,2.5
"08117",8,117,2016,21120,20685,435,2.1
"08117",8,117,2017,22008,21598,410,1.9
"08119",8,119,1990,7476,7134,342,4.6
"08119",8,119,1991,8369,7974,395,4.7
"08119",8,119,1992,8806,8183,623,7.1
"08119",8,119,1993,10003,9244,759,7.6
"08119",8,119,1994,12008,11415,593,4.9
"08119",8,119,1995,13088,12515,573,4.4
"08119",8,119,1996,13240,12579,661,5
"08119",8,119,1997,13854,13286,568,4.1
"08119",8,119,1998,14240,13634,606,4.3
"08119",8,119,1999,13931,13436,495,3.6
"08119",8,119,2000,11888,11533,355,3
"08119",8,119,2001,11992,11524,468,3.9
"08119",8,119,2002,12276,11566,710,5.8
"08119",8,119,2003,12444,11685,759,6.1
"08119",8,119,2004,12491,11799,692,5.5
"08119",8,119,2005,12597,11975,622,4.9
"08119",8,119,2006,12800,12256,544,4.3
"08119",8,119,2007,12415,11936,479,3.9
"08119",8,119,2008,12279,11604,675,5.5
"08119",8,119,2009,12099,11186,913,7.5
"08119",8,119,2010,12354,11198,1156,9.4
"08119",8,119,2011,12154,11024,1130,9.3
"08119",8,119,2012,11912,10912,1000,8.4
"08119",8,119,2013,11712,10798,914,7.8
"08119",8,119,2014,11573,10895,678,5.9
"08119",8,119,2015,11400,10892,508,4.5
"08119",8,119,2016,11730,11296,434,3.7
"08119",8,119,2017,12170,11776,394,3.2
"08121",8,121,1990,2209,2164,45,2
"08121",8,121,1991,2126,2064,62,2.9
"08121",8,121,1992,2162,2081,81,3.7
"08121",8,121,1993,2184,2113,71,3.3
"08121",8,121,1994,2198,2130,68,3.1
"08121",8,121,1995,2372,2306,66,2.8
"08121",8,121,1996,2393,2333,60,2.5
"08121",8,121,1997,2479,2403,76,3.1
"08121",8,121,1998,2520,2445,75,3
"08121",8,121,1999,2451,2388,63,2.6
"08121",8,121,2000,2440,2377,63,2.6
"08121",8,121,2001,2823,2747,76,2.7
"08121",8,121,2002,2936,2838,98,3.3
"08121",8,121,2003,2753,2657,96,3.5
"08121",8,121,2004,2795,2685,110,3.9
"08121",8,121,2005,2754,2650,104,3.8
"08121",8,121,2006,2898,2798,100,3.5
"08121",8,121,2007,2880,2803,77,2.7
"08121",8,121,2008,2656,2570,86,3.2
"08121",8,121,2009,2984,2865,119,4
"08121",8,121,2010,2590,2437,153,5.9
"08121",8,121,2011,2589,2448,141,5.4
"08121",8,121,2012,2636,2507,129,4.9
"08121",8,121,2013,2549,2432,117,4.6
"08121",8,121,2014,2645,2561,84,3.2
"08121",8,121,2015,2783,2712,71,2.6
"08121",8,121,2016,2918,2856,62,2.1
"08121",8,121,2017,3054,2995,59,1.9
"08123",8,123,1990,66589,62720,3869,5.8
"08123",8,123,1991,68230,64680,3550,5.2
"08123",8,123,1992,69238,65221,4017,5.8
"08123",8,123,1993,73211,69379,3832,5.2
"08123",8,123,1994,76510,73101,3409,4.5
"08123",8,123,1995,80199,76569,3630,4.5
"08123",8,123,1996,80485,76684,3801,4.7
"08123",8,123,1997,82578,79175,3403,4.1
"08123",8,123,1998,87301,83581,3720,4.3
"08123",8,123,1999,88839,85480,3359,3.8
"08123",8,123,2000,93511,90983,2528,2.7
"08123",8,123,2001,98046,94658,3388,3.5
"08123",8,123,2002,102298,97081,5217,5.1
"08123",8,123,2003,105619,99557,6062,5.7
"08123",8,123,2004,109077,102985,6092,5.6
"08123",8,123,2005,111087,105019,6068,5.5
"08123",8,123,2006,114953,109578,5375,4.7
"08123",8,123,2007,117044,112271,4773,4.1
"08123",8,123,2008,118948,112731,6217,5.2
"08123",8,123,2009,120964,111070,9894,8.2
"08123",8,123,2010,131910,119796,12114,9.2
"08123",8,123,2011,134285,122737,11548,8.6
"08123",8,123,2012,136906,126256,10650,7.8
"08123",8,123,2013,139047,129920,9127,6.6
"08123",8,123,2014,145272,138793,6479,4.5
"08123",8,123,2015,147722,142040,5682,3.8
"08123",8,123,2016,149909,144811,5098,3.4
"08123",8,123,2017,157286,153092,4194,2.7
"08125",8,125,1990,4011,3924,87,2.2
"08125",8,125,1991,3974,3869,105,2.6
"08125",8,125,1992,3885,3742,143,3.7
"08125",8,125,1993,3978,3854,124,3.1
"08125",8,125,1994,4122,4019,103,2.5
"08125",8,125,1995,4281,4198,83,1.9
"08125",8,125,1996,4397,4302,95,2.2
"08125",8,125,1997,4489,4387,102,2.3
"08125",8,125,1998,4644,4534,110,2.4
"08125",8,125,1999,4592,4476,116,2.5
"08125",8,125,2000,5038,4905,133,2.6
"08125",8,125,2001,5977,5842,135,2.3
"08125",8,125,2002,6399,6242,157,2.5
"08125",8,125,2003,5980,5798,182,3
"08125",8,125,2004,6122,5926,196,3.2
"08125",8,125,2005,6062,5872,190,3.1
"08125",8,125,2006,6506,6336,170,2.6
"08125",8,125,2007,6734,6591,143,2.1
"08125",8,125,2008,6505,6331,174,2.7
"08125",8,125,2009,7112,6877,235,3.3
"08125",8,125,2010,4928,4651,277,5.6
"08125",8,125,2011,4962,4701,261,5.3
"08125",8,125,2012,4884,4633,251,5.1
"08125",8,125,2013,4736,4511,225,4.8
"08125",8,125,2014,4953,4789,164,3.3
"08125",8,125,2015,5129,4995,134,2.6
"08125",8,125,2016,5437,5322,115,2.1
"08125",8,125,2017,5726,5633,93,1.6
"09001",9,1,1990,462016,440284,21732,4.7
"09001",9,1,1991,466192,439189,27003,5.8
"09001",9,1,1992,464254,432653,31601,6.8
"09001",9,1,1993,457022,430794,26228,5.7
"09001",9,1,1994,447928,426127,21801,4.9
"09001",9,1,1995,446228,424962,21266,4.8
"09001",9,1,1996,448824,427766,21058,4.7
"09001",9,1,1997,454633,435484,19149,4.2
"09001",9,1,1998,454689,441114,13575,3
"09001",9,1,1999,456719,444811,11908,2.6
"09001",9,1,2000,452280,442598,9682,2.1
"09001",9,1,2001,449338,435905,13433,3
"09001",9,1,2002,449865,431418,18447,4.1
"09001",9,1,2003,452081,429839,22242,4.9
"09001",9,1,2004,448115,428096,20019,4.5
"09001",9,1,2005,451803,431973,19830,4.4
"09001",9,1,2006,459839,442204,17635,3.8
"09001",9,1,2007,466532,448188,18344,3.9
"09001",9,1,2008,471297,447013,24284,5.2
"09001",9,1,2009,471953,436665,35288,7.5
"09001",9,1,2010,474545,434720,39825,8.4
"09001",9,1,2011,478085,438961,39124,8.2
"09001",9,1,2012,473705,436901,36804,7.8
"09001",9,1,2013,468896,434873,34023,7.3
"09001",9,1,2014,478479,448984,29495,6.2
"09001",9,1,2015,481852,456134,25718,5.3
"09001",9,1,2016,484926,461380,23546,4.9
"09001",9,1,2017,485357,463484,21873,4.5
"09003",9,3,1990,470096,445877,24219,5.2
"09003",9,3,1991,475212,442277,32935,6.9
"09003",9,3,1992,466018,428530,37488,8
"09003",9,3,1993,455764,422436,33328,7.3
"09003",9,3,1994,442258,414978,27280,6.2
"09003",9,3,1995,431297,404832,26465,6.1
"09003",9,3,1996,430337,404111,26226,6.1
"09003",9,3,1997,428793,405239,23554,5.5
"09003",9,3,1998,422566,406972,15594,3.7
"09003",9,3,1999,426197,412736,13461,3.2
"09003",9,3,2000,435261,423806,11455,2.6
"09003",9,3,2001,433800,419194,14606,3.4
"09003",9,3,2002,434196,413629,20567,4.7
"09003",9,3,2003,435069,408956,26113,6
"09003",9,3,2004,431901,408102,23799,5.5
"09003",9,3,2005,437887,414699,23188,5.3
"09003",9,3,2006,445627,424469,21158,4.7
"09003",9,3,2007,452749,430746,22003,4.9
"09003",9,3,2008,460358,432568,27790,6
"09003",9,3,2009,464754,425976,38778,8.3
"09003",9,3,2010,478126,432899,45227,9.5
"09003",9,3,2011,478396,434994,43402,9.1
"09003",9,3,2012,471204,430874,40330,8.6
"09003",9,3,2013,465640,428369,37271,8
"09003",9,3,2014,473612,441506,32106,6.8
"09003",9,3,2015,474499,446575,27924,5.9
"09003",9,3,2016,476125,450523,25602,5.4
"09003",9,3,2017,481242,457937,23305,4.8
"09005",9,5,1990,102033,97195,4838,4.7
"09005",9,5,1991,104998,98329,6669,6.4
"09005",9,5,1992,106372,98626,7746,7.3
"09005",9,5,1993,104152,97499,6653,6.4
"09005",9,5,1994,101458,96325,5133,5.1
"09005",9,5,1995,100269,95579,4690,4.7
"09005",9,5,1996,100385,95765,4620,4.6
"09005",9,5,1997,101806,97528,4278,4.2
"09005",9,5,1998,101961,99117,2844,2.8
"09005",9,5,1999,102615,100148,2467,2.4
"09005",9,5,2000,100816,98723,2093,2.1
"09005",9,5,2001,100185,97263,2922,2.9
"09005",9,5,2002,100878,96720,4158,4.1
"09005",9,5,2003,101455,96380,5075,5
"09005",9,5,2004,101343,96523,4820,4.8
"09005",9,5,2005,102186,97509,4677,4.6
"09005",9,5,2006,103802,99647,4155,4
"09005",9,5,2007,104535,100133,4402,4.2
"09005",9,5,2008,105675,100072,5603,5.3
"09005",9,5,2009,105724,97384,8340,7.9
"09005",9,5,2010,108368,98908,9460,8.7
"09005",9,5,2011,108015,99225,8790,8.1
"09005",9,5,2012,106126,98059,8067,7.6
"09005",9,5,2013,104499,97061,7438,7.1
"09005",9,5,2014,105843,99476,6367,6
"09005",9,5,2015,105607,100157,5450,5.2
"09005",9,5,2016,105484,100503,4981,4.7
"09005",9,5,2017,105736,101180,4556,4.3
"09007",9,7,1990,83647,80219,3428,4.1
"09007",9,7,1991,84996,80157,4839,5.7
"09007",9,7,1992,84110,78527,5583,6.6
"09007",9,7,1993,83995,78714,5281,6.3
"09007",9,7,1994,82621,78237,4384,5.3
"09007",9,7,1995,81788,77495,4293,5.2
"09007",9,7,1996,82984,78404,4580,5.5
"09007",9,7,1997,83386,79399,3987,4.8
"09007",9,7,1998,82987,80369,2618,3.2
"09007",9,7,1999,84357,82258,2099,2.5
"09007",9,7,2000,86650,84801,1849,2.1
"09007",9,7,2001,86623,84305,2318,2.7
"09007",9,7,2002,87614,84370,3244,3.7
"09007",9,7,2003,88091,83898,4193,4.8
"09007",9,7,2004,87715,84009,3706,4.2
"09007",9,7,2005,89289,85484,3805,4.3
"09007",9,7,2006,91260,87921,3339,3.7
"09007",9,7,2007,93011,89397,3614,3.9
"09007",9,7,2008,94548,89986,4562,4.8
"09007",9,7,2009,95148,88811,6337,6.7
"09007",9,7,2010,93110,85758,7352,7.9
"09007",9,7,2011,93453,86309,7144,7.6
"09007",9,7,2012,91837,85251,6586,7.2
"09007",9,7,2013,90808,84708,6100,6.7
"09007",9,7,2014,92289,87004,5285,5.7
"09007",9,7,2015,92262,87695,4567,5
"09007",9,7,2016,92719,88589,4130,4.5
"09007",9,7,2017,93686,89889,3797,4.1
"09009",9,9,1990,440366,415798,24568,5.6
"09009",9,9,1991,445234,414253,30981,7
"09009",9,9,1992,442805,406889,35916,8.1
"09009",9,9,1993,432532,402049,30483,7
"09009",9,9,1994,421267,395680,25587,6.1
"09009",9,9,1995,414486,390416,24070,5.8
"09009",9,9,1996,418009,393269,24740,5.9
"09009",9,9,1997,420732,398016,22716,5.4
"09009",9,9,1998,420126,404679,15447,3.7
"09009",9,9,1999,421329,408348,12981,3.1
"09009",9,9,2000,420320,409354,10966,2.6
"09009",9,9,2001,418502,404260,14242,3.4
"09009",9,9,2002,423796,404024,19772,4.7
"09009",9,9,2003,426501,401675,24826,5.8
"09009",9,9,2004,424886,402256,22630,5.3
"09009",9,9,2005,429962,407064,22898,5.3
"09009",9,9,2006,437427,416565,20862,4.8
"09009",9,9,2007,444223,422247,21976,4.9
"09009",9,9,2008,449379,421335,28044,6.2
"09009",9,9,2009,450853,412211,38642,8.6
"09009",9,9,2010,462196,416034,46162,10
"09009",9,9,2011,462437,417656,44781,9.7
"09009",9,9,2012,456726,415190,41536,9.1
"09009",9,9,2013,450812,412391,38421,8.5
"09009",9,9,2014,457038,423994,33044,7.2
"09009",9,9,2015,456601,428192,28409,6.2
"09009",9,9,2016,459026,433714,25312,5.5
"09009",9,9,2017,462382,439130,23252,5
"09011",9,11,1990,131330,123815,7515,5.7
"09011",9,11,1991,132222,123468,8754,6.6
"09011",9,11,1992,132576,123074,9502,7.2
"09011",9,11,1993,132814,124487,8327,6.3
"09011",9,11,1994,133063,126084,6979,5.2
"09011",9,11,1995,133330,126282,7048,5.3
"09011",9,11,1996,133871,126261,7610,5.7
"09011",9,11,1997,135795,128318,7477,5.5
"09011",9,11,1998,133096,127830,5266,4
"09011",9,11,1999,134612,130573,4039,3
"09011",9,11,2000,133684,130536,3148,2.4
"09011",9,11,2001,135726,131971,3755,2.8
"09011",9,11,2002,140315,134872,5443,3.9
"09011",9,11,2003,142276,135389,6887,4.8
"09011",9,11,2004,141448,135028,6420,4.5
"09011",9,11,2005,144132,137659,6473,4.5
"09011",9,11,2006,145569,139598,5971,4.1
"09011",9,11,2007,147559,141400,6159,4.2
"09011",9,11,2008,150194,142064,8130,5.4
"09011",9,11,2009,150961,139704,11257,7.5
"09011",9,11,2010,144548,131697,12851,8.9
"09011",9,11,2011,143702,131017,12685,8.8
"09011",9,11,2012,140123,128037,12086,8.6
"09011",9,11,2013,137276,126137,11139,8.1
"09011",9,11,2014,137463,128146,9317,6.8
"09011",9,11,2015,136999,128887,8112,5.9
"09011",9,11,2016,137377,130347,7030,5.1
"09011",9,11,2017,139444,133191,6253,4.5
"09013",9,13,1990,74678,71674,3004,4
"09013",9,13,1991,75592,71284,4308,5.7
"09013",9,13,1992,74557,69633,4924,6.6
"09013",9,13,1993,73469,69024,4445,6.1
"09013",9,13,1994,71985,68435,3550,4.9
"09013",9,13,1995,70223,66795,3428,4.9
"09013",9,13,1996,70444,67314,3130,4.4
"09013",9,13,1997,70924,68132,2792,3.9
"09013",9,13,1998,70486,68592,1894,2.7
"09013",9,13,1999,71638,70085,1553,2.2
"09013",9,13,2000,76716,75241,1475,1.9
"09013",9,13,2001,77035,75188,1847,2.4
"09013",9,13,2002,78143,75467,2676,3.4
"09013",9,13,2003,79032,75590,3442,4.4
"09013",9,13,2004,79351,76061,3290,4.1
"09013",9,13,2005,80817,77419,3398,4.2
"09013",9,13,2006,82675,79562,3113,3.8
"09013",9,13,2007,83967,80742,3225,3.8
"09013",9,13,2008,85296,81192,4104,4.8
"09013",9,13,2009,86559,80813,5746,6.6
"09013",9,13,2010,86139,79397,6742,7.8
"09013",9,13,2011,86080,79572,6508,7.6
"09013",9,13,2012,84431,78216,6215,7.4
"09013",9,13,2013,83155,77423,5732,6.9
"09013",9,13,2014,84735,79788,4947,5.8
"09013",9,13,2015,85126,80888,4238,5
"09013",9,13,2016,85631,81770,3861,4.5
"09013",9,13,2017,86570,83107,3463,4
"09015",9,15,1990,55602,51615,3987,7.2
"09015",9,15,1991,56656,51699,4957,8.7
"09015",9,15,1992,57016,51753,5263,9.2
"09015",9,15,1993,55972,51576,4396,7.9
"09015",9,15,1994,55722,51961,3761,6.7
"09015",9,15,1995,56447,52699,3748,6.6
"09015",9,15,1996,56872,53061,3811,6.7
"09015",9,15,1997,56475,52798,3677,6.5
"09015",9,15,1998,56289,53670,2619,4.7
"09015",9,15,1999,57099,55180,1919,3.4
"09015",9,15,2000,58402,56854,1548,2.7
"09015",9,15,2001,58622,56689,1933,3.3
"09015",9,15,2002,59344,56624,2720,4.6
"09015",9,15,2003,59753,56196,3557,6
"09015",9,15,2004,59442,56141,3301,5.6
"09015",9,15,2005,60903,57577,3326,5.5
"09015",9,15,2006,62458,59229,3229,5.2
"09015",9,15,2007,63624,60303,3321,5.2
"09015",9,15,2008,64707,60450,4257,6.6
"09015",9,15,2009,65133,59411,5722,8.8
"09015",9,15,2010,64682,58039,6643,10.3
"09015",9,15,2011,64605,58232,6373,9.9
"09015",9,15,2012,63265,57308,5957,9.4
"09015",9,15,2013,62255,56803,5452,8.8
"09015",9,15,2014,62991,58384,4607,7.3
"09015",9,15,2015,62883,58905,3978,6.3
"09015",9,15,2016,63268,59749,3519,5.6
"09015",9,15,2017,64159,60939,3220,5
"11001",11,1,1990,328924,308281,20643,6.3
"11001",11,1,1991,321433,296477,24956,7.8
"11001",11,1,1992,317226,289953,27273,8.6
"11001",11,1,1993,315856,288925,26931,8.5
"11001",11,1,1994,310532,285776,24756,8
"11001",11,1,1995,300085,273768,26317,8.8
"11001",11,1,1996,287378,263163,24215,8.4
"11001",11,1,1997,282744,260105,22639,8
"11001",11,1,1998,291902,267312,24590,8.4
"11001",11,1,1999,306131,286650,19481,6.4
"11001",11,1,2000,310469,293086,17383,5.6
"11001",11,1,2001,310515,290811,19704,6.3
"11001",11,1,2002,306099,286496,19603,6.4
"11001",11,1,2003,306422,285454,20968,6.8
"11001",11,1,2004,312027,287683,24344,7.8
"11001",11,1,2005,315616,295484,20132,6.4
"11001",11,1,2006,316083,297786,18297,5.8
"11001",11,1,2007,322237,304426,17811,5.5
"11001",11,1,2008,330544,309192,21352,6.5
"11001",11,1,2009,335672,304500,31172,9.3
"11001",11,1,2010,346065,313508,32557,9.4
"11001",11,1,2011,350778,315171,35607,10.2
"11001",11,1,2012,364989,331984,33005,9
"11001",11,1,2013,374126,342351,31775,8.5
"11001",11,1,2014,378380,348981,29399,7.8
"11001",11,1,2015,388057,361324,26733,6.9
"11001",11,1,2016,394586,370521,24065,6.1
"11001",11,1,2017,400894,376633,24261,6.1
"10001",10,1,1990,58471,55767,2704,4.6
"10001",10,1,1991,61764,57878,3886,6.3
"10001",10,1,1992,64691,60978,3713,5.7
"10001",10,1,1993,66846,63026,3820,5.7
"10001",10,1,1994,69389,65804,3585,5.2
"10001",10,1,1995,69913,66739,3174,4.5
"10001",10,1,1996,69963,66409,3554,5.1
"10001",10,1,1997,67753,64727,3026,4.5
"10001",10,1,1998,69031,66178,2853,4.1
"10001",10,1,1999,69925,67338,2587,3.7
"10001",10,1,2000,63479,60922,2557,4
"10001",10,1,2001,64923,62535,2388,3.7
"10001",10,1,2002,65666,63071,2595,4
"10001",10,1,2003,66965,64113,2852,4.3
"10001",10,1,2004,69048,66624,2424,3.5
"10001",10,1,2005,72015,69394,2621,3.6
"10001",10,1,2006,74093,71705,2388,3.2
"10001",10,1,2007,75038,72517,2521,3.4
"10001",10,1,2008,75463,71760,3703,4.9
"10001",10,1,2009,73786,67788,5998,8.1
"10001",10,1,2010,72689,66228,6461,8.9
"10001",10,1,2011,74035,67970,6065,8.2
"10001",10,1,2012,74273,68382,5891,7.9
"10001",10,1,2013,73816,68397,5419,7.3
"10001",10,1,2014,75216,70393,4823,6.4
"10001",10,1,2015,76595,72470,4125,5.4
"10001",10,1,2016,77562,73748,3814,4.9
"10001",10,1,2017,78132,74246,3886,5
"10003",10,3,1990,239994,227780,12214,5.1
"10003",10,3,1991,237540,222061,15479,6.5
"10003",10,3,1992,237745,224483,13262,5.6
"10003",10,3,1993,243758,231925,11833,4.9
"10003",10,3,1994,248524,237050,11474,4.6
"10003",10,3,1995,247420,237146,10274,4.2
"10003",10,3,1996,249353,236105,13248,5.3
"10003",10,3,1997,250659,240894,9765,3.9
"10003",10,3,1998,255370,246247,9123,3.6
"10003",10,3,1999,257207,249205,8002,3.1
"10003",10,3,2000,270531,260715,9816,3.6
"10003",10,3,2001,275308,265872,9436,3.4
"10003",10,3,2002,268410,257322,11088,4.1
"10003",10,3,2003,265814,254061,11753,4.4
"10003",10,3,2004,266051,254797,11254,4.2
"10003",10,3,2005,270152,258145,12007,4.4
"10003",10,3,2006,274789,264399,10390,3.8
"10003",10,3,2007,275852,266221,9631,3.5
"10003",10,3,2008,277739,264070,13669,4.9
"10003",10,3,2009,271289,248704,22585,8.3
"10003",10,3,2010,271492,249065,22427,8.3
"10003",10,3,2011,277295,257163,20132,7.3
"10003",10,3,2012,278297,258807,19490,7
"10003",10,3,2013,276662,258760,17902,6.5
"10003",10,3,2014,283309,267676,15633,5.5
"10003",10,3,2015,292479,278738,13741,4.7
"10003",10,3,2016,295027,281961,13066,4.4
"10003",10,3,2017,296289,282959,13330,4.5
"10005",10,5,1990,61759,59653,2106,3.4
"10005",10,5,1991,62410,59364,3046,4.9
"10005",10,5,1992,64727,61793,2934,4.5
"10005",10,5,1993,66250,62826,3424,5.2
"10005",10,5,1994,66914,63470,3444,5.1
"10005",10,5,1995,68504,65314,3190,4.7
"10005",10,5,1996,68818,65740,3078,4.5
"10005",10,5,1997,69185,66522,2663,3.8
"10005",10,5,1998,70486,67824,2662,3.8
"10005",10,5,1999,71650,68647,3003,4.2
"10005",10,5,2000,79492,76391,3101,3.9
"10005",10,5,2001,81555,78626,2929,3.6
"10005",10,5,2002,82707,79626,3081,3.7
"10005",10,5,2003,82382,79298,3084,3.7
"10005",10,5,2004,85284,82178,3106,3.6
"10005",10,5,2005,90242,86926,3316,3.7
"10005",10,5,2006,92302,89295,3007,3.3
"10005",10,5,2007,92683,89574,3109,3.4
"10005",10,5,2008,93841,89085,4756,5.1
"10005",10,5,2009,92424,84819,7605,8.2
"10005",10,5,2010,90239,82577,7662,8.5
"10005",10,5,2011,92016,84953,7063,7.7
"10005",10,5,2012,93002,86269,6733,7.2
"10005",10,5,2013,92251,85962,6289,6.8
"10005",10,5,2014,94789,89318,5471,5.8
"10005",10,5,2015,98037,93196,4841,4.9
"10005",10,5,2016,101293,96726,4567,4.5
"10005",10,5,2017,102929,98223,4706,4.6
"12001",12,1,1990,94191,90789,3402,3.6
"12001",12,1,1991,95686,91406,4280,4.5
"12001",12,1,1992,96854,92189,4665,4.8
"12001",12,1,1993,99614,95690,3924,3.9
"12001",12,1,1994,102551,99173,3378,3.3
"12001",12,1,1995,103623,100652,2971,2.9
"12001",12,1,1996,104059,101078,2981,2.9
"12001",12,1,1997,105458,102360,3098,2.9
"12001",12,1,1998,107590,104749,2841,2.6
"12001",12,1,1999,109256,106801,2455,2.2
"12001",12,1,2000,116143,112640,3503,3
"12001",12,1,2001,118547,114284,4263,3.6
"12001",12,1,2002,118163,113387,4776,4
"12001",12,1,2003,119087,114641,4446,3.7
"12001",12,1,2004,120256,115973,4283,3.6
"12001",12,1,2005,123550,119924,3626,2.9
"12001",12,1,2006,125843,122471,3372,2.7
"12001",12,1,2007,129010,125102,3908,3
"12001",12,1,2008,131246,125425,5821,4.4
"12001",12,1,2009,129815,120579,9236,7.1
"12001",12,1,2010,128370,118072,10298,8
"12001",12,1,2011,129027,119251,9776,7.6
"12001",12,1,2012,130007,121373,8634,6.6
"12001",12,1,2013,129435,122038,7397,5.7
"12001",12,1,2014,129548,122796,6752,5.2
"12001",12,1,2015,129509,123529,5980,4.6
"12001",12,1,2016,132693,127035,5658,4.3
"12001",12,1,2017,136013,130980,5033,3.7
"12003",12,3,1990,8076,7485,591,7.3
"12003",12,3,1991,8475,7628,847,10
"12003",12,3,1992,8851,7882,969,10.9
"12003",12,3,1993,8697,7914,783,9
"12003",12,3,1994,8825,8267,558,6.3
"12003",12,3,1995,8796,8316,480,5.5
"12003",12,3,1996,8625,8192,433,5
"12003",12,3,1997,8655,8245,410,4.7
"12003",12,3,1998,8929,8577,352,3.9
"12003",12,3,1999,9064,8748,316,3.5
"12003",12,3,2000,10392,10078,314,3
"12003",12,3,2001,10503,10060,443,4.2
"12003",12,3,2002,10459,9957,502,4.8
"12003",12,3,2003,10426,9922,504,4.8
"12003",12,3,2004,10601,10171,430,4.1
"12003",12,3,2005,11112,10751,361,3.2
"12003",12,3,2006,11548,11219,329,2.8
"12003",12,3,2007,11913,11477,436,3.7
"12003",12,3,2008,12245,11531,714,5.8
"12003",12,3,2009,12111,10887,1224,10.1
"12003",12,3,2010,11552,10246,1306,11.3
"12003",12,3,2011,11506,10333,1173,10.2
"12003",12,3,2012,11347,10374,973,8.6
"12003",12,3,2013,11270,10438,832,7.4
"12003",12,3,2014,11208,10491,717,6.4
"12003",12,3,2015,11174,10549,625,5.6
"12003",12,3,2016,11424,10869,555,4.9
"12003",12,3,2017,11794,11316,478,4.1
"12005",12,5,1990,61479,55866,5613,9.1
"12005",12,5,1991,62067,56955,5112,8.2
"12005",12,5,1992,63884,57890,5994,9.4
"12005",12,5,1993,65338,59148,6190,9.5
"12005",12,5,1994,65737,60242,5495,8.4
"12005",12,5,1995,64891,60547,4344,6.7
"12005",12,5,1996,66365,62283,4082,6.2
"12005",12,5,1997,67530,62907,4623,6.8
"12005",12,5,1998,68482,63742,4740,6.9
"12005",12,5,1999,68609,64225,4384,6.4
"12005",12,5,2000,71968,68623,3345,4.6
"12005",12,5,2001,72692,68857,3835,5.3
"12005",12,5,2002,74110,69782,4328,5.8
"12005",12,5,2003,75980,71922,4058,5.3
"12005",12,5,2004,78802,75238,3564,4.5
"12005",12,5,2005,82406,79474,2932,3.6
"12005",12,5,2006,85748,83077,2671,3.1
"12005",12,5,2007,86754,83532,3222,3.7
"12005",12,5,2008,88653,83626,5027,5.7
"12005",12,5,2009,88810,80695,8115,9.1
"12005",12,5,2010,86072,77054,9018,10.5
"12005",12,5,2011,87205,78311,8894,10.2
"12005",12,5,2012,86694,79206,7488,8.6
"12005",12,5,2013,86420,80126,6294,7.3
"12005",12,5,2014,87558,82008,5550,6.3
"12005",12,5,2015,87546,82751,4795,5.5
"12005",12,5,2016,87965,83785,4180,4.8
"12005",12,5,2017,88900,85261,3639,4.1
"12007",12,7,1990,9264,8844,420,4.5
"12007",12,7,1991,9675,9136,539,5.6
"12007",12,7,1992,9775,9118,657,6.7
"12007",12,7,1993,9653,9053,600,6.2
"12007",12,7,1994,9508,9059,449,4.7
"12007",12,7,1995,9769,9403,366,3.7
"12007",12,7,1996,10006,9637,369,3.7
"12007",12,7,1997,10113,9726,387,3.8
"12007",12,7,1998,9925,9470,455,4.6
"12007",12,7,1999,10057,9706,351,3.5
"12007",12,7,2000,10581,10183,398,3.8
"12007",12,7,2001,10805,10313,492,4.6
"12007",12,7,2002,10960,10470,490,4.5
"12007",12,7,2003,11322,10855,467,4.1
"12007",12,7,2004,11582,11123,459,4
"12007",12,7,2005,11709,11334,375,3.2
"12007",12,7,2006,12191,11843,348,2.9
"12007",12,7,2007,12341,11917,424,3.4
"12007",12,7,2008,12475,11856,619,5
"12007",12,7,2009,12473,11467,1006,8.1
"12007",12,7,2010,11587,10444,1143,9.9
"12007",12,7,2011,11507,10462,1045,9.1
"12007",12,7,2012,11152,10307,845,7.6
"12007",12,7,2013,10985,10293,692,6.3
"12007",12,7,2014,10752,10146,606,5.6
"12007",12,7,2015,10746,10226,520,4.8
"12007",12,7,2016,10866,10405,461,4.2
"12007",12,7,2017,11293,10885,408,3.6
"12009",12,9,1990,205653,194451,11202,5.4
"12009",12,9,1991,209660,194390,15270,7.3
"12009",12,9,1992,212127,195009,17118,8.1
"12009",12,9,1993,212712,196150,16562,7.8
"12009",12,9,1994,213165,197655,15510,7.3
"12009",12,9,1995,208467,194713,13754,6.6
"12009",12,9,1996,205621,194165,11456,5.6
"12009",12,9,1997,210011,200080,9931,4.7
"12009",12,9,1998,212543,203051,9492,4.5
"12009",12,9,1999,214156,205403,8753,4.1
"12009",12,9,2000,231904,223468,8436,3.6
"12009",12,9,2001,237019,226249,10770,4.5
"12009",12,9,2002,238028,224093,13935,5.9
"12009",12,9,2003,242235,229392,12843,5.3
"12009",12,9,2004,249353,237866,11487,4.6
"12009",12,9,2005,260435,250969,9466,3.6
"12009",12,9,2006,265618,256936,8682,3.3
"12009",12,9,2007,265782,254099,11683,4.4
"12009",12,9,2008,268840,250742,18098,6.7
"12009",12,9,2009,266755,238983,27772,10.4
"12009",12,9,2010,265643,235757,29886,11.3
"12009",12,9,2011,265213,236336,28877,10.9
"12009",12,9,2012,262648,237972,24676,9.4
"12009",12,9,2013,258685,237228,21457,8.3
"12009",12,9,2014,257909,239911,17998,7
"12009",12,9,2015,256470,241082,15388,6
"12009",12,9,2016,262683,249290,13393,5.1
"12009",12,9,2017,268757,257365,11392,4.2
"12011",12,11,1990,668642,629862,38780,5.8
"12011",12,11,1991,678695,624471,54224,8
"12011",12,11,1992,696196,635594,60602,8.7
"12011",12,11,1993,712806,662029,50777,7.1
"12011",12,11,1994,733950,686737,47213,6.4
"12011",12,11,1995,745036,702194,42842,5.8
"12011",12,11,1996,760675,720454,40221,5.3
"12011",12,11,1997,777558,738240,39318,5.1
"12011",12,11,1998,789496,752237,37259,4.7
"12011",12,11,1999,797693,763685,34008,4.3
"12011",12,11,2000,854842,823673,31169,3.6
"12011",12,11,2001,887522,846010,41512,4.7
"12011",12,11,2002,898709,844709,54000,6
"12011",12,11,2003,905406,855456,49950,5.5
"12011",12,11,2004,924362,880488,43874,4.7
"12011",12,11,2005,957619,922294,35325,3.7
"12011",12,11,2006,983211,952640,30571,3.1
"12011",12,11,2007,1000426,964482,35944,3.6
"12011",12,11,2008,1006721,950763,55958,5.6
"12011",12,11,2009,980551,891041,89510,9.1
"12011",12,11,2010,936563,841473,95090,10.2
"12011",12,11,2011,951445,861686,89759,9.4
"12011",12,11,2012,963563,886780,76783,8
"12011",12,11,2013,974428,908457,65971,6.8
"12011",12,11,2014,987282,928716,58566,5.9
"12011",12,11,2015,988228,937544,50684,5.1
"12011",12,11,2016,1004443,959470,44973,4.5
"12011",12,11,2017,1026330,986586,39744,3.9
"12013",12,13,1990,4497,4168,329,7.3
"12013",12,13,1991,4686,4286,400,8.5
"12013",12,13,1992,4664,4259,405,8.7
"12013",12,13,1993,4457,4156,301,6.8
"12013",12,13,1994,4601,4333,268,5.8
"12013",12,13,1995,4849,4630,219,4.5
"12013",12,13,1996,5015,4775,240,4.8
"12013",12,13,1997,5403,5101,302,5.6
"12013",12,13,1998,5309,5003,306,5.8
"12013",12,13,1999,4996,4651,345,6.9
"12013",12,13,2000,5152,4909,243,4.7
"12013",12,13,2001,5248,4977,271,5.2
"12013",12,13,2002,5369,5085,284,5.3
"12013",12,13,2003,5337,5073,264,4.9
"12013",12,13,2004,5288,5029,259,4.9
"12013",12,13,2005,5247,5050,197,3.8
"12013",12,13,2006,5386,5216,170,3.2
"12013",12,13,2007,5550,5345,205,3.7
"12013",12,13,2008,5757,5439,318,5.5
"12013",12,13,2009,5917,5413,504,8.5
"12013",12,13,2010,5314,4777,537,10.1
"12013",12,13,2011,5242,4698,544,10.4
"12013",12,13,2012,5093,4627,466,9.1
"12013",12,13,2013,4916,4530,386,7.9
"12013",12,13,2014,4945,4602,343,6.9
"12013",12,13,2015,4942,4639,303,6.1
"12013",12,13,2016,4988,4702,286,5.7
"12013",12,13,2017,4933,4692,241,4.9
"12015",12,15,1990,41739,39731,2008,4.8
"12015",12,15,1991,43089,40170,2919,6.8
"12015",12,15,1992,44736,41364,3372,7.5
"12015",12,15,1993,44968,42012,2956,6.6
"12015",12,15,1994,45859,43316,2543,5.5
"12015",12,15,1995,45334,43181,2153,4.7
"12015",12,15,1996,46060,44085,1975,4.3
"12015",12,15,1997,46830,44884,1946,4.2
"12015",12,15,1998,47750,46005,1745,3.7
"12015",12,15,1999,49986,48333,1653,3.3
"12015",12,15,2000,55138,53090,2048,3.7
"12015",12,15,2001,56187,53641,2546,4.5
"12015",12,15,2002,59632,56180,3452,5.8
"12015",12,15,2003,59862,56570,3292,5.5
"12015",12,15,2004,61519,58148,3371,5.5
"12015",12,15,2005,66088,63430,2658,4
"12015",12,15,2006,69533,67201,2332,3.4
"12015",12,15,2007,69876,66269,3607,5.2
"12015",12,15,2008,69531,63728,5803,8.3
"12015",12,15,2009,68858,60681,8177,11.9
"12015",12,15,2010,66293,57846,8447,12.7
"12015",12,15,2011,65722,58308,7414,11.3
"12015",12,15,2012,65886,59621,6265,9.5
"12015",12,15,2013,66196,60889,5307,8
"12015",12,15,2014,66886,62292,4594,6.9
"12015",12,15,2015,67666,63599,4067,6
"12015",12,15,2016,69321,65642,3679,5.3
"12015",12,15,2017,70269,67028,3241,4.6
"12017",12,17,1990,33176,30451,2725,8.2
"12017",12,17,1991,33817,30492,3325,9.8
"12017",12,17,1992,33972,30658,3314,9.8
"12017",12,17,1993,34453,31374,3079,8.9
"12017",12,17,1994,35748,32951,2797,7.8
"12017",12,17,1995,35387,32945,2442,6.9
"12017",12,17,1996,35731,33464,2267,6.3
"12017",12,17,1997,36093,33950,2143,5.9
"12017",12,17,1998,36814,34565,2249,6.1
"12017",12,17,1999,37682,35857,1825,4.8
"12017",12,17,2000,43726,41677,2049,4.7
"12017",12,17,2001,44653,42040,2613,5.9
"12017",12,17,2002,46276,43120,3156,6.8
"12017",12,17,2003,47248,44264,2984,6.3
"12017",12,17,2004,48233,45536,2697,5.6
"12017",12,17,2005,51324,49126,2198,4.3
"12017",12,17,2006,54552,52465,2087,3.8
"12017",12,17,2007,55641,52797,2844,5.1
"12017",12,17,2008,56616,51889,4727,8.3
"12017",12,17,2009,56762,49892,6870,12.1
"12017",12,17,2010,52847,45594,7253,13.7
"12017",12,17,2011,52057,45546,6511,12.5
"12017",12,17,2012,51550,46006,5544,10.8
"12017",12,17,2013,49374,44587,4787,9.7
"12017",12,17,2014,48229,44106,4123,8.5
"12017",12,17,2015,47816,44217,3599,7.5
"12017",12,17,2016,47861,44653,3208,6.7
"12017",12,17,2017,47901,45134,2767,5.8
"12019",12,19,1990,54151,51788,2363,4.4
"12019",12,19,1991,55268,52412,2856,5.2
"12019",12,19,1992,56869,53641,3228,5.7
"12019",12,19,1993,58630,55709,2921,5
"12019",12,19,1994,61761,59363,2398,3.9
"12019",12,19,1995,64584,62620,1964,3
"12019",12,19,1996,66295,64282,2013,3
"12019",12,19,1997,68756,66587,2169,3.2
"12019",12,19,1998,71449,69432,2017,2.8
"12019",12,19,1999,74054,72060,1994,2.7
"12019",12,19,2000,73838,71600,2238,3
"12019",12,19,2001,75746,72749,2997,4
"12019",12,19,2002,76705,72821,3884,5.1
"12019",12,19,2003,78118,74524,3594,4.6
"12019",12,19,2004,81664,78118,3546,4.3
"12019",12,19,2005,86643,83661,2982,3.4
"12019",12,19,2006,91630,88878,2752,3
"12019",12,19,2007,93804,90475,3329,3.5
"12019",12,19,2008,95993,90706,5287,5.5
"12019",12,19,2009,94785,85993,8792,9.3
"12019",12,19,2010,95867,86356,9511,9.9
"12019",12,19,2011,96166,87408,8758,9.1
"12019",12,19,2012,96340,89002,7338,7.6
"12019",12,19,2013,96943,90794,6149,6.3
"12019",12,19,2014,97811,92188,5623,5.7
"12019",12,19,2015,98464,93493,4971,5
"12019",12,19,2016,101070,96543,4527,4.5
"12019",12,19,2017,104588,100617,3971,3.8
"12021",12,21,1990,73480,69442,4038,5.5
"12021",12,21,1991,75699,69600,6099,8.1
"12021",12,21,1992,77383,69876,7507,9.7
"12021",12,21,1993,80525,73639,6886,8.6
"12021",12,21,1994,82818,76165,6653,8
"12021",12,21,1995,83763,77834,5929,7.1
"12021",12,21,1996,86164,81024,5140,6
"12021",12,21,1997,90626,85883,4743,5.2
"12021",12,21,1998,95788,91610,4178,4.4
"12021",12,21,1999,99022,95142,3880,3.9
"12021",12,21,2000,116066,111735,4331,3.7
"12021",12,21,2001,124316,119036,5280,4.2
"12021",12,21,2002,129514,122728,6786,5.2
"12021",12,21,2003,133208,126494,6714,5
"12021",12,21,2004,138907,132878,6029,4.3
"12021",12,21,2005,145136,140087,5049,3.5
"12021",12,21,2006,152464,147706,4758,3.1
"12021",12,21,2007,151925,145183,6742,4.4
"12021",12,21,2008,148368,137814,10554,7.1
"12021",12,21,2009,143337,127434,15903,11.1
"12021",12,21,2010,145349,128427,16922,11.6
"12021",12,21,2011,148810,133729,15081,10.1
"12021",12,21,2012,152762,139883,12879,8.4
"12021",12,21,2013,155575,144588,10987,7.1
"12021",12,21,2014,160059,150508,9551,6
"12021",12,21,2015,163708,155094,8614,5.3
"12021",12,21,2016,169288,161411,7877,4.7
"12021",12,21,2017,171979,164974,7005,4.1
"12023",12,23,1990,20309,18565,1744,8.6
"12023",12,23,1991,20867,18793,2074,9.9
"12023",12,23,1992,21266,19075,2191,10.3
"12023",12,23,1993,22053,19990,2063,9.4
"12023",12,23,1994,22448,20659,1789,8
"12023",12,23,1995,23235,21919,1316,5.7
"12023",12,23,1996,24016,22818,1198,5
"12023",12,23,1997,25274,24072,1202,4.8
"12023",12,23,1998,25552,24345,1207,4.7
"12023",12,23,1999,25235,24079,1156,4.6
"12023",12,23,2000,25668,24657,1011,3.9
"12023",12,23,2001,25903,24451,1452,5.6
"12023",12,23,2002,26038,24606,1432,5.5
"12023",12,23,2003,26626,25345,1281,4.8
"12023",12,23,2004,27269,26070,1199,4.4
"12023",12,23,2005,28740,27757,983,3.4
"12023",12,23,2006,29805,28844,961,3.2
"12023",12,23,2007,30955,29823,1132,3.7
"12023",12,23,2008,31560,29763,1797,5.7
"12023",12,23,2009,31597,28674,2923,9.3
"12023",12,23,2010,28788,25669,3119,10.8
"12023",12,23,2011,28242,25337,2905,10.3
"12023",12,23,2012,28041,25567,2474,8.8
"12023",12,23,2013,27867,25759,2108,7.6
"12023",12,23,2014,28359,26476,1883,6.6
"12023",12,23,2015,28978,27383,1595,5.5
"12023",12,23,2016,29773,28327,1446,4.9
"12023",12,23,2017,29419,28160,1259,4.3
"12027",12,27,1990,9746,9044,702,7.2
"12027",12,27,1991,10199,9436,763,7.5
"12027",12,27,1992,10162,9126,1036,10.2
"12027",12,27,1993,10178,9127,1051,10.3
"12027",12,27,1994,10106,9324,782,7.7
"12027",12,27,1995,10317,9634,683,6.6
"12027",12,27,1996,10219,9463,756,7.4
"12027",12,27,1997,10103,9376,727,7.2
"12027",12,27,1998,9348,8648,700,7.5
"12027",12,27,1999,9182,8561,621,6.8
"12027",12,27,2000,13270,12679,591,4.5
"12027",12,27,2001,13429,12744,685,5.1
"12027",12,27,2002,13495,12642,853,6.3
"12027",12,27,2003,13780,12981,799,5.8
"12027",12,27,2004,13484,12690,794,5.9
"12027",12,27,2005,13556,12937,619,4.6
"12027",12,27,2006,14209,13691,518,3.6
"12027",12,27,2007,14328,13620,708,4.9
"12027",12,27,2008,14778,13758,1020,6.9
"12027",12,27,2009,14967,13458,1509,10.1
"12027",12,27,2010,13081,11481,1600,12.2
"12027",12,27,2011,13884,12447,1437,10.4
"12027",12,27,2012,12899,11616,1283,9.9
"12027",12,27,2013,13133,12056,1077,8.2
"12027",12,27,2014,13168,12228,940,7.1
"12027",12,27,2015,13379,12601,778,5.8
"12027",12,27,2016,13478,12770,708,5.3
"12027",12,27,2017,13833,13225,608,4.4
"12029",12,29,1990,3802,3518,284,7.5
"12029",12,29,1991,3892,3447,445,11.4
"12029",12,29,1992,3853,3456,397,10.3
"12029",12,29,1993,3954,3609,345,8.7
"12029",12,29,1994,3962,3657,305,7.7
"12029",12,29,1995,4147,3798,349,8.4
"12029",12,29,1996,3999,3660,339,8.5
"12029",12,29,1997,3993,3691,302,7.6
"12029",12,29,1998,3916,3650,266,6.8
"12029",12,29,1999,3838,3629,209,5.4
"12029",12,29,2000,5128,4899,229,4.5
"12029",12,29,2001,5273,4972,301,5.7
"12029",12,29,2002,5983,5666,317,5.3
"12029",12,29,2003,5592,5300,292,5.2
"12029",12,29,2004,5069,4800,269,5.3
"12029",12,29,2005,5550,5339,211,3.8
"12029",12,29,2006,5698,5499,199,3.5
"12029",12,29,2007,5535,5290,245,4.4
"12029",12,29,2008,5496,5080,416,7.6
"12029",12,29,2009,5582,4944,638,11.4
"12029",12,29,2010,5749,5008,741,12.9
"12029",12,29,2011,5754,5047,707,12.3
"12029",12,29,2012,5809,5215,594,10.2
"12029",12,29,2013,5846,5348,498,8.5
"12029",12,29,2014,5555,5144,411,7.4
"12029",12,29,2015,5587,5239,348,6.2
"12029",12,29,2016,5653,5346,307,5.4
"12029",12,29,2017,5800,5536,264,4.6
"12031",12,31,1990,353287,334446,18841,5.3
"12031",12,31,1991,356943,333767,23176,6.5
"12031",12,31,1992,360777,335439,25338,7
"12031",12,31,1993,361822,341294,20528,5.7
"12031",12,31,1994,369325,351419,17906,4.8
"12031",12,31,1995,376576,362048,14528,3.9
"12031",12,31,1996,379346,364596,14750,3.9
"12031",12,31,1997,385623,370392,15231,3.9
"12031",12,31,1998,391040,377767,13273,3.4
"12031",12,31,1999,396524,383585,12939,3.3
"12031",12,31,2000,408161,394593,13568,3.3
"12031",12,31,2001,412753,394619,18134,4.4
"12031",12,31,2002,409007,385707,23300,5.7
"12031",12,31,2003,408062,385700,22362,5.5
"12031",12,31,2004,411112,390042,21070,5.1
"12031",12,31,2005,421549,404681,16868,4
"12031",12,31,2006,432151,416893,15258,3.5
"12031",12,31,2007,441216,422676,18540,4.2
"12031",12,31,2008,446829,418438,28391,6.4
"12031",12,31,2009,441641,395185,46456,10.5
"12031",12,31,2010,454798,403171,51627,11.4
"12031",12,31,2011,456441,409556,46885,10.3
"12031",12,31,2012,456398,416680,39718,8.7
"12031",12,31,2013,457588,423256,34332,7.5
"12031",12,31,2014,459978,429051,30927,6.7
"12031",12,31,2015,460613,433842,26771,5.8
"12031",12,31,2016,467864,444968,22896,4.9
"12031",12,31,2017,483717,463724,19993,4.1
"12033",12,33,1990,121742,114649,7093,5.8
"12033",12,33,1991,122678,115367,7311,6
"12033",12,33,1992,123747,116654,7093,5.7
"12033",12,33,1993,123065,116742,6323,5.1
"12033",12,33,1994,124285,118518,5767,4.6
"12033",12,33,1995,123831,118509,5322,4.3
"12033",12,33,1996,122977,117787,5190,4.2
"12033",12,33,1997,123667,118259,5408,4.4
"12033",12,33,1998,124975,119921,5054,4
"12033",12,33,1999,124696,120038,4658,3.7
"12033",12,33,2000,132433,127082,5351,4
"12033",12,33,2001,131677,125012,6665,5.1
"12033",12,33,2002,129838,122747,7091,5.5
"12033",12,33,2003,131277,124650,6627,5
"12033",12,33,2004,131998,125535,6463,4.9
"12033",12,33,2005,135677,130436,5241,3.9
"12033",12,33,2006,138216,133846,4370,3.2
"12033",12,33,2007,140808,135212,5596,4
"12033",12,33,2008,138002,129494,8508,6.2
"12033",12,33,2009,137044,123507,13537,9.9
"12033",12,33,2010,139913,125755,14158,10.1
"12033",12,33,2011,140774,127131,13643,9.7
"12033",12,33,2012,139701,127948,11753,8.4
"12033",12,33,2013,138979,128926,10053,7.2
"12033",12,33,2014,139309,130372,8937,6.4
"12033",12,33,2015,138136,130409,7727,5.6
"12033",12,33,2016,141022,134063,6959,4.9
"12033",12,33,2017,144784,138797,5987,4.1
"12035",12,35,1990,11820,11076,744,6.3
"12035",12,35,1991,12584,11496,1088,8.6
"12035",12,35,1992,13058,12050,1008,7.7
"12035",12,35,1993,13905,13073,832,6
"12035",12,35,1994,14443,13792,651,4.5
"12035",12,35,1995,15180,14667,513,3.4
"12035",12,35,1996,16159,15619,540,3.3
"12035",12,35,1997,16684,16133,551,3.3
"12035",12,35,1998,17566,17010,556,3.2
"12035",12,35,1999,18248,17635,613,3.4
"12035",12,35,2000,21000,20245,755,3.6
"12035",12,35,2001,22175,21118,1057,4.8
"12035",12,35,2002,23591,22158,1433,6.1
"12035",12,35,2003,24930,23489,1441,5.8
"12035",12,35,2004,27368,25913,1455,5.3
"12035",12,35,2005,29981,28668,1313,4.4
"12035",12,35,2006,30723,29335,1388,4.5
"12035",12,35,2007,30928,28887,2041,6.6
"12035",12,35,2008,31935,28769,3166,9.9
"12035",12,35,2009,32733,27910,4823,14.7
"12035",12,35,2010,41338,36208,5130,12.4
"12035",12,35,2011,41940,37167,4773,11.4
"12035",12,35,2012,42156,37998,4158,9.9
"12035",12,35,2013,44020,40340,3680,8.4
"12035",12,35,2014,43219,40046,3173,7.3
"12035",12,35,2015,43676,40928,2748,6.3
"12035",12,35,2016,45359,42876,2483,5.5
"12035",12,35,2017,46377,44220,2157,4.7
"12037",12,37,1990,3887,3675,212,5.5
"12037",12,37,1991,4190,3968,222,5.3
"12037",12,37,1992,4423,4145,278,6.3
"12037",12,37,1993,4447,4284,163,3.7
"12037",12,37,1994,4602,4452,150,3.3
"12037",12,37,1995,4910,4697,213,4.3
"12037",12,37,1996,4469,4152,317,7.1
"12037",12,37,1997,4613,4293,320,6.9
"12037",12,37,1998,4729,4476,253,5.3
"12037",12,37,1999,4733,4505,228,4.8
"12037",12,37,2000,4411,4237,174,3.9
"12037",12,37,2001,4600,4400,200,4.3
"12037",12,37,2002,4896,4649,247,5
"12037",12,37,2003,4955,4732,223,4.5
"12037",12,37,2004,5095,4909,186,3.7
"12037",12,37,2005,5136,4950,186,3.6
"12037",12,37,2006,5054,4903,151,3
"12037",12,37,2007,4922,4763,159,3.2
"12037",12,37,2008,4817,4582,235,4.9
"12037",12,37,2009,4919,4555,364,7.4
"12037",12,37,2010,4936,4543,393,8
"12037",12,37,2011,5051,4665,386,7.6
"12037",12,37,2012,5051,4724,327,6.5
"12037",12,37,2013,4992,4716,276,5.5
"12037",12,37,2014,4944,4666,278,5.6
"12037",12,37,2015,4773,4548,225,4.7
"12037",12,37,2016,4738,4534,204,4.3
"12037",12,37,2017,4770,4599,171,3.6
"12039",12,39,1990,18119,17204,915,5
"12039",12,39,1991,18598,17351,1247,6.7
"12039",12,39,1992,18796,17433,1363,7.3
"12039",12,39,1993,18938,17717,1221,6.4
"12039",12,39,1994,19189,18138,1051,5.5
"12039",12,39,1995,19431,18601,830,4.3
"12039",12,39,1996,20081,19101,980,4.9
"12039",12,39,1997,19799,18857,942,4.8
"12039",12,39,1998,20260,19320,940,4.6
"12039",12,39,1999,20524,19755,769,3.7
"12039",12,39,2000,19945,19145,800,4
"12039",12,39,2001,20290,19285,1005,5
"12039",12,39,2002,20000,18863,1137,5.7
"12039",12,39,2003,19737,18699,1038,5.3
"12039",12,39,2004,19987,19022,965,4.8
"12039",12,39,2005,20488,19692,796,3.9
"12039",12,39,2006,21029,20303,726,3.5
"12039",12,39,2007,20770,19853,917,4.4
"12039",12,39,2008,21106,19783,1323,6.3
"12039",12,39,2009,21270,19147,2123,10
"12039",12,39,2010,20080,17714,2366,11.8
"12039",12,39,2011,19614,17342,2272,11.6
"12039",12,39,2012,18900,16952,1948,10.3
"12039",12,39,2013,18866,17138,1728,9.2
"12039",12,39,2014,18811,17263,1548,8.2
"12039",12,39,2015,18212,16900,1312,7.2
"12039",12,39,2016,18215,17078,1137,6.2
"12039",12,39,2017,18477,17495,982,5.3
"12041",12,41,1990,4034,3718,316,7.8
"12041",12,41,1991,4072,3751,321,7.9
"12041",12,41,1992,4112,3822,290,7.1
"12041",12,41,1993,4215,3956,259,6.1
"12041",12,41,1994,4148,3954,194,4.7
"12041",12,41,1995,4375,4216,159,3.6
"12041",12,41,1996,4562,4368,194,4.3
"12041",12,41,1997,4706,4508,198,4.2
"12041",12,41,1998,4748,4552,196,4.1
"12041",12,41,1999,4650,4460,190,4.1
"12041",12,41,2000,6427,6196,231,3.6
"12041",12,41,2001,6589,6293,296,4.5
"12041",12,41,2002,6726,6390,336,5
"12041",12,41,2003,6984,6673,311,4.5
"12041",12,41,2004,7135,6847,288,4
"12041",12,41,2005,7489,7251,238,3.2
"12041",12,41,2006,7728,7505,223,2.9
"12041",12,41,2007,7613,7318,295,3.9
"12041",12,41,2008,7828,7373,455,5.8
"12041",12,41,2009,7712,6993,719,9.3
"12041",12,41,2010,6874,6132,742,10.8
"12041",12,41,2011,6857,6151,706,10.3
"12041",12,41,2012,6717,6108,609,9.1
"12041",12,41,2013,6623,6103,520,7.9
"12041",12,41,2014,6556,6115,441,6.7
"12041",12,41,2015,6499,6131,368,5.7
"12041",12,41,2016,6680,6347,333,5
"12041",12,41,2017,6839,6551,288,4.2
"12043",12,43,1990,3237,2893,344,10.6
"12043",12,43,1991,3298,2979,319,9.7
"12043",12,43,1992,3467,3057,410,11.8
"12043",12,43,1993,3486,3079,407,11.7
"12043",12,43,1994,3586,3213,373,10.4
"12043",12,43,1995,3552,3206,346,9.7
"12043",12,43,1996,4217,3846,371,8.8
"12043",12,43,1997,4161,3801,360,8.7
"12043",12,43,1998,3953,3596,357,9
"12043",12,43,1999,3952,3650,302,7.6
"12043",12,43,2000,4085,3892,193,4.7
"12043",12,43,2001,4329,4072,257,5.9
"12043",12,43,2002,4566,4290,276,6
"12043",12,43,2003,4499,4245,254,5.6
"12043",12,43,2004,4499,4249,250,5.6
"12043",12,43,2005,4295,4085,210,4.9
"12043",12,43,2006,4691,4509,182,3.9
"12043",12,43,2007,4789,4559,230,4.8
"12043",12,43,2008,4675,4345,330,7.1
"12043",12,43,2009,4843,4394,449,9.3
"12043",12,43,2010,5544,5017,527,9.5
"12043",12,43,2011,5292,4788,504,9.5
"12043",12,43,2012,5701,5262,439,7.7
"12043",12,43,2013,5468,5062,406,7.4
"12043",12,43,2014,4921,4543,378,7.7
"12043",12,43,2015,4711,4374,337,7.2
"12043",12,43,2016,4719,4426,293,6.2
"12043",12,43,2017,5043,4782,261,5.2
"12045",12,45,1990,5316,4962,354,6.7
"12045",12,45,1991,5359,5003,356,6.6
"12045",12,45,1992,5543,5072,471,8.5
"12045",12,45,1993,5846,5419,427,7.3
"12045",12,45,1994,5828,5477,351,6
"12045",12,45,1995,5846,5513,333,5.7
"12045",12,45,1996,5799,5391,408,7
"12045",12,45,1997,5886,5158,728,12.4
"12045",12,45,1998,5454,4789,665,12.2
"12045",12,45,1999,5516,4732,784,14.2
"12045",12,45,2000,5245,4928,317,6
"12045",12,45,2001,5342,5025,317,5.9
"12045",12,45,2002,5502,5194,308,5.6
"12045",12,45,2003,5842,5561,281,4.8
"12045",12,45,2004,5964,5728,236,4
"12045",12,45,2005,6321,6110,211,3.3
"12045",12,45,2006,6419,6221,198,3.1
"12045",12,45,2007,6269,6027,242,3.9
"12045",12,45,2008,6368,5957,411,6.5
"12045",12,45,2009,6361,5753,608,9.6
"12045",12,45,2010,6232,5591,641,10.3
"12045",12,45,2011,6241,5638,603,9.7
"12045",12,45,2012,6091,5598,493,8.1
"12045",12,45,2013,6162,5746,416,6.8
"12045",12,45,2014,6124,5752,372,6.1
"12045",12,45,2015,5995,5680,315,5.3
"12045",12,45,2016,5968,5692,276,4.6
"12045",12,45,2017,6024,5792,232,3.9
"12047",12,47,1990,4206,3869,337,8
"12047",12,47,1991,4143,3769,374,9
"12047",12,47,1992,4148,3604,544,13.1
"12047",12,47,1993,3778,3169,609,16.1
"12047",12,47,1994,3627,3259,368,10.1
"12047",12,47,1995,3769,3516,253,6.7
"12047",12,47,1996,3820,3522,298,7.8
"12047",12,47,1997,3543,3285,258,7.3
"12047",12,47,1998,3558,3266,292,8.2
"12047",12,47,1999,3547,3306,241,6.8
"12047",12,47,2000,4580,4335,245,5.3
"12047",12,47,2001,4393,4052,341,7.8
"12047",12,47,2002,4364,4091,273,6.3
"12047",12,47,2003,4517,4266,251,5.6
"12047",12,47,2004,4558,4333,225,4.9
"12047",12,47,2005,4616,4429,187,4.1
"12047",12,47,2006,4641,4463,178,3.8
"12047",12,47,2007,4627,4411,216,4.7
"12047",12,47,2008,4791,4441,350,7.3
"12047",12,47,2009,4848,4306,542,11.2
"12047",12,47,2010,4808,4258,550,11.4
"12047",12,47,2011,4898,4389,509,10.4
"12047",12,47,2012,5175,4717,458,8.9
"12047",12,47,2013,4633,4236,397,8.6
"12047",12,47,2014,4605,4255,350,7.6
"12047",12,47,2015,4522,4228,294,6.5
"12047",12,47,2016,4659,4396,263,5.6
"12047",12,47,2017,4438,4227,211,4.8
"12049",12,49,1990,9272,8179,1093,11.8
"12049",12,49,1991,9673,8593,1080,11.2
"12049",12,49,1992,9809,8327,1482,15.1
"12049",12,49,1993,10423,8785,1638,15.7
"12049",12,49,1994,11091,9520,1571,14.2
"12049",12,49,1995,11444,9949,1495,13.1
"12049",12,49,1996,11408,9809,1599,14
"12049",12,49,1997,11058,9602,1456,13.2
"12049",12,49,1998,9830,8615,1215,12.4
"12049",12,49,1999,9798,8759,1039,10.6
"12049",12,49,2000,10751,10114,637,5.9
"12049",12,49,2001,10778,10010,768,7.1
"12049",12,49,2002,10997,10184,813,7.4
"12049",12,49,2003,11115,10364,751,6.8
"12049",12,49,2004,10934,10245,689,6.3
"12049",12,49,2005,11378,10834,544,4.8
"12049",12,49,2006,11982,11506,476,4
"12049",12,49,2007,11858,11313,545,4.6
"12049",12,49,2008,11758,10952,806,6.9
"12049",12,49,2009,11962,10701,1261,10.5
"12049",12,49,2010,11764,10410,1354,11.5
"12049",12,49,2011,11916,10718,1198,10.1
"12049",12,49,2012,11844,10792,1052,8.9
"12049",12,49,2013,11052,10141,911,8.2
"12049",12,49,2014,10343,9550,793,7.7
"12049",12,49,2015,10091,9386,705,7
"12049",12,49,2016,9258,8646,612,6.6
"12049",12,49,2017,9378,8858,520,5.5
"12051",12,51,1990,12971,11242,1729,13.3
"12051",12,51,1991,14206,12317,1889,13.3
"12051",12,51,1992,15534,13016,2518,16.2
"12051",12,51,1993,15721,13298,2423,15.4
"12051",12,51,1994,16293,13622,2671,16.4
"12051",12,51,1995,16626,14102,2524,15.2
"12051",12,51,1996,16597,14181,2416,14.6
"12051",12,51,1997,17410,15050,2360,13.6
"12051",12,51,1998,16248,14091,2157,13.3
"12051",12,51,1999,16248,14158,2090,12.9
"12051",12,51,2000,16295,15116,1179,7.2
"12051",12,51,2001,17101,15770,1331,7.8
"12051",12,51,2002,17318,15828,1490,8.6
"12051",12,51,2003,17176,15696,1480,8.6
"12051",12,51,2004,17001,15543,1458,8.6
"12051",12,51,2005,17375,16088,1287,7.4
"12051",12,51,2006,17698,16578,1120,6.3
"12051",12,51,2007,18008,16654,1354,7.5
"12051",12,51,2008,17565,15619,1946,11.1
"12051",12,51,2009,17192,14744,2448,14.2
"12051",12,51,2010,18361,15786,2575,14
"12051",12,51,2011,17971,15482,2489,13.9
"12051",12,51,2012,17004,14830,2174,12.8
"12051",12,51,2013,16651,14661,1990,12
"12051",12,51,2014,15827,14033,1794,11.3
"12051",12,51,2015,15099,13491,1608,10.6
"12051",12,51,2016,15411,14103,1308,8.5
"12051",12,51,2017,15652,14518,1134,7.2
"12053",12,53,1990,36327,33655,2672,7.4
"12053",12,53,1991,37497,34108,3389,9
"12053",12,53,1992,38813,35156,3657,9.4
"12053",12,53,1993,40122,37099,3023,7.5
"12053",12,53,1994,42917,40026,2891,6.7
"12053",12,53,1995,43602,41253,2349,5.4
"12053",12,53,1996,44796,42728,2068,4.6
"12053",12,53,1997,46423,44524,1899,4.1
"12053",12,53,1998,48309,46358,1951,4
"12053",12,53,1999,49621,47891,1730,3.5
"12053",12,53,2000,49574,47411,2163,4.4
"12053",12,53,2001,50567,47829,2738,5.4
"12053",12,53,2002,51545,47944,3601,7
"12053",12,53,2003,52747,49323,3424,6.5
"12053",12,53,2004,55841,52578,3263,5.8
"12053",12,53,2005,57093,54294,2799,4.9
"12053",12,53,2006,59884,57191,2693,4.5
"12053",12,53,2007,61681,58059,3622,5.9
"12053",12,53,2008,63163,57578,5585,8.8
"12053",12,53,2009,62318,54056,8262,13.3
"12053",12,53,2010,66470,57464,9006,13.5
"12053",12,53,2011,66199,57925,8274,12.5
"12053",12,53,2012,66289,59281,7008,10.6
"12053",12,53,2013,66338,60381,5957,9
"12053",12,53,2014,66235,60994,5241,7.9
"12053",12,53,2015,66100,61502,4598,7
"12053",12,53,2016,67945,63856,4089,6
"12053",12,53,2017,69356,65799,3557,5.1
"12055",12,55,1990,25951,23615,2336,9
"12055",12,55,1991,26715,24333,2382,8.9
"12055",12,55,1992,27273,24385,2888,10.6
"12055",12,55,1993,27377,24511,2866,10.5
"12055",12,55,1994,28295,25560,2735,9.7
"12055",12,55,1995,28587,26081,2506,8.8
"12055",12,55,1996,28601,26132,2469,8.6
"12055",12,55,1997,28104,25687,2417,8.6
"12055",12,55,1998,28299,25907,2392,8.5
"12055",12,55,1999,26906,24985,1921,7.1
"12055",12,55,2000,33162,31569,1593,4.8
"12055",12,55,2001,34522,32679,1843,5.3
"12055",12,55,2002,36262,33986,2276,6.3
"12055",12,55,2003,37938,35768,2170,5.7
"12055",12,55,2004,37751,35723,2028,5.4
"12055",12,55,2005,39983,38293,1690,4.2
"12055",12,55,2006,40797,39270,1527,3.7
"12055",12,55,2007,40249,38284,1965,4.9
"12055",12,55,2008,40939,37916,3023,7.4
"12055",12,55,2009,40483,36113,4370,10.8
"12055",12,55,2010,37247,32587,4660,12.5
"12055",12,55,2011,38151,33773,4378,11.5
"12055",12,55,2012,37385,33542,3843,10.3
"12055",12,55,2013,36128,32688,3440,9.5
"12055",12,55,2014,35843,32821,3022,8.4
"12055",12,55,2015,35344,32691,2653,7.5
"12055",12,55,2016,35739,33410,2329,6.5
"12055",12,55,2017,35921,33902,2019,5.6
"12057",12,57,1990,456029,433823,22206,4.9
"12057",12,57,1991,456479,427333,29146,6.4
"12057",12,57,1992,468484,434253,34231,7.3
"12057",12,57,1993,480840,449262,31578,6.6
"12057",12,57,1994,497980,472379,25601,5.1
"12057",12,57,1995,507720,485604,22116,4.4
"12057",12,57,1996,514463,494264,20199,3.9
"12057",12,57,1997,534015,515515,18500,3.5
"12057",12,57,1998,552712,536723,15989,2.9
"12057",12,57,1999,570838,555196,15642,2.7
"12057",12,57,2000,528746,511461,17285,3.3
"12057",12,57,2001,539862,516621,23241,4.3
"12057",12,57,2002,545558,515356,30202,5.5
"12057",12,57,2003,550232,521627,28605,5.2
"12057",12,57,2004,569195,543533,25662,4.5
"12057",12,57,2005,570252,548804,21448,3.8
"12057",12,57,2006,585548,566146,19402,3.3
"12057",12,57,2007,595244,570539,24705,4.2
"12057",12,57,2008,599256,560054,39202,6.5
"12057",12,57,2009,596872,533687,63185,10.6
"12057",12,57,2010,645687,576400,69287,10.7
"12057",12,57,2011,661540,598119,63421,9.6
"12057",12,57,2012,668540,615740,52800,7.9
"12057",12,57,2013,673420,629073,44347,6.6
"12057",12,57,2014,682847,643346,39501,5.8
"12057",12,57,2015,689381,654510,34871,5.1
"12057",12,57,2016,707545,676381,31164,4.4
"12057",12,57,2017,723973,696278,27695,3.8
"12059",12,59,1990,6774,6304,470,6.9
"12059",12,59,1991,6511,6077,434,6.7
"12059",12,59,1992,6464,5931,533,8.2
"12059",12,59,1993,6580,6108,472,7.2
"12059",12,59,1994,6896,6470,426,6.2
"12059",12,59,1995,7043,6548,495,7
"12059",12,59,1996,7006,6515,491,7
"12059",12,59,1997,6837,6390,447,6.5
"12059",12,59,1998,6842,6380,462,6.8
"12059",12,59,1999,6798,6408,390,5.7
"12059",12,59,2000,7737,7364,373,4.8
"12059",12,59,2001,7754,7271,483,6.2
"12059",12,59,2002,7660,7210,450,5.9
"12059",12,59,2003,7744,7363,381,4.9
"12059",12,59,2004,7987,7619,368,4.6
"12059",12,59,2005,8366,8064,302,3.6
"12059",12,59,2006,8625,8362,263,3
"12059",12,59,2007,8769,8455,314,3.6
"12059",12,59,2008,8999,8531,468,5.2
"12059",12,59,2009,8884,8173,711,8
"12059",12,59,2010,7190,6445,745,10.4
"12059",12,59,2011,7195,6488,707,9.8
"12059",12,59,2012,7166,6534,632,8.8
"12059",12,59,2013,7012,6461,551,7.9
"12059",12,59,2014,6862,6383,479,7
"12059",12,59,2015,6692,6280,412,6.2
"12059",12,59,2016,6715,6353,362,5.4
"12059",12,59,2017,6801,6477,324,4.8
"12061",12,61,1990,41314,36566,4748,11.5
"12061",12,61,1991,40568,35435,5133,12.7
"12061",12,61,1992,40347,34904,5443,13.5
"12061",12,61,1993,40126,35505,4621,11.5
"12061",12,61,1994,41371,36867,4504,10.9
"12061",12,61,1995,42944,38716,4228,9.8
"12061",12,61,1996,44232,40116,4116,9.3
"12061",12,61,1997,45632,41784,3848,8.4
"12061",12,61,1998,47403,43496,3907,8.2
"12061",12,61,1999,47140,43428,3712,7.9
"12061",12,61,2000,51043,48426,2617,5.1
"12061",12,61,2001,52803,49612,3191,6
"12061",12,61,2002,53979,49958,4021,7.4
"12061",12,61,2003,56163,52242,3921,7
"12061",12,61,2004,56200,52264,3936,7
"12061",12,61,2005,59484,56638,2846,4.8
"12061",12,61,2006,61703,59163,2540,4.1
"12061",12,61,2007,62723,59155,3568,5.7
"12061",12,61,2008,62940,57748,5192,8.2
"12061",12,61,2009,62299,54261,8038,12.9
"12061",12,61,2010,61384,52848,8536,13.9
"12061",12,61,2011,61940,54097,7843,12.7
"12061",12,61,2012,62012,55217,6795,11
"12061",12,61,2013,61499,55568,5931,9.6
"12061",12,61,2014,61753,56875,4878,7.9
"12061",12,61,2015,61223,57023,4200,6.9
"12061",12,61,2016,62211,58480,3731,6
"12061",12,61,2017,63322,60169,3153,5
"12063",12,63,1990,18820,17699,1121,6
"12063",12,63,1991,19534,18204,1330,6.8
"12063",12,63,1992,19949,18538,1411,7.1
"12063",12,63,1993,19903,18605,1298,6.5
"12063",12,63,1994,19680,18416,1264,6.4
"12063",12,63,1995,19408,18352,1056,5.4
"12063",12,63,1996,19195,18308,887,4.6
"12063",12,63,1997,18706,17781,925,4.9
"12063",12,63,1998,18891,17854,1037,5.5
"12063",12,63,1999,18562,17318,1244,6.7
"12063",12,63,2000,19391,18499,892,4.6
"12063",12,63,2001,19641,18645,996,5.1
"12063",12,63,2002,20079,19117,962,4.8
"12063",12,63,2003,20181,19309,872,4.3
"12063",12,63,2004,20873,20015,858,4.1
"12063",12,63,2005,21058,20313,745,3.5
"12063",12,63,2006,21288,20527,761,3.6
"12063",12,63,2007,21538,20679,859,4
"12063",12,63,2008,22155,20973,1182,5.3
"12063",12,63,2009,21958,20328,1630,7.4
"12063",12,63,2010,18938,17214,1724,9.1
"12063",12,63,2011,18260,16531,1729,9.5
"12063",12,63,2012,18067,16502,1565,8.7
"12063",12,63,2013,17779,16438,1341,7.5
"12063",12,63,2014,17484,16313,1171,6.7
"12063",12,63,2015,17313,16291,1022,5.9
"12063",12,63,2016,17347,16445,902,5.2
"12063",12,63,2017,17307,16537,770,4.4
"12065",12,65,1990,5299,5074,225,4.2
"12065",12,65,1991,5555,5265,290,5.2
"12065",12,65,1992,5712,5389,323,5.7
"12065",12,65,1993,5610,5344,266,4.7
"12065",12,65,1994,5415,5149,266,4.9
"12065",12,65,1995,5415,5155,260,4.8
"12065",12,65,1996,5453,5190,263,4.8
"12065",12,65,1997,5333,5084,249,4.7
"12065",12,65,1998,5170,4946,224,4.3
"12065",12,65,1999,5034,4811,223,4.4
"12065",12,65,2000,6065,5841,224,3.7
"12065",12,65,2001,6318,6030,288,4.6
"12065",12,65,2002,6407,6108,299,4.7
"12065",12,65,2003,6511,6223,288,4.4
"12065",12,65,2004,6627,6377,250,3.8
"12065",12,65,2005,6814,6599,215,3.2
"12065",12,65,2006,7066,6863,203,2.9
"12065",12,65,2007,6749,6519,230,3.4
"12065",12,65,2008,6844,6491,353,5.2
"12065",12,65,2009,6578,6042,536,8.1
"12065",12,65,2010,6042,5443,599,9.9
"12065",12,65,2011,5918,5323,595,10.1
"12065",12,65,2012,5505,4996,509,9.2
"12065",12,65,2013,5469,5045,424,7.8
"12065",12,65,2014,5497,5134,363,6.6
"12065",12,65,2015,5375,5054,321,6
"12065",12,65,2016,5388,5106,282,5.2
"12065",12,65,2017,5444,5209,235,4.3
"12067",12,67,1990,2334,2198,136,5.8
"12067",12,67,1991,2288,2131,157,6.9
"12067",12,67,1992,2322,2180,142,6.1
"12067",12,67,1993,2351,2210,141,6
"12067",12,67,1994,2464,2356,108,4.4
"12067",12,67,1995,2670,2576,94,3.5
"12067",12,67,1996,2698,2619,79,2.9
"12067",12,67,1997,2891,2810,81,2.8
"12067",12,67,1998,2884,2803,81,2.8
"12067",12,67,1999,3050,2978,72,2.4
"12067",12,67,2000,2718,2607,111,4.1
"12067",12,67,2001,2663,2518,145,5.4
"12067",12,67,2002,2761,2624,137,5
"12067",12,67,2003,2804,2686,118,4.2
"12067",12,67,2004,2797,2702,95,3.4
"12067",12,67,2005,2798,2713,85,3
"12067",12,67,2006,2850,2771,79,2.8
"12067",12,67,2007,2921,2833,88,3
"12067",12,67,2008,2978,2839,139,4.7
"12067",12,67,2009,3074,2844,230,7.5
"12067",12,67,2010,3404,3156,248,7.3
"12067",12,67,2011,3636,3409,227,6.2
"12067",12,67,2012,3485,3286,199,5.7
"12067",12,67,2013,3501,3319,182,5.2
"12067",12,67,2014,3354,3182,172,5.1
"12067",12,67,2015,3204,3057,147,4.6
"12067",12,67,2016,2968,2840,128,4.3
"12067",12,67,2017,2955,2845,110,3.7
"12069",12,69,1990,66829,61369,5460,8.2
"12069",12,69,1991,66651,61069,5582,8.4
"12069",12,69,1992,69338,63202,6136,8.8
"12069",12,69,1993,71310,66401,4909,6.9
"12069",12,69,1994,74731,70081,4650,6.2
"12069",12,69,1995,78211,74057,4154,5.3
"12069",12,69,1996,81711,77990,3721,4.6
"12069",12,69,1997,86315,82785,3530,4.1
"12069",12,69,1998,90734,87688,3046,3.4
"12069",12,69,1999,95616,93064,2552,2.7
"12069",12,69,2000,93264,89912,3352,3.6
"12069",12,69,2001,97392,92899,4493,4.6
"12069",12,69,2002,99439,93581,5858,5.9
"12069",12,69,2003,103685,98199,5486,5.3
"12069",12,69,2004,110583,105453,5130,4.6
"12069",12,69,2005,118339,113846,4493,3.8
"12069",12,69,2006,126341,122105,4236,3.4
"12069",12,69,2007,132744,127162,5582,4.2
"12069",12,69,2008,136844,127816,9028,6.6
"12069",12,69,2009,135874,120749,15125,11.1
"12069",12,69,2010,134021,118246,15775,11.8
"12069",12,69,2011,133860,119672,14188,10.6
"12069",12,69,2012,134048,122203,11845,8.8
"12069",12,69,2013,135456,125441,10015,7.4
"12069",12,69,2014,138345,129500,8845,6.4
"12069",12,69,2015,140801,133031,7770,5.5
"12069",12,69,2016,146168,139096,7072,4.8
"12069",12,69,2017,151015,144864,6151,4.1
"12071",12,71,1990,155371,149321,6050,3.9
"12071",12,71,1991,158371,148493,9878,6.2
"12071",12,71,1992,162840,150465,12375,7.6
"12071",12,71,1993,165264,155513,9751,5.9
"12071",12,71,1994,171853,163541,8312,4.8
"12071",12,71,1995,175427,168059,7368,4.2
"12071",12,71,1996,174906,168114,6792,3.9
"12071",12,71,1997,177284,171058,6226,3.5
"12071",12,71,1998,182214,176555,5659,3.1
"12071",12,71,1999,186043,181024,5019,2.7
"12071",12,71,2000,207658,200939,6719,3.2
"12071",12,71,2001,219821,211335,8486,3.9
"12071",12,71,2002,228531,217154,11377,5
"12071",12,71,2003,237744,226562,11182,4.7
"12071",12,71,2004,251852,241399,10453,4.2
"12071",12,71,2005,272752,263972,8780,3.2
"12071",12,71,2006,287157,278772,8385,2.9
"12071",12,71,2007,290882,277066,13816,4.7
"12071",12,71,2008,286092,262214,23878,8.3
"12071",12,71,2009,278817,244526,34291,12.3
"12071",12,71,2010,283236,247790,35446,12.5
"12071",12,71,2011,287064,255884,31180,10.9
"12071",12,71,2012,292354,266535,25819,8.8
"12071",12,71,2013,299129,277332,21797,7.3
"12071",12,71,2014,310352,291638,18714,6
"12071",12,71,2015,319381,302883,16498,5.2
"12071",12,71,2016,329489,314325,15164,4.6
"12071",12,71,2017,335542,322180,13362,4
"12073",12,73,1990,113420,109740,3680,3.2
"12073",12,73,1991,115895,111549,4346,3.7
"12073",12,73,1992,118350,113672,4678,4
"12073",12,73,1993,121340,116880,4460,3.7
"12073",12,73,1994,125201,120872,4329,3.5
"12073",12,73,1995,127896,124327,3569,2.8
"12073",12,73,1996,126481,122755,3726,2.9
"12073",12,73,1997,129027,125211,3816,3
"12073",12,73,1998,132119,128254,3865,2.9
"12073",12,73,1999,134906,131423,3483,2.6
"12073",12,73,2000,134773,130656,4117,3.1
"12073",12,73,2001,134525,129594,4931,3.7
"12073",12,73,2002,133250,127314,5936,4.5
"12073",12,73,2003,134093,128524,5569,4.2
"12073",12,73,2004,133899,128757,5142,3.8
"12073",12,73,2005,137708,133367,4341,3.2
"12073",12,73,2006,140574,136722,3852,2.7
"12073",12,73,2007,144890,140326,4564,3.1
"12073",12,73,2008,147218,140372,6846,4.7
"12073",12,73,2009,147363,136962,10401,7.1
"12073",12,73,2010,149972,138074,11898,7.9
"12073",12,73,2011,149969,138321,11648,7.8
"12073",12,73,2012,149342,138903,10439,7
"12073",12,73,2013,148268,139235,9033,6.1
"12073",12,73,2014,149877,141567,8310,5.5
"12073",12,73,2015,147573,140142,7431,5
"12073",12,73,2016,150292,143506,6786,4.5
"12073",12,73,2017,152544,146651,5893,3.9
"12075",12,75,1990,10693,10097,596,5.6
"12075",12,75,1991,10803,10066,737,6.8
"12075",12,75,1992,11067,10201,866,7.8
"12075",12,75,1993,11539,10767,772,6.7
"12075",12,75,1994,11918,11226,692,5.8
"12075",12,75,1995,12768,12165,603,4.7
"12075",12,75,1996,13240,12646,594,4.5
"12075",12,75,1997,13329,12732,597,4.5
"12075",12,75,1998,13326,12752,574,4.3
"12075",12,75,1999,13404,12960,444,3.3
"12075",12,75,2000,14394,13834,560,3.9
"12075",12,75,2001,14634,13865,769,5.3
"12075",12,75,2002,14816,13937,879,5.9
"12075",12,75,2003,15251,14419,832,5.5
"12075",12,75,2004,15616,14860,756,4.8
"12075",12,75,2005,16579,15948,631,3.8
"12075",12,75,2006,16500,15917,583,3.5
"12075",12,75,2007,16793,16072,721,4.3
"12075",12,75,2008,16891,15666,1225,7.3
"12075",12,75,2009,16742,14824,1918,11.5
"12075",12,75,2010,17327,15262,2065,11.9
"12075",12,75,2011,16974,15125,1849,10.9
"12075",12,75,2012,16732,15176,1556,9.3
"12075",12,75,2013,16335,15001,1334,8.2
"12075",12,75,2014,16298,15182,1116,6.8
"12075",12,75,2015,16448,15496,952,5.8
"12075",12,75,2016,16655,15797,858,5.2
"12075",12,75,2017,16967,16230,737,4.3
"12077",12,77,1990,2216,2128,88,4
"12077",12,77,1991,2298,2167,131,5.7
"12077",12,77,1992,2373,2260,113,4.8
"12077",12,77,1993,2292,2200,92,4
"12077",12,77,1994,2370,2285,85,3.6
"12077",12,77,1995,2484,2428,56,2.3
"12077",12,77,1996,2478,2408,70,2.8
"12077",12,77,1997,2558,2441,117,4.6
"12077",12,77,1998,2433,2296,137,5.6
"12077",12,77,1999,2389,2271,118,4.9
"12077",12,77,2000,2621,2512,109,4.2
"12077",12,77,2001,2706,2573,133,4.9
"12077",12,77,2002,2930,2796,134,4.6
"12077",12,77,2003,3026,2911,115,3.8
"12077",12,77,2004,3141,3027,114,3.6
"12077",12,77,2005,3297,3204,93,2.8
"12077",12,77,2006,3537,3444,93,2.6
"12077",12,77,2007,3667,3563,104,2.8
"12077",12,77,2008,3851,3683,168,4.4
"12077",12,77,2009,3867,3644,223,5.8
"12077",12,77,2010,2933,2676,257,8.8
"12077",12,77,2011,2862,2600,262,9.2
"12077",12,77,2012,2747,2529,218,7.9
"12077",12,77,2013,2844,2654,190,6.7
"12077",12,77,2014,2752,2569,183,6.6
"12077",12,77,2015,2638,2483,155,5.9
"12077",12,77,2016,2639,2504,135,5.1
"12077",12,77,2017,2632,2514,118,4.5
"12079",12,79,1990,7065,6439,626,8.9
"12079",12,79,1991,7034,6442,592,8.4
"12079",12,79,1992,6897,6350,547,7.9
"12079",12,79,1993,6978,6496,482,6.9
"12079",12,79,1994,7252,6872,380,5.2
"12079",12,79,1995,7500,7194,306,4.1
"12079",12,79,1996,7446,7095,351,4.7
"12079",12,79,1997,7446,7057,389,5.2
"12079",12,79,1998,7482,7113,369,4.9
"12079",12,79,1999,7672,7379,293,3.8
"12079",12,79,2000,7695,7381,314,4.1
"12079",12,79,2001,7412,7031,381,5.1
"12079",12,79,2002,7220,6835,385,5.3
"12079",12,79,2003,7212,6845,367,5.1
"12079",12,79,2004,7192,6801,391,5.4
"12079",12,79,2005,7438,7091,347,4.7
"12079",12,79,2006,7339,6960,379,5.2
"12079",12,79,2007,6954,6526,428,6.2
"12079",12,79,2008,7034,6530,504,7.2
"12079",12,79,2009,7140,6378,762,10.7
"12079",12,79,2010,7946,7148,798,10
"12079",12,79,2011,8078,7303,775,9.6
"12079",12,79,2012,7999,7313,686,8.6
"12079",12,79,2013,7910,7295,615,7.8
"12079",12,79,2014,7738,7186,552,7.1
"12079",12,79,2015,7476,7016,460,6.2
"12079",12,79,2016,7329,6945,384,5.2
"12079",12,79,2017,7407,7083,324,4.4
"12081",12,81,1990,95658,91843,3815,4
"12081",12,81,1991,99037,93733,5304,5.4
"12081",12,81,1992,103517,97122,6395,6.2
"12081",12,81,1993,98842,93469,5373,5.4
"12081",12,81,1994,101852,97275,4577,4.5
"12081",12,81,1995,104619,100448,4171,4
"12081",12,81,1996,113221,109174,4047,3.6
"12081",12,81,1997,117927,114297,3630,3.1
"12081",12,81,1998,119063,115804,3259,2.7
"12081",12,81,1999,125056,122143,2913,2.3
"12081",12,81,2000,123188,119262,3926,3.2
"12081",12,81,2001,125865,120586,5279,4.2
"12081",12,81,2002,132835,125956,6879,5.2
"12081",12,81,2003,136093,129549,6544,4.8
"12081",12,81,2004,142577,136478,6099,4.3
"12081",12,81,2005,144617,139595,5022,3.5
"12081",12,81,2006,149208,144644,4564,3.1
"12081",12,81,2007,147550,141381,6169,4.2
"12081",12,81,2008,144269,133932,10337,7.2
"12081",12,81,2009,142403,125901,16502,11.6
"12081",12,81,2010,147572,130750,16822,11.4
"12081",12,81,2011,148173,133384,14789,10
"12081",12,81,2012,150763,138509,12254,8.1
"12081",12,81,2013,155326,144918,10408,6.7
"12081",12,81,2014,160548,151358,9190,5.7
"12081",12,81,2015,164899,156532,8367,5.1
"12081",12,81,2016,170679,162937,7742,4.5
"12081",12,81,2017,174945,168161,6784,3.9
"12083",12,83,1990,83776,78711,5065,6
"12083",12,83,1991,85934,78776,7158,8.3
"12083",12,83,1992,87751,80063,7688,8.8
"12083",12,83,1993,90860,83496,7364,8.1
"12083",12,83,1994,91517,85116,6401,7
"12083",12,83,1995,92167,87174,4993,5.4
"12083",12,83,1996,94848,90121,4727,5
"12083",12,83,1997,97917,93276,4641,4.7
"12083",12,83,1998,100234,95854,4380,4.4
"12083",12,83,1999,102068,98176,3892,3.8
"12083",12,83,2000,109171,104748,4423,4.1
"12083",12,83,2001,109925,104286,5639,5.1
"12083",12,83,2002,111655,104907,6748,6
"12083",12,83,2003,114386,108099,6287,5.5
"12083",12,83,2004,119728,113984,5744,4.8
"12083",12,83,2005,127862,123011,4851,3.8
"12083",12,83,2006,134179,129573,4606,3.4
"12083",12,83,2007,137247,130851,6396,4.7
"12083",12,83,2008,138375,127220,11155,8.1
"12083",12,83,2009,135282,118007,17275,12.8
"12083",12,83,2010,132351,114297,18054,13.6
"12083",12,83,2011,131031,114905,16126,12.3
"12083",12,83,2012,130450,117140,13310,10.2
"12083",12,83,2013,131043,119852,11191,8.5
"12083",12,83,2014,131605,122005,9600,7.3
"12083",12,83,2015,130198,121727,8471,6.5
"12083",12,83,2016,132083,124426,7657,5.8
"12083",12,83,2017,133553,126934,6619,5
"12085",12,85,1990,45647,42205,3442,7.5
"12085",12,85,1991,45582,40929,4653,10.2
"12085",12,85,1992,45471,40387,5084,11.2
"12085",12,85,1993,46088,41470,4618,10
"12085",12,85,1994,46214,41976,4238,9.2
"12085",12,85,1995,46539,42914,3625,7.8
"12085",12,85,1996,47650,44103,3547,7.4
"12085",12,85,1997,47921,44505,3416,7.1
"12085",12,85,1998,48791,45834,2957,6.1
"12085",12,85,1999,50204,47599,2605,5.2
"12085",12,85,2000,56333,53983,2350,4.2
"12085",12,85,2001,58526,55511,3015,5.2
"12085",12,85,2002,59658,56135,3523,5.9
"12085",12,85,2003,61161,57777,3384,5.5
"12085",12,85,2004,62199,58991,3208,5.2
"12085",12,85,2005,64652,62084,2568,4
"12085",12,85,2006,65247,62964,2283,3.5
"12085",12,85,2007,64940,62057,2883,4.4
"12085",12,85,2008,63675,59125,4550,7.1
"12085",12,85,2009,62927,56024,6903,11
"12085",12,85,2010,66636,59472,7164,10.8
"12085",12,85,2011,66822,60208,6614,9.9
"12085",12,85,2012,67147,61568,5579,8.3
"12085",12,85,2013,67497,62628,4869,7.2
"12085",12,85,2014,68687,64521,4166,6.1
"12085",12,85,2015,69503,65768,3735,5.4
"12085",12,85,2016,70925,67503,3422,4.8
"12085",12,85,2017,72370,69391,2979,4.1
"12086",12,86,1990,979215,906577,72638,7.4
"12086",12,86,1991,978740,891995,86745,8.9
"12086",12,86,1992,981643,891791,89852,9.2
"12086",12,86,1993,987593,911777,75816,7.7
"12086",12,86,1994,1021971,939049,82922,8.1
"12086",12,86,1995,1037572,960532,77040,7.4
"12086",12,86,1996,1055328,980443,74885,7.1
"12086",12,86,1997,1081900,1013925,67975,6.3
"12086",12,86,1998,1085519,1025265,60254,5.6
"12086",12,86,1999,1086593,1033333,53260,4.9
"12086",12,86,2000,1093542,1046967,46575,4.3
"12086",12,86,2001,1104264,1049691,54573,4.9
"12086",12,86,2002,1086424,1030669,55755,5.1
"12086",12,86,2003,1083791,1034235,49556,4.6
"12086",12,86,2004,1106508,1062894,43614,3.9
"12086",12,86,2005,1147797,1111437,36360,3.2
"12086",12,86,2006,1192179,1159006,33173,2.8
"12086",12,86,2007,1226005,1188136,37869,3.1
"12086",12,86,2008,1228554,1169367,59187,4.8
"12086",12,86,2009,1209622,1083804,125818,10.4
"12086",12,86,2010,1225397,1089226,136171,11.1
"12086",12,86,2011,1255105,1137041,118064,9.4
"12086",12,86,2012,1282458,1176385,106073,8.3
"12086",12,86,2013,1291199,1195237,95962,7.4
"12086",12,86,2014,1320102,1231286,88816,6.7
"12086",12,86,2015,1317053,1239626,77427,5.9
"12086",12,86,2016,1333801,1262998,70803,5.3
"12086",12,86,2017,1384224,1317493,66731,4.8
"12087",12,87,1990,41050,39954,1096,2.7
"12087",12,87,1991,41363,39722,1641,4
"12087",12,87,1992,41644,39666,1978,4.7
"12087",12,87,1993,43277,41704,1573,3.6
"12087",12,87,1994,43680,42350,1330,3
"12087",12,87,1995,44664,43437,1227,2.7
"12087",12,87,1996,45649,44393,1256,2.8
"12087",12,87,1997,47064,45925,1139,2.4
"12087",12,87,1998,47798,46486,1312,2.7
"12087",12,87,1999,47660,46543,1117,2.3
"12087",12,87,2000,45170,43877,1293,2.9
"12087",12,87,2001,46671,45020,1651,3.5
"12087",12,87,2002,46717,44849,1868,4
"12087",12,87,2003,46720,45131,1589,3.4
"12087",12,87,2004,45976,44527,1449,3.2
"12087",12,87,2005,45496,44259,1237,2.7
"12087",12,87,2006,44497,43396,1101,2.5
"12087",12,87,2007,44757,43532,1225,2.7
"12087",12,87,2008,46650,44710,1940,4.2
"12087",12,87,2009,45385,42279,3106,6.8
"12087",12,87,2010,42182,38904,3278,7.8
"12087",12,87,2011,42781,39791,2990,7
"12087",12,87,2012,43928,41431,2497,5.7
"12087",12,87,2013,44317,42172,2145,4.8
"12087",12,87,2014,45043,43189,1854,4.1
"12087",12,87,2015,45783,44186,1597,3.5
"12087",12,87,2016,46474,45000,1474,3.2
"12087",12,87,2017,45317,43816,1501,3.3
"12089",12,89,1990,22762,21443,1319,5.8
"12089",12,89,1991,23228,21647,1581,6.8
"12089",12,89,1992,23871,22078,1793,7.5
"12089",12,89,1993,24545,23039,1506,6.1
"12089",12,89,1994,25719,24394,1325,5.2
"12089",12,89,1995,26620,25545,1075,4
"12089",12,89,1996,26867,25749,1118,4.2
"12089",12,89,1997,27951,26889,1062,3.8
"12089",12,89,1998,28941,27944,997,3.4
"12089",12,89,1999,29984,28943,1041,3.5
"12089",12,89,2000,30268,29267,1001,3.3
"12089",12,89,2001,30728,29450,1278,4.2
"12089",12,89,2002,30576,29053,1523,5
"12089",12,89,2003,30704,29203,1501,4.9
"12089",12,89,2004,31256,29941,1315,4.2
"12089",12,89,2005,32720,31631,1089,3.3
"12089",12,89,2006,34093,33111,982,2.9
"12089",12,89,2007,35191,33994,1197,3.4
"12089",12,89,2008,36276,34261,2015,5.6
"12089",12,89,2009,35920,32469,3451,9.6
"12089",12,89,2010,35799,31995,3804,10.6
"12089",12,89,2011,36018,32556,3462,9.6
"12089",12,89,2012,35950,33059,2891,8
"12089",12,89,2013,36175,33743,2432,6.7
"12089",12,89,2014,36269,34108,2161,6
"12089",12,89,2015,36565,34682,1883,5.1
"12089",12,89,2016,37794,36100,1694,4.5
"12089",12,89,2017,39078,37594,1484,3.8
"12091",12,91,1990,66194,62283,3911,5.9
"12091",12,91,1991,67013,62795,4218,6.3
"12091",12,91,1992,69408,65040,4368,6.3
"12091",12,91,1993,71868,67384,4484,6.2
"12091",12,91,1994,75311,71457,3854,5.1
"12091",12,91,1995,76921,73520,3401,4.4
"12091",12,91,1996,77556,74493,3063,3.9
"12091",12,91,1997,81627,78628,2999,3.7
"12091",12,91,1998,82548,79725,2823,3.4
"12091",12,91,1999,83745,80872,2873,3.4
"12091",12,91,2000,80375,77412,2963,3.7
"12091",12,91,2001,83055,79612,3443,4.1
"12091",12,91,2002,85706,81940,3766,4.4
"12091",12,91,2003,88742,85403,3339,3.8
"12091",12,91,2004,93054,89920,3134,3.4
"12091",12,91,2005,96570,93848,2722,2.8
"12091",12,91,2006,98731,96352,2379,2.4
"12091",12,91,2007,97527,94552,2975,3.1
"12091",12,91,2008,96861,92269,4592,4.7
"12091",12,91,2009,96418,89500,6918,7.2
"12091",12,91,2010,89046,81547,7499,8.4
"12091",12,91,2011,90913,83806,7107,7.8
"12091",12,91,2012,91453,85311,6142,6.7
"12091",12,91,2013,92170,86899,5271,5.7
"12091",12,91,2014,92072,87331,4741,5.1
"12091",12,91,2015,91741,87579,4162,4.5
"12091",12,91,2016,93285,89550,3735,4
"12091",12,91,2017,95850,92613,3237,3.4
"12093",12,93,1990,13774,12624,1150,8.3
"12093",12,93,1991,14471,13093,1378,9.5
"12093",12,93,1992,14774,13040,1734,11.7
"12093",12,93,1993,15318,13739,1579,10.3
"12093",12,93,1994,15360,13659,1701,11.1
"12093",12,93,1995,15890,14305,1585,10
"12093",12,93,1996,17582,15844,1738,9.9
"12093",12,93,1997,17368,15838,1530,8.8
"12093",12,93,1998,16734,15282,1452,8.7
"12093",12,93,1999,16411,15113,1298,7.9
"12093",12,93,2000,15658,14815,843,5.4
"12093",12,93,2001,15675,14675,1000,6.4
"12093",12,93,2002,16151,15015,1136,7
"12093",12,93,2003,16219,15118,1101,6.8
"12093",12,93,2004,16182,15144,1038,6.4
"12093",12,93,2005,17220,16386,834,4.8
"12093",12,93,2006,17473,16748,725,4.1
"12093",12,93,2007,17537,16608,929,5.3
"12093",12,93,2008,17662,16183,1479,8.4
"12093",12,93,2009,18199,16040,2159,11.9
"12093",12,93,2010,18103,15816,2287,12.6
"12093",12,93,2011,17822,15695,2127,11.9
"12093",12,93,2012,18321,16495,1826,10
"12093",12,93,2013,18103,16519,1584,8.7
"12093",12,93,2014,17674,16374,1300,7.4
"12093",12,93,2015,17249,16162,1087,6.3
"12093",12,93,2016,18153,17226,927,5.1
"12093",12,93,2017,18691,17909,782,4.2
"12095",12,95,1990,393649,371771,21878,5.6
"12095",12,95,1991,395349,367598,27751,7
"12095",12,95,1992,408186,377161,31025,7.6
"12095",12,95,1993,417638,391034,26604,6.4
"12095",12,95,1994,430579,406404,24175,5.6
"12095",12,95,1995,435574,415857,19717,4.5
"12095",12,95,1996,447709,430340,17369,3.9
"12095",12,95,1997,469247,452962,16285,3.5
"12095",12,95,1998,489757,474437,15320,3.1
"12095",12,95,1999,507335,492721,14614,2.9
"12095",12,95,2000,499432,484112,15320,3.1
"12095",12,95,2001,509594,487402,22192,4.4
"12095",12,95,2002,507357,477859,29498,5.8
"12095",12,95,2003,514061,486989,27072,5.3
"12095",12,95,2004,530884,506346,24538,4.6
"12095",12,95,2005,553951,533969,19982,3.6
"12095",12,95,2006,575327,557220,18107,3.1
"12095",12,95,2007,594761,571946,22815,3.8
"12095",12,95,2008,603287,566854,36433,6
"12095",12,95,2009,596021,533867,62154,10.4
"12095",12,95,2010,635299,566478,68821,10.8
"12095",12,95,2011,642178,579251,62927,9.8
"12095",12,95,2012,653886,600251,53635,8.2
"12095",12,95,2013,663087,618150,44937,6.8
"12095",12,95,2014,676557,637038,39519,5.8
"12095",12,95,2015,686092,651611,34481,5
"12095",12,95,2016,706819,676243,30576,4.3
"12095",12,95,2017,731398,704715,26683,3.6
"12097",12,97,1990,59082,56163,2919,4.9
"12097",12,97,1991,61148,57236,3912,6.4
"12097",12,97,1992,64431,59283,5148,8
"12097",12,97,1993,66663,62313,4350,6.5
"12097",12,97,1994,69138,65197,3941,5.7
"12097",12,97,1995,72243,68820,3423,4.7
"12097",12,97,1996,75401,72492,2909,3.9
"12097",12,97,1997,79553,76528,3025,3.8
"12097",12,97,1998,83491,80791,2700,3.2
"12097",12,97,1999,87824,85348,2476,2.8
"12097",12,97,2000,89542,86592,2950,3.3
"12097",12,97,2001,93700,89394,4306,4.6
"12097",12,97,2002,96824,91003,5821,6
"12097",12,97,2003,102110,96488,5622,5.5
"12097",12,97,2004,109692,104334,5358,4.9
"12097",12,97,2005,116456,111999,4457,3.8
"12097",12,97,2006,124996,120750,4246,3.4
"12097",12,97,2007,132902,127164,5738,4.3
"12097",12,97,2008,138080,129094,8986,6.5
"12097",12,97,2009,138807,123212,15595,11.2
"12097",12,97,2010,137372,120253,17119,12.5
"12097",12,97,2011,140286,124469,15817,11.3
"12097",12,97,2012,143550,129979,13571,9.5
"12097",12,97,2013,147899,136197,11702,7.9
"12097",12,97,2014,152667,142399,10268,6.7
"12097",12,97,2015,157274,148194,9080,5.8
"12097",12,97,2016,164327,156211,8116,4.9
"12097",12,97,2017,169949,162768,7181,4.2
"12099",12,99,1990,434048,402576,31472,7.3
"12099",12,99,1991,441647,400981,40666,9.2
"12099",12,99,1992,449398,401802,47596,10.6
"12099",12,99,1993,455657,413471,42186,9.3
"12099",12,99,1994,468261,427601,40660,8.7
"12099",12,99,1995,470288,436254,34034,7.2
"12099",12,99,1996,484112,451078,33034,6.8
"12099",12,99,1997,502138,469560,32578,6.5
"12099",12,99,1998,517142,486773,30369,5.9
"12099",12,99,1999,526787,498879,27908,5.3
"12099",12,99,2000,541551,518667,22884,4.2
"12099",12,99,2001,568372,538842,29530,5.2
"12099",12,99,2002,581208,544442,36766,6.3
"12099",12,99,2003,585815,551385,34430,5.9
"12099",12,99,2004,598161,566247,31914,5.3
"12099",12,99,2005,604861,578769,26092,4.3
"12099",12,99,2006,619269,596415,22854,3.7
"12099",12,99,2007,626062,598221,27841,4.4
"12099",12,99,2008,628411,585947,42464,6.8
"12099",12,99,2009,615500,549671,65829,10.7
"12099",12,99,2010,645737,574890,70847,11
"12099",12,99,2011,652697,587173,65524,10
"12099",12,99,2012,660634,604549,56085,8.5
"12099",12,99,2013,672215,624322,47893,7.1
"12099",12,99,2014,684793,644664,40129,5.9
"12099",12,99,2015,690937,655590,35347,5.1
"12099",12,99,2016,709627,676408,33219,4.7
"12099",12,99,2017,724465,694979,29486,4.1
"12101",12,101,1990,109699,102820,6879,6.3
"12101",12,101,1991,110009,101337,8672,7.9
"12101",12,101,1992,112108,102367,9741,8.7
"12101",12,101,1993,115513,106603,8910,7.7
"12101",12,101,1994,120995,113459,7536,6.2
"12101",12,101,1995,124034,117700,6334,5.1
"12101",12,101,1996,127885,121583,6302,4.9
"12101",12,101,1997,132491,127004,5487,4.1
"12101",12,101,1998,137995,132580,5415,3.9
"12101",12,101,1999,141898,137259,4639,3.3
"12101",12,101,2000,150210,144659,5551,3.7
"12101",12,101,2001,155216,147745,7471,4.8
"12101",12,101,2002,159092,149351,9741,6.1
"12101",12,101,2003,163533,154113,9420,5.8
"12101",12,101,2004,173717,164628,9089,5.2
"12101",12,101,2005,177737,169875,7862,4.4
"12101",12,101,2006,187047,179799,7248,3.9
"12101",12,101,2007,193243,183551,9692,5
"12101",12,101,2008,197619,182473,15146,7.7
"12101",12,101,2009,195279,172016,23263,11.9
"12101",12,101,2010,207364,182593,24771,11.9
"12101",12,101,2011,206715,184347,22368,10.8
"12101",12,101,2012,208712,189824,18888,9
"12101",12,101,2013,210396,194247,16149,7.7
"12101",12,101,2014,213023,198813,14210,6.7
"12101",12,101,2015,215394,202727,12667,5.9
"12101",12,101,2016,222621,211246,11375,5.1
"12101",12,101,2017,227733,217800,9933,4.4
"12103",12,103,1990,422736,402986,19750,4.7
"12103",12,103,1991,422510,395970,26540,6.3
"12103",12,103,1992,426341,397552,28789,6.8
"12103",12,103,1993,434160,407174,26986,6.2
"12103",12,103,1994,447733,425502,22231,5
"12103",12,103,1995,451302,432658,18644,4.1
"12103",12,103,1996,452939,435576,17363,3.8
"12103",12,103,1997,466468,449774,16694,3.6
"12103",12,103,1998,477516,462070,15446,3.2
"12103",12,103,1999,484824,470970,13854,2.9
"12103",12,103,2000,470985,455503,15482,3.3
"12103",12,103,2001,471589,450408,21181,4.5
"12103",12,103,2002,465976,439107,26869,5.8
"12103",12,103,2003,460833,435958,24875,5.4
"12103",12,103,2004,465181,443802,21379,4.6
"12103",12,103,2005,453533,435761,17772,3.9
"12103",12,103,2006,453148,437883,15265,3.4
"12103",12,103,2007,450329,431617,18712,4.2
"12103",12,103,2008,447744,418214,29530,6.6
"12103",12,103,2009,440723,393139,47584,10.8
"12103",12,103,2010,465178,414856,50322,10.8
"12103",12,103,2011,463993,418950,45043,9.7
"12103",12,103,2012,467029,429860,37169,8
"12103",12,103,2013,470232,438997,31235,6.6
"12103",12,103,2014,471706,444471,27235,5.8
"12103",12,103,2015,470699,447351,23348,5
"12103",12,103,2016,478464,457756,20708,4.3
"12103",12,103,2017,490061,471855,18206,3.7
"12105",12,105,1990,202034,181476,20558,10.2
"12105",12,105,1991,199890,179833,20057,10
"12105",12,105,1992,199736,177485,22251,11.1
"12105",12,105,1993,200560,180573,19987,10
"12105",12,105,1994,201086,183826,17260,8.6
"12105",12,105,1995,200191,185398,14793,7.4
"12105",12,105,1996,201388,187627,13761,6.8
"12105",12,105,1997,203667,190145,13522,6.6
"12105",12,105,1998,206365,194537,11828,5.7
"12105",12,105,1999,208685,198023,10662,5.1
"12105",12,105,2000,231202,221632,9570,4.1
"12105",12,105,2001,237564,225189,12375,5.2
"12105",12,105,2002,237919,223792,14127,5.9
"12105",12,105,2003,239924,226315,13609,5.7
"12105",12,105,2004,249232,236570,12662,5.1
"12105",12,105,2005,258158,247679,10479,4.1
"12105",12,105,2006,264259,254605,9654,3.7
"12105",12,105,2007,268193,255915,12278,4.6
"12105",12,105,2008,273427,254490,18937,6.9
"12105",12,105,2009,273152,242326,30826,11.3
"12105",12,105,2010,278479,244668,33811,12.1
"12105",12,105,2011,276920,245740,31180,11.3
"12105",12,105,2012,277091,250458,26633,9.6
"12105",12,105,2013,278708,255795,22913,8.2
"12105",12,105,2014,278477,258446,20031,7.2
"12105",12,105,2015,279976,262248,17728,6.3
"12105",12,105,2016,287016,271212,15804,5.5
"12105",12,105,2017,293587,279944,13643,4.6
"12107",12,107,1990,26315,24649,1666,6.3
"12107",12,107,1991,27799,25737,2062,7.4
"12107",12,107,1992,29235,26644,2591,8.9
"12107",12,107,1993,30049,27689,2360,7.9
"12107",12,107,1994,29576,27549,2027,6.9
"12107",12,107,1995,30325,28749,1576,5.2
"12107",12,107,1996,28892,27273,1619,5.6
"12107",12,107,1997,28547,26838,1709,6
"12107",12,107,1998,29028,27461,1567,5.4
"12107",12,107,1999,28916,27392,1524,5.3
"12107",12,107,2000,29345,28090,1255,4.3
"12107",12,107,2001,29128,27497,1631,5.6
"12107",12,107,2002,29725,27725,2000,6.7
"12107",12,107,2003,30712,28960,1752,5.7
"12107",12,107,2004,30759,29075,1684,5.5
"12107",12,107,2005,31351,29994,1357,4.3
"12107",12,107,2006,31781,30597,1184,3.7
"12107",12,107,2007,31945,30420,1525,4.8
"12107",12,107,2008,32057,29618,2439,7.6
"12107",12,107,2009,32311,28514,3797,11.8
"12107",12,107,2010,30518,26434,4084,13.4
"12107",12,107,2011,29776,25968,3808,12.8
"12107",12,107,2012,28930,25513,3417,11.8
"12107",12,107,2013,28211,25274,2937,10.4
"12107",12,107,2014,27946,25506,2440,8.7
"12107",12,107,2015,27267,25183,2084,7.6
"12107",12,107,2016,26989,25278,1711,6.3
"12107",12,107,2017,27106,25661,1445,5.3
"12109",12,109,1990,44284,41996,2288,5.2
"12109",12,109,1991,45374,42655,2719,6
"12109",12,109,1992,46355,43418,2937,6.3
"12109",12,109,1993,48958,46007,2951,6
"12109",12,109,1994,52142,49505,2637,5.1
"12109",12,109,1995,54342,52474,1868,3.4
"12109",12,109,1996,55926,54273,1653,3
"12109",12,109,1997,58562,56749,1813,3.1
"12109",12,109,1998,61383,59809,1574,2.6
"12109",12,109,1999,63910,62300,1610,2.5
"12109",12,109,2000,66434,64467,1967,3
"12109",12,109,2001,69083,66453,2630,3.8
"12109",12,109,2002,70321,67123,3198,4.5
"12109",12,109,2003,72616,69518,3098,4.3
"12109",12,109,2004,77315,74386,2929,3.8
"12109",12,109,2005,83507,80952,2555,3.1
"12109",12,109,2006,88575,86169,2406,2.7
"12109",12,109,2007,92427,89382,3045,3.3
"12109",12,109,2008,96362,91366,4996,5.2
"12109",12,109,2009,96570,88459,8111,8.4
"12109",12,109,2010,99104,90440,8664,8.7
"12109",12,109,2011,101402,93552,7850,7.7
"12109",12,109,2012,104055,97255,6800,6.5
"12109",12,109,2013,107375,101542,5833,5.4
"12109",12,109,2014,110658,105458,5200,4.7
"12109",12,109,2015,113384,108908,4476,3.9
"12109",12,109,2016,118655,114181,4474,3.8
"12109",12,109,2017,122964,118889,4075,3.3
"12111",12,111,1990,72527,63089,9438,13
"12111",12,111,1991,71831,61801,10030,14
"12111",12,111,1992,73992,61999,11993,16.2
"12111",12,111,1993,73815,63843,9972,13.5
"12111",12,111,1994,75568,64926,10642,14.1
"12111",12,111,1995,76247,66683,9564,12.5
"12111",12,111,1996,78051,68185,9866,12.6
"12111",12,111,1997,77798,69210,8588,11
"12111",12,111,1998,79331,70810,8521,10.7
"12111",12,111,1999,80876,73189,7687,9.5
"12111",12,111,2000,87437,82393,5044,5.8
"12111",12,111,2001,91292,85370,5922,6.5
"12111",12,111,2002,94713,87697,7016,7.4
"12111",12,111,2003,98471,91824,6647,6.8
"12111",12,111,2004,104341,97567,6774,6.5
"12111",12,111,2005,112948,107512,5436,4.8
"12111",12,111,2006,119477,114472,5005,4.2
"12111",12,111,2007,123851,116666,7185,5.8
"12111",12,111,2008,124487,113354,11133,8.9
"12111",12,111,2009,123665,107098,16567,13.4
"12111",12,111,2010,128690,110976,17714,13.8
"12111",12,111,2011,128670,112473,16197,12.6
"12111",12,111,2012,129091,114967,14124,10.9
"12111",12,111,2013,129208,116341,12867,10
"12111",12,111,2014,130539,120081,10458,8
"12111",12,111,2015,131310,122938,8372,6.4
"12111",12,111,2016,135255,127466,7789,5.8
"12111",12,111,2017,138067,131067,7000,5.1
"12113",12,113,1990,39199,37037,2162,5.5
"12113",12,113,1991,40476,38252,2224,5.5
"12113",12,113,1992,42569,40256,2313,5.4
"12113",12,113,1993,44312,42243,2069,4.7
"12113",12,113,1994,46647,44688,1959,4.2
"12113",12,113,1995,48402,46404,1998,4.1
"12113",12,113,1996,49813,48036,1777,3.6
"12113",12,113,1997,51187,49294,1893,3.7
"12113",12,113,1998,53685,51423,2262,4.2
"12113",12,113,1999,55472,53217,2255,4.1
"12113",12,113,2000,54960,52852,2108,3.8
"12113",12,113,2001,55732,53115,2617,4.7
"12113",12,113,2002,57328,54275,3053,5.3
"12113",12,113,2003,60030,57230,2800,4.7
"12113",12,113,2004,63198,60368,2830,4.5
"12113",12,113,2005,67451,65003,2448,3.6
"12113",12,113,2006,69789,67688,2101,3
"12113",12,113,2007,69649,67061,2588,3.7
"12113",12,113,2008,70359,66289,4070,5.8
"12113",12,113,2009,70216,63859,6357,9.1
"12113",12,113,2010,71333,64713,6620,9.3
"12113",12,113,2011,72675,66399,6276,8.6
"12113",12,113,2012,72665,67192,5473,7.5
"12113",12,113,2013,73045,68373,4672,6.4
"12113",12,113,2014,73121,69122,3999,5.5
"12113",12,113,2015,73970,70388,3582,4.8
"12113",12,113,2016,76163,72739,3424,4.5
"12113",12,113,2017,78353,75353,3000,3.8
"12115",12,115,1990,124304,119626,4678,3.8
"12115",12,115,1991,128302,122027,6275,4.9
"12115",12,115,1992,133207,125766,7441,5.6
"12115",12,115,1993,126895,120305,6590,5.2
"12115",12,115,1994,130637,125148,5489,4.2
"12115",12,115,1995,132681,128150,4531,3.4
"12115",12,115,1996,142728,138239,4489,3.1
"12115",12,115,1997,149189,145133,4056,2.7
"12115",12,115,1998,149584,145706,3878,2.6
"12115",12,115,1999,156357,152817,3540,2.3
"12115",12,115,2000,148776,144010,4766,3.2
"12115",12,115,2001,150916,144808,6108,4
"12115",12,115,2002,157826,149946,7880,5
"12115",12,115,2003,160918,153394,7524,4.7
"12115",12,115,2004,167945,160928,7017,4.2
"12115",12,115,2005,169305,163509,5796,3.4
"12115",12,115,2006,172810,167383,5427,3.1
"12115",12,115,2007,171609,163784,7825,4.6
"12115",12,115,2008,167160,154823,12337,7.4
"12115",12,115,2009,161799,143465,18334,11.3
"12115",12,115,2010,167222,147825,19397,11.6
"12115",12,115,2011,166864,149796,17068,10.2
"12115",12,115,2012,168019,153858,14161,8.4
"12115",12,115,2013,170746,158821,11925,7
"12115",12,115,2014,174927,164704,10223,5.8
"12115",12,115,2015,177827,168802,9025,5.1
"12115",12,115,2016,181099,172907,8192,4.5
"12115",12,115,2017,185793,178650,7143,3.8
"12117",12,117,1990,169768,160689,9079,5.3
"12117",12,117,1991,172402,160954,11448,6.6
"12117",12,117,1992,179469,166500,12969,7.2
"12117",12,117,1993,184094,173205,10889,5.9
"12117",12,117,1994,190690,180799,9891,5.2
"12117",12,117,1995,195416,187541,7875,4
"12117",12,117,1996,199848,192586,7262,3.6
"12117",12,117,1997,208780,201710,7070,3.4
"12117",12,117,1998,216298,210077,6221,2.9
"12117",12,117,1999,225332,219006,6326,2.8
"12117",12,117,2000,212542,206108,6434,3
"12117",12,117,2001,214534,205653,8881,4.1
"12117",12,117,2002,213794,201686,12108,5.7
"12117",12,117,2003,214905,203760,11145,5.2
"12117",12,117,2004,219012,209455,9557,4.4
"12117",12,117,2005,227032,219393,7639,3.4
"12117",12,117,2006,234285,227390,6895,2.9
"12117",12,117,2007,238644,229929,8715,3.7
"12117",12,117,2008,241178,227205,13973,5.8
"12117",12,117,2009,235674,212497,23177,9.8
"12117",12,117,2010,230697,206168,24529,10.6
"12117",12,117,2011,230621,208447,22174,9.6
"12117",12,117,2012,231131,212462,18669,8.1
"12117",12,117,2013,232955,217434,15521,6.7
"12117",12,117,2014,236046,222576,13470,5.7
"12117",12,117,2015,236649,224989,11660,4.9
"12117",12,117,2016,242158,231845,10313,4.3
"12117",12,117,2017,250562,241507,9055,3.6
"12119",12,119,1990,12298,11336,962,7.8
"12119",12,119,1991,12291,11206,1085,8.8
"12119",12,119,1992,12309,11273,1036,8.4
"12119",12,119,1993,12227,11344,883,7.2
"12119",12,119,1994,12436,11599,837,6.7
"12119",12,119,1995,13110,12399,711,5.4
"12119",12,119,1996,14346,13686,660,4.6
"12119",12,119,1997,14570,13915,655,4.5
"12119",12,119,1998,14462,13969,493,3.4
"12119",12,119,1999,14724,14297,427,2.9
"12119",12,119,2000,16919,16189,730,4.3
"12119",12,119,2001,17481,16500,981,5.6
"12119",12,119,2002,18632,17514,1118,6
"12119",12,119,2003,19493,18461,1032,5.3
"12119",12,119,2004,21051,20065,986,4.7
"12119",12,119,2005,25555,24685,870,3.4
"12119",12,119,2006,29768,28936,832,2.8
"12119",12,119,2007,31509,30390,1119,3.6
"12119",12,119,2008,30934,29145,1789,5.8
"12119",12,119,2009,31877,28967,2910,9.1
"12119",12,119,2010,25310,21955,3355,13.3
"12119",12,119,2011,26041,22876,3165,12.2
"12119",12,119,2012,26860,24028,2832,10.5
"12119",12,119,2013,27572,25020,2552,9.3
"12119",12,119,2014,28269,25910,2359,8.3
"12119",12,119,2015,28635,26430,2205,7.7
"12119",12,119,2016,29399,27301,2098,7.1
"12119",12,119,2017,30293,28465,1828,6
"12121",12,121,1990,12065,11108,957,7.9
"12121",12,121,1991,12109,10993,1116,9.2
"12121",12,121,1992,12618,11367,1251,9.9
"12121",12,121,1993,12670,11473,1197,9.4
"12121",12,121,1994,12921,12024,897,6.9
"12121",12,121,1995,13291,12608,683,5.1
"12121",12,121,1996,13314,12701,613,4.6
"12121",12,121,1997,13352,12754,598,4.5
"12121",12,121,1998,13891,13270,621,4.5
"12121",12,121,1999,13795,13231,564,4.1
"12121",12,121,2000,15419,14866,553,3.6
"12121",12,121,2001,15574,14775,799,5.1
"12121",12,121,2002,16028,15197,831,5.2
"12121",12,121,2003,16084,15331,753,4.7
"12121",12,121,2004,16163,15453,710,4.4
"12121",12,121,2005,16638,16031,607,3.6
"12121",12,121,2006,16956,16405,551,3.2
"12121",12,121,2007,17350,16707,643,3.7
"12121",12,121,2008,17008,15979,1029,6.1
"12121",12,121,2009,17450,15765,1685,9.7
"12121",12,121,2010,19153,17267,1886,9.8
"12121",12,121,2011,18870,17125,1745,9.2
"12121",12,121,2012,18342,16871,1471,8
"12121",12,121,2013,18077,16826,1251,6.9
"12121",12,121,2014,17973,16840,1133,6.3
"12121",12,121,2015,17937,16957,980,5.5
"12121",12,121,2016,18193,17305,888,4.9
"12121",12,121,2017,18082,17312,770,4.3
"12123",12,123,1990,8314,7312,1002,12.1
"12123",12,123,1991,8169,6896,1273,15.6
"12123",12,123,1992,8000,6955,1045,13.1
"12123",12,123,1993,7846,6615,1231,15.7
"12123",12,123,1994,7618,6718,900,11.8
"12123",12,123,1995,7707,6950,757,9.8
"12123",12,123,1996,7840,7058,782,10
"12123",12,123,1997,7635,6917,718,9.4
"12123",12,123,1998,7537,6944,593,7.9
"12123",12,123,1999,7590,7016,574,7.6
"12123",12,123,2000,8276,7868,408,4.9
"12123",12,123,2001,8297,7730,567,6.8
"12123",12,123,2002,8547,7967,580,6.8
"12123",12,123,2003,8220,7662,558,6.8
"12123",12,123,2004,8379,7920,459,5.5
"12123",12,123,2005,8813,8456,357,4.1
"12123",12,123,2006,8755,8408,347,4
"12123",12,123,2007,8814,8431,383,4.3
"12123",12,123,2008,9139,8525,614,6.7
"12123",12,123,2009,9167,8181,986,10.8
"12123",12,123,2010,9473,8471,1002,10.6
"12123",12,123,2011,9444,8493,951,10.1
"12123",12,123,2012,9408,8564,844,9
"12123",12,123,2013,9484,8742,742,7.8
"12123",12,123,2014,9363,8720,643,6.9
"12123",12,123,2015,8981,8377,604,6.7
"12123",12,123,2016,8841,8365,476,5.4
"12123",12,123,2017,8785,8390,395,4.5
"12125",12,125,1990,3755,3564,191,5.1
"12125",12,125,1991,3828,3618,210,5.5
"12125",12,125,1992,3833,3615,218,5.7
"12125",12,125,1993,4008,3805,203,5.1
"12125",12,125,1994,4020,3871,149,3.7
"12125",12,125,1995,4061,3876,185,4.6
"12125",12,125,1996,3983,3792,191,4.8
"12125",12,125,1997,4058,3903,155,3.8
"12125",12,125,1998,3771,3661,110,2.9
"12125",12,125,1999,3578,3480,98,2.7
"12125",12,125,2000,4529,4331,198,4.4
"12125",12,125,2001,4760,4514,246,5.2
"12125",12,125,2002,4819,4632,187,3.9
"12125",12,125,2003,4858,4673,185,3.8
"12125",12,125,2004,4893,4711,182,3.7
"12125",12,125,2005,5045,4893,152,3
"12125",12,125,2006,5122,4987,135,2.6
"12125",12,125,2007,5136,4973,163,3.2
"12125",12,125,2008,5309,5045,264,5
"12125",12,125,2009,5388,4982,406,7.5
"12125",12,125,2010,5479,5013,466,8.5
"12125",12,125,2011,5178,4754,424,8.2
"12125",12,125,2012,5087,4720,367,7.2
"12125",12,125,2013,4984,4669,315,6.3
"12125",12,125,2014,4734,4451,283,6
"12125",12,125,2015,4736,4505,231,4.9
"12125",12,125,2016,4799,4592,207,4.3
"12125",12,125,2017,4876,4701,175,3.6
"12127",12,127,1990,169196,160418,8778,5.2
"12127",12,127,1991,170829,159237,11592,6.8
"12127",12,127,1992,172929,159410,13519,7.8
"12127",12,127,1993,176725,164620,12105,6.8
"12127",12,127,1994,178216,167330,10886,6.1
"12127",12,127,1995,179345,170638,8707,4.9
"12127",12,127,1996,177690,169881,7809,4.4
"12127",12,127,1997,178484,171196,7288,4.1
"12127",12,127,1998,180192,173722,6470,3.6
"12127",12,127,1999,180429,174554,5875,3.3
"12127",12,127,2000,209603,202516,7087,3.4
"12127",12,127,2001,215774,206227,9547,4.4
"12127",12,127,2002,220727,208182,12545,5.7
"12127",12,127,2003,226951,214968,11983,5.3
"12127",12,127,2004,234360,223275,11085,4.7
"12127",12,127,2005,244688,235627,9061,3.7
"12127",12,127,2006,250088,241875,8213,3.3
"12127",12,127,2007,252491,241896,10595,4.2
"12127",12,127,2008,254567,237301,17266,6.8
"12127",12,127,2009,252474,225174,27300,10.8
"12127",12,127,2010,238183,208987,29196,12.3
"12127",12,127,2011,237832,211132,26700,11.2
"12127",12,127,2012,237385,214879,22506,9.5
"12127",12,127,2013,235627,216323,19304,8.2
"12127",12,127,2014,237798,221573,16225,6.8
"12127",12,127,2015,238676,224701,13975,5.9
"12127",12,127,2016,245595,233207,12388,5
"12127",12,127,2017,251509,240636,10873,4.3
"12129",12,129,1990,7868,7564,304,3.9
"12129",12,129,1991,8291,7892,399,4.8
"12129",12,129,1992,8608,8167,441,5.1
"12129",12,129,1993,8885,8482,403,4.5
"12129",12,129,1994,8987,8581,406,4.5
"12129",12,129,1995,9491,9092,399,4.2
"12129",12,129,1996,9879,9449,430,4.4
"12129",12,129,1997,10392,10001,391,3.8
"12129",12,129,1998,11221,10827,394,3.5
"12129",12,129,1999,11387,11025,362,3.2
"12129",12,129,2000,11691,11316,375,3.2
"12129",12,129,2001,12309,11854,455,3.7
"12129",12,129,2002,12712,12155,557,4.4
"12129",12,129,2003,13117,12562,555,4.2
"12129",12,129,2004,13536,13051,485,3.6
"12129",12,129,2005,14399,13997,402,2.8
"12129",12,129,2006,15450,15067,383,2.5
"12129",12,129,2007,15109,14650,459,3
"12129",12,129,2008,15916,15178,738,4.6
"12129",12,129,2009,16732,15569,1163,7
"12129",12,129,2010,14589,13368,1221,8.4
"12129",12,129,2011,14604,13398,1206,8.3
"12129",12,129,2012,14121,13092,1029,7.3
"12129",12,129,2013,14078,13238,840,6
"12129",12,129,2014,14308,13567,741,5.2
"12129",12,129,2015,13960,13308,652,4.7
"12129",12,129,2016,14303,13714,589,4.1
"12129",12,129,2017,14622,14108,514,3.5
"12131",12,131,1990,12984,12149,835,6.4
"12131",12,131,1991,13378,12446,932,7
"12131",12,131,1992,13561,12824,737,5.4
"12131",12,131,1993,14212,13426,786,5.5
"12131",12,131,1994,14663,13935,728,5
"12131",12,131,1995,14752,14092,660,4.5
"12131",12,131,1996,15271,14591,680,4.5
"12131",12,131,1997,15504,14816,688,4.4
"12131",12,131,1998,15847,15179,668,4.2
"12131",12,131,1999,16483,15849,634,3.8
"12131",12,131,2000,19410,18737,673,3.5
"12131",12,131,2001,20757,19935,822,4
"12131",12,131,2002,21553,20562,991,4.6
"12131",12,131,2003,22749,21875,874,3.8
"12131",12,131,2004,24444,23573,871,3.6
"12131",12,131,2005,27944,27174,770,2.8
"12131",12,131,2006,31122,30441,681,2.2
"12131",12,131,2007,31252,30380,872,2.8
"12131",12,131,2008,31129,29684,1445,4.6
"12131",12,131,2009,30837,28499,2338,7.6
"12131",12,131,2010,25984,23547,2437,9.4
"12131",12,131,2011,26285,24050,2235,8.5
"12131",12,131,2012,26271,24360,1911,7.3
"12131",12,131,2013,26975,25329,1646,6.1
"12131",12,131,2014,27350,25902,1448,5.3
"12131",12,131,2015,27844,26534,1310,4.7
"12131",12,131,2016,28956,27717,1239,4.3
"12131",12,131,2017,29702,28639,1063,3.6
"12133",12,133,1990,7439,6924,515,6.9
"12133",12,133,1991,7722,7211,511,6.6
"12133",12,133,1992,7914,7297,617,7.8
"12133",12,133,1993,7952,7320,632,7.9
"12133",12,133,1994,8177,7645,532,6.5
"12133",12,133,1995,8953,8396,557,6.2
"12133",12,133,1996,9291,8736,555,6
"12133",12,133,1997,9370,8854,516,5.5
"12133",12,133,1998,9279,8810,469,5.1
"12133",12,133,1999,9996,9568,428,4.3
"12133",12,133,2000,8945,8541,404,4.5
"12133",12,133,2001,8848,8337,511,5.8
"12133",12,133,2002,8906,8346,560,6.3
"12133",12,133,2003,8832,8356,476,5.4
"12133",12,133,2004,9093,8670,423,4.7
"12133",12,133,2005,9291,8946,345,3.7
"12133",12,133,2006,9598,9279,319,3.3
"12133",12,133,2007,9652,9259,393,4.1
"12133",12,133,2008,9881,9234,647,6.5
"12133",12,133,2009,9920,8922,998,10.1
"12133",12,133,2010,10298,9210,1088,10.6
"12133",12,133,2011,10412,9369,1043,10
"12133",12,133,2012,10064,9176,888,8.8
"12133",12,133,2013,9853,9094,759,7.7
"12133",12,133,2014,9693,9041,652,6.7
"12133",12,133,2015,9610,9038,572,6
"12133",12,133,2016,9704,9208,496,5.1
"12133",12,133,2017,9839,9412,427,4.3
"13001",13,1,1990,7465,6567,898,12
"13001",13,1,1991,7564,6937,627,8.3
"13001",13,1,1992,7951,6949,1002,12.6
"13001",13,1,1993,8261,7335,926,11.2
"13001",13,1,1994,8492,7781,711,8.4
"13001",13,1,1995,8133,7525,608,7.5
"13001",13,1,1996,8286,7490,796,9.6
"13001",13,1,1997,8557,7832,725,8.5
"13001",13,1,1998,8580,7680,900,10.5
"13001",13,1,1999,8300,7486,814,9.8
"13001",13,1,2000,8562,8095,467,5.5
"13001",13,1,2001,8395,7824,571,6.8
"13001",13,1,2002,8194,7561,633,7.7
"13001",13,1,2003,8200,7652,548,6.7
"13001",13,1,2004,8207,7689,518,6.3
"13001",13,1,2005,8947,8414,533,6
"13001",13,1,2006,8834,8344,490,5.5
"13001",13,1,2007,9079,8599,480,5.3
"13001",13,1,2008,9354,8701,653,7
"13001",13,1,2009,9455,8500,955,10.1
"13001",13,1,2010,8746,7710,1036,11.8
"13001",13,1,2011,8875,7778,1097,12.4
"13001",13,1,2012,8982,7975,1007,11.2
"13001",13,1,2013,8673,7741,932,10.7
"13001",13,1,2014,8664,7902,762,8.8
"13001",13,1,2015,8673,8040,633,7.3
"13001",13,1,2016,9198,8613,585,6.4
"13001",13,1,2017,9261,8749,512,5.5
"13003",13,3,1990,2755,2548,207,7.5
"13003",13,3,1991,2497,2342,155,6.2
"13003",13,3,1992,2699,2448,251,9.3
"13003",13,3,1993,2844,2604,240,8.4
"13003",13,3,1994,2995,2800,195,6.5
"13003",13,3,1995,3193,2976,217,6.8
"13003",13,3,1996,3188,2955,233,7.3
"13003",13,3,1997,3390,3102,288,8.5
"13003",13,3,1998,3199,2943,256,8
"13003",13,3,1999,3392,3185,207,6.1
"13003",13,3,2000,3506,3318,188,5.4
"13003",13,3,2001,3327,3124,203,6.1
"13003",13,3,2002,3411,3211,200,5.9
"13003",13,3,2003,3495,3284,211,6
"13003",13,3,2004,3585,3307,278,7.8
"13003",13,3,2005,3504,3315,189,5.4
"13003",13,3,2006,3376,3195,181,5.4
"13003",13,3,2007,3390,3198,192,5.7
"13003",13,3,2008,3388,3106,282,8.3
"13003",13,3,2009,3289,2797,492,15
"13003",13,3,2010,3451,2925,526,15.2
"13003",13,3,2011,3495,3047,448,12.8
"13003",13,3,2012,3446,3048,398,11.5
"13003",13,3,2013,3485,3159,326,9.4
"13003",13,3,2014,3615,3342,273,7.6
"13003",13,3,2015,3866,3644,222,5.7
"13003",13,3,2016,3981,3773,208,5.2
"13003",13,3,2017,4160,3973,187,4.5
"13005",13,5,1990,4395,4134,261,5.9
"13005",13,5,1991,4381,4101,280,6.4
"13005",13,5,1992,4544,4144,400,8.8
"13005",13,5,1993,4512,4157,355,7.9
"13005",13,5,1994,4479,4231,248,5.5
"13005",13,5,1995,4578,4369,209,4.6
"13005",13,5,1996,4679,4381,298,6.4
"13005",13,5,1997,4474,4110,364,8.1
"13005",13,5,1998,4372,3966,406,9.3
"13005",13,5,1999,4340,4032,308,7.1
"13005",13,5,2000,4664,4449,215,4.6
"13005",13,5,2001,4491,4246,245,5.5
"13005",13,5,2002,4185,3923,262,6.3
"13005",13,5,2003,4295,4063,232,5.4
"13005",13,5,2004,4302,4075,227,5.3
"13005",13,5,2005,4726,4474,252,5.3
"13005",13,5,2006,4789,4570,219,4.6
"13005",13,5,2007,4738,4511,227,4.8
"13005",13,5,2008,4794,4495,299,6.2
"13005",13,5,2009,4643,4207,436,9.4
"13005",13,5,2010,4542,4059,483,10.6
"13005",13,5,2011,4508,4035,473,10.5
"13005",13,5,2012,4557,4116,441,9.7
"13005",13,5,2013,4628,4237,391,8.4
"13005",13,5,2014,4847,4511,336,6.9
"13005",13,5,2015,4896,4615,281,5.7
"13005",13,5,2016,4988,4727,261,5.2
"13005",13,5,2017,5091,4860,231,4.5
"13007",13,7,1990,1575,1493,82,5.2
"13007",13,7,1991,1632,1531,101,6.2
"13007",13,7,1992,1489,1209,280,18.8
"13007",13,7,1993,1343,1137,206,15.3
"13007",13,7,1994,1525,1352,173,11.3
"13007",13,7,1995,1474,1359,115,7.8
"13007",13,7,1996,1506,1403,103,6.8
"13007",13,7,1997,1621,1467,154,9.5
"13007",13,7,1998,1667,1511,156,9.4
"13007",13,7,1999,1644,1530,114,6.9
"13007",13,7,2000,1742,1667,75,4.3
"13007",13,7,2001,1723,1639,84,4.9
"13007",13,7,2002,1688,1604,84,5
"13007",13,7,2003,1851,1761,90,4.9
"13007",13,7,2004,1798,1718,80,4.4
"13007",13,7,2005,1791,1697,94,5.2
"13007",13,7,2006,1781,1691,90,5.1
"13007",13,7,2007,1657,1574,83,5
"13007",13,7,2008,1677,1570,107,6.4
"13007",13,7,2009,1586,1439,147,9.3
"13007",13,7,2010,1232,1083,149,12.1
"13007",13,7,2011,1172,1036,136,11.6
"13007",13,7,2012,1172,1043,129,11
"13007",13,7,2013,1129,1010,119,10.5
"13007",13,7,2014,1114,1014,100,9
"13007",13,7,2015,1124,1042,82,7.3
"13007",13,7,2016,1183,1092,91,7.7
"13007",13,7,2017,1220,1143,77,6.3
"13009",13,9,1990,16772,16071,701,4.2
"13009",13,9,1991,16632,15988,644,3.9
"13009",13,9,1992,17003,16008,995,5.9
"13009",13,9,1993,17048,16253,795,4.7
"13009",13,9,1994,17047,16439,608,3.6
"13009",13,9,1995,17432,16750,682,3.9
"13009",13,9,1996,17479,16621,858,4.9
"13009",13,9,1997,17625,16847,778,4.4
"13009",13,9,1998,18025,16999,1026,5.7
"13009",13,9,1999,17831,16766,1065,6
"13009",13,9,2000,18967,18042,925,4.9
"13009",13,9,2001,18816,17971,845,4.5
"13009",13,9,2002,19582,18624,958,4.9
"13009",13,9,2003,19930,18992,938,4.7
"13009",13,9,2004,20150,19186,964,4.8
"13009",13,9,2005,20216,19103,1113,5.5
"13009",13,9,2006,20941,19804,1137,5.4
"13009",13,9,2007,20745,19590,1155,5.6
"13009",13,9,2008,21101,19445,1656,7.8
"13009",13,9,2009,20401,17868,2533,12.4
"13009",13,9,2010,19192,16243,2949,15.4
"13009",13,9,2011,18617,16054,2563,13.8
"13009",13,9,2012,18881,16689,2192,11.6
"13009",13,9,2013,18527,16649,1878,10.1
"13009",13,9,2014,18474,16870,1604,8.7
"13009",13,9,2015,17750,16391,1359,7.7
"13009",13,9,2016,17653,16447,1206,6.8
"13009",13,9,2017,17815,16756,1059,5.9
"13011",13,11,1990,5564,5267,297,5.3
"13011",13,11,1991,5847,5545,302,5.2
"13011",13,11,1992,5922,5558,364,6.1
"13011",13,11,1993,5801,5481,320,5.5
"13011",13,11,1994,5859,5610,249,4.2
"13011",13,11,1995,5737,5467,270,4.7
"13011",13,11,1996,5981,5693,288,4.8
"13011",13,11,1997,6137,5806,331,5.4
"13011",13,11,1998,6140,5890,250,4.1
"13011",13,11,1999,6442,6203,239,3.7
"13011",13,11,2000,7804,7565,239,3.1
"13011",13,11,2001,7802,7523,279,3.6
"13011",13,11,2002,8107,7764,343,4.2
"13011",13,11,2003,8333,8011,322,3.9
"13011",13,11,2004,8786,8472,314,3.6
"13011",13,11,2005,9163,8803,360,3.9
"13011",13,11,2006,9592,9283,309,3.2
"13011",13,11,2007,10601,10283,318,3
"13011",13,11,2008,11055,10556,499,4.5
"13011",13,11,2009,10552,9747,805,7.6
"13011",13,11,2010,8457,7640,817,9.7
"13011",13,11,2011,8506,7720,786,9.2
"13011",13,11,2012,8591,7885,706,8.2
"13011",13,11,2013,7995,7365,630,7.9
"13011",13,11,2014,8149,7611,538,6.6
"13011",13,11,2015,8222,7764,458,5.6
"13011",13,11,2016,8825,8397,428,4.8
"13011",13,11,2017,9242,8876,366,4
"13013",13,13,1990,15209,14033,1176,7.7
"13013",13,13,1991,15089,14159,930,6.2
"13013",13,13,1992,15782,14537,1245,7.9
"13013",13,13,1993,16379,15264,1115,6.8
"13013",13,13,1994,17060,16163,897,5.3
"13013",13,13,1995,17819,16838,981,5.5
"13013",13,13,1996,18761,18039,722,3.8
"13013",13,13,1997,19890,19082,808,4.1
"13013",13,13,1998,20945,20091,854,4.1
"13013",13,13,1999,21518,20884,634,2.9
"13013",13,13,2000,25128,24364,764,3
"13013",13,13,2001,25919,24901,1018,3.9
"13013",13,13,2002,26798,25493,1305,4.9
"13013",13,13,2003,27438,26136,1302,4.7
"13013",13,13,2004,28718,27421,1297,4.5
"13013",13,13,2005,30504,29050,1454,4.8
"13013",13,13,2006,32009,30653,1356,4.2
"13013",13,13,2007,33863,32447,1416,4.2
"13013",13,13,2008,35332,33103,2229,6.3
"13013",13,13,2009,35215,31479,3736,10.6
"13013",13,13,2010,34670,30939,3731,10.8
"13013",13,13,2011,34618,31174,3444,9.9
"13013",13,13,2012,34566,31581,2985,8.6
"13013",13,13,2013,34681,32118,2563,7.4
"13013",13,13,2014,35183,32983,2200,6.3
"13013",13,13,2015,36122,34224,1898,5.3
"13013",13,13,2016,37740,35964,1776,4.7
"13013",13,13,2017,38866,37280,1586,4.1
"13015",13,15,1990,29766,27601,2165,7.3
"13015",13,15,1991,29755,27733,2022,6.8
"13015",13,15,1992,30780,28263,2517,8.2
"13015",13,15,1993,31166,28954,2212,7.1
"13015",13,15,1994,32159,30332,1827,5.7
"13015",13,15,1995,33488,31458,2030,6.1
"13015",13,15,1996,35325,33438,1887,5.3
"13015",13,15,1997,37597,35531,2066,5.5
"13015",13,15,1998,39194,37485,1709,4.4
"13015",13,15,1999,40594,39009,1585,3.9
"13015",13,15,2000,40537,39030,1507,3.7
"13015",13,15,2001,41483,39674,1809,4.4
"13015",13,15,2002,42311,39961,2350,5.6
"13015",13,15,2003,42706,40447,2259,5.3
"13015",13,15,2004,43182,40898,2284,5.3
"13015",13,15,2005,44608,42034,2574,5.8
"13015",13,15,2006,44896,42696,2200,4.9
"13015",13,15,2007,45865,43620,2245,4.9
"13015",13,15,2008,46936,43592,3344,7.1
"13015",13,15,2009,46443,40810,5633,12.1
"13015",13,15,2010,47837,42007,5830,12.2
"13015",13,15,2011,47746,42279,5467,11.5
"13015",13,15,2012,47422,42716,4706,9.9
"13015",13,15,2013,47053,42976,4077,8.7
"13015",13,15,2014,46609,43279,3330,7.1
"13015",13,15,2015,46858,44103,2755,5.9
"13015",13,15,2016,48244,45778,2466,5.1
"13015",13,15,2017,49763,47468,2295,4.6
"13017",13,17,1990,7207,6752,455,6.3
"13017",13,17,1991,7095,6693,402,5.7
"13017",13,17,1992,7517,6995,522,6.9
"13017",13,17,1993,7961,7364,597,7.5
"13017",13,17,1994,8206,7700,506,6.2
"13017",13,17,1995,8434,8000,434,5.1
"13017",13,17,1996,8778,8211,567,6.5
"13017",13,17,1997,9000,8385,615,6.8
"13017",13,17,1998,9316,8743,573,6.2
"13017",13,17,1999,9687,9079,608,6.3
"13017",13,17,2000,8151,7752,399,4.9
"13017",13,17,2001,7837,7433,404,5.2
"13017",13,17,2002,7890,7441,449,5.7
"13017",13,17,2003,7762,7243,519,6.7
"13017",13,17,2004,7882,7500,382,4.8
"13017",13,17,2005,8090,7635,455,5.6
"13017",13,17,2006,8237,7770,467,5.7
"13017",13,17,2007,7891,7348,543,6.9
"13017",13,17,2008,7536,6719,817,10.8
"13017",13,17,2009,7286,6148,1138,15.6
"13017",13,17,2010,6516,5481,1035,15.9
"13017",13,17,2011,6254,5279,975,15.6
"13017",13,17,2012,6183,5321,862,13.9
"13017",13,17,2013,5775,5055,720,12.5
"13017",13,17,2014,5596,5039,557,10
"13017",13,17,2015,5477,4984,493,9
"13017",13,17,2016,5554,5099,455,8.2
"13017",13,17,2017,5511,5078,433,7.9
"13019",13,19,1990,6929,6423,506,7.3
"13019",13,19,1991,6592,6226,366,5.6
"13019",13,19,1992,6599,6094,505,7.7
"13019",13,19,1993,6418,5899,519,8.1
"13019",13,19,1994,6424,6030,394,6.1
"13019",13,19,1995,6538,6155,383,5.9
"13019",13,19,1996,6751,6398,353,5.2
"13019",13,19,1997,7035,6696,339,4.8
"13019",13,19,1998,6943,6620,323,4.7
"13019",13,19,1999,6880,6424,456,6.6
"13019",13,19,2000,8053,7728,325,4
"13019",13,19,2001,7928,7601,327,4.1
"13019",13,19,2002,8104,7768,336,4.1
"13019",13,19,2003,8465,8175,290,3.4
"13019",13,19,2004,8592,8275,317,3.7
"13019",13,19,2005,8833,8464,369,4.2
"13019",13,19,2006,8936,8566,370,4.1
"13019",13,19,2007,8801,8419,382,4.3
"13019",13,19,2008,8665,8061,604,7
"13019",13,19,2009,8211,7140,1071,13
"13019",13,19,2010,7990,6951,1039,13
"13019",13,19,2011,7868,6886,982,12.5
"13019",13,19,2012,7859,7054,805,10.2
"13019",13,19,2013,7410,6703,707,9.5
"13019",13,19,2014,7234,6619,615,8.5
"13019",13,19,2015,7045,6540,505,7.2
"13019",13,19,2016,7227,6786,441,6.1
"13019",13,19,2017,7419,7042,377,5.1
"13021",13,21,1990,69366,65841,3525,5.1
"13021",13,21,1991,68111,64994,3117,4.6
"13021",13,21,1992,69456,64834,4622,6.7
"13021",13,21,1993,69920,65609,4311,6.2
"13021",13,21,1994,71620,66887,4733,6.6
"13021",13,21,1995,71467,67646,3821,5.3
"13021",13,21,1996,73202,69336,3866,5.3
"13021",13,21,1997,74949,71039,3910,5.2
"13021",13,21,1998,75441,70879,4562,6
"13021",13,21,1999,71063,67378,3685,5.2
"13021",13,21,2000,70329,67260,3069,4.4
"13021",13,21,2001,69231,66170,3061,4.4
"13021",13,21,2002,70455,66892,3563,5.1
"13021",13,21,2003,71971,68488,3483,4.8
"13021",13,21,2004,72537,68846,3691,5.1
"13021",13,21,2005,72845,68652,4193,5.8
"13021",13,21,2006,73392,69204,4188,5.7
"13021",13,21,2007,73788,69952,3836,5.2
"13021",13,21,2008,75685,70795,4890,6.5
"13021",13,21,2009,74638,67382,7256,9.7
"13021",13,21,2010,70225,62053,8172,11.6
"13021",13,21,2011,71223,63035,8188,11.5
"13021",13,21,2012,71737,64176,7561,10.5
"13021",13,21,2013,69888,63407,6481,9.3
"13021",13,21,2014,69005,63493,5512,8
"13021",13,21,2015,67932,63413,4519,6.7
"13021",13,21,2016,68728,64646,4082,5.9
"13021",13,21,2017,69653,65922,3731,5.4
"13023",13,23,1990,4889,4605,284,5.8
"13023",13,23,1991,4794,4579,215,4.5
"13023",13,23,1992,5049,4783,266,5.3
"13023",13,23,1993,4950,4707,243,4.9
"13023",13,23,1994,5365,5113,252,4.7
"13023",13,23,1995,5578,5342,236,4.2
"13023",13,23,1996,5349,5054,295,5.5
"13023",13,23,1997,5477,5218,259,4.7
"13023",13,23,1998,5794,5502,292,5
"13023",13,23,1999,5812,5558,254,4.4
"13023",13,23,2000,5170,4950,220,4.3
"13023",13,23,2001,5067,4802,265,5.2
"13023",13,23,2002,5154,4862,292,5.7
"13023",13,23,2003,5311,5047,264,5
"13023",13,23,2004,5104,4801,303,5.9
"13023",13,23,2005,5081,4702,379,7.5
"13023",13,23,2006,5153,4851,302,5.9
"13023",13,23,2007,5364,5084,280,5.2
"13023",13,23,2008,5406,5013,393,7.3
"13023",13,23,2009,5451,4908,543,10
"13023",13,23,2010,5474,4792,682,12.5
"13023",13,23,2011,5492,4759,733,13.3
"13023",13,23,2012,5282,4617,665,12.6
"13023",13,23,2013,4788,4118,670,14
"13023",13,23,2014,4630,4112,518,11.2
"13023",13,23,2015,4372,3999,373,8.5
"13023",13,23,2016,4507,4151,356,7.9
"13023",13,23,2017,4581,4263,318,6.9
"13025",13,25,1990,4782,4375,407,8.5
"13025",13,25,1991,4619,4275,344,7.4
"13025",13,25,1992,4722,4217,505,10.7
"13025",13,25,1993,5026,4576,450,9
"13025",13,25,1994,5143,4666,477,9.3
"13025",13,25,1995,4947,4527,420,8.5
"13025",13,25,1996,5492,5079,413,7.5
"13025",13,25,1997,5774,5347,427,7.4
"13025",13,25,1998,6067,5663,404,6.7
"13025",13,25,1999,5995,5586,409,6.8
"13025",13,25,2000,6786,6498,288,4.2
"13025",13,25,2001,6813,6489,324,4.8
"13025",13,25,2002,7018,6636,382,5.4
"13025",13,25,2003,7195,6806,389,5.4
"13025",13,25,2004,7330,6962,368,5
"13025",13,25,2005,7559,7148,411,5.4
"13025",13,25,2006,7650,7291,359,4.7
"13025",13,25,2007,7559,7220,339,4.5
"13025",13,25,2008,7677,7186,491,6.4
"13025",13,25,2009,7545,6723,822,10.9
"13025",13,25,2010,7468,6516,952,12.7
"13025",13,25,2011,7463,6480,983,13.2
"13025",13,25,2012,7440,6546,894,12
"13025",13,25,2013,7036,6287,749,10.6
"13025",13,25,2014,6887,6253,634,9.2
"13025",13,25,2015,6905,6391,514,7.4
"13025",13,25,2016,7104,6627,477,6.7
"13025",13,25,2017,7238,6818,420,5.8
"13027",13,27,1990,6377,6140,237,3.7
"13027",13,27,1991,6384,6167,217,3.4
"13027",13,27,1992,6497,6181,316,4.9
"13027",13,27,1993,6566,6259,307,4.7
"13027",13,27,1994,6583,6329,254,3.9
"13027",13,27,1995,6812,6549,263,3.9
"13027",13,27,1996,7022,6742,280,4
"13027",13,27,1997,7933,7527,406,5.1
"13027",13,27,1998,7784,7310,474,6.1
"13027",13,27,1999,7779,7433,346,4.4
"13027",13,27,2000,7557,7205,352,4.7
"13027",13,27,2001,7563,7207,356,4.7
"13027",13,27,2002,7843,7479,364,4.6
"13027",13,27,2003,7997,7727,270,3.4
"13027",13,27,2004,8058,7774,284,3.5
"13027",13,27,2005,8289,7932,357,4.3
"13027",13,27,2006,8525,8174,351,4.1
"13027",13,27,2007,8407,8047,360,4.3
"13027",13,27,2008,8406,7927,479,5.7
"13027",13,27,2009,8022,7334,688,8.6
"13027",13,27,2010,7309,6605,704,9.6
"13027",13,27,2011,7066,6359,707,10
"13027",13,27,2012,6808,6184,624,9.2
"13027",13,27,2013,6682,6125,557,8.3
"13027",13,27,2014,6631,6154,477,7.2
"13027",13,27,2015,6886,6467,419,6.1
"13027",13,27,2016,7018,6651,367,5.2
"13027",13,27,2017,7158,6835,323,4.5
"13029",13,29,1990,7088,6773,315,4.4
"13029",13,29,1991,7322,6987,335,4.6
"13029",13,29,1992,7950,7505,445,5.6
"13029",13,29,1993,8369,7970,399,4.8
"13029",13,29,1994,8919,8508,411,4.6
"13029",13,29,1995,9428,9045,383,4.1
"13029",13,29,1996,10014,9632,382,3.8
"13029",13,29,1997,10657,10273,384,3.6
"13029",13,29,1998,10909,10547,362,3.3
"13029",13,29,1999,11377,11009,368,3.2
"13029",13,29,2000,11595,11228,367,3.2
"13029",13,29,2001,11898,11529,369,3.1
"13029",13,29,2002,12545,12088,457,3.6
"13029",13,29,2003,13183,12708,475,3.6
"13029",13,29,2004,14330,13818,512,3.6
"13029",13,29,2005,15280,14673,607,4
"13029",13,29,2006,16108,15539,569,3.5
"13029",13,29,2007,16623,16054,569,3.4
"13029",13,29,2008,17096,16255,841,4.9
"13029",13,29,2009,16983,15653,1330,7.8
"13029",13,29,2010,14455,13070,1385,9.6
"13029",13,29,2011,14722,13344,1378,9.4
"13029",13,29,2012,15153,13896,1257,8.3
"13029",13,29,2013,15417,14270,1147,7.4
"13029",13,29,2014,15543,14543,1000,6.4
"13029",13,29,2015,16149,15301,848,5.3
"13029",13,29,2016,16947,16125,822,4.9
"13029",13,29,2017,17325,16593,732,4.2
"13031",13,31,1990,19580,18549,1031,5.3
"13031",13,31,1991,20003,19145,858,4.3
"13031",13,31,1992,20650,19661,989,4.8
"13031",13,31,1993,20533,19782,751,3.7
"13031",13,31,1994,21386,20696,690,3.2
"13031",13,31,1995,22883,22104,779,3.4
"13031",13,31,1996,24562,23814,748,3
"13031",13,31,1997,26092,25235,857,3.3
"13031",13,31,1998,26044,25090,954,3.7
"13031",13,31,1999,26885,26203,682,2.5
"13031",13,31,2000,27281,26214,1067,3.9
"13031",13,31,2001,27469,26274,1195,4.4
"13031",13,31,2002,28170,26946,1224,4.3
"13031",13,31,2003,29120,27895,1225,4.2
"13031",13,31,2004,29027,27710,1317,4.5
"13031",13,31,2005,30251,28835,1416,4.7
"13031",13,31,2006,31426,30076,1350,4.3
"13031",13,31,2007,32393,30994,1399,4.3
"13031",13,31,2008,33157,31140,2017,6.1
"13031",13,31,2009,32964,29867,3097,9.4
"13031",13,31,2010,33132,29802,3330,10.1
"13031",13,31,2011,33499,29978,3521,10.5
"13031",13,31,2012,33926,30602,3324,9.8
"13031",13,31,2013,34177,31209,2968,8.7
"13031",13,31,2014,34535,32015,2520,7.3
"13031",13,31,2015,34740,32636,2104,6.1
"13031",13,31,2016,36004,33947,2057,5.7
"13031",13,31,2017,37157,35299,1858,5
"13033",13,33,1990,8649,7711,938,10.8
"13033",13,33,1991,8471,7490,981,11.6
"13033",13,33,1992,8548,7209,1339,15.7
"13033",13,33,1993,8530,7475,1055,12.4
"13033",13,33,1994,8587,7537,1050,12.2
"13033",13,33,1995,8680,7477,1203,13.9
"13033",13,33,1996,8881,7412,1469,16.5
"13033",13,33,1997,8804,7507,1297,14.7
"13033",13,33,1998,8274,7173,1101,13.3
"13033",13,33,1999,8825,7983,842,9.5
"13033",13,33,2000,9176,8707,469,5.1
"13033",13,33,2001,9351,8780,571,6.1
"13033",13,33,2002,9565,8912,653,6.8
"13033",13,33,2003,9964,9139,825,8.3
"13033",13,33,2004,9997,9314,683,6.8
"13033",13,33,2005,10078,9315,763,7.6
"13033",13,33,2006,9863,9201,662,6.7
"13033",13,33,2007,9979,9208,771,7.7
"13033",13,33,2008,10002,9133,869,8.7
"13033",13,33,2009,9939,8759,1180,11.9
"13033",13,33,2010,9791,8601,1190,12.2
"13033",13,33,2011,9953,8690,1263,12.7
"13033",13,33,2012,9718,8517,1201,12.4
"13033",13,33,2013,9484,8348,1136,12
"13033",13,33,2014,9169,8253,916,10
"13033",13,33,2015,9131,8390,741,8.1
"13033",13,33,2016,9252,8540,712,7.7
"13033",13,33,2017,9479,8808,671,7.1
"13035",13,35,1990,6456,6020,436,6.8
"13035",13,35,1991,6780,6289,491,7.2
"13035",13,35,1992,6845,6196,649,9.5
"13035",13,35,1993,7121,6644,477,6.7
"13035",13,35,1994,7258,6880,378,5.2
"13035",13,35,1995,7917,7464,453,5.7
"13035",13,35,1996,8097,7618,479,5.9
"13035",13,35,1997,8434,8023,411,4.9
"13035",13,35,1998,8597,8177,420,4.9
"13035",13,35,1999,8633,8270,363,4.2
"13035",13,35,2000,9070,8650,420,4.6
"13035",13,35,2001,9194,8784,410,4.5
"13035",13,35,2002,9472,8946,526,5.6
"13035",13,35,2003,9576,9077,499,5.2
"13035",13,35,2004,8847,8355,492,5.6
"13035",13,35,2005,9107,8550,557,6.1
"13035",13,35,2006,10047,9506,541,5.4
"13035",13,35,2007,10151,9628,523,5.2
"13035",13,35,2008,10456,9674,782,7.5
"13035",13,35,2009,10144,8923,1221,12
"13035",13,35,2010,10491,9288,1203,11.5
"13035",13,35,2011,10458,9270,1188,11.4
"13035",13,35,2012,10375,9311,1064,10.3
"13035",13,35,2013,10197,9250,947,9.3
"13035",13,35,2014,10025,9277,748,7.5
"13035",13,35,2015,10126,9454,672,6.6
"13035",13,35,2016,10389,9805,584,5.6
"13035",13,35,2017,10684,10167,517,4.8
"13037",13,37,1990,2083,1967,116,5.6
"13037",13,37,1991,2089,1948,141,6.7
"13037",13,37,1992,2172,1891,281,12.9
"13037",13,37,1993,2084,1782,302,14.5
"13037",13,37,1994,1992,1734,258,13
"13037",13,37,1995,2251,2074,177,7.9
"13037",13,37,1996,2301,2109,192,8.3
"13037",13,37,1997,2363,2174,189,8
"13037",13,37,1998,2298,2107,191,8.3
"13037",13,37,1999,2443,2225,218,8.9
"13037",13,37,2000,2358,2203,155,6.6
"13037",13,37,2001,2363,2207,156,6.6
"13037",13,37,2002,2355,2190,165,7
"13037",13,37,2003,2454,2294,160,6.5
"13037",13,37,2004,2326,2189,137,5.9
"13037",13,37,2005,2325,2158,167,7.2
"13037",13,37,2006,2427,2282,145,6
"13037",13,37,2007,2175,2032,143,6.6
"13037",13,37,2008,2407,2214,193,8
"13037",13,37,2009,2343,2080,263,11.2
"13037",13,37,2010,2620,2390,230,8.8
"13037",13,37,2011,2522,2310,212,8.4
"13037",13,37,2012,2375,2190,185,7.8
"13037",13,37,2013,2105,1934,171,8.1
"13037",13,37,2014,2139,1991,148,6.9
"13037",13,37,2015,2129,1997,132,6.2
"13037",13,37,2016,2166,2044,122,5.6
"13037",13,37,2017,2236,2119,117,5.2
"13039",13,39,1990,11549,10932,617,5.3
"13039",13,39,1991,13611,13093,518,3.8
"13039",13,39,1992,14395,13568,827,5.7
"13039",13,39,1993,15058,14395,663,4.4
"13039",13,39,1994,15229,14590,639,4.2
"13039",13,39,1995,15187,14595,592,3.9
"13039",13,39,1996,15711,15017,694,4.4
"13039",13,39,1997,16384,15602,782,4.8
"13039",13,39,1998,16854,16170,684,4.1
"13039",13,39,1999,17108,16483,625,3.7
"13039",13,39,2000,17796,17141,655,3.7
"13039",13,39,2001,17872,17199,673,3.8
"13039",13,39,2002,18370,17546,824,4.5
"13039",13,39,2003,18756,17745,1011,5.4
"13039",13,39,2004,19071,18213,858,4.5
"13039",13,39,2005,20428,19466,962,4.7
"13039",13,39,2006,20884,20024,860,4.1
"13039",13,39,2007,21609,20742,867,4
"13039",13,39,2008,21373,20178,1195,5.6
"13039",13,39,2009,20757,18902,1855,8.9
"13039",13,39,2010,20695,18643,2052,9.9
"13039",13,39,2011,21154,19133,2021,9.6
"13039",13,39,2012,21882,20003,1879,8.6
"13039",13,39,2013,21579,19904,1675,7.8
"13039",13,39,2014,21957,20514,1443,6.6
"13039",13,39,2015,22305,21068,1237,5.5
"13039",13,39,2016,20374,19203,1171,5.7
"13039",13,39,2017,20906,19823,1083,5.2
"13043",13,43,1990,3485,3310,175,5
"13043",13,43,1991,3484,3335,149,4.3
"13043",13,43,1992,3609,3381,228,6.3
"13043",13,43,1993,3741,3567,174,4.7
"13043",13,43,1994,3716,3482,234,6.3
"13043",13,43,1995,3640,3458,182,5
"13043",13,43,1996,3900,3727,173,4.4
"13043",13,43,1997,4178,3992,186,4.5
"13043",13,43,1998,4080,3845,235,5.8
"13043",13,43,1999,4126,3901,225,5.5
"13043",13,43,2000,3985,3798,187,4.7
"13043",13,43,2001,3905,3720,185,4.7
"13043",13,43,2002,4037,3850,187,4.6
"13043",13,43,2003,4162,3980,182,4.4
"13043",13,43,2004,4394,4190,204,4.6
"13043",13,43,2005,4494,4277,217,4.8
"13043",13,43,2006,4595,4401,194,4.2
"13043",13,43,2007,4418,4223,195,4.4
"13043",13,43,2008,4348,4075,273,6.3
"13043",13,43,2009,4341,3938,403,9.3
"13043",13,43,2010,4917,4482,435,8.8
"13043",13,43,2011,5033,4549,484,9.6
"13043",13,43,2012,5187,4737,450,8.7
"13043",13,43,2013,5102,4685,417,8.2
"13043",13,43,2014,5074,4725,349,6.9
"13043",13,43,2015,4967,4685,282,5.7
"13043",13,43,2016,5077,4835,242,4.8
"13043",13,43,2017,5270,5051,219,4.2
"13045",13,45,1990,36659,34401,2258,6.2
"13045",13,45,1991,36171,34088,2083,5.8
"13045",13,45,1992,37011,34356,2655,7.2
"13045",13,45,1993,37690,35372,2318,6.2
"13045",13,45,1994,38664,36811,1853,4.8
"13045",13,45,1995,39698,37650,2048,5.2
"13045",13,45,1996,41148,39022,2126,5.2
"13045",13,45,1997,43040,40874,2166,5
"13045",13,45,1998,44264,42235,2029,4.6
"13045",13,45,1999,45351,43330,2021,4.5
"13045",13,45,2000,44846,43157,1689,3.8
"13045",13,45,2001,46154,43984,2170,4.7
"13045",13,45,2002,46735,44249,2486,5.3
"13045",13,45,2003,47729,45255,2474,5.2
"13045",13,45,2004,48730,46314,2416,5
"13045",13,45,2005,50679,47869,2810,5.5
"13045",13,45,2006,50874,48381,2493,4.9
"13045",13,45,2007,53240,50688,2552,4.8
"13045",13,45,2008,53935,50314,3621,6.7
"13045",13,45,2009,52693,46910,5783,11
"13045",13,45,2010,51817,45762,6055,11.7
"13045",13,45,2011,51917,46021,5896,11.4
"13045",13,45,2012,52013,46676,5337,10.3
"13045",13,45,2013,51854,46866,4988,9.6
"13045",13,45,2014,51951,47716,4235,8.2
"13045",13,45,2015,51792,48314,3478,6.7
"13045",13,45,2016,53600,50389,3211,6
"13045",13,45,2017,55039,52272,2767,5
"13047",13,47,1990,21247,20272,975,4.6
"13047",13,47,1991,21630,20608,1022,4.7
"13047",13,47,1992,22447,21109,1338,6
"13047",13,47,1993,23094,21985,1109,4.8
"13047",13,47,1994,23729,22693,1036,4.4
"13047",13,47,1995,24257,23228,1029,4.2
"13047",13,47,1996,24813,23714,1099,4.4
"13047",13,47,1997,25506,24483,1023,4
"13047",13,47,1998,26313,25255,1058,4
"13047",13,47,1999,27451,26592,859,3.1
"13047",13,47,2000,29667,28863,804,2.7
"13047",13,47,2001,30204,29309,895,3
"13047",13,47,2002,31507,30434,1073,3.4
"13047",13,47,2003,32863,31775,1088,3.3
"13047",13,47,2004,33912,32717,1195,3.5
"13047",13,47,2005,34815,33295,1520,4.4
"13047",13,47,2006,36037,34649,1388,3.9
"13047",13,47,2007,35453,34177,1276,3.6
"13047",13,47,2008,35778,33948,1830,5.1
"13047",13,47,2009,34611,31689,2922,8.4
"13047",13,47,2010,31351,28665,2686,8.6
"13047",13,47,2011,32062,29433,2629,8.2
"13047",13,47,2012,32250,29840,2410,7.5
"13047",13,47,2013,31646,29516,2130,6.7
"13047",13,47,2014,31036,29138,1898,6.1
"13047",13,47,2015,31376,29738,1638,5.2
"13047",13,47,2016,32208,30655,1553,4.8
"13047",13,47,2017,33123,31747,1376,4.2
"13049",13,49,1990,3536,3364,172,4.9
"13049",13,49,1991,3840,3678,162,4.2
"13049",13,49,1992,3800,3548,252,6.6
"13049",13,49,1993,3889,3661,228,5.9
"13049",13,49,1994,3868,3647,221,5.7
"13049",13,49,1995,3919,3670,249,6.4
"13049",13,49,1996,3910,3634,276,7.1
"13049",13,49,1997,3768,3575,193,5.1
"13049",13,49,1998,3789,3597,192,5.1
"13049",13,49,1999,3876,3700,176,4.5
"13049",13,49,2000,3948,3784,164,4.2
"13049",13,49,2001,3941,3772,169,4.3
"13049",13,49,2002,4092,3890,202,4.9
"13049",13,49,2003,4243,4014,229,5.4
"13049",13,49,2004,4216,4006,210,5
"13049",13,49,2005,4380,4147,233,5.3
"13049",13,49,2006,4574,4365,209,4.6
"13049",13,49,2007,4595,4377,218,4.7
"13049",13,49,2008,4587,4278,309,6.7
"13049",13,49,2009,4472,3983,489,10.9
"13049",13,49,2010,4797,4288,509,10.6
"13049",13,49,2011,4965,4437,528,10.6
"13049",13,49,2012,4980,4515,465,9.3
"13049",13,49,2013,4919,4504,415,8.4
"13049",13,49,2014,4804,4451,353,7.3
"13049",13,49,2015,4768,4463,305,6.4
"13049",13,49,2016,4746,4479,267,5.6
"13049",13,49,2017,4841,4595,246,5.1
"13051",13,51,1990,100184,95519,4665,4.7
"13051",13,51,1991,99590,95148,4442,4.5
"13051",13,51,1992,103638,96720,6918,6.7
"13051",13,51,1993,102863,96425,6438,6.3
"13051",13,51,1994,103508,97460,6048,5.8
"13051",13,51,1995,103842,98220,5622,5.4
"13051",13,51,1996,104888,99468,5420,5.2
"13051",13,51,1997,107847,102188,5659,5.2
"13051",13,51,1998,108471,103279,5192,4.8
"13051",13,51,1999,108268,103553,4715,4.4
"13051",13,51,2000,111566,107528,4038,3.6
"13051",13,51,2001,111580,107564,4016,3.6
"13051",13,51,2002,114891,109941,4950,4.3
"13051",13,51,2003,116179,111181,4998,4.3
"13051",13,51,2004,121432,116271,5161,4.3
"13051",13,51,2005,124569,118847,5722,4.6
"13051",13,51,2006,127947,122727,5220,4.1
"13051",13,51,2007,133680,128394,5286,4
"13051",13,51,2008,134606,127004,7602,5.6
"13051",13,51,2009,131170,119831,11339,8.6
"13051",13,51,2010,127323,114777,12546,9.9
"13051",13,51,2011,129639,116650,12989,10
"13051",13,51,2012,131983,119798,12185,9.2
"13051",13,51,2013,131360,120499,10861,8.3
"13051",13,51,2014,131711,122124,9587,7.3
"13051",13,51,2015,133266,125482,7784,5.8
"13051",13,51,2016,136230,129105,7125,5.2
"13051",13,51,2017,139026,132767,6259,4.5
"13053",13,53,1990,2251,2017,234,10.4
"13053",13,53,1991,1980,1827,153,7.7
"13053",13,53,1992,2136,1914,222,10.4
"13053",13,53,1993,2059,1877,182,8.8
"13053",13,53,1994,2031,1856,175,8.6
"13053",13,53,1995,2093,1941,152,7.3
"13053",13,53,1996,2219,2055,164,7.4
"13053",13,53,1997,2342,2166,176,7.5
"13053",13,53,1998,2417,2238,179,7.4
"13053",13,53,1999,2471,2304,167,6.8
"13053",13,53,2000,2633,2415,218,8.3
"13053",13,53,2001,2603,2408,195,7.5
"13053",13,53,2002,2665,2433,232,8.7
"13053",13,53,2003,2748,2523,225,8.2
"13053",13,53,2004,2760,2512,248,9
"13053",13,53,2005,2657,2375,282,10.6
"13053",13,53,2006,2508,2264,244,9.7
"13053",13,53,2007,1704,1543,161,9.4
"13053",13,53,2008,2558,2246,312,12.2
"13053",13,53,2009,2621,2232,389,14.8
"13053",13,53,2010,2218,1976,242,10.9
"13053",13,53,2011,2369,2095,274,11.6
"13053",13,53,2012,2601,2296,305,11.7
"13053",13,53,2013,2461,2191,270,11
"13053",13,53,2014,2229,2013,216,9.7
"13053",13,53,2015,2110,1925,185,8.8
"13053",13,53,2016,2061,1891,170,8.2
"13053",13,53,2017,2088,1935,153,7.3
"13055",13,55,1990,10686,9893,793,7.4
"13055",13,55,1991,10563,9785,778,7.4
"13055",13,55,1992,11451,10490,961,8.4
"13055",13,55,1993,11799,11088,711,6
"13055",13,55,1994,11828,11207,621,5.3
"13055",13,55,1995,11933,11367,566,4.7
"13055",13,55,1996,12106,11565,541,4.5
"13055",13,55,1997,11996,11398,598,5
"13055",13,55,1998,11842,11364,478,4
"13055",13,55,1999,12184,11702,482,4
"13055",13,55,2000,11630,11187,443,3.8
"13055",13,55,2001,11186,10649,537,4.8
"13055",13,55,2002,11253,10780,473,4.2
"13055",13,55,2003,11335,10836,499,4.4
"13055",13,55,2004,10958,10408,550,5
"13055",13,55,2005,11053,10449,604,5.5
"13055",13,55,2006,10866,10323,543,5
"13055",13,55,2007,10922,10279,643,5.9
"13055",13,55,2008,11279,10172,1107,9.8
"13055",13,55,2009,10773,9339,1434,13.3
"13055",13,55,2010,10671,9425,1246,11.7
"13055",13,55,2011,10578,9411,1167,11
"13055",13,55,2012,10642,9552,1090,10.2
"13055",13,55,2013,10537,9589,948,9
"13055",13,55,2014,10515,9718,797,7.6
"13055",13,55,2015,10553,9902,651,6.2
"13055",13,55,2016,10447,9790,657,6.3
"13055",13,55,2017,10632,10128,504,4.7
"13057",13,57,1990,50991,48867,2124,4.2
"13057",13,57,1991,52535,50533,2002,3.8
"13057",13,57,1992,55881,52987,2894,5.2
"13057",13,57,1993,56874,54442,2432,4.3
"13057",13,57,1994,60613,58546,2067,3.4
"13057",13,57,1995,64236,62009,2227,3.5
"13057",13,57,1996,68601,66772,1829,2.7
"13057",13,57,1997,72904,71148,1756,2.4
"13057",13,57,1998,78227,76461,1766,2.3
"13057",13,57,1999,82552,80910,1642,2
"13057",13,57,2000,82743,80578,2165,2.6
"13057",13,57,2001,85741,83286,2455,2.9
"13057",13,57,2002,88668,85028,3640,4.1
"13057",13,57,2003,91178,87455,3723,4.1
"13057",13,57,2004,94256,90610,3646,3.9
"13057",13,57,2005,99737,95569,4168,4.2
"13057",13,57,2006,104485,100633,3852,3.7
"13057",13,57,2007,109716,105748,3968,3.6
"13057",13,57,2008,112409,106486,5923,5.3
"13057",13,57,2009,110242,100467,9775,8.9
"13057",13,57,2010,112578,102687,9891,8.8
"13057",13,57,2011,113843,104542,9301,8.2
"13057",13,57,2012,115046,106895,8151,7.1
"13057",13,57,2013,115674,108567,7107,6.1
"13057",13,57,2014,118001,111560,6441,5.5
"13057",13,57,2015,120360,114736,5624,4.7
"13057",13,57,2016,126039,120685,5354,4.2
"13057",13,57,2017,129987,125131,4856,3.7
"13059",13,59,1990,43287,40755,2532,5.8
"13059",13,59,1991,42387,40707,1680,4
"13059",13,59,1992,42290,40254,2036,4.8
"13059",13,59,1993,42806,41051,1755,4.1
"13059",13,59,1994,44188,42530,1658,3.8
"13059",13,59,1995,45566,44030,1536,3.4
"13059",13,59,1996,46463,44940,1523,3.3
"13059",13,59,1997,47362,45857,1505,3.2
"13059",13,59,1998,47972,46406,1566,3.3
"13059",13,59,1999,47095,45786,1309,2.8
"13059",13,59,2000,54212,52334,1878,3.5
"13059",13,59,2001,54603,52542,2061,3.8
"13059",13,59,2002,55634,53411,2223,4
"13059",13,59,2003,57142,54998,2144,3.8
"13059",13,59,2004,57858,55500,2358,4.1
"13059",13,59,2005,59066,56414,2652,4.5
"13059",13,59,2006,62595,59905,2690,4.3
"13059",13,59,2007,64398,61911,2487,3.9
"13059",13,59,2008,66162,62795,3367,5.1
"13059",13,59,2009,64085,59216,4869,7.6
"13059",13,59,2010,56637,51361,5276,9.3
"13059",13,59,2011,57177,51856,5321,9.3
"13059",13,59,2012,58146,53081,5065,8.7
"13059",13,59,2013,57878,53353,4525,7.8
"13059",13,59,2014,56217,52333,3884,6.9
"13059",13,59,2015,57140,53664,3476,6.1
"13059",13,59,2016,58827,55591,3236,5.5
"13059",13,59,2017,60980,58078,2902,4.8
"13061",13,61,1990,1320,1258,62,4.7
"13061",13,61,1991,1385,1330,55,4
"13061",13,61,1992,1512,1399,113,7.5
"13061",13,61,1993,1466,1349,117,8
"13061",13,61,1994,1490,1397,93,6.2
"13061",13,61,1995,1509,1401,108,7.2
"13061",13,61,1996,1569,1439,130,8.3
"13061",13,61,1997,1726,1587,139,8.1
"13061",13,61,1998,1589,1470,119,7.5
"13061",13,61,1999,1571,1469,102,6.5
"13061",13,61,2000,1343,1268,75,5.6
"13061",13,61,2001,1316,1238,78,5.9
"13061",13,61,2002,1458,1389,69,4.7
"13061",13,61,2003,1536,1468,68,4.4
"13061",13,61,2004,1445,1368,77,5.3
"13061",13,61,2005,1384,1309,75,5.4
"13061",13,61,2006,1547,1480,67,4.3
"13061",13,61,2007,1476,1394,82,5.6
"13061",13,61,2008,1477,1370,107,7.2
"13061",13,61,2009,1414,1293,121,8.6
"13061",13,61,2010,1101,973,128,11.6
"13061",13,61,2011,1066,935,131,12.3
"13061",13,61,2012,1009,883,126,12.5
"13061",13,61,2013,955,846,109,11.4
"13061",13,61,2014,915,811,104,11.4
"13061",13,61,2015,859,758,101,11.8
"13061",13,61,2016,885,793,92,10.4
"13061",13,61,2017,875,797,78,8.9
"13063",13,63,1990,102614,97087,5527,5.4
"13063",13,63,1991,102028,96053,5975,5.9
"13063",13,63,1992,104800,97216,7584,7.2
"13063",13,63,1993,107045,100246,6799,6.4
"13063",13,63,1994,110475,104252,6223,5.6
"13063",13,63,1995,112328,106697,5631,5
"13063",13,63,1996,115919,110632,5287,4.6
"13063",13,63,1997,118998,114019,4979,4.2
"13063",13,63,1998,123083,118399,4684,3.8
"13063",13,63,1999,125858,121492,4366,3.5
"13063",13,63,2000,126141,121852,4289,3.4
"13063",13,63,2001,129379,124190,5189,4
"13063",13,63,2002,130859,123136,7723,5.9
"13063",13,63,2003,131772,123982,7790,5.9
"13063",13,63,2004,132632,124857,7775,5.9
"13063",13,63,2005,136125,126767,9358,6.9
"13063",13,63,2006,135385,127426,7959,5.9
"13063",13,63,2007,136206,128444,7762,5.7
"13063",13,63,2008,136611,126243,10368,7.6
"13063",13,63,2009,133143,117459,15684,11.8
"13063",13,63,2010,125156,108243,16913,13.5
"13063",13,63,2011,126983,109948,17035,13.4
"13063",13,63,2012,127655,112298,15357,12
"13063",13,63,2013,125018,111547,13471,10.8
"13063",13,63,2014,124667,113123,11544,9.3
"13063",13,63,2015,126392,116765,9627,7.6
"13063",13,63,2016,130906,122284,8622,6.6
"13063",13,63,2017,134595,126727,7868,5.8
"13065",13,65,1990,2566,2437,129,5
"13065",13,65,1991,2831,2704,127,4.5
"13065",13,65,1992,3135,2937,198,6.3
"13065",13,65,1993,3524,3381,143,4.1
"13065",13,65,1994,3799,3651,148,3.9
"13065",13,65,1995,3868,3717,151,3.9
"13065",13,65,1996,3854,3670,184,4.8
"13065",13,65,1997,4056,3876,180,4.4
"13065",13,65,1998,4097,3955,142,3.5
"13065",13,65,1999,3516,3391,125,3.6
"13065",13,65,2000,2766,2616,150,5.4
"13065",13,65,2001,2427,2251,176,7.3
"13065",13,65,2002,2384,2248,136,5.7
"13065",13,65,2003,2426,2284,142,5.9
"13065",13,65,2004,2419,2277,142,5.9
"13065",13,65,2005,2499,2345,154,6.2
"13065",13,65,2006,2778,2640,138,5
"13065",13,65,2007,2763,2616,147,5.3
"13065",13,65,2008,2798,2597,201,7.2
"13065",13,65,2009,2789,2482,307,11
"13065",13,65,2010,2900,2579,321,11.1
"13065",13,65,2011,2889,2572,317,11
"13065",13,65,2012,2917,2634,283,9.7
"13065",13,65,2013,2830,2571,259,9.2
"13065",13,65,2014,2826,2590,236,8.4
"13065",13,65,2015,2774,2579,195,7
"13065",13,65,2016,2773,2602,171,6.2
"13065",13,65,2017,2825,2669,156,5.5
"13067",13,67,1990,265592,254819,10773,4.1
"13067",13,67,1991,266809,255556,11253,4.2
"13067",13,67,1992,277476,261929,15547,5.6
"13067",13,67,1993,289740,275925,13815,4.8
"13067",13,67,1994,302083,289455,12628,4.2
"13067",13,67,1995,310908,299651,11257,3.6
"13067",13,67,1996,322815,312969,9846,3.1
"13067",13,67,1997,336948,326750,10198,3
"13067",13,67,1998,349982,340534,9448,2.7
"13067",13,67,1999,361419,352249,9170,2.5
"13067",13,67,2000,360309,350131,10178,2.8
"13067",13,67,2001,363263,351172,12091,3.3
"13067",13,67,2002,364098,347181,16917,4.6
"13067",13,67,2003,361172,345198,15974,4.4
"13067",13,67,2004,362060,346157,15903,4.4
"13067",13,67,2005,369291,351402,17889,4.8
"13067",13,67,2006,372993,357118,15875,4.3
"13067",13,67,2007,380566,365319,15247,4
"13067",13,67,2008,381680,360319,21361,5.6
"13067",13,67,2009,374868,340632,34236,9.1
"13067",13,67,2010,380297,344871,35426,9.3
"13067",13,67,2011,384688,350725,33963,8.8
"13067",13,67,2012,388649,358646,30003,7.7
"13067",13,67,2013,388813,362780,26033,6.7
"13067",13,67,2014,393441,370236,23205,5.9
"13067",13,67,2015,398319,378139,20180,5.1
"13067",13,67,2016,410558,391746,18812,4.6
"13067",13,67,2017,423398,406109,17289,4.1
"13069",13,69,1990,14339,13303,1036,7.2
"13069",13,69,1991,14520,13752,768,5.3
"13069",13,69,1992,14965,13855,1110,7.4
"13069",13,69,1993,15476,14363,1113,7.2
"13069",13,69,1994,16148,15342,806,5
"13069",13,69,1995,16656,15654,1002,6
"13069",13,69,1996,17540,16459,1081,6.2
"13069",13,69,1997,18330,17178,1152,6.3
"13069",13,69,1998,19143,18118,1025,5.4
"13069",13,69,1999,21131,20116,1015,4.8
"13069",13,69,2000,17154,16352,802,4.7
"13069",13,69,2001,16649,15742,907,5.4
"13069",13,69,2002,17052,16125,927,5.4
"13069",13,69,2003,17318,16114,1204,7
"13069",13,69,2004,17305,16253,1052,6.1
"13069",13,69,2005,17335,16333,1002,5.8
"13069",13,69,2006,16837,15937,900,5.3
"13069",13,69,2007,16522,15547,975,5.9
"13069",13,69,2008,16729,15348,1381,8.3
"13069",13,69,2009,16376,13854,2522,15.4
"13069",13,69,2010,17202,14484,2718,15.8
"13069",13,69,2011,17605,15336,2269,12.9
"13069",13,69,2012,17477,15483,1994,11.4
"13069",13,69,2013,17509,15772,1737,9.9
"13069",13,69,2014,17634,16206,1428,8.1
"13069",13,69,2015,17291,16129,1162,6.7
"13069",13,69,2016,18107,17056,1051,5.8
"13069",13,69,2017,18436,17482,954,5.2
"13071",13,71,1990,16579,15709,870,5.2
"13071",13,71,1991,16233,15385,848,5.2
"13071",13,71,1992,16645,15522,1123,6.7
"13071",13,71,1993,16986,16021,965,5.7
"13071",13,71,1994,16927,16030,897,5.3
"13071",13,71,1995,17195,16501,694,4
"13071",13,71,1996,18190,17312,878,4.8
"13071",13,71,1997,19296,18308,988,5.1
"13071",13,71,1998,19164,18252,912,4.8
"13071",13,71,1999,19623,18408,1215,6.2
"13071",13,71,2000,19350,18447,903,4.7
"13071",13,71,2001,18772,17711,1061,5.7
"13071",13,71,2002,18327,17380,947,5.2
"13071",13,71,2003,18303,17337,966,5.3
"13071",13,71,2004,18211,17331,880,4.8
"13071",13,71,2005,19256,18261,995,5.2
"13071",13,71,2006,20614,19740,874,4.2
"13071",13,71,2007,20474,19561,913,4.5
"13071",13,71,2008,20769,19522,1247,6
"13071",13,71,2009,20475,18610,1865,9.1
"13071",13,71,2010,21316,19247,2069,9.7
"13071",13,71,2011,21236,19217,2019,9.5
"13071",13,71,2012,21009,19162,1847,8.8
"13071",13,71,2013,20328,18545,1783,8.8
"13071",13,71,2014,20080,18463,1617,8.1
"13071",13,71,2015,20053,18773,1280,6.4
"13071",13,71,2016,21123,20016,1107,5.2
"13071",13,71,2017,22195,21192,1003,4.5
"13073",13,73,1990,34576,33429,1147,3.3
"13073",13,73,1991,35217,33969,1248,3.5
"13073",13,73,1992,35811,34021,1790,5
"13073",13,73,1993,37959,36027,1932,5.1
"13073",13,73,1994,38841,37197,1644,4.2
"13073",13,73,1995,40025,38368,1657,4.1
"13073",13,73,1996,41070,39381,1689,4.1
"13073",13,73,1997,42815,41115,1700,4
"13073",13,73,1998,44393,42910,1483,3.3
"13073",13,73,1999,45963,44553,1410,3.1
"13073",13,73,2000,47195,45805,1390,2.9
"13073",13,73,2001,47847,46403,1444,3
"13073",13,73,2002,50221,48394,1827,3.6
"13073",13,73,2003,52446,50601,1845,3.5
"13073",13,73,2004,55009,52893,2116,3.8
"13073",13,73,2005,56828,54198,2630,4.6
"13073",13,73,2006,58260,55871,2389,4.1
"13073",13,73,2007,59917,57652,2265,3.8
"13073",13,73,2008,60937,58040,2897,4.8
"13073",13,73,2009,60883,56676,4207,6.9
"13073",13,73,2010,61522,57027,4495,7.3
"13073",13,73,2011,63320,58667,4653,7.3
"13073",13,73,2012,64708,60188,4520,7
"13073",13,73,2013,65565,61317,4248,6.5
"13073",13,73,2014,66428,62587,3841,5.8
"13073",13,73,2015,68650,65209,3441,5
"13073",13,73,2016,71128,67830,3298,4.6
"13073",13,73,2017,72880,69833,3047,4.2
"13075",13,75,1990,6335,5931,404,6.4
"13075",13,75,1991,6092,5651,441,7.2
"13075",13,75,1992,6587,6102,485,7.4
"13075",13,75,1993,6900,6414,486,7
"13075",13,75,1994,7090,6738,352,5
"13075",13,75,1995,6988,6737,251,3.6
"13075",13,75,1996,7275,6987,288,4
"13075",13,75,1997,7812,7396,416,5.3
"13075",13,75,1998,7795,7414,381,4.9
"13075",13,75,1999,7968,7582,386,4.8
"13075",13,75,2000,7260,6926,334,4.6
"13075",13,75,2001,7146,6793,353,4.9
"13075",13,75,2002,7123,6785,338,4.7
"13075",13,75,2003,7032,6661,371,5.3
"13075",13,75,2004,6845,6482,363,5.3
"13075",13,75,2005,7008,6590,418,6
"13075",13,75,2006,7120,6740,380,5.3
"13075",13,75,2007,7134,6731,403,5.6
"13075",13,75,2008,7252,6691,561,7.7
"13075",13,75,2009,6967,6077,890,12.8
"13075",13,75,2010,7885,6966,919,11.7
"13075",13,75,2011,7602,6746,856,11.3
"13075",13,75,2012,7534,6821,713,9.5
"13075",13,75,2013,7437,6802,635,8.5
"13075",13,75,2014,7394,6797,597,8.1
"13075",13,75,2015,7287,6801,486,6.7
"13075",13,75,2016,7532,7125,407,5.4
"13075",13,75,2017,7732,7375,357,4.6
"13077",13,77,1990,27559,25950,1609,5.8
"13077",13,77,1991,28140,26559,1581,5.6
"13077",13,77,1992,30081,27909,2172,7.2
"13077",13,77,1993,31632,29879,1753,5.5
"13077",13,77,1994,33925,32480,1445,4.3
"13077",13,77,1995,36095,34629,1466,4.1
"13077",13,77,1996,38877,37383,1494,3.8
"13077",13,77,1997,41932,40270,1662,4
"13077",13,77,1998,44611,43116,1495,3.4
"13077",13,77,1999,46728,45441,1287,2.8
"13077",13,77,2000,48664,47041,1623,3.3
"13077",13,77,2001,49844,48102,1742,3.5
"13077",13,77,2002,50851,48573,2278,4.5
"13077",13,77,2003,51879,49526,2353,4.5
"13077",13,77,2004,53044,50865,2179,4.1
"13077",13,77,2005,55824,53100,2724,4.9
"13077",13,77,2006,57736,55317,2419,4.2
"13077",13,77,2007,59681,57316,2365,4
"13077",13,77,2008,61411,57904,3507,5.7
"13077",13,77,2009,61330,55295,6035,9.8
"13077",13,77,2010,64319,58095,6224,9.7
"13077",13,77,2011,65009,59123,5886,9.1
"13077",13,77,2012,65493,60271,5222,8
"13077",13,77,2013,65810,61216,4594,7
"13077",13,77,2014,66501,62426,4075,6.1
"13077",13,77,2015,67859,64257,3602,5.3
"13077",13,77,2016,70479,66983,3496,5
"13077",13,77,2017,72479,69436,3043,4.2
"13079",13,79,1990,4278,3989,289,6.8
"13079",13,79,1991,4015,3723,292,7.3
"13079",13,79,1992,4698,4316,382,8.1
"13079",13,79,1993,4917,4572,345,7
"13079",13,79,1994,5064,4788,276,5.5
"13079",13,79,1995,5325,5062,263,4.9
"13079",13,79,1996,5500,5221,279,5.1
"13079",13,79,1997,5146,4886,260,5.1
"13079",13,79,1998,5248,5031,217,4.1
"13079",13,79,1999,5710,5463,247,4.3
"13079",13,79,2000,5869,5633,236,4
"13079",13,79,2001,5816,5569,247,4.2
"13079",13,79,2002,5926,5640,286,4.8
"13079",13,79,2003,6095,5806,289,4.7
"13079",13,79,2004,6219,5919,300,4.8
"13079",13,79,2005,6269,5899,370,5.9
"13079",13,79,2006,6243,5924,319,5.1
"13079",13,79,2007,6124,5837,287,4.7
"13079",13,79,2008,6278,5900,378,6
"13079",13,79,2009,6075,5465,610,10
"13079",13,79,2010,5769,5109,660,11.4
"13079",13,79,2011,5807,5181,626,10.8
"13079",13,79,2012,5831,5259,572,9.8
"13079",13,79,2013,5688,5185,503,8.8
"13079",13,79,2014,5612,5194,418,7.4
"13079",13,79,2015,5576,5225,351,6.3
"13079",13,79,2016,5683,5349,334,5.9
"13079",13,79,2017,5758,5470,288,5
"13081",13,81,1990,8658,8056,602,7
"13081",13,81,1991,8660,8097,563,6.5
"13081",13,81,1992,9052,8217,835,9.2
"13081",13,81,1993,9124,8468,656,7.2
"13081",13,81,1994,9466,8914,552,5.8
"13081",13,81,1995,9852,9339,513,5.2
"13081",13,81,1996,9930,9219,711,7.2
"13081",13,81,1997,10082,9351,731,7.3
"13081",13,81,1998,9928,9289,639,6.4
"13081",13,81,1999,10036,9450,586,5.8
"13081",13,81,2000,9729,9269,460,4.7
"13081",13,81,2001,9397,8895,502,5.3
"13081",13,81,2002,9502,8934,568,6
"13081",13,81,2003,9527,8982,545,5.7
"13081",13,81,2004,9831,9297,534,5.4
"13081",13,81,2005,10108,9442,666,6.6
"13081",13,81,2006,10353,9751,602,5.8
"13081",13,81,2007,10625,10011,614,5.8
"13081",13,81,2008,10223,9437,786,7.7
"13081",13,81,2009,9765,8574,1191,12.2
"13081",13,81,2010,9208,7901,1307,14.2
"13081",13,81,2011,9203,7923,1280,13.9
"13081",13,81,2012,9177,8030,1147,12.5
"13081",13,81,2013,9674,8594,1080,11.2
"13081",13,81,2014,9453,8621,832,8.8
"13081",13,81,2015,9426,8781,645,6.8
"13081",13,81,2016,9199,8645,554,6
"13081",13,81,2017,9462,8968,494,5.2
"13083",13,83,1990,6229,5859,370,5.9
"13083",13,83,1991,6266,5920,346,5.5
"13083",13,83,1992,6384,5962,422,6.6
"13083",13,83,1993,6508,6161,347,5.3
"13083",13,83,1994,6730,6376,354,5.3
"13083",13,83,1995,6766,6438,328,4.8
"13083",13,83,1996,6979,6650,329,4.7
"13083",13,83,1997,7132,6794,338,4.7
"13083",13,83,1998,7363,7035,328,4.5
"13083",13,83,1999,7628,7347,281,3.7
"13083",13,83,2000,7703,7469,234,3
"13083",13,83,2001,7839,7563,276,3.5
"13083",13,83,2002,8105,7731,374,4.6
"13083",13,83,2003,8286,7932,354,4.3
"13083",13,83,2004,8324,7982,342,4.1
"13083",13,83,2005,8433,8027,406,4.8
"13083",13,83,2006,8652,8291,361,4.2
"13083",13,83,2007,8436,8080,356,4.2
"13083",13,83,2008,8451,7972,479,5.7
"13083",13,83,2009,8146,7294,852,10.5
"13083",13,83,2010,8348,7624,724,8.7
"13083",13,83,2011,8365,7697,668,8
"13083",13,83,2012,8386,7747,639,7.6
"13083",13,83,2013,8127,7548,579,7.1
"13083",13,83,2014,7887,7391,496,6.3
"13083",13,83,2015,7853,7423,430,5.5
"13083",13,83,2016,8026,7622,404,5
"13083",13,83,2017,8282,7918,364,4.4
"13085",13,85,1990,5225,4960,265,5.1
"13085",13,85,1991,5903,5628,275,4.7
"13085",13,85,1992,6301,5920,381,6
"13085",13,85,1993,6757,6420,337,5
"13085",13,85,1994,7166,6876,290,4
"13085",13,85,1995,8243,7921,322,3.9
"13085",13,85,1996,9051,8755,296,3.3
"13085",13,85,1997,10179,9884,295,2.9
"13085",13,85,1998,10736,10422,314,2.9
"13085",13,85,1999,10469,10193,276,2.6
"13085",13,85,2000,9021,8774,247,2.7
"13085",13,85,2001,9222,8934,288,3.1
"13085",13,85,2002,9462,9035,427,4.5
"13085",13,85,2003,9731,9352,379,3.9
"13085",13,85,2004,9882,9491,391,4
"13085",13,85,2005,10287,9846,441,4.3
"13085",13,85,2006,10634,10230,404,3.8
"13085",13,85,2007,11103,10693,410,3.7
"13085",13,85,2008,11376,10707,669,5.9
"13085",13,85,2009,11256,10134,1122,10
"13085",13,85,2010,10966,9771,1195,10.9
"13085",13,85,2011,10882,9779,1103,10.1
"13085",13,85,2012,10859,9928,931,8.6
"13085",13,85,2013,10782,9986,796,7.4
"13085",13,85,2014,10796,10142,654,6.1
"13085",13,85,2015,10945,10387,558,5.1
"13085",13,85,2016,11343,10814,529,4.7
"13085",13,85,2017,11688,11231,457,3.9
"13087",13,87,1990,10997,10515,482,4.4
"13087",13,87,1991,11033,10289,744,6.7
"13087",13,87,1992,11120,9981,1139,10.2
"13087",13,87,1993,10920,9977,943,8.6
"13087",13,87,1994,11398,10362,1036,9.1
"13087",13,87,1995,11646,10877,769,6.6
"13087",13,87,1996,11782,11197,585,5
"13087",13,87,1997,12355,11741,614,5
"13087",13,87,1998,12531,11885,646,5.2
"13087",13,87,1999,12099,11432,667,5.5
"13087",13,87,2000,12298,11737,561,4.6
"13087",13,87,2001,11952,11304,648,5.4
"13087",13,87,2002,11864,11147,717,6
"13087",13,87,2003,12160,11470,690,5.7
"13087",13,87,2004,11637,10863,774,6.7
"13087",13,87,2005,12136,11389,747,6.2
"13087",13,87,2006,12018,11330,688,5.7
"13087",13,87,2007,11769,11062,707,6
"13087",13,87,2008,12114,11190,924,7.6
"13087",13,87,2009,11912,10404,1508,12.7
"13087",13,87,2010,12446,10897,1549,12.4
"13087",13,87,2011,12066,10619,1447,12
"13087",13,87,2012,12246,11006,1240,10.1
"13087",13,87,2013,11575,10476,1099,9.5
"13087",13,87,2014,11374,10451,923,8.1
"13087",13,87,2015,11394,10620,774,6.8
"13087",13,87,2016,11486,10724,762,6.6
"13087",13,87,2017,11663,11006,657,5.6
"13089",13,89,1990,316619,300964,15655,4.9
"13089",13,89,1991,312445,297564,14881,4.8
"13089",13,89,1992,320792,299717,21075,6.6
"13089",13,89,1993,327039,307751,19288,5.9
"13089",13,89,1994,336349,318104,18245,5.4
"13089",13,89,1995,340088,323643,16445,4.8
"13089",13,89,1996,347338,331770,15568,4.5
"13089",13,89,1997,354513,338469,16044,4.5
"13089",13,89,1998,361589,346402,15187,4.2
"13089",13,89,1999,364047,349921,14126,3.9
"13089",13,89,2000,380802,368116,12686,3.3
"13089",13,89,2001,378313,362942,15371,4.1
"13089",13,89,2002,374102,352718,21384,5.7
"13089",13,89,2003,366983,346963,20020,5.5
"13089",13,89,2004,363403,343516,19887,5.5
"13089",13,89,2005,368282,345752,22530,6.1
"13089",13,89,2006,386291,366471,19820,5.1
"13089",13,89,2007,393836,374934,18902,4.8
"13089",13,89,2008,392969,367914,25055,6.4
"13089",13,89,2009,381335,343126,38209,10
"13089",13,89,2010,363001,323687,39314,10.8
"13089",13,89,2011,366603,327936,38667,10.5
"13089",13,89,2012,370150,335318,34832,9.4
"13089",13,89,2013,368650,337594,31056,8.4
"13089",13,89,2014,368717,342134,26583,7.2
"13089",13,89,2015,373115,350620,22495,6
"13089",13,89,2016,383126,362524,20602,5.4
"13089",13,89,2017,394688,375712,18976,4.8
"13091",13,91,1990,7598,7143,455,6
"13091",13,91,1991,8106,7655,451,5.6
"13091",13,91,1992,8584,7947,637,7.4
"13091",13,91,1993,8823,8241,582,6.6
"13091",13,91,1994,9265,8784,481,5.2
"13091",13,91,1995,9694,9170,524,5.4
"13091",13,91,1996,9382,8529,853,9.1
"13091",13,91,1997,9402,8789,613,6.5
"13091",13,91,1998,9827,9220,607,6.2
"13091",13,91,1999,9916,9412,504,5.1
"13091",13,91,2000,8505,8096,409,4.8
"13091",13,91,2001,8348,7898,450,5.4
"13091",13,91,2002,8569,8080,489,5.7
"13091",13,91,2003,8753,8290,463,5.3
"13091",13,91,2004,8517,8087,430,5
"13091",13,91,2005,9104,8576,528,5.8
"13091",13,91,2006,9550,9079,471,4.9
"13091",13,91,2007,9524,9051,473,5
"13091",13,91,2008,9419,8788,631,6.7
"13091",13,91,2009,9079,8104,975,10.7
"13091",13,91,2010,8361,7271,1090,13
"13091",13,91,2011,8292,7274,1018,12.3
"13091",13,91,2012,8152,7212,940,11.5
"13091",13,91,2013,7781,6896,885,11.4
"13091",13,91,2014,7430,6708,722,9.7
"13091",13,91,2015,6957,6374,583,8.4
"13091",13,91,2016,7023,6514,509,7.2
"13091",13,91,2017,7126,6677,449,6.3
"13093",13,93,1990,3963,3717,246,6.2
"13093",13,93,1991,3944,3659,285,7.2
"13093",13,93,1992,4117,3773,344,8.4
"13093",13,93,1993,4292,3974,318,7.4
"13093",13,93,1994,4422,4090,332,7.5
"13093",13,93,1995,4639,4324,315,6.8
"13093",13,93,1996,4686,4294,392,8.4
"13093",13,93,1997,4771,4384,387,8.1
"13093",13,93,1998,4667,4347,320,6.9
"13093",13,93,1999,4753,4445,308,6.5
"13093",13,93,2000,4793,4561,232,4.8
"13093",13,93,2001,4795,4537,258,5.4
"13093",13,93,2002,4696,4426,270,5.7
"13093",13,93,2003,4749,4464,285,6
"13093",13,93,2004,4553,4282,271,6
"13093",13,93,2005,4852,4548,304,6.3
"13093",13,93,2006,4861,4591,270,5.6
"13093",13,93,2007,4927,4668,259,5.3
"13093",13,93,2008,4805,4482,323,6.7
"13093",13,93,2009,4836,4356,480,9.9
"13093",13,93,2010,4960,4386,574,11.6
"13093",13,93,2011,4789,4164,625,13.1
"13093",13,93,2012,4813,4260,553,11.5
"13093",13,93,2013,4515,3996,519,11.5
"13093",13,93,2014,4635,4192,443,9.6
"13093",13,93,2015,4759,4400,359,7.5
"13093",13,93,2016,4955,4669,286,5.8
"13093",13,93,2017,5105,4843,262,5.1
"13095",13,95,1990,42489,39200,3289,7.7
"13095",13,95,1991,42091,39229,2862,6.8
"13095",13,95,1992,43491,39028,4463,10.3
"13095",13,95,1993,43788,39650,4138,9.5
"13095",13,95,1994,45478,41116,4362,9.6
"13095",13,95,1995,44586,41646,2940,6.6
"13095",13,95,1996,45909,42899,3010,6.6
"13095",13,95,1997,46867,43499,3368,7.2
"13095",13,95,1998,47095,42890,4205,8.9
"13095",13,95,1999,45820,42055,3765,8.2
"13095",13,95,2000,41490,39301,2189,5.3
"13095",13,95,2001,40337,38121,2216,5.5
"13095",13,95,2002,40582,38102,2480,6.1
"13095",13,95,2003,41489,39134,2355,5.7
"13095",13,95,2004,41136,38666,2470,6
"13095",13,95,2005,41217,38622,2595,6.3
"13095",13,95,2006,41454,38964,2490,6
"13095",13,95,2007,42009,39662,2347,5.6
"13095",13,95,2008,42288,39348,2940,7
"13095",13,95,2009,42209,37762,4447,10.5
"13095",13,95,2010,41490,36281,5209,12.6
"13095",13,95,2011,41256,36235,5021,12.2
"13095",13,95,2012,40905,36288,4617,11.3
"13095",13,95,2013,39714,35610,4104,10.3
"13095",13,95,2014,38645,35094,3551,9.2
"13095",13,95,2015,37879,34958,2921,7.7
"13095",13,95,2016,38200,35592,2608,6.8
"13095",13,95,2017,39080,36689,2391,6.1
"13097",13,97,1990,39551,37693,1858,4.7
"13097",13,97,1991,39570,37676,1894,4.8
"13097",13,97,1992,40944,38454,2490,6.1
"13097",13,97,1993,42162,40150,2012,4.8
"13097",13,97,1994,44113,42346,1767,4
"13097",13,97,1995,45096,43488,1608,3.6
"13097",13,97,1996,47313,45796,1517,3.2
"13097",13,97,1997,49394,47839,1555,3.1
"13097",13,97,1998,51672,50074,1598,3.1
"13097",13,97,1999,52751,51244,1507,2.9
"13097",13,97,2000,51398,49859,1539,3
"13097",13,97,2001,52086,50387,1699,3.3
"13097",13,97,2002,52839,50359,2480,4.7
"13097",13,97,2003,53789,51241,2548,4.7
"13097",13,97,2004,55960,53249,2711,4.8
"13097",13,97,2005,59500,56134,3366,5.7
"13097",13,97,2006,62225,59106,3119,5
"13097",13,97,2007,64829,61815,3014,4.6
"13097",13,97,2008,66368,62091,4277,6.4
"13097",13,97,2009,65190,58135,7055,10.8
"13097",13,97,2010,66575,59108,7467,11.2
"13097",13,97,2011,66989,59707,7282,10.9
"13097",13,97,2012,66984,60547,6437,9.6
"13097",13,97,2013,67309,61525,5784,8.6
"13097",13,97,2014,67664,62679,4985,7.4
"13097",13,97,2015,68340,64014,4326,6.3
"13097",13,97,2016,70298,66402,3896,5.5
"13097",13,97,2017,72367,68825,3542,4.9
"13099",13,99,1990,5109,4796,313,6.1
"13099",13,99,1991,5253,4887,366,7
"13099",13,99,1992,5421,4823,598,11
"13099",13,99,1993,5172,4657,515,10
"13099",13,99,1994,5079,4606,473,9.3
"13099",13,99,1995,4975,4576,399,8
"13099",13,99,1996,4913,4538,375,7.6
"13099",13,99,1997,4934,4521,413,8.4
"13099",13,99,1998,4770,4338,432,9.1
"13099",13,99,1999,4752,4335,417,8.8
"13099",13,99,2000,5356,5084,272,5.1
"13099",13,99,2001,5454,5191,263,4.8
"13099",13,99,2002,5541,5240,301,5.4
"13099",13,99,2003,5864,5530,334,5.7
"13099",13,99,2004,5598,5316,282,5
"13099",13,99,2005,5618,5304,314,5.6
"13099",13,99,2006,5691,5404,287,5
"13099",13,99,2007,5334,5037,297,5.6
"13099",13,99,2008,5524,5157,367,6.6
"13099",13,99,2009,5517,4937,580,10.5
"13099",13,99,2010,4478,3953,525,11.7
"13099",13,99,2011,4449,3938,511,11.5
"13099",13,99,2012,4489,4033,456,10.2
"13099",13,99,2013,4375,3975,400,9.1
"13099",13,99,2014,4343,3955,388,8.9
"13099",13,99,2015,4358,4056,302,6.9
"13099",13,99,2016,4405,4103,302,6.9
"13099",13,99,2017,4555,4305,250,5.5
"13101",13,101,1990,1036,985,51,4.9
"13101",13,101,1991,1001,965,36,3.6
"13101",13,101,1992,1010,954,56,5.5
"13101",13,101,1993,1017,939,78,7.7
"13101",13,101,1994,987,932,55,5.6
"13101",13,101,1995,1031,994,37,3.6
"13101",13,101,1996,1082,1047,35,3.2
"13101",13,101,1997,1191,1147,44,3.7
"13101",13,101,1998,1184,1137,47,4
"13101",13,101,1999,1282,1225,57,4.4
"13101",13,101,2000,1857,1792,65,3.5
"13101",13,101,2001,1899,1828,71,3.7
"13101",13,101,2002,1980,1912,68,3.4
"13101",13,101,2003,2114,2049,65,3.1
"13101",13,101,2004,2185,2118,67,3.1
"13101",13,101,2005,2314,2236,78,3.4
"13101",13,101,2006,2370,2296,74,3.1
"13101",13,101,2007,2251,2182,69,3.1
"13101",13,101,2008,2217,2122,95,4.3
"13101",13,101,2009,2204,2045,159,7.2
"13101",13,101,2010,1876,1722,154,8.2
"13101",13,101,2011,1879,1727,152,8.1
"13101",13,101,2012,1807,1674,133,7.4
"13101",13,101,2013,1780,1667,113,6.3
"13101",13,101,2014,1783,1679,104,5.8
"13101",13,101,2015,1866,1779,87,4.7
"13101",13,101,2016,1884,1803,81,4.3
"13101",13,101,2017,1933,1859,74,3.8
"13103",13,103,1990,12271,11801,470,3.8
"13103",13,103,1991,12538,11895,643,5.1
"13103",13,103,1992,13156,12331,825,6.3
"13103",13,103,1993,13497,12838,659,4.9
"13103",13,103,1994,14284,13616,668,4.7
"13103",13,103,1995,14893,14267,626,4.2
"13103",13,103,1996,15749,15134,615,3.9
"13103",13,103,1997,17004,16372,632,3.7
"13103",13,103,1998,17979,17304,675,3.8
"13103",13,103,1999,18780,18177,603,3.2
"13103",13,103,2000,19004,18398,606,3.2
"13103",13,103,2001,19747,19122,625,3.2
"13103",13,103,2002,20985,20180,805,3.8
"13103",13,103,2003,22030,21165,865,3.9
"13103",13,103,2004,23727,22832,895,3.8
"13103",13,103,2005,25609,24593,1016,4
"13103",13,103,2006,27084,26165,919,3.4
"13103",13,103,2007,28501,27560,941,3.3
"13103",13,103,2008,29084,27683,1401,4.8
"13103",13,103,2009,28603,26247,2356,8.2
"13103",13,103,2010,25777,23310,2467,9.6
"13103",13,103,2011,25639,23251,2388,9.3
"13103",13,103,2012,25958,23786,2172,8.4
"13103",13,103,2013,26177,24303,1874,7.2
"13103",13,103,2014,26264,24638,1626,6.2
"13103",13,103,2015,27172,25783,1389,5.1
"13103",13,103,2016,28446,27078,1368,4.8
"13103",13,103,2017,29036,27840,1196,4.1
"13105",13,105,1990,8938,8200,738,8.3
"13105",13,105,1991,8740,8127,613,7
"13105",13,105,1992,8996,7877,1119,12.4
"13105",13,105,1993,8561,7720,841,9.8
"13105",13,105,1994,8413,7753,660,7.8
"13105",13,105,1995,8687,7983,704,8.1
"13105",13,105,1996,8839,7986,853,9.7
"13105",13,105,1997,9011,8240,771,8.6
"13105",13,105,1998,8789,8045,744,8.5
"13105",13,105,1999,8894,8239,655,7.4
"13105",13,105,2000,9710,9195,515,5.3
"13105",13,105,2001,9788,9239,549,5.6
"13105",13,105,2002,10153,9558,595,5.9
"13105",13,105,2003,10190,9605,585,5.7
"13105",13,105,2004,9937,9385,552,5.6
"13105",13,105,2005,9954,9273,681,6.8
"13105",13,105,2006,9987,9343,644,6.4
"13105",13,105,2007,9862,9303,559,5.7
"13105",13,105,2008,10087,9246,841,8.3
"13105",13,105,2009,10045,8816,1229,12.2
"13105",13,105,2010,8934,7605,1329,14.9
"13105",13,105,2011,8796,7378,1418,16.1
"13105",13,105,2012,8557,7481,1076,12.6
"13105",13,105,2013,8368,7463,905,10.8
"13105",13,105,2014,8065,7373,692,8.6
"13105",13,105,2015,7613,7048,565,7.4
"13105",13,105,2016,7737,7237,500,6.5
"13105",13,105,2017,7874,7455,419,5.3
"13107",13,107,1990,8878,8056,822,9.3
"13107",13,107,1991,8799,7945,854,9.7
"13107",13,107,1992,8713,7693,1020,11.7
"13107",13,107,1993,8569,7647,922,10.8
"13107",13,107,1994,8521,7734,787,9.2
"13107",13,107,1995,8794,7858,936,10.6
"13107",13,107,1996,8749,7885,864,9.9
"13107",13,107,1997,8671,7756,915,10.6
"13107",13,107,1998,8583,7808,775,9
"13107",13,107,1999,8767,7851,916,10.4
"13107",13,107,2000,9933,9364,569,5.7
"13107",13,107,2001,9606,9027,579,6
"13107",13,107,2002,9899,9352,547,5.5
"13107",13,107,2003,10448,9929,519,5
"13107",13,107,2004,10313,9775,538,5.2
"13107",13,107,2005,10651,10059,592,5.6
"13107",13,107,2006,10802,10251,551,5.1
"13107",13,107,2007,10829,10271,558,5.2
"13107",13,107,2008,10803,10007,796,7.4
"13107",13,107,2009,10568,9438,1130,10.7
"13107",13,107,2010,9118,7946,1172,12.9
"13107",13,107,2011,9162,7944,1218,13.3
"13107",13,107,2012,9090,7967,1123,12.4
"13107",13,107,2013,8845,7738,1107,12.5
"13107",13,107,2014,8582,7689,893,10.4
"13107",13,107,2015,8317,7590,727,8.7
"13107",13,107,2016,8455,7803,652,7.7
"13107",13,107,2017,8683,8101,582,6.7
"13109",13,109,1990,3867,3707,160,4.1
"13109",13,109,1991,3930,3743,187,4.8
"13109",13,109,1992,4053,3757,296,7.3
"13109",13,109,1993,4358,3954,404,9.3
"13109",13,109,1994,4477,4061,416,9.3
"13109",13,109,1995,4468,4217,251,5.6
"13109",13,109,1996,4637,4410,227,4.9
"13109",13,109,1997,5108,4906,202,4
"13109",13,109,1998,5031,4827,204,4.1
"13109",13,109,1999,4873,4683,190,3.9
"13109",13,109,2000,4690,4485,205,4.4
"13109",13,109,2001,4688,4496,192,4.1
"13109",13,109,2002,4708,4491,217,4.6
"13109",13,109,2003,4765,4565,200,4.2
"13109",13,109,2004,4737,4544,193,4.1
"13109",13,109,2005,4858,4609,249,5.1
"13109",13,109,2006,4930,4709,221,4.5
"13109",13,109,2007,4985,4771,214,4.3
"13109",13,109,2008,5023,4707,316,6.3
"13109",13,109,2009,4958,4524,434,8.8
"13109",13,109,2010,4769,4336,433,9.1
"13109",13,109,2011,4809,4370,439,9.1
"13109",13,109,2012,4804,4393,411,8.6
"13109",13,109,2013,4727,4367,360,7.6
"13109",13,109,2014,4736,4432,304,6.4
"13109",13,109,2015,4663,4403,260,5.6
"13109",13,109,2016,4794,4559,235,4.9
"13109",13,109,2017,4921,4706,215,4.4
"13111",13,111,1990,6944,6402,542,7.8
"13111",13,111,1991,7165,6645,520,7.3
"13111",13,111,1992,7836,7189,647,8.3
"13111",13,111,1993,7942,7314,628,7.9
"13111",13,111,1994,8032,7559,473,5.9
"13111",13,111,1995,8020,7525,495,6.2
"13111",13,111,1996,8363,7787,576,6.9
"13111",13,111,1997,8674,8030,644,7.4
"13111",13,111,1998,8926,8428,498,5.6
"13111",13,111,1999,8998,8600,398,4.4
"13111",13,111,2000,9070,8712,358,3.9
"13111",13,111,2001,9198,8793,405,4.4
"13111",13,111,2002,9556,9042,514,5.4
"13111",13,111,2003,9643,9032,611,6.3
"13111",13,111,2004,9729,9243,486,5
"13111",13,111,2005,10068,9550,518,5.1
"13111",13,111,2006,10769,10338,431,4
"13111",13,111,2007,11000,10588,412,3.7
"13111",13,111,2008,10959,10275,684,6.2
"13111",13,111,2009,10811,9676,1135,10.5
"13111",13,111,2010,10271,9070,1201,11.7
"13111",13,111,2011,10273,9113,1160,11.3
"13111",13,111,2012,10020,8996,1024,10.2
"13111",13,111,2013,9762,8884,878,9
"13111",13,111,2014,9853,9109,744,7.6
"13111",13,111,2015,10115,9489,626,6.2
"13111",13,111,2016,10839,10261,578,5.3
"13111",13,111,2017,11006,10481,525,4.8
"13113",13,113,1990,33372,32275,1097,3.3
"13113",13,113,1991,34304,32986,1318,3.8
"13113",13,113,1992,35996,34482,1514,4.2
"13113",13,113,1993,37763,36488,1275,3.4
"13113",13,113,1994,40081,38933,1148,2.9
"13113",13,113,1995,41532,40476,1056,2.5
"13113",13,113,1996,44015,42979,1036,2.4
"13113",13,113,1997,46609,45516,1093,2.3
"13113",13,113,1998,49320,48180,1140,2.3
"13113",13,113,1999,51257,50330,927,1.8
"13113",13,113,2000,49730,48393,1337,2.7
"13113",13,113,2001,50053,48640,1413,2.8
"13113",13,113,2002,49998,48185,1813,3.6
"13113",13,113,2003,50383,48525,1858,3.7
"13113",13,113,2004,51088,49179,1909,3.7
"13113",13,113,2005,53172,50717,2455,4.6
"13113",13,113,2006,53673,51536,2137,4
"13113",13,113,2007,53556,51506,2050,3.8
"13113",13,113,2008,53285,50498,2787,5.2
"13113",13,113,2009,51081,46776,4305,8.4
"13113",13,113,2010,52927,48564,4363,8.2
"13113",13,113,2011,53224,48960,4264,8
"13113",13,113,2012,53498,49458,4040,7.6
"13113",13,113,2013,53405,49826,3579,6.7
"13113",13,113,2014,53750,50490,3260,6.1
"13113",13,113,2015,54164,51358,2806,5.2
"13113",13,113,2016,55775,53154,2621,4.7
"13113",13,113,2017,57431,55086,2345,4.1
"13115",13,115,1990,42150,38895,3255,7.7
"13115",13,115,1991,42111,39641,2470,5.9
"13115",13,115,1992,43478,40398,3080,7.1
"13115",13,115,1993,44443,41479,2964,6.7
"13115",13,115,1994,45603,43322,2281,5
"13115",13,115,1995,45083,42652,2431,5.4
"13115",13,115,1996,45669,43288,2381,5.2
"13115",13,115,1997,46594,44385,2209,4.7
"13115",13,115,1998,45673,43620,2053,4.5
"13115",13,115,1999,45708,43530,2178,4.8
"13115",13,115,2000,44685,42959,1726,3.9
"13115",13,115,2001,45187,43155,2032,4.5
"13115",13,115,2002,46720,44377,2343,5
"13115",13,115,2003,49057,46768,2289,4.7
"13115",13,115,2004,49196,46862,2334,4.7
"13115",13,115,2005,50139,47541,2598,5.2
"13115",13,115,2006,49315,47104,2211,4.5
"13115",13,115,2007,49791,47450,2341,4.7
"13115",13,115,2008,50328,47077,3251,6.5
"13115",13,115,2009,49526,44302,5224,10.5
"13115",13,115,2010,45087,39750,5337,11.8
"13115",13,115,2011,44852,39440,5412,12.1
"13115",13,115,2012,44808,39913,4895,10.9
"13115",13,115,2013,43769,39614,4155,9.5
"13115",13,115,2014,43274,39868,3406,7.9
"13115",13,115,2015,42982,40115,2867,6.7
"13115",13,115,2016,43546,40937,2609,6
"13115",13,115,2017,44296,41986,2310,5.2
"13117",13,117,1990,24750,23624,1126,4.5
"13117",13,117,1991,25355,24206,1149,4.5
"13117",13,117,1992,27003,25524,1479,5.5
"13117",13,117,1993,28466,27343,1123,3.9
"13117",13,117,1994,31228,30246,982,3.1
"13117",13,117,1995,34209,33173,1036,3
"13117",13,117,1996,38423,37614,809,2.1
"13117",13,117,1997,42840,41937,903,2.1
"13117",13,117,1998,49432,48535,897,1.8
"13117",13,117,1999,55366,54493,873,1.6
"13117",13,117,2000,57230,55837,1393,2.4
"13117",13,117,2001,61106,59359,1747,2.9
"13117",13,117,2002,64342,61713,2629,4.1
"13117",13,117,2003,67047,64525,2522,3.8
"13117",13,117,2004,70229,67788,2441,3.5
"13117",13,117,2005,75083,72207,2876,3.8
"13117",13,117,2006,79777,77107,2670,3.3
"13117",13,117,2007,84302,81520,2782,3.3
"13117",13,117,2008,88509,84270,4239,4.8
"13117",13,117,2009,87995,80815,7180,8.2
"13117",13,117,2010,88343,81251,7092,8
"13117",13,117,2011,91061,84314,6747,7.4
"13117",13,117,2012,93750,87542,6208,6.6
"13117",13,117,2013,96487,90817,5670,5.9
"13117",13,117,2014,100368,95123,5245,5.2
"13117",13,117,2015,104421,99689,4732,4.5
"13117",13,117,2016,111123,106502,4621,4.2
"13117",13,117,2017,114728,110421,4307,3.8
"13119",13,119,1990,8248,7589,659,8
"13119",13,119,1991,8078,7553,525,6.5
"13119",13,119,1992,8498,7706,792,9.3
"13119",13,119,1993,8948,8358,590,6.6
"13119",13,119,1994,8902,8447,455,5.1
"13119",13,119,1995,9470,8949,521,5.5
"13119",13,119,1996,9965,9369,596,6
"13119",13,119,1997,10276,9762,514,5
"13119",13,119,1998,9989,9601,388,3.9
"13119",13,119,1999,10337,9994,343,3.3
"13119",13,119,2000,9934,9540,394,4
"13119",13,119,2001,9884,9355,529,5.4
"13119",13,119,2002,10141,9589,552,5.4
"13119",13,119,2003,10342,9792,550,5.3
"13119",13,119,2004,10315,9791,524,5.1
"13119",13,119,2005,10389,9795,594,5.7
"13119",13,119,2006,10724,10183,541,5
"13119",13,119,2007,10448,9938,510,4.9
"13119",13,119,2008,10465,9734,731,7
"13119",13,119,2009,10261,9042,1219,11.9
"13119",13,119,2010,9698,8468,1230,12.7
"13119",13,119,2011,9751,8566,1185,12.2
"13119",13,119,2012,9543,8466,1077,11.3
"13119",13,119,2013,9331,8420,911,9.8
"13119",13,119,2014,9247,8500,747,8.1
"13119",13,119,2015,9287,8704,583,6.3
"13119",13,119,2016,9799,9287,512,5.2
"13119",13,119,2017,10019,9541,478,4.8
"13121",13,121,1990,339328,320341,18987,5.6
"13121",13,121,1991,333851,315693,18158,5.4
"13121",13,121,1992,343922,318585,25337,7.4
"13121",13,121,1993,352098,329009,23089,6.6
"13121",13,121,1994,363641,342611,21030,5.8
"13121",13,121,1995,369786,349806,19980,5.4
"13121",13,121,1996,382432,363261,19171,5
"13121",13,121,1997,392406,374007,18399,4.7
"13121",13,121,1998,403901,387165,16736,4.1
"13121",13,121,1999,408023,392495,15528,3.8
"13121",13,121,2000,429759,414781,14978,3.5
"13121",13,121,2001,439452,421301,18151,4.1
"13121",13,121,2002,442733,417741,24992,5.6
"13121",13,121,2003,445338,421444,23894,5.4
"13121",13,121,2004,448696,425535,23161,5.2
"13121",13,121,2005,457326,430634,26692,5.8
"13121",13,121,2006,472127,448380,23747,5
"13121",13,121,2007,488891,465409,23482,4.8
"13121",13,121,2008,497388,465380,32008,6.4
"13121",13,121,2009,486983,437746,49237,10.1
"13121",13,121,2010,485002,434315,50687,10.5
"13121",13,121,2011,498861,448034,50827,10.2
"13121",13,121,2012,511185,464673,46512,9.1
"13121",13,121,2013,508273,467197,41076,8.1
"13121",13,121,2014,509436,473594,35842,7
"13121",13,121,2015,514749,483972,30777,6
"13121",13,121,2016,531690,503142,28548,5.4
"13121",13,121,2017,548023,521549,26474,4.8
"13123",13,123,1990,6625,6134,491,7.4
"13123",13,123,1991,6515,6041,474,7.3
"13123",13,123,1992,6606,5966,640,9.7
"13123",13,123,1993,6694,6166,528,7.9
"13123",13,123,1994,6875,6483,392,5.7
"13123",13,123,1995,7251,6792,459,6.3
"13123",13,123,1996,8170,7659,511,6.3
"13123",13,123,1997,8403,7848,555,6.6
"13123",13,123,1998,8289,7838,451,5.4
"13123",13,123,1999,8472,8160,312,3.7
"13123",13,123,2000,11300,10920,380,3.4
"13123",13,123,2001,11469,11058,411,3.6
"13123",13,123,2002,12154,11626,528,4.3
"13123",13,123,2003,12593,12055,538,4.3
"13123",13,123,2004,12787,12255,532,4.2
"13123",13,123,2005,13412,12776,636,4.7
"13123",13,123,2006,14153,13641,512,3.6
"13123",13,123,2007,14221,13715,506,3.6
"13123",13,123,2008,14116,13289,827,5.9
"13123",13,123,2009,13620,12206,1414,10.4
"13123",13,123,2010,12811,11366,1445,11.3
"13123",13,123,2011,12372,10917,1455,11.8
"13123",13,123,2012,12158,10874,1284,10.6
"13123",13,123,2013,11907,10837,1070,9
"13123",13,123,2014,11963,11098,865,7.2
"13123",13,123,2015,11723,11016,707,6
"13123",13,123,2016,11847,11176,671,5.7
"13123",13,123,2017,11988,11387,601,5
"13125",13,125,1990,1118,1052,66,5.9
"13125",13,125,1991,1206,1136,70,5.8
"13125",13,125,1992,1235,1161,74,6
"13125",13,125,1993,1158,1084,74,6.4
"13125",13,125,1994,1001,946,55,5.5
"13125",13,125,1995,977,933,44,4.5
"13125",13,125,1996,1035,943,92,8.9
"13125",13,125,1997,1144,995,149,13
"13125",13,125,1998,1022,893,129,12.6
"13125",13,125,1999,998,928,70,7
"13125",13,125,2000,1189,1140,49,4.1
"13125",13,125,2001,1169,1117,52,4.4
"13125",13,125,2002,1183,1119,64,5.4
"13125",13,125,2003,1201,1141,60,5
"13125",13,125,2004,1194,1136,58,4.9
"13125",13,125,2005,1188,1110,78,6.6
"13125",13,125,2006,1216,1154,62,5.1
"13125",13,125,2007,1119,1062,57,5.1
"13125",13,125,2008,1130,1053,77,6.8
"13125",13,125,2009,1133,1004,129,11.4
"13125",13,125,2010,1324,1178,146,11
"13125",13,125,2011,1335,1193,142,10.6
"13125",13,125,2012,1322,1194,128,9.7
"13125",13,125,2013,1289,1167,122,9.5
"13125",13,125,2014,1267,1165,102,8.1
"13125",13,125,2015,1234,1152,82,6.6
"13125",13,125,2016,1269,1193,76,6
"13125",13,125,2017,1303,1237,66,5.1
"13127",13,127,1990,30463,29139,1324,4.3
"13127",13,127,1991,30619,29354,1265,4.1
"13127",13,127,1992,31615,29939,1676,5.3
"13127",13,127,1993,31844,30390,1454,4.6
"13127",13,127,1994,32407,31003,1404,4.3
"13127",13,127,1995,33329,32125,1204,3.6
"13127",13,127,1996,34075,32948,1127,3.3
"13127",13,127,1997,34765,33500,1265,3.6
"13127",13,127,1998,35743,34524,1219,3.4
"13127",13,127,1999,36144,34970,1174,3.2
"13127",13,127,2000,34787,33548,1239,3.6
"13127",13,127,2001,34768,33480,1288,3.7
"13127",13,127,2002,35365,33934,1431,4
"13127",13,127,2003,36363,34899,1464,4
"13127",13,127,2004,37453,35932,1521,4.1
"13127",13,127,2005,38916,37168,1748,4.5
"13127",13,127,2006,39804,38239,1565,3.9
"13127",13,127,2007,40736,39275,1461,3.6
"13127",13,127,2008,41495,39401,2094,5
"13127",13,127,2009,40419,37002,3417,8.5
"13127",13,127,2010,38340,34508,3832,10
"13127",13,127,2011,38256,34267,3989,10.4
"13127",13,127,2012,38791,35114,3677,9.5
"13127",13,127,2013,38055,34821,3234,8.5
"13127",13,127,2014,37076,34325,2751,7.4
"13127",13,127,2015,37695,35408,2287,6.1
"13127",13,127,2016,39219,37143,2076,5.3
"13127",13,127,2017,39838,37951,1887,4.7
"13129",13,129,1990,18945,17476,1469,7.8
"13129",13,129,1991,18367,17042,1325,7.2
"13129",13,129,1992,19363,17784,1579,8.2
"13129",13,129,1993,19820,18465,1355,6.8
"13129",13,129,1994,20497,19324,1173,5.7
"13129",13,129,1995,20962,19681,1281,6.1
"13129",13,129,1996,20990,19858,1132,5.4
"13129",13,129,1997,21755,20520,1235,5.7
"13129",13,129,1998,21505,20516,989,4.6
"13129",13,129,1999,22644,21505,1139,5
"13129",13,129,2000,24302,23474,828,3.4
"13129",13,129,2001,23787,22539,1248,5.2
"13129",13,129,2002,24258,23025,1233,5.1
"13129",13,129,2003,24904,23731,1173,4.7
"13129",13,129,2004,25516,24371,1145,4.5
"13129",13,129,2005,26657,25363,1294,4.9
"13129",13,129,2006,27073,25891,1182,4.4
"13129",13,129,2007,26858,25598,1260,4.7
"13129",13,129,2008,26642,24669,1973,7.4
"13129",13,129,2009,25498,22190,3308,13
"13129",13,129,2010,26068,22749,3319,12.7
"13129",13,129,2011,26267,23198,3069,11.7
"13129",13,129,2012,26845,24216,2629,9.8
"13129",13,129,2013,26195,23876,2319,8.9
"13129",13,129,2014,26070,24180,1890,7.2
"13129",13,129,2015,26154,24611,1543,5.9
"13129",13,129,2016,25327,23913,1414,5.6
"13129",13,129,2017,26745,25503,1242,4.6
"13131",13,131,1990,9373,8907,466,5
"13131",13,131,1991,9223,8722,501,5.4
"13131",13,131,1992,9795,9023,772,7.9
"13131",13,131,1993,9737,8977,760,7.8
"13131",13,131,1994,9752,9159,593,6.1
"13131",13,131,1995,9659,9162,497,5.1
"13131",13,131,1996,9806,9320,486,5
"13131",13,131,1997,10069,9177,892,8.9
"13131",13,131,1998,9655,8950,705,7.3
"13131",13,131,1999,9389,8545,844,9
"13131",13,131,2000,11001,10507,494,4.5
"13131",13,131,2001,11048,10572,476,4.3
"13131",13,131,2002,11049,10574,475,4.3
"13131",13,131,2003,11135,10629,506,4.5
"13131",13,131,2004,11057,10559,498,4.5
"13131",13,131,2005,11609,11070,539,4.6
"13131",13,131,2006,12265,11775,490,4
"13131",13,131,2007,12272,11779,493,4
"13131",13,131,2008,11997,11278,719,6
"13131",13,131,2009,11764,10622,1142,9.7
"13131",13,131,2010,10399,9309,1090,10.5
"13131",13,131,2011,10847,9817,1030,9.5
"13131",13,131,2012,10831,9902,929,8.6
"13131",13,131,2013,10482,9673,809,7.7
"13131",13,131,2014,10452,9689,763,7.3
"13131",13,131,2015,10422,9796,626,6
"13131",13,131,2016,10264,9708,556,5.4
"13131",13,131,2017,10750,10223,527,4.9
"13133",13,133,1990,5190,4836,354,6.8
"13133",13,133,1991,5192,4787,405,7.8
"13133",13,133,1992,5223,4694,529,10.1
"13133",13,133,1993,5106,4534,572,11.2
"13133",13,133,1994,5136,4686,450,8.8
"13133",13,133,1995,5233,4815,418,8
"13133",13,133,1996,5343,4942,401,7.5
"13133",13,133,1997,5743,5371,372,6.5
"13133",13,133,1998,5874,5480,394,6.7
"13133",13,133,1999,5962,5609,353,5.9
"13133",13,133,2000,6371,6085,286,4.5
"13133",13,133,2001,6238,5811,427,6.8
"13133",13,133,2002,6298,5720,578,9.2
"13133",13,133,2003,6467,6054,413,6.4
"13133",13,133,2004,6387,5996,391,6.1
"13133",13,133,2005,6639,6156,483,7.3
"13133",13,133,2006,6953,6553,400,5.8
"13133",13,133,2007,7458,7061,397,5.3
"13133",13,133,2008,7624,7107,517,6.8
"13133",13,133,2009,7588,6727,861,11.3
"13133",13,133,2010,6412,5567,845,13.2
"13133",13,133,2011,6379,5592,787,12.3
"13133",13,133,2012,6420,5708,712,11.1
"13133",13,133,2013,6350,5721,629,9.9
"13133",13,133,2014,6424,5900,524,8.2
"13133",13,133,2015,6827,6376,451,6.6
"13133",13,133,2016,6610,6212,398,6
"13133",13,133,2017,6817,6466,351,5.1
"13135",13,135,1990,214380,205504,8876,4.1
"13135",13,135,1991,217988,209447,8541,3.9
"13135",13,135,1992,230946,218860,12086,5.2
"13135",13,135,1993,244829,234262,10567,4.3
"13135",13,135,1994,261429,251606,9823,3.8
"13135",13,135,1995,275003,266346,8657,3.1
"13135",13,135,1996,291605,283445,8160,2.8
"13135",13,135,1997,310831,302761,8070,2.6
"13135",13,135,1998,328847,320573,8274,2.5
"13135",13,135,1999,343799,335801,7998,2.3
"13135",13,135,2000,346112,336524,9588,2.8
"13135",13,135,2001,356582,344712,11870,3.3
"13135",13,135,2002,365238,348206,17032,4.7
"13135",13,135,2003,371758,355315,16443,4.4
"13135",13,135,2004,381656,365548,16108,4.2
"13135",13,135,2005,398300,379383,18917,4.7
"13135",13,135,2006,409907,392746,17161,4.2
"13135",13,135,2007,421203,404504,16699,4
"13135",13,135,2008,425860,402076,23784,5.6
"13135",13,135,2009,417641,380094,37547,9
"13135",13,135,2010,418368,379794,38574,9.2
"13135",13,135,2011,427145,389936,37209,8.7
"13135",13,135,2012,434145,400458,33687,7.8
"13135",13,135,2013,438240,408130,30110,6.9
"13135",13,135,2014,444312,417546,26766,6
"13135",13,135,2015,452452,429027,23425,5.2
"13135",13,135,2016,468217,446010,22207,4.7
"13135",13,135,2017,482878,462438,20440,4.2
"13137",13,137,1990,14058,13328,730,5.2
"13137",13,137,1991,14030,13333,697,5
"13137",13,137,1992,14322,13574,748,5.2
"13137",13,137,1993,14387,13736,651,4.5
"13137",13,137,1994,14373,13737,636,4.4
"13137",13,137,1995,14728,14134,594,4
"13137",13,137,1996,14883,14134,749,5
"13137",13,137,1997,15334,14546,788,5.1
"13137",13,137,1998,15682,15056,626,4
"13137",13,137,1999,16047,15478,569,3.5
"13137",13,137,2000,18359,17709,650,3.5
"13137",13,137,2001,18428,17622,806,4.4
"13137",13,137,2002,18746,17940,806,4.3
"13137",13,137,2003,19365,18590,775,4
"13137",13,137,2004,19338,18604,734,3.8
"13137",13,137,2005,19726,18855,871,4.4
"13137",13,137,2006,19768,18974,794,4
"13137",13,137,2007,20218,19416,802,4
"13137",13,137,2008,20854,19664,1190,5.7
"13137",13,137,2009,20243,18218,2025,10
"13137",13,137,2010,18347,16390,1957,10.7
"13137",13,137,2011,18337,16411,1926,10.5
"13137",13,137,2012,18427,16673,1754,9.5
"13137",13,137,2013,19316,17768,1548,8
"13137",13,137,2014,18968,17654,1314,6.9
"13137",13,137,2015,18818,17743,1075,5.7
"13137",13,137,2016,19323,18305,1018,5.3
"13137",13,137,2017,19372,18485,887,4.6
"13139",13,139,1990,52512,49604,2908,5.5
"13139",13,139,1991,52955,50332,2623,5
"13139",13,139,1992,55890,52556,3334,6
"13139",13,139,1993,58941,56214,2727,4.6
"13139",13,139,1994,62842,60469,2373,3.8
"13139",13,139,1995,64304,62010,2294,3.6
"13139",13,139,1996,65799,63644,2155,3.3
"13139",13,139,1997,68597,66521,2076,3
"13139",13,139,1998,71188,69074,2114,3
"13139",13,139,1999,72722,70861,1861,2.6
"13139",13,139,2000,73522,71319,2203,3
"13139",13,139,2001,74433,71826,2607,3.5
"13139",13,139,2002,75653,72420,3233,4.3
"13139",13,139,2003,79352,76163,3189,4
"13139",13,139,2004,80083,76884,3199,4
"13139",13,139,2005,82801,79099,3702,4.5
"13139",13,139,2006,86454,83160,3294,3.8
"13139",13,139,2007,90768,87514,3254,3.6
"13139",13,139,2008,93111,88082,5029,5.4
"13139",13,139,2009,89690,81284,8406,9.4
"13139",13,139,2010,86546,78205,8341,9.6
"13139",13,139,2011,87726,79953,7773,8.9
"13139",13,139,2012,89115,82180,6935,7.8
"13139",13,139,2013,89494,83366,6128,6.8
"13139",13,139,2014,90063,84779,5284,5.9
"13139",13,139,2015,92791,88284,4507,4.9
"13139",13,139,2016,96421,92093,4328,4.5
"13139",13,139,2017,100338,96413,3925,3.9
"13141",13,141,1990,3616,3386,230,6.4
"13141",13,141,1991,3647,3296,351,9.6
"13141",13,141,1992,3594,3158,436,12.1
"13141",13,141,1993,3903,3535,368,9.4
"13141",13,141,1994,3922,3655,267,6.8
"13141",13,141,1995,4020,3749,271,6.7
"13141",13,141,1996,4027,3418,609,15.1
"13141",13,141,1997,3880,3445,435,11.2
"13141",13,141,1998,3994,3518,476,11.9
"13141",13,141,1999,4030,3524,506,12.6
"13141",13,141,2000,3274,3015,259,7.9
"13141",13,141,2001,3310,3000,310,9.4
"13141",13,141,2002,3380,3092,288,8.5
"13141",13,141,2003,3378,3128,250,7.4
"13141",13,141,2004,3326,3102,224,6.7
"13141",13,141,2005,3301,3030,271,8.2
"13141",13,141,2006,3442,3149,293,8.5
"13141",13,141,2007,3304,3027,277,8.4
"13141",13,141,2008,3361,2924,437,13
"13141",13,141,2009,3290,2645,645,19.6
"13141",13,141,2010,3104,2393,711,22.9
"13141",13,141,2011,2961,2375,586,19.8
"13141",13,141,2012,2758,2290,468,17
"13141",13,141,2013,2641,2253,388,14.7
"13141",13,141,2014,2521,2228,293,11.6
"13141",13,141,2015,2488,2244,244,9.8
"13141",13,141,2016,2534,2322,212,8.4
"13141",13,141,2017,2569,2386,183,7.1
"13143",13,143,1990,10386,9667,719,6.9
"13143",13,143,1991,9748,8788,960,9.8
"13143",13,143,1992,9613,8401,1212,12.6
"13143",13,143,1993,9202,8293,909,9.9
"13143",13,143,1994,9363,8778,585,6.2
"13143",13,143,1995,9305,8580,725,7.8
"13143",13,143,1996,9380,8623,757,8.1
"13143",13,143,1997,9397,8740,657,7
"13143",13,143,1998,9429,8855,574,6.1
"13143",13,143,1999,9677,9206,471,4.9
"13143",13,143,2000,12391,11945,446,3.6
"13143",13,143,2001,12515,11958,557,4.5
"13143",13,143,2002,12417,11826,591,4.8
"13143",13,143,2003,12494,11881,613,4.9
"13143",13,143,2004,12614,11965,649,5.1
"13143",13,143,2005,12834,12138,696,5.4
"13143",13,143,2006,12782,12173,609,4.8
"13143",13,143,2007,12872,12270,602,4.7
"13143",13,143,2008,12951,12102,849,6.6
"13143",13,143,2009,12665,11142,1523,12
"13143",13,143,2010,12385,10866,1519,12.3
"13143",13,143,2011,12255,10833,1422,11.6
"13143",13,143,2012,12101,10863,1238,10.2
"13143",13,143,2013,11968,10859,1109,9.3
"13143",13,143,2014,11871,10934,937,7.9
"13143",13,143,2015,11870,11094,776,6.5
"13143",13,143,2016,12171,11467,704,5.8
"13143",13,143,2017,12491,11894,597,4.8
"13145",13,145,1990,8660,8214,446,5.2
"13145",13,145,1991,8640,8219,421,4.9
"13145",13,145,1992,8644,8132,512,5.9
"13145",13,145,1993,8999,8575,424,4.7
"13145",13,145,1994,9385,9013,372,4
"13145",13,145,1995,10038,9586,452,4.5
"13145",13,145,1996,10796,10446,350,3.2
"13145",13,145,1997,11674,11321,353,3
"13145",13,145,1998,12009,11676,333,2.8
"13145",13,145,1999,12356,12020,336,2.7
"13145",13,145,2000,12901,12491,410,3.2
"13145",13,145,2001,13011,12557,454,3.5
"13145",13,145,2002,13465,12967,498,3.7
"13145",13,145,2003,14334,13809,525,3.7
"13145",13,145,2004,14638,14037,601,4.1
"13145",13,145,2005,15281,14636,645,4.2
"13145",13,145,2006,15709,15113,596,3.8
"13145",13,145,2007,16064,15490,574,3.6
"13145",13,145,2008,16428,15658,770,4.7
"13145",13,145,2009,16406,15215,1191,7.3
"13145",13,145,2010,16415,15149,1266,7.7
"13145",13,145,2011,16399,15184,1215,7.4
"13145",13,145,2012,16275,15102,1173,7.2
"13145",13,145,2013,15810,14776,1034,6.5
"13145",13,145,2014,15723,14788,935,5.9
"13145",13,145,2015,15700,14878,822,5.2
"13145",13,145,2016,16086,15303,783,4.9
"13145",13,145,2017,16350,15653,697,4.3
"13147",13,147,1990,9715,9109,606,6.2
"13147",13,147,1991,9389,8847,542,5.8
"13147",13,147,1992,9473,8613,860,9.1
"13147",13,147,1993,9120,8443,677,7.4
"13147",13,147,1994,8699,8155,544,6.3
"13147",13,147,1995,8637,7847,790,9.1
"13147",13,147,1996,8517,7865,652,7.7
"13147",13,147,1997,8616,8127,489,5.7
"13147",13,147,1998,8928,8542,386,4.3
"13147",13,147,1999,9762,9367,395,4
"13147",13,147,2000,11367,10910,457,4
"13147",13,147,2001,11156,10507,649,5.8
"13147",13,147,2002,10895,10247,648,5.9
"13147",13,147,2003,10972,10416,556,5.1
"13147",13,147,2004,10990,10434,556,5.1
"13147",13,147,2005,10936,10174,762,7
"13147",13,147,2006,10943,10239,704,6.4
"13147",13,147,2007,10834,10132,702,6.5
"13147",13,147,2008,10704,9764,940,8.8
"13147",13,147,2009,10458,9051,1407,13.5
"13147",13,147,2010,10959,9697,1262,11.5
"13147",13,147,2011,11146,9898,1248,11.2
"13147",13,147,2012,10823,9709,1114,10.3
"13147",13,147,2013,10498,9533,965,9.2
"13147",13,147,2014,10383,9608,775,7.5
"13147",13,147,2015,10402,9758,644,6.2
"13147",13,147,2016,11024,10433,591,5.4
"13147",13,147,2017,11259,10758,501,4.4
"13149",13,149,1990,3955,3750,205,5.2
"13149",13,149,1991,3983,3689,294,7.4
"13149",13,149,1992,4119,3738,381,9.2
"13149",13,149,1993,4015,3706,309,7.7
"13149",13,149,1994,3887,3618,269,6.9
"13149",13,149,1995,3725,3508,217,5.8
"13149",13,149,1996,3653,3350,303,8.3
"13149",13,149,1997,3887,3641,246,6.3
"13149",13,149,1998,4870,4618,252,5.2
"13149",13,149,1999,4873,4556,317,6.5
"13149",13,149,2000,5124,4918,206,4
"13149",13,149,2001,5109,4855,254,5
"13149",13,149,2002,5016,4738,278,5.5
"13149",13,149,2003,4941,4636,305,6.2
"13149",13,149,2004,4876,4614,262,5.4
"13149",13,149,2005,4936,4652,284,5.8
"13149",13,149,2006,4913,4671,242,4.9
"13149",13,149,2007,4900,4656,244,5
"13149",13,149,2008,4962,4587,375,7.6
"13149",13,149,2009,4893,4255,638,13
"13149",13,149,2010,5249,4615,634,12.1
"13149",13,149,2011,5169,4584,585,11.3
"13149",13,149,2012,5122,4593,529,10.3
"13149",13,149,2013,5010,4539,471,9.4
"13149",13,149,2014,4967,4575,392,7.9
"13149",13,149,2015,4913,4597,316,6.4
"13149",13,149,2016,5003,4707,296,5.9
"13149",13,149,2017,5143,4885,258,5
"13151",13,151,1990,32248,30764,1484,4.6
"13151",13,151,1991,33454,31863,1591,4.8
"13151",13,151,1992,35625,33713,1912,5.4
"13151",13,151,1993,38564,36916,1648,4.3
"13151",13,151,1994,42371,40778,1593,3.8
"13151",13,151,1995,45380,43851,1529,3.4
"13151",13,151,1996,49685,48269,1416,2.8
"13151",13,151,1997,54249,52860,1389,2.6
"13151",13,151,1998,58756,57359,1397,2.4
"13151",13,151,1999,63475,62227,1248,2
"13151",13,151,2000,67461,65635,1826,2.7
"13151",13,151,2001,71117,68973,2144,3
"13151",13,151,2002,75070,71914,3156,4.2
"13151",13,151,2003,79163,75731,3432,4.3
"13151",13,151,2004,82971,79319,3652,4.4
"13151",13,151,2005,88594,83860,4734,5.3
"13151",13,151,2006,92567,88332,4235,4.6
"13151",13,151,2007,96909,92705,4204,4.3
"13151",13,151,2008,99348,93281,6067,6.1
"13151",13,151,2009,97375,87884,9491,9.7
"13151",13,151,2010,101141,90686,10455,10.3
"13151",13,151,2011,102687,92085,10602,10.3
"13151",13,151,2012,103207,93513,9694,9.4
"13151",13,151,2013,103433,94697,8736,8.4
"13151",13,151,2014,103521,96043,7478,7.2
"13151",13,151,2015,105040,98573,6467,6.2
"13151",13,151,2016,109026,103043,5983,5.5
"13151",13,151,2017,112204,106742,5462,4.9
"13153",13,153,1990,42725,41005,1720,4
"13153",13,153,1991,42535,40880,1655,3.9
"13153",13,153,1992,44110,41506,2604,5.9
"13153",13,153,1993,44826,42517,2309,5.2
"13153",13,153,1994,46432,44305,2127,4.6
"13153",13,153,1995,47334,45395,1939,4.1
"13153",13,153,1996,49071,47206,1865,3.8
"13153",13,153,1997,51343,49231,2112,4.1
"13153",13,153,1998,52102,50124,1978,3.8
"13153",13,153,1999,50694,48711,1983,3.9
"13153",13,153,2000,53584,51743,1841,3.4
"13153",13,153,2001,54816,52969,1847,3.4
"13153",13,153,2002,56878,54692,2186,3.8
"13153",13,153,2003,59021,56840,2181,3.7
"13153",13,153,2004,60299,57888,2411,4
"13153",13,153,2005,62594,59586,3008,4.8
"13153",13,153,2006,66050,63249,2801,4.2
"13153",13,153,2007,68319,65683,2636,3.9
"13153",13,153,2008,69986,66343,3643,5.2
"13153",13,153,2009,70793,65701,5092,7.2
"13153",13,153,2010,67099,61422,5677,8.5
"13153",13,153,2011,68352,62512,5840,8.5
"13153",13,153,2012,68742,63212,5530,8
"13153",13,153,2013,67462,62389,5073,7.5
"13153",13,153,2014,65923,61457,4466,6.8
"13153",13,153,2015,65689,61864,3825,5.8
"13153",13,153,2016,67743,64130,3613,5.3
"13153",13,153,2017,69194,65899,3295,4.8
"13155",13,155,1990,3880,3652,228,5.9
"13155",13,155,1991,3725,3545,180,4.8
"13155",13,155,1992,3913,3683,230,5.9
"13155",13,155,1993,4091,3838,253,6.2
"13155",13,155,1994,4135,3937,198,4.8
"13155",13,155,1995,4272,4081,191,4.5
"13155",13,155,1996,4476,4252,224,5
"13155",13,155,1997,4675,4409,266,5.7
"13155",13,155,1998,4864,4604,260,5.3
"13155",13,155,1999,5082,4850,232,4.6
"13155",13,155,2000,4537,4325,212,4.7
"13155",13,155,2001,4418,4177,241,5.5
"13155",13,155,2002,4481,4226,255,5.7
"13155",13,155,2003,4432,4166,266,6
"13155",13,155,2004,4393,4184,209,4.8
"13155",13,155,2005,4623,4356,267,5.8
"13155",13,155,2006,4723,4486,237,5
"13155",13,155,2007,4307,4048,259,6
"13155",13,155,2008,4236,3816,420,9.9
"13155",13,155,2009,4070,3456,614,15.1
"13155",13,155,2010,3674,3135,539,14.7
"13155",13,155,2011,3541,3054,487,13.8
"13155",13,155,2012,3543,3127,416,11.7
"13155",13,155,2013,3371,3013,358,10.6
"13155",13,155,2014,3141,2844,297,9.5
"13155",13,155,2015,3134,2872,262,8.4
"13155",13,155,2016,3222,2970,252,7.8
"13155",13,155,2017,3280,3048,232,7.1
"13157",13,157,1990,15044,14090,954,6.3
"13157",13,157,1991,15227,14285,942,6.2
"13157",13,157,1992,15656,14491,1165,7.4
"13157",13,157,1993,16597,15714,883,5.3
"13157",13,157,1994,18136,17343,793,4.4
"13157",13,157,1995,19809,18864,945,4.8
"13157",13,157,1996,20515,19655,860,4.2
"13157",13,157,1997,21939,21102,837,3.8
"13157",13,157,1998,22028,21129,899,4.1
"13157",13,157,1999,22678,21868,810,3.6
"13157",13,157,2000,21347,20662,685,3.2
"13157",13,157,2001,21375,20460,915,4.3
"13157",13,157,2002,21999,20857,1142,5.2
"13157",13,157,2003,22844,21805,1039,4.5
"13157",13,157,2004,23900,22864,1036,4.3
"13157",13,157,2005,25395,24196,1199,4.7
"13157",13,157,2006,26711,25615,1096,4.1
"13157",13,157,2007,26964,25849,1115,4.1
"13157",13,157,2008,27695,25975,1720,6.2
"13157",13,157,2009,27055,24053,3002,11.1
"13157",13,157,2010,28656,25660,2996,10.5
"13157",13,157,2011,28906,26135,2771,9.6
"13157",13,157,2012,29412,26995,2417,8.2
"13157",13,157,2013,29599,27557,2042,6.9
"13157",13,157,2014,29812,28075,1737,5.8
"13157",13,157,2015,30748,29261,1487,4.8
"13157",13,157,2016,33326,31909,1417,4.3
"13157",13,157,2017,35004,33729,1275,3.6
"13159",13,159,1990,3830,3604,226,5.9
"13159",13,159,1991,3824,3509,315,8.2
"13159",13,159,1992,3824,3484,340,8.9
"13159",13,159,1993,3834,3525,309,8.1
"13159",13,159,1994,4121,3929,192,4.7
"13159",13,159,1995,4360,4157,203,4.7
"13159",13,159,1996,4716,4392,324,6.9
"13159",13,159,1997,4883,4606,277,5.7
"13159",13,159,1998,4822,4632,190,3.9
"13159",13,159,1999,4841,4653,188,3.9
"13159",13,159,2000,5774,5586,188,3.3
"13159",13,159,2001,5801,5596,205,3.5
"13159",13,159,2002,5933,5651,282,4.8
"13159",13,159,2003,6037,5727,310,5.1
"13159",13,159,2004,6043,5741,302,5
"13159",13,159,2005,6231,5914,317,5.1
"13159",13,159,2006,6390,6085,305,4.8
"13159",13,159,2007,6438,6129,309,4.8
"13159",13,159,2008,6617,6070,547,8.3
"13159",13,159,2009,6461,5651,810,12.5
"13159",13,159,2010,6873,6069,804,11.7
"13159",13,159,2011,6796,6047,749,11
"13159",13,159,2012,6666,6013,653,9.8
"13159",13,159,2013,6514,5975,539,8.3
"13159",13,159,2014,6351,5930,421,6.6
"13159",13,159,2015,6441,6086,355,5.5
"13159",13,159,2016,6588,6274,314,4.8
"13159",13,159,2017,6811,6516,295,4.3
"13161",13,161,1990,5845,5467,378,6.5
"13161",13,161,1991,5783,5366,417,7.2
"13161",13,161,1992,5870,5336,534,9.1
"13161",13,161,1993,5635,5155,480,8.5
"13161",13,161,1994,5709,5306,403,7.1
"13161",13,161,1995,5742,5394,348,6.1
"13161",13,161,1996,5730,5271,459,8
"13161",13,161,1997,5673,5287,386,6.8
"13161",13,161,1998,5671,5211,460,8.1
"13161",13,161,1999,5394,5016,378,7
"13161",13,161,2000,5783,5513,270,4.7
"13161",13,161,2001,5637,5216,421,7.5
"13161",13,161,2002,5726,5249,477,8.3
"13161",13,161,2003,5629,5200,429,7.6
"13161",13,161,2004,5363,4983,380,7.1
"13161",13,161,2005,5459,5074,385,7.1
"13161",13,161,2006,5545,5149,396,7.1
"13161",13,161,2007,5267,4910,357,6.8
"13161",13,161,2008,5313,4794,519,9.8
"13161",13,161,2009,5357,4619,738,13.8
"13161",13,161,2010,6372,5557,815,12.8
"13161",13,161,2011,6512,5692,820,12.6
"13161",13,161,2012,6382,5645,737,11.5
"13161",13,161,2013,6383,5749,634,9.9
"13161",13,161,2014,6395,5875,520,8.1
"13161",13,161,2015,6343,5921,422,6.7
"13161",13,161,2016,6233,5838,395,6.3
"13161",13,161,2017,6159,5788,371,6
"13163",13,163,1990,7468,6867,601,8
"13163",13,163,1991,7568,7049,519,6.9
"13163",13,163,1992,7709,7049,660,8.6
"13163",13,163,1993,7862,7248,614,7.8
"13163",13,163,1994,7812,7247,565,7.2
"13163",13,163,1995,8184,7268,916,11.2
"13163",13,163,1996,8115,7007,1108,13.7
"13163",13,163,1997,8134,7043,1091,13.4
"13163",13,163,1998,7811,6841,970,12.4
"13163",13,163,1999,7587,6584,1003,13.2
"13163",13,163,2000,6764,6307,457,6.8
"13163",13,163,2001,6636,6096,540,8.1
"13163",13,163,2002,6738,6133,605,9
"13163",13,163,2003,6918,6352,566,8.2
"13163",13,163,2004,7124,6559,565,7.9
"13163",13,163,2005,6883,6298,585,8.5
"13163",13,163,2006,7044,6591,453,6.4
"13163",13,163,2007,7098,6594,504,7.1
"13163",13,163,2008,7180,6476,704,9.8
"13163",13,163,2009,7106,6078,1028,14.5
"13163",13,163,2010,7158,6151,1007,14.1
"13163",13,163,2011,7121,6177,944,13.3
"13163",13,163,2012,7085,6148,937,13.2
"13163",13,163,2013,6841,5885,956,14
"13163",13,163,2014,6650,5905,745,11.2
"13163",13,163,2015,6367,5792,575,9
"13163",13,163,2016,6604,6118,486,7.4
"13163",13,163,2017,6760,6334,426,6.3
"13165",13,165,1990,3552,3200,352,9.9
"13165",13,165,1991,3634,3437,197,5.4
"13165",13,165,1992,3882,3640,242,6.2
"13165",13,165,1993,3904,3660,244,6.3
"13165",13,165,1994,3889,3677,212,5.5
"13165",13,165,1995,4210,3854,356,8.5
"13165",13,165,1996,4290,4088,202,4.7
"13165",13,165,1997,4670,4404,266,5.7
"13165",13,165,1998,4572,4321,251,5.5
"13165",13,165,1999,4530,4320,210,4.6
"13165",13,165,2000,3727,3527,200,5.4
"13165",13,165,2001,3543,3323,220,6.2
"13165",13,165,2002,3395,3165,230,6.8
"13165",13,165,2003,3410,3198,212,6.2
"13165",13,165,2004,3290,3086,204,6.2
"13165",13,165,2005,3501,3292,209,6
"13165",13,165,2006,3564,3369,195,5.5
"13165",13,165,2007,3329,3034,295,8.9
"13165",13,165,2008,2864,2415,449,15.7
"13165",13,165,2009,2723,2192,531,19.5
"13165",13,165,2010,3229,2738,491,15.2
"13165",13,165,2011,3206,2746,460,14.3
"13165",13,165,2012,3364,2902,462,13.7
"13165",13,165,2013,3324,2914,410,12.3
"13165",13,165,2014,3260,2936,324,9.9
"13165",13,165,2015,3104,2846,258,8.3
"13165",13,165,2016,3166,2927,239,7.5
"13165",13,165,2017,3206,2987,219,6.8
"13167",13,167,1990,3668,3422,246,6.7
"13167",13,167,1991,3673,3474,199,5.4
"13167",13,167,1992,3709,3431,278,7.5
"13167",13,167,1993,3906,3652,254,6.5
"13167",13,167,1994,4073,3835,238,5.8
"13167",13,167,1995,4057,3624,433,10.7
"13167",13,167,1996,3742,3388,354,9.5
"13167",13,167,1997,3687,3385,302,8.2
"13167",13,167,1998,3723,3245,478,12.8
"13167",13,167,1999,3582,3273,309,8.6
"13167",13,167,2000,3401,3193,208,6.1
"13167",13,167,2001,3378,3173,205,6.1
"13167",13,167,2002,3654,3415,239,6.5
"13167",13,167,2003,3662,3406,256,7
"13167",13,167,2004,3724,3519,205,5.5
"13167",13,167,2005,3712,3484,228,6.1
"13167",13,167,2006,3781,3578,203,5.4
"13167",13,167,2007,3729,3511,218,5.8
"13167",13,167,2008,3715,3419,296,8
"13167",13,167,2009,3542,3099,443,12.5
"13167",13,167,2010,4240,3781,459,10.8
"13167",13,167,2011,4165,3703,462,11.1
"13167",13,167,2012,4065,3660,405,10
"13167",13,167,2013,4000,3607,393,9.8
"13167",13,167,2014,3935,3598,337,8.6
"13167",13,167,2015,3872,3601,271,7
"13167",13,167,2016,3930,3691,239,6.1
"13167",13,167,2017,4003,3797,206,5.1
"13169",13,169,1990,10607,10168,439,4.1
"13169",13,169,1991,10462,10017,445,4.3
"13169",13,169,1992,10665,10111,554,5.2
"13169",13,169,1993,10740,10191,549,5.1
"13169",13,169,1994,10896,10444,452,4.1
"13169",13,169,1995,11236,10761,475,4.2
"13169",13,169,1996,11553,11083,470,4.1
"13169",13,169,1997,11952,11507,445,3.7
"13169",13,169,1998,12217,11668,549,4.5
"13169",13,169,1999,11774,11277,497,4.2
"13169",13,169,2000,11787,11327,460,3.9
"13169",13,169,2001,11795,11376,419,3.6
"13169",13,169,2002,12256,11743,513,4.2
"13169",13,169,2003,12881,12372,509,4
"13169",13,169,2004,13371,12800,571,4.3
"13169",13,169,2005,13664,13001,663,4.9
"13169",13,169,2006,13869,13174,695,5
"13169",13,169,2007,14054,13460,594,4.2
"13169",13,169,2008,14571,13733,838,5.8
"13169",13,169,2009,14322,13095,1227,8.6
"13169",13,169,2010,13698,12366,1332,9.7
"13169",13,169,2011,13817,12544,1273,9.2
"13169",13,169,2012,13879,12700,1179,8.5
"13169",13,169,2013,13610,12619,991,7.3
"13169",13,169,2014,13691,12830,861,6.3
"13169",13,169,2015,13477,12734,743,5.5
"13169",13,169,2016,13809,13147,662,4.8
"13169",13,169,2017,14045,13430,615,4.4
"13171",13,171,1990,6148,5824,324,5.3
"13171",13,171,1991,5977,5639,338,5.7
"13171",13,171,1992,6204,5774,430,6.9
"13171",13,171,1993,6795,6437,358,5.3
"13171",13,171,1994,7124,6815,309,4.3
"13171",13,171,1995,7121,6831,290,4.1
"13171",13,171,1996,7356,7048,308,4.2
"13171",13,171,1997,7496,7153,343,4.6
"13171",13,171,1998,7260,6937,323,4.4
"13171",13,171,1999,6960,6552,408,5.9
"13171",13,171,2000,8045,7681,364,4.5
"13171",13,171,2001,8129,7734,395,4.9
"13171",13,171,2002,7911,7416,495,6.3
"13171",13,171,2003,7740,7328,412,5.3
"13171",13,171,2004,7687,7255,432,5.6
"13171",13,171,2005,7764,7287,477,6.1
"13171",13,171,2006,7810,7370,440,5.6
"13171",13,171,2007,7923,7526,397,5
"13171",13,171,2008,7962,7374,588,7.4
"13171",13,171,2009,8134,7031,1103,13.6
"13171",13,171,2010,8160,6998,1162,14.2
"13171",13,171,2011,8116,7002,1114,13.7
"13171",13,171,2012,7968,7005,963,12.1
"13171",13,171,2013,7822,6939,883,11.3
"13171",13,171,2014,7786,7046,740,9.5
"13171",13,171,2015,7682,7092,590,7.7
"13171",13,171,2016,7907,7390,517,6.5
"13171",13,171,2017,8126,7665,461,5.7
"13173",13,173,1990,2501,2383,118,4.7
"13173",13,173,1991,2543,2437,106,4.2
"13173",13,173,1992,2626,2481,145,5.5
"13173",13,173,1993,2695,2549,146,5.4
"13173",13,173,1994,2784,2681,103,3.7
"13173",13,173,1995,2917,2800,117,4
"13173",13,173,1996,3216,3042,174,5.4
"13173",13,173,1997,3439,3319,120,3.5
"13173",13,173,1998,3565,3460,105,2.9
"13173",13,173,1999,3604,3458,146,4.1
"13173",13,173,2000,3332,3167,165,5
"13173",13,173,2001,3274,3135,139,4.2
"13173",13,173,2002,3429,3282,147,4.3
"13173",13,173,2003,3637,3509,128,3.5
"13173",13,173,2004,3655,3523,132,3.6
"13173",13,173,2005,3810,3658,152,4
"13173",13,173,2006,3974,3821,153,3.9
"13173",13,173,2007,4052,3902,150,3.7
"13173",13,173,2008,4227,3982,245,5.8
"13173",13,173,2009,4139,3764,375,9.1
"13173",13,173,2010,3872,3464,408,10.5
"13173",13,173,2011,3951,3536,415,10.5
"13173",13,173,2012,3910,3544,366,9.4
"13173",13,173,2013,3844,3514,330,8.6
"13173",13,173,2014,3792,3487,305,8
"13173",13,173,2015,3782,3530,252,6.7
"13173",13,173,2016,3832,3611,221,5.8
"13173",13,173,2017,3874,3676,198,5.1
"13175",13,175,1990,18468,17466,1002,5.4
"13175",13,175,1991,18652,17754,898,4.8
"13175",13,175,1992,19853,18694,1159,5.8
"13175",13,175,1993,20147,19071,1076,5.3
"13175",13,175,1994,20755,19804,951,4.6
"13175",13,175,1995,21644,20456,1188,5.5
"13175",13,175,1996,21815,20670,1145,5.2
"13175",13,175,1997,22306,21305,1001,4.5
"13175",13,175,1998,23041,21262,1779,7.7
"13175",13,175,1999,23102,21306,1796,7.8
"13175",13,175,2000,21401,20416,985,4.6
"13175",13,175,2001,21343,20389,954,4.5
"13175",13,175,2002,21364,20227,1137,5.3
"13175",13,175,2003,21594,20306,1288,6
"13175",13,175,2004,21900,20692,1208,5.5
"13175",13,175,2005,22054,20844,1210,5.5
"13175",13,175,2006,22587,21404,1183,5.2
"13175",13,175,2007,22430,21304,1126,5
"13175",13,175,2008,22440,20848,1592,7.1
"13175",13,175,2009,22061,19591,2470,11.2
"13175",13,175,2010,20599,17879,2720,13.2
"13175",13,175,2011,20302,17493,2809,13.8
"13175",13,175,2012,19799,17372,2427,12.3
"13175",13,175,2013,19422,17331,2091,10.8
"13175",13,175,2014,19026,17279,1747,9.2
"13175",13,175,2015,18642,17235,1407,7.5
"13175",13,175,2016,19083,17817,1266,6.6
"13175",13,175,2017,19445,18294,1151,5.9
"13177",13,177,1990,7882,7446,436,5.5
"13177",13,177,1991,7977,7606,371,4.7
"13177",13,177,1992,8366,7783,583,7
"13177",13,177,1993,8847,8315,532,6
"13177",13,177,1994,9410,8916,494,5.2
"13177",13,177,1995,9996,9557,439,4.4
"13177",13,177,1996,10756,10337,419,3.9
"13177",13,177,1997,11598,11131,467,4
"13177",13,177,1998,12119,11516,603,5
"13177",13,177,1999,12244,11693,551,4.5
"13177",13,177,2000,13142,12688,454,3.5
"13177",13,177,2001,13701,13233,468,3.4
"13177",13,177,2002,14257,13736,521,3.7
"13177",13,177,2003,15200,14679,521,3.4
"13177",13,177,2004,15699,15150,549,3.5
"13177",13,177,2005,16403,15749,654,4
"13177",13,177,2006,17251,16621,630,3.7
"13177",13,177,2007,17684,17042,642,3.6
"13177",13,177,2008,18073,17260,813,4.5
"13177",13,177,2009,18181,16865,1316,7.2
"13177",13,177,2010,14345,13047,1298,9
"13177",13,177,2011,14330,13119,1211,8.5
"13177",13,177,2012,14324,13227,1097,7.7
"13177",13,177,2013,14297,13314,983,6.9
"13177",13,177,2014,14142,13264,878,6.2
"13177",13,177,2015,14130,13379,751,5.3
"13177",13,177,2016,14573,13891,682,4.7
"13177",13,177,2017,14956,14324,632,4.2
"13179",13,179,1990,13848,12898,950,6.9
"13179",13,179,1991,13997,13320,677,4.8
"13179",13,179,1992,14501,13265,1236,8.5
"13179",13,179,1993,15109,13668,1441,9.5
"13179",13,179,1994,15641,14259,1382,8.8
"13179",13,179,1995,15729,14367,1362,8.7
"13179",13,179,1996,16368,15113,1255,7.7
"13179",13,179,1997,17264,15971,1293,7.5
"13179",13,179,1998,17074,15838,1236,7.2
"13179",13,179,1999,17301,16228,1073,6.2
"13179",13,179,2000,19618,18576,1042,5.3
"13179",13,179,2001,19787,18810,977,4.9
"13179",13,179,2002,20380,19191,1189,5.8
"13179",13,179,2003,20909,19819,1090,5.2
"13179",13,179,2004,22164,20954,1210,5.5
"13179",13,179,2005,22914,21562,1352,5.9
"13179",13,179,2006,23976,22585,1391,5.8
"13179",13,179,2007,24269,23006,1263,5.2
"13179",13,179,2008,25479,23961,1518,6
"13179",13,179,2009,26003,23796,2207,8.5
"13179",13,179,2010,26927,24493,2434,9
"13179",13,179,2011,27588,25015,2573,9.3
"13179",13,179,2012,27156,24736,2420,8.9
"13179",13,179,2013,26201,23978,2223,8.5
"13179",13,179,2014,25629,23680,1949,7.6
"13179",13,179,2015,24973,23396,1577,6.3
"13179",13,179,2016,25071,23609,1462,5.8
"13179",13,179,2017,25838,24490,1348,5.2
"13181",13,181,1990,3292,3102,190,5.8
"13181",13,181,1991,3579,3417,162,4.5
"13181",13,181,1992,3711,3462,249,6.7
"13181",13,181,1993,3839,3594,245,6.4
"13181",13,181,1994,3657,3384,273,7.5
"13181",13,181,1995,3596,3323,273,7.6
"13181",13,181,1996,3452,3226,226,6.5
"13181",13,181,1997,3708,3440,268,7.2
"13181",13,181,1998,3546,3292,254,7.2
"13181",13,181,1999,3492,3114,378,10.8
"13181",13,181,2000,3771,3552,219,5.8
"13181",13,181,2001,3459,3171,288,8.3
"13181",13,181,2002,3440,3186,254,7.4
"13181",13,181,2003,3481,3225,256,7.4
"13181",13,181,2004,3537,3315,222,6.3
"13181",13,181,2005,3615,3357,258,7.1
"13181",13,181,2006,3805,3572,233,6.1
"13181",13,181,2007,3838,3617,221,5.8
"13181",13,181,2008,3910,3633,277,7.1
"13181",13,181,2009,3902,3477,425,10.9
"13181",13,181,2010,3679,3256,423,11.5
"13181",13,181,2011,3636,3216,420,11.6
"13181",13,181,2012,3538,3156,382,10.8
"13181",13,181,2013,3451,3105,346,10
"13181",13,181,2014,3336,3060,276,8.3
"13181",13,181,2015,3365,3138,227,6.7
"13181",13,181,2016,3482,3277,205,5.9
"13181",13,181,2017,3578,3389,189,5.3
"13183",13,183,1990,2453,2333,120,4.9
"13183",13,183,1991,2391,2313,78,3.3
"13183",13,183,1992,2499,2402,97,3.9
"13183",13,183,1993,2695,2550,145,5.4
"13183",13,183,1994,2826,2710,116,4.1
"13183",13,183,1995,3043,2916,127,4.2
"13183",13,183,1996,3279,3164,115,3.5
"13183",13,183,1997,3489,3357,132,3.8
"13183",13,183,1998,3598,3477,121,3.4
"13183",13,183,1999,3689,3580,109,3
"13183",13,183,2000,4317,4158,159,3.7
"13183",13,183,2001,4528,4382,146,3.2
"13183",13,183,2002,4709,4513,196,4.2
"13183",13,183,2003,4922,4741,181,3.7
"13183",13,183,2004,5235,5025,210,4
"13183",13,183,2005,5749,5517,232,4
"13183",13,183,2006,5717,5491,226,4
"13183",13,183,2007,5928,5710,218,3.7
"13183",13,183,2008,6521,6233,288,4.4
"13183",13,183,2009,6655,6220,435,6.5
"13183",13,183,2010,6231,5706,525,8.4
"13183",13,183,2011,6375,5809,566,8.9
"13183",13,183,2012,6647,6079,568,8.5
"13183",13,183,2013,6697,6152,545,8.1
"13183",13,183,2014,6699,6205,494,7.4
"13183",13,183,2015,7086,6670,416,5.9
"13183",13,183,2016,7432,7032,400,5.4
"13183",13,183,2017,7703,7321,382,5
"13185",13,185,1990,33946,32343,1603,4.7
"13185",13,185,1991,33956,32593,1363,4
"13185",13,185,1992,35339,33170,2169,6.1
"13185",13,185,1993,36099,34080,2019,5.6
"13185",13,185,1994,37076,35429,1647,4.4
"13185",13,185,1995,37940,36461,1479,3.9
"13185",13,185,1996,39434,37978,1456,3.7
"13185",13,185,1997,41981,40262,1719,4.1
"13185",13,185,1998,43237,41476,1761,4.1
"13185",13,185,1999,43717,41805,1912,4.4
"13185",13,185,2000,43444,41485,1959,4.5
"13185",13,185,2001,43496,41835,1661,3.8
"13185",13,185,2002,45986,44216,1770,3.8
"13185",13,185,2003,47898,46201,1697,3.5
"13185",13,185,2004,48720,47012,1708,3.5
"13185",13,185,2005,50416,48390,2026,4
"13185",13,185,2006,52048,50030,2018,3.9
"13185",13,185,2007,53698,51634,2064,3.8
"13185",13,185,2008,54974,51985,2989,5.4
"13185",13,185,2009,53907,49335,4572,8.5
"13185",13,185,2010,51019,46120,4899,9.6
"13185",13,185,2011,51359,46277,5082,9.9
"13185",13,185,2012,52459,47676,4783,9.1
"13185",13,185,2013,51098,46998,4100,8
"13185",13,185,2014,50537,46882,3655,7.2
"13185",13,185,2015,50366,47392,2974,5.9
"13185",13,185,2016,51367,48664,2703,5.3
"13185",13,185,2017,51826,49391,2435,4.7
"13187",13,187,1990,7191,6824,367,5.1
"13187",13,187,1991,7411,7032,379,5.1
"13187",13,187,1992,7688,7282,406,5.3
"13187",13,187,1993,7706,7342,364,4.7
"13187",13,187,1994,8055,7825,230,2.9
"13187",13,187,1995,8533,8210,323,3.8
"13187",13,187,1996,8569,8291,278,3.2
"13187",13,187,1997,9680,9378,302,3.1
"13187",13,187,1998,10262,9930,332,3.2
"13187",13,187,1999,10937,10701,236,2.2
"13187",13,187,2000,10903,10577,326,3
"13187",13,187,2001,10939,10575,364,3.3
"13187",13,187,2002,11173,10702,471,4.2
"13187",13,187,2003,11664,11184,480,4.1
"13187",13,187,2004,11826,11324,502,4.2
"13187",13,187,2005,12168,11586,582,4.8
"13187",13,187,2006,12752,12224,528,4.1
"13187",13,187,2007,13154,12612,542,4.1
"13187",13,187,2008,13460,12520,940,7
"13187",13,187,2009,13305,11743,1562,11.7
"13187",13,187,2010,14711,13184,1527,10.4
"13187",13,187,2011,14884,13429,1455,9.8
"13187",13,187,2012,15178,13910,1268,8.4
"13187",13,187,2013,15140,14024,1116,7.4
"13187",13,187,2014,15255,14289,966,6.3
"13187",13,187,2015,15321,14494,827,5.4
"13187",13,187,2016,15989,15226,763,4.8
"13187",13,187,2017,16756,16083,673,4
"13189",13,189,1990,9518,8984,534,5.6
"13189",13,189,1991,9421,8829,592,6.3
"13189",13,189,1992,9416,8705,711,7.6
"13189",13,189,1993,9443,8783,660,7
"13189",13,189,1994,9457,8803,654,6.9
"13189",13,189,1995,9322,8741,581,6.2
"13189",13,189,1996,9654,8732,922,9.6
"13189",13,189,1997,9904,8916,988,10
"13189",13,189,1998,9939,9143,796,8
"13189",13,189,1999,9952,9292,660,6.6
"13189",13,189,2000,9898,9457,441,4.5
"13189",13,189,2001,9985,9399,586,5.9
"13189",13,189,2002,10215,9499,716,7
"13189",13,189,2003,10375,9723,652,6.3
"13189",13,189,2004,10490,9885,605,5.8
"13189",13,189,2005,10635,9894,741,7
"13189",13,189,2006,10649,9986,663,6.2
"13189",13,189,2007,10595,9927,668,6.3
"13189",13,189,2008,10794,9949,845,7.8
"13189",13,189,2009,10793,9561,1232,11.4
"13189",13,189,2010,9447,8204,1243,13.2
"13189",13,189,2011,9405,8150,1255,13.3
"13189",13,189,2012,9332,8154,1178,12.6
"13189",13,189,2013,9079,8053,1026,11.3
"13189",13,189,2014,8797,7923,874,9.9
"13189",13,189,2015,8786,8055,731,8.3
"13189",13,189,2016,8809,8167,642,7.3
"13189",13,189,2017,8964,8405,559,6.2
"13191",13,191,1990,3823,3539,284,7.4
"13191",13,191,1991,3505,3290,215,6.1
"13191",13,191,1992,3490,3227,263,7.5
"13191",13,191,1993,3446,3196,250,7.3
"13191",13,191,1994,3408,3185,223,6.5
"13191",13,191,1995,3771,3551,220,5.8
"13191",13,191,1996,3903,3660,243,6.2
"13191",13,191,1997,4544,4300,244,5.4
"13191",13,191,1998,4623,4411,212,4.6
"13191",13,191,1999,4633,4438,195,4.2
"13191",13,191,2000,4890,4678,212,4.3
"13191",13,191,2001,4875,4670,205,4.2
"13191",13,191,2002,4881,4635,246,5
"13191",13,191,2003,4933,4718,215,4.4
"13191",13,191,2004,5088,4854,234,4.6
"13191",13,191,2005,5231,4951,280,5.4
"13191",13,191,2006,5283,5054,229,4.3
"13191",13,191,2007,5398,5178,220,4.1
"13191",13,191,2008,5469,5145,324,5.9
"13191",13,191,2009,5276,4741,535,10.1
"13191",13,191,2010,6289,5625,664,10.6
"13191",13,191,2011,6188,5530,658,10.6
"13191",13,191,2012,6033,5444,589,9.8
"13191",13,191,2013,5931,5399,532,9
"13191",13,191,2014,5867,5406,461,7.9
"13191",13,191,2015,5820,5442,378,6.5
"13191",13,191,2016,6010,5660,350,5.8
"13191",13,191,2017,6120,5808,312,5.1
"13193",13,193,1990,5820,5302,518,8.9
"13193",13,193,1991,5511,4962,549,10
"13193",13,193,1992,6002,5169,833,13.9
"13193",13,193,1993,5732,4938,794,13.9
"13193",13,193,1994,5722,4893,829,14.5
"13193",13,193,1995,5557,4917,640,11.5
"13193",13,193,1996,5718,5040,678,11.9
"13193",13,193,1997,5883,5117,766,13
"13193",13,193,1998,5450,4862,588,10.8
"13193",13,193,1999,5412,4933,479,8.9
"13193",13,193,2000,5419,5055,364,6.7
"13193",13,193,2001,5307,4949,358,6.7
"13193",13,193,2002,5154,4756,398,7.7
"13193",13,193,2003,5176,4774,402,7.8
"13193",13,193,2004,5232,4816,416,8
"13193",13,193,2005,5408,4930,478,8.8
"13193",13,193,2006,5282,4874,408,7.7
"13193",13,193,2007,5089,4719,370,7.3
"13193",13,193,2008,5154,4720,434,8.4
"13193",13,193,2009,5196,4551,645,12.4
"13193",13,193,2010,5383,4672,711,13.2
"13193",13,193,2011,5281,4550,731,13.8
"13193",13,193,2012,5173,4485,688,13.3
"13193",13,193,2013,4964,4331,633,12.8
"13193",13,193,2014,4737,4182,555,11.7
"13193",13,193,2015,4617,4193,424,9.2
"13193",13,193,2016,4684,4298,386,8.2
"13193",13,193,2017,4763,4430,333,7
"13195",13,195,1990,11196,10413,783,7
"13195",13,195,1991,11181,10591,590,5.3
"13195",13,195,1992,11394,10638,756,6.6
"13195",13,195,1993,11622,11073,549,4.7
"13195",13,195,1994,11832,11367,465,3.9
"13195",13,195,1995,12560,12099,461,3.7
"13195",13,195,1996,13180,12672,508,3.9
"13195",13,195,1997,13470,13008,462,3.4
"13195",13,195,1998,13704,13246,458,3.3
"13195",13,195,1999,13892,13469,423,3
"13195",13,195,2000,13797,13344,453,3.3
"13195",13,195,2001,14036,13481,555,4
"13195",13,195,2002,14595,13982,613,4.2
"13195",13,195,2003,15101,14498,603,4
"13195",13,195,2004,14929,14313,616,4.1
"13195",13,195,2005,15469,14782,687,4.4
"13195",13,195,2006,15399,14826,573,3.7
"13195",13,195,2007,15835,15246,589,3.7
"13195",13,195,2008,16325,15477,848,5.2
"13195",13,195,2009,15786,14410,1376,8.7
"13195",13,195,2010,13374,11984,1390,10.4
"13195",13,195,2011,13222,11885,1337,10.1
"13195",13,195,2012,13127,11955,1172,8.9
"13195",13,195,2013,12909,11931,978,7.6
"13195",13,195,2014,12704,11859,845,6.7
"13195",13,195,2015,12626,11926,700,5.5
"13195",13,195,2016,13098,12452,646,4.9
"13195",13,195,2017,13602,13020,582,4.3
"13197",13,197,1990,2264,1974,290,12.8
"13197",13,197,1991,2109,1961,148,7
"13197",13,197,1992,2405,2214,191,7.9
"13197",13,197,1993,3280,3053,227,6.9
"13197",13,197,1994,3351,3148,203,6.1
"13197",13,197,1995,3224,3084,140,4.3
"13197",13,197,1996,3050,2902,148,4.9
"13197",13,197,1997,3427,3243,184,5.4
"13197",13,197,1998,3311,3154,157,4.7
"13197",13,197,1999,3463,3287,176,5.1
"13197",13,197,2000,3321,3188,133,4
"13197",13,197,2001,3306,3126,180,5.4
"13197",13,197,2002,3284,3127,157,4.8
"13197",13,197,2003,3392,3202,190,5.6
"13197",13,197,2004,3339,3156,183,5.5
"13197",13,197,2005,3410,3229,181,5.3
"13197",13,197,2006,3385,3232,153,4.5
"13197",13,197,2007,3322,3166,156,4.7
"13197",13,197,2008,3338,3132,206,6.2
"13197",13,197,2009,3317,2987,330,9.9
"13197",13,197,2010,3723,3326,397,10.7
"13197",13,197,2011,3681,3297,384,10.4
"13197",13,197,2012,3612,3251,361,10
"13197",13,197,2013,3453,3148,305,8.8
"13197",13,197,2014,3457,3192,265,7.7
"13197",13,197,2015,3445,3155,290,8.4
"13197",13,197,2016,3383,3136,247,7.3
"13197",13,197,2017,3421,3213,208,6.1
"13199",13,199,1990,9514,8801,713,7.5
"13199",13,199,1991,9377,8726,651,6.9
"13199",13,199,1992,9400,8352,1048,11.1
"13199",13,199,1993,9268,8419,849,9.2
"13199",13,199,1994,9176,8469,707,7.7
"13199",13,199,1995,8886,8302,584,6.6
"13199",13,199,1996,8987,8403,584,6.5
"13199",13,199,1997,9224,8706,518,5.6
"13199",13,199,1998,9238,8753,485,5.3
"13199",13,199,1999,9249,8726,523,5.7
"13199",13,199,2000,10129,9666,463,4.6
"13199",13,199,2001,10031,9497,534,5.3
"13199",13,199,2002,9932,9331,601,6.1
"13199",13,199,2003,9722,9096,626,6.4
"13199",13,199,2004,9679,9042,637,6.6
"13199",13,199,2005,9814,9103,711,7.2
"13199",13,199,2006,9644,9025,619,6.4
"13199",13,199,2007,9572,9012,560,5.9
"13199",13,199,2008,9662,8845,817,8.5
"13199",13,199,2009,9449,8148,1301,13.8
"13199",13,199,2010,9336,8054,1282,13.7
"13199",13,199,2011,9244,8009,1235,13.4
"13199",13,199,2012,9031,7946,1085,12
"13199",13,199,2013,8815,7867,948,10.8
"13199",13,199,2014,8743,7894,849,9.7
"13199",13,199,2015,8672,7977,695,8
"13199",13,199,2016,8766,8166,600,6.8
"13199",13,199,2017,9012,8482,530,5.9
"13201",13,201,1990,2670,2579,91,3.4
"13201",13,201,1991,2734,2565,169,6.2
"13201",13,201,1992,2897,2601,296,10.2
"13201",13,201,1993,2937,2703,234,8
"13201",13,201,1994,2969,2714,255,8.6
"13201",13,201,1995,3190,3015,175,5.5
"13201",13,201,1996,2931,2751,180,6.1
"13201",13,201,1997,3107,2953,154,5
"13201",13,201,1998,3059,2928,131,4.3
"13201",13,201,1999,3214,3060,154,4.8
"13201",13,201,2000,3253,3117,136,4.2
"13201",13,201,2001,3218,3086,132,4.1
"13201",13,201,2002,3367,3216,151,4.5
"13201",13,201,2003,3502,3329,173,4.9
"13201",13,201,2004,3436,3290,146,4.2
"13201",13,201,2005,3600,3465,135,3.8
"13201",13,201,2006,3705,3571,134,3.6
"13201",13,201,2007,3579,3422,157,4.4
"13201",13,201,2008,3600,3422,178,4.9
"13201",13,201,2009,3615,3301,314,8.7
"13201",13,201,2010,2803,2512,291,10.4
"13201",13,201,2011,2737,2486,251,9.2
"13201",13,201,2012,2700,2479,221,8.2
"13201",13,201,2013,2655,2462,193,7.3
"13201",13,201,2014,2675,2506,169,6.3
"13201",13,201,2015,2671,2526,145,5.4
"13201",13,201,2016,2757,2608,149,5.4
"13201",13,201,2017,2840,2711,129,4.5
"13205",13,205,1990,9033,8163,870,9.6
"13205",13,205,1991,8897,8178,719,8.1
"13205",13,205,1992,9275,8193,1082,11.7
"13205",13,205,1993,9479,8451,1028,10.8
"13205",13,205,1994,9948,9147,801,8.1
"13205",13,205,1995,10285,9683,602,5.9
"13205",13,205,1996,10908,10223,685,6.3
"13205",13,205,1997,11506,10388,1118,9.7
"13205",13,205,1998,11685,10708,977,8.4
"13205",13,205,1999,12040,11106,934,7.8
"13205",13,205,2000,9907,9394,513,5.2
"13205",13,205,2001,9793,9273,520,5.3
"13205",13,205,2002,9715,9152,563,5.8
"13205",13,205,2003,9928,9375,553,5.6
"13205",13,205,2004,9865,9288,577,5.8
"13205",13,205,2005,10130,9559,571,5.6
"13205",13,205,2006,10465,9950,515,4.9
"13205",13,205,2007,10420,9886,534,5.1
"13205",13,205,2008,10571,9851,720,6.8
"13205",13,205,2009,10395,9354,1041,10
"13205",13,205,2010,9646,8602,1044,10.8
"13205",13,205,2011,9523,8568,955,10
"13205",13,205,2012,9615,8761,854,8.9
"13205",13,205,2013,9016,8242,774,8.6
"13205",13,205,2014,8763,8078,685,7.8
"13205",13,205,2015,8717,8131,586,6.7
"13205",13,205,2016,8579,8017,562,6.6
"13205",13,205,2017,8538,7995,543,6.4
"13207",13,207,1990,8215,7698,517,6.3
"13207",13,207,1991,7703,7201,502,6.5
"13207",13,207,1992,7766,7187,579,7.5
"13207",13,207,1993,7748,7256,492,6.4
"13207",13,207,1994,7785,7380,405,5.2
"13207",13,207,1995,7878,7356,522,6.6
"13207",13,207,1996,7670,7210,460,6
"13207",13,207,1997,7596,7118,478,6.3
"13207",13,207,1998,7552,7015,537,7.1
"13207",13,207,1999,7777,7350,427,5.5
"13207",13,207,2000,11349,10924,425,3.7
"13207",13,207,2001,11291,10867,424,3.8
"13207",13,207,2002,11756,11216,540,4.6
"13207",13,207,2003,12327,11825,502,4.1
"13207",13,207,2004,12424,11895,529,4.3
"13207",13,207,2005,12689,12047,642,5.1
"13207",13,207,2006,13069,12481,588,4.5
"13207",13,207,2007,13547,12994,553,4.1
"13207",13,207,2008,13952,13164,788,5.6
"13207",13,207,2009,13800,12547,1253,9.1
"13207",13,207,2010,12551,11273,1278,10.2
"13207",13,207,2011,12739,11503,1236,9.7
"13207",13,207,2012,12821,11712,1109,8.6
"13207",13,207,2013,12768,11742,1026,8
"13207",13,207,2014,12729,11880,849,6.7
"13207",13,207,2015,12670,11934,736,5.8
"13207",13,207,2016,13033,12361,672,5.2
"13207",13,207,2017,13235,12637,598,4.5
"13209",13,209,1990,3340,3113,227,6.8
"13209",13,209,1991,3338,3132,206,6.2
"13209",13,209,1992,3473,3140,333,9.6
"13209",13,209,1993,3389,3114,275,8.1
"13209",13,209,1994,3605,3316,289,8
"13209",13,209,1995,3748,3474,274,7.3
"13209",13,209,1996,3724,3404,320,8.6
"13209",13,209,1997,3806,3476,330,8.7
"13209",13,209,1998,3776,3443,333,8.8
"13209",13,209,1999,3905,3519,386,9.9
"13209",13,209,2000,3918,3690,228,5.8
"13209",13,209,2001,3870,3614,256,6.6
"13209",13,209,2002,3780,3519,261,6.9
"13209",13,209,2003,4132,3893,239,5.8
"13209",13,209,2004,4198,3967,231,5.5
"13209",13,209,2005,4255,4007,248,5.8
"13209",13,209,2006,4508,4275,233,5.2
"13209",13,209,2007,4597,4385,212,4.6
"13209",13,209,2008,4559,4226,333,7.3
"13209",13,209,2009,4484,4082,402,9
"13209",13,209,2010,3876,3411,465,12
"13209",13,209,2011,3913,3397,516,13.2
"13209",13,209,2012,3900,3447,453,11.6
"13209",13,209,2013,4049,3587,462,11.4
"13209",13,209,2014,3857,3461,396,10.3
"13209",13,209,2015,3712,3390,322,8.7
"13209",13,209,2016,3728,3451,277,7.4
"13209",13,209,2017,3811,3558,253,6.6
"13211",13,211,1990,6383,5926,457,7.2
"13211",13,211,1991,5931,5548,383,6.5
"13211",13,211,1992,6051,5578,473,7.8
"13211",13,211,1993,6262,5834,428,6.8
"13211",13,211,1994,6131,5810,321,5.2
"13211",13,211,1995,6259,5892,367,5.9
"13211",13,211,1996,6647,6350,297,4.5
"13211",13,211,1997,7223,6900,323,4.5
"13211",13,211,1998,7306,7005,301,4.1
"13211",13,211,1999,7257,6979,278,3.8
"13211",13,211,2000,8170,7886,284,3.5
"13211",13,211,2001,8223,7949,274,3.3
"13211",13,211,2002,8570,8207,363,4.2
"13211",13,211,2003,8567,8203,364,4.2
"13211",13,211,2004,8579,8220,359,4.2
"13211",13,211,2005,8932,8517,415,4.6
"13211",13,211,2006,9397,8989,408,4.3
"13211",13,211,2007,9498,9086,412,4.3
"13211",13,211,2008,9626,9051,575,6
"13211",13,211,2009,9346,8415,931,10
"13211",13,211,2010,8630,7729,901,10.4
"13211",13,211,2011,8639,7771,868,10
"13211",13,211,2012,8541,7770,771,9
"13211",13,211,2013,8348,7674,674,8.1
"13211",13,211,2014,8359,7812,547,6.5
"13211",13,211,2015,8422,7960,462,5.5
"13211",13,211,2016,8709,8270,439,5
"13211",13,211,2017,9015,8606,409,4.5
"13213",13,213,1990,14315,13324,991,6.9
"13213",13,213,1991,14660,13558,1102,7.5
"13213",13,213,1992,16108,14883,1225,7.6
"13213",13,213,1993,16356,15499,857,5.2
"13213",13,213,1994,17498,16742,756,4.3
"13213",13,213,1995,18014,17156,858,4.8
"13213",13,213,1996,17923,17045,878,4.9
"13213",13,213,1997,17675,16658,1017,5.8
"13213",13,213,1998,18606,17810,796,4.3
"13213",13,213,1999,19547,18930,617,3.2
"13213",13,213,2000,19601,18935,666,3.4
"13213",13,213,2001,19678,18846,832,4.2
"13213",13,213,2002,20299,19401,898,4.4
"13213",13,213,2003,20534,19686,848,4.1
"13213",13,213,2004,20676,19849,827,4
"13213",13,213,2005,20981,20013,968,4.6
"13213",13,213,2006,21441,20512,929,4.3
"13213",13,213,2007,21072,20115,957,4.5
"13213",13,213,2008,20422,18915,1507,7.4
"13213",13,213,2009,19722,17163,2559,13
"13213",13,213,2010,17181,14812,2369,13.8
"13213",13,213,2011,17062,14692,2370,13.9
"13213",13,213,2012,16406,14306,2100,12.8
"13213",13,213,2013,15887,14102,1785,11.2
"13213",13,213,2014,15866,14388,1478,9.3
"13213",13,213,2015,16070,14887,1183,7.4
"13213",13,213,2016,15659,14551,1108,7.1
"13213",13,213,2017,15815,14833,982,6.2
"13215",13,215,1990,76423,71666,4757,6.2
"13215",13,215,1991,75546,71741,3805,5
"13215",13,215,1992,77622,72008,5614,7.2
"13215",13,215,1993,77944,72691,5253,6.7
"13215",13,215,1994,78618,73596,5022,6.4
"13215",13,215,1995,79399,74688,4711,5.9
"13215",13,215,1996,81910,77452,4458,5.4
"13215",13,215,1997,84913,80492,4421,5.2
"13215",13,215,1998,87181,82593,4588,5.3
"13215",13,215,1999,88389,83604,4785,5.4
"13215",13,215,2000,83631,79637,3994,4.8
"13215",13,215,2001,82264,78155,4109,5
"13215",13,215,2002,82436,77880,4556,5.5
"13215",13,215,2003,83339,78888,4451,5.3
"13215",13,215,2004,83704,79046,4658,5.6
"13215",13,215,2005,84703,79487,5216,6.2
"13215",13,215,2006,85344,80659,4685,5.5
"13215",13,215,2007,85604,81150,4454,5.2
"13215",13,215,2008,86288,80960,5328,6.2
"13215",13,215,2009,86098,78276,7822,9.1
"13215",13,215,2010,81718,73484,8234,10.1
"13215",13,215,2011,82863,74559,8304,10
"13215",13,215,2012,83617,75432,8185,9.8
"13215",13,215,2013,83129,75375,7754,9.3
"13215",13,215,2014,80811,74035,6776,8.4
"13215",13,215,2015,78898,73014,5884,7.5
"13215",13,215,2016,78508,73190,5318,6.8
"13215",13,215,2017,79554,74739,4815,6.1
"13217",13,217,1990,20737,19282,1455,7
"13217",13,217,1991,20694,19500,1194,5.8
"13217",13,217,1992,21503,19898,1605,7.5
"13217",13,217,1993,22315,20951,1364,6.1
"13217",13,217,1994,23401,22317,1084,4.6
"13217",13,217,1995,24418,23351,1067,4.4
"13217",13,217,1996,26096,24926,1170,4.5
"13217",13,217,1997,27840,26519,1321,4.7
"13217",13,217,1998,29407,28230,1177,4
"13217",13,217,1999,30686,29658,1028,3.4
"13217",13,217,2000,32279,31214,1065,3.3
"13217",13,217,2001,33910,32679,1231,3.6
"13217",13,217,2002,35675,33880,1795,5
"13217",13,217,2003,37464,35495,1969,5.3
"13217",13,217,2004,39511,37451,2060,5.2
"13217",13,217,2005,42367,39831,2536,6
"13217",13,217,2006,44063,41716,2347,5.3
"13217",13,217,2007,46421,43991,2430,5.2
"13217",13,217,2008,47716,44131,3585,7.5
"13217",13,217,2009,47101,41333,5768,12.2
"13217",13,217,2010,47977,41899,6078,12.7
"13217",13,217,2011,48399,42424,5975,12.3
"13217",13,217,2012,48311,42993,5318,11
"13217",13,217,2013,48066,43403,4663,9.7
"13217",13,217,2014,47931,44019,3912,8.2
"13217",13,217,2015,48436,45165,3271,6.8
"13217",13,217,2016,50053,47063,2990,6
"13217",13,217,2017,51535,48794,2741,5.3
"13219",13,219,1990,9439,9031,408,4.3
"13219",13,219,1991,9576,9260,316,3.3
"13219",13,219,1992,9716,9320,396,4.1
"13219",13,219,1993,10073,9773,300,3
"13219",13,219,1994,10666,10412,254,2.4
"13219",13,219,1995,11581,11361,220,1.9
"13219",13,219,1996,12421,12172,249,2
"13219",13,219,1997,12953,12698,255,2
"13219",13,219,1998,13525,13286,239,1.8
"13219",13,219,1999,13745,13543,202,1.5
"13219",13,219,2000,14334,13963,371,2.6
"13219",13,219,2001,14535,14141,394,2.7
"13219",13,219,2002,15123,14655,468,3.1
"13219",13,219,2003,15875,15421,454,2.9
"13219",13,219,2004,16082,15591,491,3.1
"13219",13,219,2005,17109,16513,596,3.5
"13219",13,219,2006,17395,16843,552,3.2
"13219",13,219,2007,18031,17496,535,3
"13219",13,219,2008,18886,18122,764,4
"13219",13,219,2009,18585,17429,1156,6.2
"13219",13,219,2010,16837,15635,1202,7.1
"13219",13,219,2011,16910,15727,1183,7
"13219",13,219,2012,17068,15992,1076,6.3
"13219",13,219,2013,17095,16137,958,5.6
"13219",13,219,2014,17260,16389,871,5
"13219",13,219,2015,17592,16814,778,4.4
"13219",13,219,2016,18495,17740,755,4.1
"13219",13,219,2017,19231,18550,681,3.5
"13221",13,221,1990,5144,4839,305,5.9
"13221",13,221,1991,5137,4849,288,5.6
"13221",13,221,1992,4963,4595,368,7.4
"13221",13,221,1993,5043,4688,355,7
"13221",13,221,1994,4911,4612,299,6.1
"13221",13,221,1995,5061,4829,232,4.6
"13221",13,221,1996,5004,4763,241,4.8
"13221",13,221,1997,5383,5140,243,4.5
"13221",13,221,1998,5799,5553,246,4.2
"13221",13,221,1999,6100,5908,192,3.1
"13221",13,221,2000,6624,6421,203,3.1
"13221",13,221,2001,6768,6502,266,3.9
"13221",13,221,2002,7030,6733,297,4.2
"13221",13,221,2003,7285,6987,298,4.1
"13221",13,221,2004,7277,6981,296,4.1
"13221",13,221,2005,7556,7211,345,4.6
"13221",13,221,2006,7575,7292,283,3.7
"13221",13,221,2007,7731,7434,297,3.8
"13221",13,221,2008,7986,7572,414,5.2
"13221",13,221,2009,7817,7153,664,8.5
"13221",13,221,2010,7079,6396,683,9.6
"13221",13,221,2011,6999,6319,680,9.7
"13221",13,221,2012,6893,6305,588,8.5
"13221",13,221,2013,6739,6229,510,7.6
"13221",13,221,2014,6659,6220,439,6.6
"13221",13,221,2015,6728,6355,373,5.5
"13221",13,221,2016,6927,6591,336,4.9
"13221",13,221,2017,7212,6902,310,4.3
"13223",13,223,1990,22060,20938,1122,5.1
"13223",13,223,1991,22914,21720,1194,5.2
"13223",13,223,1992,24420,22890,1530,6.3
"13223",13,223,1993,26527,25261,1266,4.8
"13223",13,223,1994,28971,27931,1040,3.6
"13223",13,223,1995,31130,30049,1081,3.5
"13223",13,223,1996,33756,32855,901,2.7
"13223",13,223,1997,37030,36042,988,2.7
"13223",13,223,1998,40096,39178,918,2.3
"13223",13,223,1999,43224,42345,879,2
"13223",13,223,2000,45732,44497,1235,2.7
"13223",13,223,2001,48051,46647,1404,2.9
"13223",13,223,2002,50164,48113,2051,4.1
"13223",13,223,2003,52290,50125,2165,4.1
"13223",13,223,2004,54933,52567,2366,4.3
"13223",13,223,2005,58563,55791,2772,4.7
"13223",13,223,2006,62499,59899,2600,4.2
"13223",13,223,2007,65995,63316,2679,4.1
"13223",13,223,2008,68486,64420,4066,5.9
"13223",13,223,2009,67939,61065,6874,10.1
"13223",13,223,2010,73735,66352,7383,10
"13223",13,223,2011,74316,67219,7097,9.5
"13223",13,223,2012,74473,68282,6191,8.3
"13223",13,223,2013,74530,69166,5364,7.2
"13223",13,223,2014,74827,70247,4580,6.1
"13223",13,223,2015,76339,72370,3969,5.2
"13223",13,223,2016,79738,76061,3677,4.6
"13223",13,223,2017,82244,78836,3408,4.1
"13225",13,225,1990,9459,8901,558,5.9
"13225",13,225,1991,9320,8760,560,6
"13225",13,225,1992,9785,8927,858,8.8
"13225",13,225,1993,9853,9072,781,7.9
"13225",13,225,1994,10137,9380,757,7.5
"13225",13,225,1995,10390,9649,741,7.1
"13225",13,225,1996,10771,10052,719,6.7
"13225",13,225,1997,11185,10471,714,6.4
"13225",13,225,1998,11377,10633,744,6.5
"13225",13,225,1999,10997,10357,640,5.8
"13225",13,225,2000,10808,10311,497,4.6
"13225",13,225,2001,10662,10172,490,4.6
"13225",13,225,2002,10894,10324,570,5.2
"13225",13,225,2003,11276,10622,654,5.8
"13225",13,225,2004,11168,10440,728,6.5
"13225",13,225,2005,11353,10591,762,6.7
"13225",13,225,2006,11513,10842,671,5.8
"13225",13,225,2007,11537,10909,628,5.4
"13225",13,225,2008,12172,11313,859,7.1
"13225",13,225,2009,12340,11063,1277,10.3
"13225",13,225,2010,12918,11359,1559,12.1
"13225",13,225,2011,12693,11189,1504,11.8
"13225",13,225,2012,12548,11149,1399,11.1
"13225",13,225,2013,11890,10622,1268,10.7
"13225",13,225,2014,11484,10400,1084,9.4
"13225",13,225,2015,11288,10394,894,7.9
"13225",13,225,2016,11451,10651,800,7
"13225",13,225,2017,11669,10986,683,5.9
"13227",13,227,1990,7652,7034,618,8.1
"13227",13,227,1991,7503,6996,507,6.8
"13227",13,227,1992,7658,7068,590,7.7
"13227",13,227,1993,7926,7395,531,6.7
"13227",13,227,1994,8332,7919,413,5
"13227",13,227,1995,8692,8217,475,5.5
"13227",13,227,1996,9154,8801,353,3.9
"13227",13,227,1997,9818,9454,364,3.7
"13227",13,227,1998,10495,10190,305,2.9
"13227",13,227,1999,11179,10894,285,2.5
"13227",13,227,2000,12476,12097,379,3
"13227",13,227,2001,12880,12455,425,3.3
"13227",13,227,2002,13197,12646,551,4.2
"13227",13,227,2003,13644,13048,596,4.4
"13227",13,227,2004,13863,13315,548,4
"13227",13,227,2005,14232,13639,593,4.2
"13227",13,227,2006,14657,14115,542,3.7
"13227",13,227,2007,15150,14582,568,3.7
"13227",13,227,2008,15497,14575,922,5.9
"13227",13,227,2009,15098,13498,1600,10.6
"13227",13,227,2010,14045,12505,1540,11
"13227",13,227,2011,14063,12582,1481,10.5
"13227",13,227,2012,13899,12637,1262,9.1
"13227",13,227,2013,13809,12710,1099,8
"13227",13,227,2014,13821,12905,916,6.6
"13227",13,227,2015,13876,13138,738,5.3
"13227",13,227,2016,14420,13719,701,4.9
"13227",13,227,2017,14857,14220,637,4.3
"13229",13,229,1990,6333,5940,393,6.2
"13229",13,229,1991,6368,5986,382,6
"13229",13,229,1992,6969,6431,538,7.7
"13229",13,229,1993,6779,6247,532,7.8
"13229",13,229,1994,6922,6427,495,7.2
"13229",13,229,1995,6766,6321,445,6.6
"13229",13,229,1996,6968,6539,429,6.2
"13229",13,229,1997,7474,7076,398,5.3
"13229",13,229,1998,7443,7059,384,5.2
"13229",13,229,1999,7474,7084,390,5.2
"13229",13,229,2000,7635,7325,310,4.1
"13229",13,229,2001,7455,7130,325,4.4
"13229",13,229,2002,7547,7188,359,4.8
"13229",13,229,2003,7902,7559,343,4.3
"13229",13,229,2004,8056,7707,349,4.3
"13229",13,229,2005,8327,7931,396,4.8
"13229",13,229,2006,8356,8006,350,4.2
"13229",13,229,2007,8572,8235,337,3.9
"13229",13,229,2008,8710,8242,468,5.4
"13229",13,229,2009,8678,7864,814,9.4
"13229",13,229,2010,8245,7387,858,10.4
"13229",13,229,2011,8099,7236,863,10.7
"13229",13,229,2012,8338,7550,788,9.5
"13229",13,229,2013,8159,7463,696,8.5
"13229",13,229,2014,8087,7486,601,7.4
"13229",13,229,2015,8046,7544,502,6.2
"13229",13,229,2016,8564,8112,452,5.3
"13229",13,229,2017,8840,8439,401,4.5
"13231",13,231,1990,4991,4713,278,5.6
"13231",13,231,1991,5182,4924,258,5
"13231",13,231,1992,5425,5097,328,6
"13231",13,231,1993,5050,4695,355,7
"13231",13,231,1994,5231,4964,267,5.1
"13231",13,231,1995,5640,5429,211,3.7
"13231",13,231,1996,5940,5668,272,4.6
"13231",13,231,1997,6294,6049,245,3.9
"13231",13,231,1998,6225,5990,235,3.8
"13231",13,231,1999,6491,6227,264,4.1
"13231",13,231,2000,6979,6719,260,3.7
"13231",13,231,2001,6976,6703,273,3.9
"13231",13,231,2002,7134,6764,370,5.2
"13231",13,231,2003,7230,6856,374,5.2
"13231",13,231,2004,7427,7064,363,4.9
"13231",13,231,2005,7706,7269,437,5.7
"13231",13,231,2006,7879,7521,358,4.5
"13231",13,231,2007,8076,7734,342,4.2
"13231",13,231,2008,8264,7721,543,6.6
"13231",13,231,2009,8077,7192,885,11
"13231",13,231,2010,8505,7599,906,10.7
"13231",13,231,2011,8437,7577,860,10.2
"13231",13,231,2012,8422,7643,779,9.2
"13231",13,231,2013,8302,7599,703,8.5
"13231",13,231,2014,8192,7620,572,7
"13231",13,231,2015,8229,7758,471,5.7
"13231",13,231,2016,8412,7977,435,5.2
"13231",13,231,2017,8667,8280,387,4.5
"13233",13,233,1990,16464,14646,1818,11
"13233",13,233,1991,15914,14401,1513,9.5
"13233",13,233,1992,15715,13782,1933,12.3
"13233",13,233,1993,15656,13871,1785,11.4
"13233",13,233,1994,15453,14117,1336,8.6
"13233",13,233,1995,15294,13960,1334,8.7
"13233",13,233,1996,15000,13597,1403,9.4
"13233",13,233,1997,15246,14130,1116,7.3
"13233",13,233,1998,15783,14891,892,5.7
"13233",13,233,1999,16421,15469,952,5.8
"13233",13,233,2000,17583,16855,728,4.1
"13233",13,233,2001,18270,17388,882,4.8
"13233",13,233,2002,19003,17982,1021,5.4
"13233",13,233,2003,19626,18703,923,4.7
"13233",13,233,2004,19650,18686,964,4.9
"13233",13,233,2005,20428,19391,1037,5.1
"13233",13,233,2006,20715,19805,910,4.4
"13233",13,233,2007,20967,20035,932,4.4
"13233",13,233,2008,21500,20140,1360,6.3
"13233",13,233,2009,21188,18905,2283,10.8
"13233",13,233,2010,18690,16444,2246,12
"13233",13,233,2011,18679,16532,2147,11.5
"13233",13,233,2012,18793,16917,1876,10
"13233",13,233,2013,18507,16860,1647,8.9
"13233",13,233,2014,18342,16915,1427,7.8
"13233",13,233,2015,18151,16949,1202,6.6
"13233",13,233,2016,18090,16982,1108,6.1
"13233",13,233,2017,18470,17494,976,5.3
"13235",13,235,1990,3596,3389,207,5.8
"13235",13,235,1991,3688,3536,152,4.1
"13235",13,235,1992,4032,3799,233,5.8
"13235",13,235,1993,4014,3803,211,5.3
"13235",13,235,1994,4108,3909,199,4.8
"13235",13,235,1995,4303,4126,177,4.1
"13235",13,235,1996,4312,4101,211,4.9
"13235",13,235,1997,4493,4263,230,5.1
"13235",13,235,1998,4716,4462,254,5.4
"13235",13,235,1999,4664,4437,227,4.9
"13235",13,235,2000,4369,4189,180,4.1
"13235",13,235,2001,4263,3994,269,6.3
"13235",13,235,2002,4136,3900,236,5.7
"13235",13,235,2003,4284,4096,188,4.4
"13235",13,235,2004,4250,4057,193,4.5
"13235",13,235,2005,4368,4120,248,5.7
"13235",13,235,2006,4630,4421,209,4.5
"13235",13,235,2007,4649,4465,184,4
"13235",13,235,2008,4607,4362,245,5.3
"13235",13,235,2009,4357,4017,340,7.8
"13235",13,235,2010,4530,4112,418,9.2
"13235",13,235,2011,4486,4055,431,9.6
"13235",13,235,2012,4380,3987,393,9
"13235",13,235,2013,4197,3826,371,8.8
"13235",13,235,2014,4062,3746,316,7.8
"13235",13,235,2015,4013,3749,264,6.6
"13235",13,235,2016,4043,3807,236,5.8
"13235",13,235,2017,4149,3930,219,5.3
"13237",13,237,1990,6826,6596,230,3.4
"13237",13,237,1991,6927,6595,332,4.8
"13237",13,237,1992,7222,6857,365,5.1
"13237",13,237,1993,7384,7057,327,4.4
"13237",13,237,1994,7331,7085,246,3.4
"13237",13,237,1995,7816,7587,229,2.9
"13237",13,237,1996,8673,8327,346,4
"13237",13,237,1997,9054,8641,413,4.6
"13237",13,237,1998,9144,8820,324,3.5
"13237",13,237,1999,9679,9350,329,3.4
"13237",13,237,2000,9040,8717,323,3.6
"13237",13,237,2001,8974,8622,352,3.9
"13237",13,237,2002,9237,8816,421,4.6
"13237",13,237,2003,9095,8690,405,4.5
"13237",13,237,2004,9446,9028,418,4.4
"13237",13,237,2005,10075,9528,547,5.4
"13237",13,237,2006,10374,9903,471,4.5
"13237",13,237,2007,10414,9960,454,4.4
"13237",13,237,2008,10496,9756,740,7.1
"13237",13,237,2009,10371,9234,1137,11
"13237",13,237,2010,9053,7883,1170,12.9
"13237",13,237,2011,8667,7541,1126,13
"13237",13,237,2012,8292,7336,956,11.5
"13237",13,237,2013,8143,7303,840,10.3
"13237",13,237,2014,8088,7360,728,9
"13237",13,237,2015,7802,7172,630,8.1
"13237",13,237,2016,7961,7402,559,7
"13237",13,237,2017,8145,7670,475,5.8
"13239",13,239,1990,872,813,59,6.8
"13239",13,239,1991,893,843,50,5.6
"13239",13,239,1992,945,854,91,9.6
"13239",13,239,1993,1018,939,79,7.8
"13239",13,239,1994,1044,981,63,6
"13239",13,239,1995,1108,1017,91,8.2
"13239",13,239,1996,1237,1154,83,6.7
"13239",13,239,1997,1317,1252,65,4.9
"13239",13,239,1998,1347,1276,71,5.3
"13239",13,239,1999,1283,1235,48,3.7
"13239",13,239,2000,1041,974,67,6.4
"13239",13,239,2001,1034,956,78,7.5
"13239",13,239,2002,993,930,63,6.3
"13239",13,239,2003,971,921,50,5.1
"13239",13,239,2004,953,893,60,6.3
"13239",13,239,2005,985,924,61,6.2
"13239",13,239,2006,1000,949,51,5.1
"13239",13,239,2007,1060,1003,57,5.4
"13239",13,239,2008,1031,942,89,8.6
"13239",13,239,2009,968,853,115,11.9
"13239",13,239,2010,1006,905,101,10
"13239",13,239,2011,979,879,100,10.2
"13239",13,239,2012,943,853,90,9.5
"13239",13,239,2013,902,828,74,8.2
"13239",13,239,2014,890,816,74,8.3
"13239",13,239,2015,817,761,56,6.9
"13239",13,239,2016,816,757,59,7.2
"13239",13,239,2017,827,778,49,5.9
"13241",13,241,1990,5759,5460,299,5.2
"13241",13,241,1991,5675,5299,376,6.6
"13241",13,241,1992,5735,5172,563,9.8
"13241",13,241,1993,6108,5584,524,8.6
"13241",13,241,1994,6573,6236,337,5.1
"13241",13,241,1995,6953,6660,293,4.2
"13241",13,241,1996,6894,6653,241,3.5
"13241",13,241,1997,7149,6913,236,3.3
"13241",13,241,1998,7149,6947,202,2.8
"13241",13,241,1999,7404,7196,208,2.8
"13241",13,241,2000,7267,7032,235,3.2
"13241",13,241,2001,7061,6786,275,3.9
"13241",13,241,2002,7049,6754,295,4.2
"13241",13,241,2003,7435,7160,275,3.7
"13241",13,241,2004,7495,7216,279,3.7
"13241",13,241,2005,7810,7444,366,4.7
"13241",13,241,2006,7521,7105,416,5.5
"13241",13,241,2007,7277,6852,425,5.8
"13241",13,241,2008,6973,6530,443,6.4
"13241",13,241,2009,6968,6244,724,10.4
"13241",13,241,2010,7141,6298,843,11.8
"13241",13,241,2011,7034,6163,871,12.4
"13241",13,241,2012,6939,6144,795,11.5
"13241",13,241,2013,6822,6146,676,9.9
"13241",13,241,2014,6548,6015,533,8.1
"13241",13,241,2015,6504,6068,436,6.7
"13241",13,241,2016,6705,6310,395,5.9
"13241",13,241,2017,6915,6570,345,5
"13243",13,243,1990,3078,2830,248,8.1
"13243",13,243,1991,2947,2731,216,7.3
"13243",13,243,1992,3115,2827,288,9.2
"13243",13,243,1993,3175,2899,276,8.7
"13243",13,243,1994,3147,2907,240,7.6
"13243",13,243,1995,3170,2896,274,8.6
"13243",13,243,1996,3403,3049,354,10.4
"13243",13,243,1997,3430,3121,309,9
"13243",13,243,1998,3391,2910,481,14.2
"13243",13,243,1999,3243,2954,289,8.9
"13243",13,243,2000,3003,2823,180,6
"13243",13,243,2001,2888,2654,234,8.1
"13243",13,243,2002,2951,2687,264,8.9
"13243",13,243,2003,2970,2748,222,7.5
"13243",13,243,2004,2814,2612,202,7.2
"13243",13,243,2005,2727,2519,208,7.6
"13243",13,243,2006,2873,2688,185,6.4
"13243",13,243,2007,2745,2568,177,6.4
"13243",13,243,2008,2790,2555,235,8.4
"13243",13,243,2009,2752,2417,335,12.2
"13243",13,243,2010,2979,2616,363,12.2
"13243",13,243,2011,2945,2569,376,12.8
"13243",13,243,2012,2836,2481,355,12.5
"13243",13,243,2013,2790,2502,288,10.3
"13243",13,243,2014,2718,2456,262,9.6
"13243",13,243,2015,2426,2205,221,9.1
"13243",13,243,2016,2476,2268,208,8.4
"13243",13,243,2017,2510,2343,167,6.7
"13245",13,245,1990,85218,80551,4667,5.5
"13245",13,245,1991,84686,79879,4807,5.7
"13245",13,245,1992,87385,79921,7464,8.5
"13245",13,245,1993,84852,77959,6893,8.1
"13245",13,245,1994,83508,77384,6124,7.3
"13245",13,245,1995,81295,75423,5872,7.2
"13245",13,245,1996,80760,74716,6044,7.5
"13245",13,245,1997,81795,75697,6098,7.5
"13245",13,245,1998,82504,76535,5969,7.2
"13245",13,245,1999,82070,76944,5126,6.2
"13245",13,245,2000,87167,83280,3887,4.5
"13245",13,245,2001,86512,82298,4214,4.9
"13245",13,245,2002,87790,82907,4883,5.6
"13245",13,245,2003,88868,84014,4854,5.5
"13245",13,245,2004,90074,84776,5298,5.9
"13245",13,245,2005,89801,83650,6151,6.8
"13245",13,245,2006,88769,83164,5605,6.3
"13245",13,245,2007,90907,85362,5545,6.1
"13245",13,245,2008,92255,85658,6597,7.2
"13245",13,245,2009,91254,82033,9221,10.1
"13245",13,245,2010,87887,78209,9678,11
"13245",13,245,2011,88510,78559,9951,11.2
"13245",13,245,2012,88450,79050,9400,10.6
"13245",13,245,2013,86714,78191,8523,9.8
"13245",13,245,2014,84627,77305,7322,8.7
"13245",13,245,2015,84282,78051,6231,7.4
"13245",13,245,2016,84919,79198,5721,6.7
"13245",13,245,2017,86601,81450,5151,5.9
"13247",13,247,1990,30049,28733,1316,4.4
"13247",13,247,1991,30474,29201,1273,4.2
"13247",13,247,1992,31801,30076,1725,5.4
"13247",13,247,1993,32846,31350,1496,4.6
"13247",13,247,1994,34043,32743,1300,3.8
"13247",13,247,1995,35374,34183,1191,3.4
"13247",13,247,1996,36481,35345,1136,3.1
"13247",13,247,1997,38200,36978,1222,3.2
"13247",13,247,1998,39365,38204,1161,2.9
"13247",13,247,1999,39711,38722,989,2.5
"13247",13,247,2000,36870,35713,1157,3.1
"13247",13,247,2001,36867,35597,1270,3.4
"13247",13,247,2002,36973,35178,1795,4.9
"13247",13,247,2003,37304,35459,1845,4.9
"13247",13,247,2004,37863,35975,1888,5
"13247",13,247,2005,39089,36806,2283,5.8
"13247",13,247,2006,39376,37383,1993,5.1
"13247",13,247,2007,40365,38349,2016,5
"13247",13,247,2008,40840,38020,2820,6.9
"13247",13,247,2009,40153,35680,4473,11.1
"13247",13,247,2010,41960,37210,4750,11.3
"13247",13,247,2011,42258,37516,4742,11.2
"13247",13,247,2012,42138,37844,4294,10.2
"13247",13,247,2013,42178,38321,3857,9.1
"13247",13,247,2014,42028,38741,3287,7.8
"13247",13,247,2015,42272,39516,2756,6.5
"13247",13,247,2016,43296,40793,2503,5.8
"13247",13,247,2017,44641,42284,2357,5.3
"13249",13,249,1990,1656,1506,150,9.1
"13249",13,249,1991,1354,1250,104,7.7
"13249",13,249,1992,1441,1309,132,9.2
"13249",13,249,1993,1490,1380,110,7.4
"13249",13,249,1994,1515,1428,87,5.7
"13249",13,249,1995,1480,1417,63,4.3
"13249",13,249,1996,1703,1593,110,6.5
"13249",13,249,1997,1783,1668,115,6.4
"13249",13,249,1998,1805,1708,97,5.4
"13249",13,249,1999,1840,1756,84,4.6
"13249",13,249,2000,1715,1644,71,4.1
"13249",13,249,2001,1680,1599,81,4.8
"13249",13,249,2002,1677,1596,81,4.8
"13249",13,249,2003,1728,1631,97,5.6
"13249",13,249,2004,1737,1635,102,5.9
"13249",13,249,2005,1769,1649,120,6.8
"13249",13,249,2006,1864,1759,105,5.6
"13249",13,249,2007,1823,1715,108,5.9
"13249",13,249,2008,1881,1756,125,6.6
"13249",13,249,2009,1903,1661,242,12.7
"13249",13,249,2010,2165,1903,262,12.1
"13249",13,249,2011,2162,1914,248,11.5
"13249",13,249,2012,2176,1949,227,10.4
"13249",13,249,2013,2131,1934,197,9.2
"13249",13,249,2014,2175,2010,165,7.6
"13249",13,249,2015,2110,1970,140,6.6
"13249",13,249,2016,2118,1985,133,6.3
"13249",13,249,2017,2130,2011,119,5.6
"13251",13,251,1990,6045,5574,471,7.8
"13251",13,251,1991,6320,5759,561,8.9
"13251",13,251,1992,6639,6012,627,9.4
"13251",13,251,1993,6573,6088,485,7.4
"13251",13,251,1994,6577,6142,435,6.6
"13251",13,251,1995,6759,6138,621,9.2
"13251",13,251,1996,6500,5752,748,11.5
"13251",13,251,1997,6511,5749,762,11.7
"13251",13,251,1998,6180,5649,531,8.6
"13251",13,251,1999,5974,5540,434,7.3
"13251",13,251,2000,6598,6271,327,5
"13251",13,251,2001,6391,5952,439,6.9
"13251",13,251,2002,6415,6058,357,5.6
"13251",13,251,2003,6611,6247,364,5.5
"13251",13,251,2004,6671,6322,349,5.2
"13251",13,251,2005,6937,6555,382,5.5
"13251",13,251,2006,7190,6842,348,4.8
"13251",13,251,2007,7239,6888,351,4.8
"13251",13,251,2008,7383,6805,578,7.8
"13251",13,251,2009,7302,6268,1034,14.2
"13251",13,251,2010,5804,4818,986,17
"13251",13,251,2011,5768,4857,911,15.8
"13251",13,251,2012,5694,4908,786,13.8
"13251",13,251,2013,5563,4863,700,12.6
"13251",13,251,2014,5361,4827,534,10
"13251",13,251,2015,5041,4622,419,8.3
"13251",13,251,2016,5244,4850,394,7.5
"13251",13,251,2017,5275,4939,336,6.4
"13253",13,253,1990,4034,3870,164,4.1
"13253",13,253,1991,4088,3822,266,6.5
"13253",13,253,1992,4449,3973,476,10.7
"13253",13,253,1993,4352,4001,351,8.1
"13253",13,253,1994,4374,4058,316,7.2
"13253",13,253,1995,4283,4044,239,5.6
"13253",13,253,1996,4456,4205,251,5.6
"13253",13,253,1997,4586,4362,224,4.9
"13253",13,253,1998,4485,4270,215,4.8
"13253",13,253,1999,4516,4303,213,4.7
"13253",13,253,2000,4007,3807,200,5
"13253",13,253,2001,3980,3772,208,5.2
"13253",13,253,2002,3942,3715,227,5.8
"13253",13,253,2003,4045,3827,218,5.4
"13253",13,253,2004,3823,3609,214,5.6
"13253",13,253,2005,3982,3755,227,5.7
"13253",13,253,2006,4005,3799,206,5.1
"13253",13,253,2007,3990,3773,217,5.4
"13253",13,253,2008,4105,3805,300,7.3
"13253",13,253,2009,4090,3649,441,10.8
"13253",13,253,2010,3383,2959,424,12.5
"13253",13,253,2011,3272,2860,412,12.6
"13253",13,253,2012,3254,2899,355,10.9
"13253",13,253,2013,3138,2817,321,10.2
"13253",13,253,2014,3120,2826,294,9.4
"13253",13,253,2015,3090,2840,250,8.1
"13253",13,253,2016,3095,2852,243,7.9
"13253",13,253,2017,3124,2919,205,6.6
"13255",13,255,1990,26651,25128,1523,5.7
"13255",13,255,1991,26520,24876,1644,6.2
"13255",13,255,1992,26958,25061,1897,7
"13255",13,255,1993,27415,25681,1734,6.3
"13255",13,255,1994,27724,26278,1446,5.2
"13255",13,255,1995,27794,26492,1302,4.7
"13255",13,255,1996,28624,27158,1466,5.1
"13255",13,255,1997,28949,27452,1497,5.2
"13255",13,255,1998,29500,28160,1340,4.5
"13255",13,255,1999,29581,28365,1216,4.1
"13255",13,255,2000,28104,26882,1222,4.3
"13255",13,255,2001,28012,26670,1342,4.8
"13255",13,255,2002,27852,26112,1740,6.2
"13255",13,255,2003,27734,25981,1753,6.3
"13255",13,255,2004,27500,25827,1673,6.1
"13255",13,255,2005,28138,26088,2050,7.3
"13255",13,255,2006,28067,26286,1781,6.3
"13255",13,255,2007,28269,26672,1597,5.6
"13255",13,255,2008,28974,26522,2452,8.5
"13255",13,255,2009,28894,24798,4096,14.2
"13255",13,255,2010,28669,24409,4260,14.9
"13255",13,255,2011,28573,24569,4004,14
"13255",13,255,2012,28196,24658,3538,12.5
"13255",13,255,2013,27777,24587,3190,11.5
"13255",13,255,2014,27269,24702,2567,9.4
"13255",13,255,2015,27114,24934,2180,8
"13255",13,255,2016,27820,25913,1907,6.9
"13255",13,255,2017,28529,26870,1659,5.8
"13257",13,257,1990,11916,11047,869,7.3
"13257",13,257,1991,11718,11070,648,5.5
"13257",13,257,1992,12349,11446,903,7.3
"13257",13,257,1993,12451,11647,804,6.5
"13257",13,257,1994,12421,11787,634,5.1
"13257",13,257,1995,12722,12057,665,5.2
"13257",13,257,1996,12979,12122,857,6.6
"13257",13,257,1997,13073,12325,748,5.7
"13257",13,257,1998,12825,12091,734,5.7
"13257",13,257,1999,12143,11550,593,4.9
"13257",13,257,2000,13206,12724,482,3.6
"13257",13,257,2001,13402,12722,680,5.1
"13257",13,257,2002,13736,13029,707,5.1
"13257",13,257,2003,13383,12591,792,5.9
"13257",13,257,2004,12832,12038,794,6.2
"13257",13,257,2005,12977,12217,760,5.9
"13257",13,257,2006,13379,12714,665,5
"13257",13,257,2007,13590,12933,657,4.8
"13257",13,257,2008,13809,12954,855,6.2
"13257",13,257,2009,13894,12420,1474,10.6
"13257",13,257,2010,11892,10429,1463,12.3
"13257",13,257,2011,11743,10340,1403,11.9
"13257",13,257,2012,11763,10528,1235,10.5
"13257",13,257,2013,11511,10458,1053,9.1
"13257",13,257,2014,11210,10355,855,7.6
"13257",13,257,2015,10862,10153,709,6.5
"13257",13,257,2016,11046,10398,648,5.9
"13257",13,257,2017,11020,10438,582,5.3
"13259",13,259,1990,2140,1958,182,8.5
"13259",13,259,1991,2095,1923,172,8.2
"13259",13,259,1992,2179,1976,203,9.3
"13259",13,259,1993,2366,2195,171,7.2
"13259",13,259,1994,2358,2192,166,7
"13259",13,259,1995,2377,2242,135,5.7
"13259",13,259,1996,2454,2318,136,5.5
"13259",13,259,1997,2629,2459,170,6.5
"13259",13,259,1998,2595,2421,174,6.7
"13259",13,259,1999,2367,2226,141,6
"13259",13,259,2000,2086,1971,115,5.5
"13259",13,259,2001,1972,1828,144,7.3
"13259",13,259,2002,1966,1844,122,6.2
"13259",13,259,2003,2050,1901,149,7.3
"13259",13,259,2004,1897,1696,201,10.6
"13259",13,259,2005,1951,1770,181,9.3
"13259",13,259,2006,1979,1848,131,6.6
"13259",13,259,2007,2272,2129,143,6.3
"13259",13,259,2008,2322,2141,181,7.8
"13259",13,259,2009,2317,2071,246,10.6
"13259",13,259,2010,2402,2154,248,10.3
"13259",13,259,2011,2337,2108,229,9.8
"13259",13,259,2012,2320,2105,215,9.3
"13259",13,259,2013,2287,2087,200,8.7
"13259",13,259,2014,2188,2024,164,7.5
"13259",13,259,2015,2114,1968,146,6.9
"13259",13,259,2016,2139,2003,136,6.4
"13259",13,259,2017,2266,2133,133,5.9
"13261",13,261,1990,13681,12458,1223,8.9
"13261",13,261,1991,13429,12507,922,6.9
"13261",13,261,1992,13930,12562,1368,9.8
"13261",13,261,1993,14046,12928,1118,8
"13261",13,261,1994,14210,13260,950,6.7
"13261",13,261,1995,15389,14631,758,4.9
"13261",13,261,1996,15519,14539,980,6.3
"13261",13,261,1997,15867,14343,1524,9.6
"13261",13,261,1998,15669,14410,1259,8
"13261",13,261,1999,15638,14679,959,6.1
"13261",13,261,2000,15318,14677,641,4.2
"13261",13,261,2001,14835,13993,842,5.7
"13261",13,261,2002,14675,13769,906,6.2
"13261",13,261,2003,14747,13927,820,5.6
"13261",13,261,2004,14486,13640,846,5.8
"13261",13,261,2005,14368,13381,987,6.9
"13261",13,261,2006,14752,13844,908,6.2
"13261",13,261,2007,14796,13748,1048,7.1
"13261",13,261,2008,14741,13612,1129,7.7
"13261",13,261,2009,14387,12520,1867,13
"13261",13,261,2010,14262,12370,1892,13.3
"13261",13,261,2011,13933,12183,1750,12.6
"13261",13,261,2012,13960,12300,1660,11.9
"13261",13,261,2013,13416,11905,1511,11.3
"13261",13,261,2014,13434,12165,1269,9.4
"13261",13,261,2015,12832,11766,1066,8.3
"13261",13,261,2016,12859,11888,971,7.6
"13261",13,261,2017,12941,12043,898,6.9
"13263",13,263,1990,2867,2668,199,6.9
"13263",13,263,1991,2699,2540,159,5.9
"13263",13,263,1992,2642,2398,244,9.2
"13263",13,263,1993,2487,2281,206,8.3
"13263",13,263,1994,2585,2407,178,6.9
"13263",13,263,1995,2548,2316,232,9.1
"13263",13,263,1996,2646,2398,248,9.4
"13263",13,263,1997,2697,2519,178,6.6
"13263",13,263,1998,2790,2652,138,4.9
"13263",13,263,1999,2885,2701,184,6.4
"13263",13,263,2000,2849,2692,157,5.5
"13263",13,263,2001,2821,2644,177,6.3
"13263",13,263,2002,2890,2726,164,5.7
"13263",13,263,2003,2958,2784,174,5.9
"13263",13,263,2004,2984,2799,185,6.2
"13263",13,263,2005,2973,2762,211,7.1
"13263",13,263,2006,3078,2885,193,6.3
"13263",13,263,2007,3160,2958,202,6.4
"13263",13,263,2008,3192,2982,210,6.6
"13263",13,263,2009,3125,2830,295,9.4
"13263",13,263,2010,2875,2585,290,10.1
"13263",13,263,2011,2918,2611,307,10.5
"13263",13,263,2012,2922,2628,294,10.1
"13263",13,263,2013,2861,2596,265,9.3
"13263",13,263,2014,2805,2586,219,7.8
"13263",13,263,2015,2696,2488,208,7.7
"13263",13,263,2016,2747,2564,183,6.7
"13263",13,263,2017,2797,2625,172,6.1
"13265",13,265,1990,752,712,40,5.3
"13265",13,265,1991,780,740,40,5.1
"13265",13,265,1992,720,658,62,8.6
"13265",13,265,1993,702,651,51,7.3
"13265",13,265,1994,627,593,34,5.4
"13265",13,265,1995,568,526,42,7.4
"13265",13,265,1996,663,602,61,9.2
"13265",13,265,1997,689,632,57,8.3
"13265",13,265,1998,694,644,50,7.2
"13265",13,265,1999,769,726,43,5.6
"13265",13,265,2000,848,804,44,5.2
"13265",13,265,2001,800,728,72,9
"13265",13,265,2002,786,696,90,11.5
"13265",13,265,2003,762,704,58,7.6
"13265",13,265,2004,716,670,46,6.4
"13265",13,265,2005,712,659,53,7.4
"13265",13,265,2006,783,728,55,7
"13265",13,265,2007,848,781,67,7.9
"13265",13,265,2008,848,779,69,8.1
"13265",13,265,2009,833,712,121,14.5
"13265",13,265,2010,634,520,114,18
"13265",13,265,2011,618,521,97,15.7
"13265",13,265,2012,607,521,86,14.2
"13265",13,265,2013,590,520,70,11.9
"13265",13,265,2014,592,528,64,10.8
"13265",13,265,2015,593,547,46,7.8
"13265",13,265,2016,549,511,38,6.9
"13265",13,265,2017,572,533,39,6.8
"13267",13,267,1990,6847,6511,336,4.9
"13267",13,267,1991,6845,6577,268,3.9
"13267",13,267,1992,6913,6437,476,6.9
"13267",13,267,1993,6788,6278,510,7.5
"13267",13,267,1994,6901,6431,470,6.8
"13267",13,267,1995,7026,6676,350,5
"13267",13,267,1996,7232,6861,371,5.1
"13267",13,267,1997,7330,6975,355,4.8
"13267",13,267,1998,7123,6739,384,5.4
"13267",13,267,1999,7428,6999,429,5.8
"13267",13,267,2000,8848,8331,517,5.8
"13267",13,267,2001,8468,8039,429,5.1
"13267",13,267,2002,8468,8012,456,5.4
"13267",13,267,2003,8549,8124,425,5
"13267",13,267,2004,8525,8067,458,5.4
"13267",13,267,2005,8832,8269,563,6.4
"13267",13,267,2006,9075,8592,483,5.3
"13267",13,267,2007,9144,8708,436,4.8
"13267",13,267,2008,9279,8665,614,6.6
"13267",13,267,2009,9356,8513,843,9
"13267",13,267,2010,9678,8802,876,9.1
"13267",13,267,2011,9874,9005,869,8.8
"13267",13,267,2012,9814,8997,817,8.3
"13267",13,267,2013,9561,8801,760,7.9
"13267",13,267,2014,9521,8862,659,6.9
"13267",13,267,2015,9277,8705,572,6.2
"13267",13,267,2016,9342,8843,499,5.3
"13267",13,267,2017,9626,9147,479,5
"13269",13,269,1990,3187,2901,286,9
"13269",13,269,1991,3134,2894,240,7.7
"13269",13,269,1992,3389,3102,287,8.5
"13269",13,269,1993,3378,3030,348,10.3
"13269",13,269,1994,3342,3062,280,8.4
"13269",13,269,1995,3386,3124,262,7.7
"13269",13,269,1996,3359,3045,314,9.3
"13269",13,269,1997,3452,3189,263,7.6
"13269",13,269,1998,3601,3385,216,6
"13269",13,269,1999,3938,3695,243,6.2
"13269",13,269,2000,3407,3225,182,5.3
"13269",13,269,2001,3304,3104,200,6.1
"13269",13,269,2002,3305,3108,197,6
"13269",13,269,2003,3303,3104,199,6
"13269",13,269,2004,3202,2987,215,6.7
"13269",13,269,2005,3233,2981,252,7.8
"13269",13,269,2006,3337,3127,210,6.3
"13269",13,269,2007,3333,3137,196,5.9
"13269",13,269,2008,3447,3190,257,7.5
"13269",13,269,2009,3550,3128,422,11.9
"13269",13,269,2010,3255,2784,471,14.5
"13269",13,269,2011,3179,2720,459,14.4
"13269",13,269,2012,3116,2699,417,13.4
"13269",13,269,2013,3173,2803,370,11.7
"13269",13,269,2014,2846,2556,290,10.2
"13269",13,269,2015,2773,2519,254,9.2
"13269",13,269,2016,3326,3078,248,7.5
"13269",13,269,2017,2844,2595,249,8.8
"13271",13,271,1990,4726,4323,403,8.5
"13271",13,271,1991,4522,4269,253,5.6
"13271",13,271,1992,4921,4425,496,10.1
"13271",13,271,1993,4896,4472,424,8.7
"13271",13,271,1994,4840,4359,481,9.9
"13271",13,271,1995,4835,4341,494,10.2
"13271",13,271,1996,4745,4144,601,12.7
"13271",13,271,1997,4883,4418,465,9.5
"13271",13,271,1998,4966,4496,470,9.5
"13271",13,271,1999,5003,4404,599,12
"13271",13,271,2000,4427,4081,346,7.8
"13271",13,271,2001,4037,3570,467,11.6
"13271",13,271,2002,4004,3591,413,10.3
"13271",13,271,2003,4149,3795,354,8.5
"13271",13,271,2004,4139,3827,312,7.5
"13271",13,271,2005,4594,4246,348,7.6
"13271",13,271,2006,5041,4658,383,7.6
"13271",13,271,2007,4998,4612,386,7.7
"13271",13,271,2008,4713,4207,506,10.7
"13271",13,271,2009,4616,3973,643,13.9
"13271",13,271,2010,5234,4462,772,14.7
"13271",13,271,2011,5282,4583,699,13.2
"13271",13,271,2012,5344,4715,629,11.8
"13271",13,271,2013,5295,4691,604,11.4
"13271",13,271,2014,5248,4738,510,9.7
"13271",13,271,2015,4825,4405,420,8.7
"13271",13,271,2016,4817,4415,402,8.3
"13271",13,271,2017,4800,4424,376,7.8
"13273",13,273,1990,4575,4191,384,8.4
"13273",13,273,1991,4581,4289,292,6.4
"13273",13,273,1992,4798,4343,455,9.5
"13273",13,273,1993,4641,4194,447,9.6
"13273",13,273,1994,4600,4077,523,11.4
"13273",13,273,1995,4267,3600,667,15.6
"13273",13,273,1996,4076,3540,536,13.2
"13273",13,273,1997,4066,3568,498,12.2
"13273",13,273,1998,4025,3494,531,13.2
"13273",13,273,1999,4003,3607,396,9.9
"13273",13,273,2000,4654,4406,248,5.3
"13273",13,273,2001,4553,4267,286,6.3
"13273",13,273,2002,4554,4219,335,7.4
"13273",13,273,2003,4649,4403,246,5.3
"13273",13,273,2004,4619,4349,270,5.8
"13273",13,273,2005,4586,4271,315,6.9
"13273",13,273,2006,4554,4292,262,5.8
"13273",13,273,2007,4430,4166,264,6
"13273",13,273,2008,4437,4144,293,6.6
"13273",13,273,2009,4442,3982,460,10.4
"13273",13,273,2010,3917,3439,478,12.2
"13273",13,273,2011,3850,3388,462,12
"13273",13,273,2012,3755,3345,410,10.9
"13273",13,273,2013,3665,3307,358,9.8
"13273",13,273,2014,3618,3329,289,8
"13273",13,273,2015,3632,3361,271,7.5
"13273",13,273,2016,3660,3423,237,6.5
"13273",13,273,2017,3759,3534,225,6
"13275",13,275,1990,18114,17209,905,5
"13275",13,275,1991,17907,17086,821,4.6
"13275",13,275,1992,18302,16973,1329,7.3
"13275",13,275,1993,18863,17785,1078,5.7
"13275",13,275,1994,19325,18471,854,4.4
"13275",13,275,1995,19959,19146,813,4.1
"13275",13,275,1996,20745,19853,892,4.3
"13275",13,275,1997,21288,20308,980,4.6
"13275",13,275,1998,21322,20319,1003,4.7
"13275",13,275,1999,22226,21077,1149,5.2
"13275",13,275,2000,19832,18989,843,4.3
"13275",13,275,2001,20296,19443,853,4.2
"13275",13,275,2002,20947,19998,949,4.5
"13275",13,275,2003,21218,20298,920,4.3
"13275",13,275,2004,21275,20319,956,4.5
"13275",13,275,2005,22905,21875,1030,4.5
"13275",13,275,2006,23513,22549,964,4.1
"13275",13,275,2007,22989,22047,942,4.1
"13275",13,275,2008,22221,20937,1284,5.8
"13275",13,275,2009,21412,19442,1970,9.2
"13275",13,275,2010,17884,15874,2010,11.2
"13275",13,275,2011,18338,16437,1901,10.4
"13275",13,275,2012,18487,16696,1791,9.7
"13275",13,275,2013,17803,16198,1605,9
"13275",13,275,2014,17145,15651,1494,8.7
"13275",13,275,2015,16815,15600,1215,7.2
"13275",13,275,2016,17551,16459,1092,6.2
"13275",13,275,2017,17273,16255,1018,5.9
"13277",13,277,1990,17612,16324,1288,7.3
"13277",13,277,1991,17514,16518,996,5.7
"13277",13,277,1992,17947,16610,1337,7.4
"13277",13,277,1993,18832,17393,1439,7.6
"13277",13,277,1994,18871,17732,1139,6
"13277",13,277,1995,19412,18303,1109,5.7
"13277",13,277,1996,20442,19309,1133,5.5
"13277",13,277,1997,21439,20203,1236,5.8
"13277",13,277,1998,21335,20118,1217,5.7
"13277",13,277,1999,20988,19959,1029,4.9
"13277",13,277,2000,18903,18114,789,4.2
"13277",13,277,2001,18649,17798,851,4.6
"13277",13,277,2002,18744,17901,843,4.5
"13277",13,277,2003,19057,18223,834,4.4
"13277",13,277,2004,19022,18174,848,4.5
"13277",13,277,2005,19683,18660,1023,5.2
"13277",13,277,2006,19957,18946,1011,5.1
"13277",13,277,2007,19128,18121,1007,5.3
"13277",13,277,2008,19076,17720,1356,7.1
"13277",13,277,2009,18876,16808,2068,11
"13277",13,277,2010,18784,16537,2247,12
"13277",13,277,2011,18942,16652,2290,12.1
"13277",13,277,2012,19159,17226,1933,10.1
"13277",13,277,2013,18694,17106,1588,8.5
"13277",13,277,2014,18250,16925,1325,7.3
"13277",13,277,2015,18347,17227,1120,6.1
"13277",13,277,2016,18573,17576,997,5.4
"13277",13,277,2017,19253,18339,914,4.7
"13279",13,279,1990,10781,10080,701,6.5
"13279",13,279,1991,10807,10110,697,6.4
"13279",13,279,1992,11248,10161,1087,9.7
"13279",13,279,1993,11032,10038,994,9
"13279",13,279,1994,11541,10628,913,7.9
"13279",13,279,1995,12123,11321,802,6.6
"13279",13,279,1996,12338,11275,1063,8.6
"13279",13,279,1997,12653,11409,1244,9.8
"13279",13,279,1998,12582,11422,1160,9.2
"13279",13,279,1999,12835,11561,1274,9.9
"13279",13,279,2000,12239,11428,811,6.6
"13279",13,279,2001,11692,10939,753,6.4
"13279",13,279,2002,11563,10716,847,7.3
"13279",13,279,2003,12262,11512,750,6.1
"13279",13,279,2004,12419,11685,734,5.9
"13279",13,279,2005,12843,12030,813,6.3
"13279",13,279,2006,13478,12774,704,5.2
"13279",13,279,2007,13864,13209,655,4.7
"13279",13,279,2008,14049,13043,1006,7.2
"13279",13,279,2009,13911,12535,1376,9.9
"13279",13,279,2010,12303,10792,1511,12.3
"13279",13,279,2011,12433,10766,1667,13.4
"13279",13,279,2012,12517,11045,1472,11.8
"13279",13,279,2013,12790,11383,1407,11
"13279",13,279,2014,12233,11031,1202,9.8
"13279",13,279,2015,11864,10829,1035,8.7
"13279",13,279,2016,11798,10879,919,7.8
"13279",13,279,2017,12005,11223,782,6.5
"13281",13,281,1990,2822,2640,182,6.4
"13281",13,281,1991,2601,2463,138,5.3
"13281",13,281,1992,2629,2441,188,7.2
"13281",13,281,1993,2762,2534,228,8.3
"13281",13,281,1994,3010,2860,150,5
"13281",13,281,1995,3185,3055,130,4.1
"13281",13,281,1996,3523,3318,205,5.8
"13281",13,281,1997,3837,3451,386,10.1
"13281",13,281,1998,3910,3717,193,4.9
"13281",13,281,1999,4036,3873,163,4
"13281",13,281,2000,4249,4064,185,4.4
"13281",13,281,2001,4424,4258,166,3.8
"13281",13,281,2002,4734,4549,185,3.9
"13281",13,281,2003,5126,4938,188,3.7
"13281",13,281,2004,5347,5154,193,3.6
"13281",13,281,2005,5667,5445,222,3.9
"13281",13,281,2006,5930,5728,202,3.4
"13281",13,281,2007,6025,5803,222,3.7
"13281",13,281,2008,5831,5485,346,5.9
"13281",13,281,2009,5740,5241,499,8.7
"13281",13,281,2010,4341,3783,558,12.9
"13281",13,281,2011,4357,3811,546,12.5
"13281",13,281,2012,4440,3939,501,11.3
"13281",13,281,2013,4159,3719,440,10.6
"13281",13,281,2014,4138,3759,379,9.2
"13281",13,281,2015,3915,3607,308,7.9
"13281",13,281,2016,4112,3833,279,6.8
"13281",13,281,2017,3839,3588,251,6.5
"13283",13,283,1990,2667,2464,203,7.6
"13283",13,283,1991,2648,2463,185,7
"13283",13,283,1992,2757,2418,339,12.3
"13283",13,283,1993,2616,2369,247,9.4
"13283",13,283,1994,2745,2506,239,8.7
"13283",13,283,1995,2988,2644,344,11.5
"13283",13,283,1996,2810,2571,239,8.5
"13283",13,283,1997,2882,2611,271,9.4
"13283",13,283,1998,2850,2596,254,8.9
"13283",13,283,1999,2972,2596,376,12.7
"13283",13,283,2000,2634,2426,208,7.9
"13283",13,283,2001,2600,2426,174,6.7
"13283",13,283,2002,2601,2404,197,7.6
"13283",13,283,2003,2653,2470,183,6.9
"13283",13,283,2004,2677,2510,167,6.2
"13283",13,283,2005,2713,2510,203,7.5
"13283",13,283,2006,2690,2525,165,6.1
"13283",13,283,2007,2714,2557,157,5.8
"13283",13,283,2008,2891,2645,246,8.5
"13283",13,283,2009,2927,2592,335,11.4
"13283",13,283,2010,2945,2589,356,12.1
"13283",13,283,2011,2989,2592,397,13.3
"13283",13,283,2012,2905,2514,391,13.5
"13283",13,283,2013,2828,2480,348,12.3
"13283",13,283,2014,2794,2499,295,10.6
"13283",13,283,2015,2701,2472,229,8.5
"13283",13,283,2016,2744,2534,210,7.7
"13283",13,283,2017,2752,2569,183,6.6
"13285",13,285,1990,26287,24678,1609,6.1
"13285",13,285,1991,25314,23311,2003,7.9
"13285",13,285,1992,26071,23449,2622,10.1
"13285",13,285,1993,25917,23714,2203,8.5
"13285",13,285,1994,25996,24247,1749,6.7
"13285",13,285,1995,27459,26041,1418,5.2
"13285",13,285,1996,28298,26857,1441,5.1
"13285",13,285,1997,28994,27384,1610,5.6
"13285",13,285,1998,29476,28022,1454,4.9
"13285",13,285,1999,31111,29634,1477,4.7
"13285",13,285,2000,30066,28969,1097,3.6
"13285",13,285,2001,30775,29419,1356,4.4
"13285",13,285,2002,29326,27699,1627,5.5
"13285",13,285,2003,30064,28439,1625,5.4
"13285",13,285,2004,29942,28246,1696,5.7
"13285",13,285,2005,30190,28127,2063,6.8
"13285",13,285,2006,30352,28574,1778,5.9
"13285",13,285,2007,30448,28721,1727,5.7
"13285",13,285,2008,30594,28102,2492,8.1
"13285",13,285,2009,30909,26923,3986,12.9
"13285",13,285,2010,32546,28788,3758,11.5
"13285",13,285,2011,34505,30705,3800,11
"13285",13,285,2012,35610,32110,3500,9.8
"13285",13,285,2013,36163,33048,3115,8.6
"13285",13,285,2014,36096,33458,2638,7.3
"13285",13,285,2015,35599,33437,2162,6.1
"13285",13,285,2016,36878,35004,1874,5.1
"13285",13,285,2017,37665,35996,1669,4.4
"13287",13,287,1990,3533,3255,278,7.9
"13287",13,287,1991,3573,3379,194,5.4
"13287",13,287,1992,3862,3528,334,8.6
"13287",13,287,1993,3954,3647,307,7.8
"13287",13,287,1994,4005,3738,267,6.7
"13287",13,287,1995,4068,3776,292,7.2
"13287",13,287,1996,4230,3917,313,7.4
"13287",13,287,1997,4551,4046,505,11.1
"13287",13,287,1998,4475,3926,549,12.3
"13287",13,287,1999,4357,3917,440,10.1
"13287",13,287,2000,4366,4121,245,5.6
"13287",13,287,2001,4871,4566,305,6.3
"13287",13,287,2002,4713,4399,314,6.7
"13287",13,287,2003,4889,4578,311,6.4
"13287",13,287,2004,5061,4788,273,5.4
"13287",13,287,2005,4937,4610,327,6.6
"13287",13,287,2006,5096,4803,293,5.7
"13287",13,287,2007,4942,4615,327,6.6
"13287",13,287,2008,4800,4411,389,8.1
"13287",13,287,2009,4626,3975,651,14.1
"13287",13,287,2010,3530,2944,586,16.6
"13287",13,287,2011,3598,3084,514,14.3
"13287",13,287,2012,3460,3055,405,11.7
"13287",13,287,2013,3336,3003,333,10
"13287",13,287,2014,3257,2999,258,7.9
"13287",13,287,2015,3192,2976,216,6.8
"13287",13,287,2016,3239,3030,209,6.5
"13287",13,287,2017,3305,3116,189,5.7
"13289",13,289,1990,4023,3779,244,6.1
"13289",13,289,1991,3890,3675,215,5.5
"13289",13,289,1992,3900,3632,268,6.9
"13289",13,289,1993,3879,3639,240,6.2
"13289",13,289,1994,4036,3746,290,7.2
"13289",13,289,1995,4076,3849,227,5.6
"13289",13,289,1996,4131,3877,254,6.1
"13289",13,289,1997,4162,3943,219,5.3
"13289",13,289,1998,4351,4033,318,7.3
"13289",13,289,1999,4160,3878,282,6.8
"13289",13,289,2000,4597,4392,205,4.5
"13289",13,289,2001,4573,4326,247,5.4
"13289",13,289,2002,4606,4317,289,6.3
"13289",13,289,2003,4676,4429,247,5.3
"13289",13,289,2004,4664,4413,251,5.4
"13289",13,289,2005,4648,4328,320,6.9
"13289",13,289,2006,4578,4313,265,5.8
"13289",13,289,2007,4668,4406,262,5.6
"13289",13,289,2008,4766,4436,330,6.9
"13289",13,289,2009,4654,4139,515,11.1
"13289",13,289,2010,3265,2760,505,15.5
"13289",13,289,2011,3255,2751,504,15.5
"13289",13,289,2012,3174,2702,472,14.9
"13289",13,289,2013,3122,2693,429,13.7
"13289",13,289,2014,2996,2664,332,11.1
"13289",13,289,2015,2965,2695,270,9.1
"13289",13,289,2016,2952,2696,256,8.7
"13289",13,289,2017,2973,2747,226,7.6
"13291",13,291,1990,5169,4934,235,4.5
"13291",13,291,1991,5503,5258,245,4.5
"13291",13,291,1992,5966,5566,400,6.7
"13291",13,291,1993,6065,5682,383,6.3
"13291",13,291,1994,6234,5966,268,4.3
"13291",13,291,1995,6365,6117,248,3.9
"13291",13,291,1996,6918,6509,409,5.9
"13291",13,291,1997,7241,6813,428,5.9
"13291",13,291,1998,7329,7030,299,4.1
"13291",13,291,1999,7774,7514,260,3.3
"13291",13,291,2000,8098,7775,323,4
"13291",13,291,2001,8327,8021,306,3.7
"13291",13,291,2002,8987,8587,400,4.5
"13291",13,291,2003,9478,9076,402,4.2
"13291",13,291,2004,9816,9412,404,4.1
"13291",13,291,2005,10196,9760,436,4.3
"13291",13,291,2006,10744,10346,398,3.7
"13291",13,291,2007,11442,11029,413,3.6
"13291",13,291,2008,11173,10521,652,5.8
"13291",13,291,2009,10984,9944,1040,9.5
"13291",13,291,2010,9502,8456,1046,11
"13291",13,291,2011,9480,8517,963,10.2
"13291",13,291,2012,9661,8807,854,8.8
"13291",13,291,2013,9329,8593,736,7.9
"13291",13,291,2014,9515,8891,624,6.6
"13291",13,291,2015,9832,9307,525,5.3
"13291",13,291,2016,10461,9967,494,4.7
"13291",13,291,2017,10188,9732,456,4.5
"13293",13,293,1990,12365,11669,696,5.6
"13293",13,293,1991,12282,11630,652,5.3
"13293",13,293,1992,12732,12018,714,5.6
"13293",13,293,1993,12872,12110,762,5.9
"13293",13,293,1994,12753,12081,672,5.3
"13293",13,293,1995,12960,12369,591,4.6
"13293",13,293,1996,13089,12304,785,6
"13293",13,293,1997,13040,12467,573,4.4
"13293",13,293,1998,13379,12898,481,3.6
"13293",13,293,1999,13158,12196,962,7.3
"13293",13,293,2000,12798,12143,655,5.1
"13293",13,293,2001,12264,11218,1046,8.5
"13293",13,293,2002,11686,10625,1061,9.1
"13293",13,293,2003,11530,10802,728,6.3
"13293",13,293,2004,11715,11009,706,6
"13293",13,293,2005,12048,11233,815,6.8
"13293",13,293,2006,11794,11052,742,6.3
"13293",13,293,2007,12011,11244,767,6.4
"13293",13,293,2008,12032,11037,995,8.3
"13293",13,293,2009,11912,10371,1541,12.9
"13293",13,293,2010,11932,10471,1461,12.2
"13293",13,293,2011,12013,10621,1392,11.6
"13293",13,293,2012,11994,10713,1281,10.7
"13293",13,293,2013,11923,10752,1171,9.8
"13293",13,293,2014,11303,10302,1001,8.9
"13293",13,293,2015,11130,10324,806,7.2
"13293",13,293,2016,11154,10437,717,6.4
"13293",13,293,2017,11295,10669,626,5.5
"13295",13,295,1990,28422,26617,1805,6.4
"13295",13,295,1991,28693,26863,1830,6.4
"13295",13,295,1992,29595,27114,2481,8.4
"13295",13,295,1993,29501,27700,1801,6.1
"13295",13,295,1994,29753,28077,1676,5.6
"13295",13,295,1995,29951,28248,1703,5.7
"13295",13,295,1996,30345,28771,1574,5.2
"13295",13,295,1997,31059,29327,1732,5.6
"13295",13,295,1998,31442,29973,1469,4.7
"13295",13,295,1999,32117,30851,1266,3.9
"13295",13,295,2000,30410,29323,1087,3.6
"13295",13,295,2001,30714,29399,1315,4.3
"13295",13,295,2002,31174,29790,1384,4.4
"13295",13,295,2003,31834,30471,1363,4.3
"13295",13,295,2004,32248,30876,1372,4.3
"13295",13,295,2005,32829,31201,1628,5
"13295",13,295,2006,33701,32197,1504,4.5
"13295",13,295,2007,33084,31617,1467,4.4
"13295",13,295,2008,33436,31232,2204,6.6
"13295",13,295,2009,32199,28683,3516,10.9
"13295",13,295,2010,30980,27788,3192,10.3
"13295",13,295,2011,31064,28025,3039,9.8
"13295",13,295,2012,30923,28145,2778,9
"13295",13,295,2013,30158,27725,2433,8.1
"13295",13,295,2014,29396,27285,2111,7.2
"13295",13,295,2015,29400,27646,1754,6
"13295",13,295,2016,29969,28303,1666,5.6
"13295",13,295,2017,30728,29326,1402,4.6
"13297",13,297,1990,19504,18179,1325,6.8
"13297",13,297,1991,19266,18244,1022,5.3
"13297",13,297,1992,20034,18514,1520,7.6
"13297",13,297,1993,21000,19661,1339,6.4
"13297",13,297,1994,22055,21095,960,4.4
"13297",13,297,1995,23308,22213,1095,4.7
"13297",13,297,1996,24883,23853,1030,4.1
"13297",13,297,1997,26549,25355,1194,4.5
"13297",13,297,1998,28192,27266,926,3.3
"13297",13,297,1999,30278,29296,982,3.2
"13297",13,297,2000,32489,31464,1025,3.2
"13297",13,297,2001,33417,32213,1204,3.6
"13297",13,297,2002,34070,32581,1489,4.4
"13297",13,297,2003,34653,33168,1485,4.3
"13297",13,297,2004,35609,34023,1586,4.5
"13297",13,297,2005,37577,35765,1812,4.8
"13297",13,297,2006,39051,37273,1778,4.6
"13297",13,297,2007,41084,39207,1877,4.6
"13297",13,297,2008,42256,39554,2702,6.4
"13297",13,297,2009,41476,37166,4310,10.4
"13297",13,297,2010,41037,36667,4370,10.6
"13297",13,297,2011,41220,36929,4291,10.4
"13297",13,297,2012,41141,37400,3741,9.1
"13297",13,297,2013,41052,37860,3192,7.8
"13297",13,297,2014,41409,38753,2656,6.4
"13297",13,297,2015,41677,39424,2253,5.4
"13297",13,297,2016,43431,41302,2129,4.9
"13297",13,297,2017,44747,42813,1934,4.3
"13299",13,299,1990,14764,13861,903,6.1
"13299",13,299,1991,14625,13778,847,5.8
"13299",13,299,1992,14879,13746,1133,7.6
"13299",13,299,1993,15100,14063,1037,6.9
"13299",13,299,1994,15463,14590,873,5.6
"13299",13,299,1995,15417,14521,896,5.8
"13299",13,299,1996,15534,14684,850,5.5
"13299",13,299,1997,15920,15087,833,5.2
"13299",13,299,1998,16146,15387,759,4.7
"13299",13,299,1999,15641,14823,818,5.2
"13299",13,299,2000,15209,14436,773,5.1
"13299",13,299,2001,14811,14016,795,5.4
"13299",13,299,2002,14747,13946,801,5.4
"13299",13,299,2003,15222,14435,787,5.2
"13299",13,299,2004,14639,13861,778,5.3
"13299",13,299,2005,14780,13956,824,5.6
"13299",13,299,2006,15072,14321,751,5
"13299",13,299,2007,15148,14411,737,4.9
"13299",13,299,2008,15255,14249,1006,6.6
"13299",13,299,2009,14894,13276,1618,10.9
"13299",13,299,2010,15561,13847,1714,11
"13299",13,299,2011,15280,13556,1724,11.3
"13299",13,299,2012,15485,13915,1570,10.1
"13299",13,299,2013,15098,13685,1413,9.4
"13299",13,299,2014,14756,13594,1162,7.9
"13299",13,299,2015,14488,13546,942,6.5
"13299",13,299,2016,15501,14666,835,5.4
"13299",13,299,2017,15972,15243,729,4.6
"13301",13,301,1990,2564,2346,218,8.5
"13301",13,301,1991,2437,2165,272,11.2
"13301",13,301,1992,2620,2364,256,9.8
"13301",13,301,1993,2483,2274,209,8.4
"13301",13,301,1994,2433,2248,185,7.6
"13301",13,301,1995,2558,2387,171,6.7
"13301",13,301,1996,2816,2536,280,9.9
"13301",13,301,1997,2772,2431,341,12.3
"13301",13,301,1998,2983,2490,493,16.5
"13301",13,301,1999,2697,2416,281,10.4
"13301",13,301,2000,2641,2494,147,5.6
"13301",13,301,2001,2622,2404,218,8.3
"13301",13,301,2002,2554,2281,273,10.7
"13301",13,301,2003,2519,2269,250,9.9
"13301",13,301,2004,2566,2387,179,7
"13301",13,301,2005,2608,2341,267,10.2
"13301",13,301,2006,2466,2262,204,8.3
"13301",13,301,2007,2455,2271,184,7.5
"13301",13,301,2008,2490,2235,255,10.2
"13301",13,301,2009,2623,2149,474,18.1
"13301",13,301,2010,2657,2200,457,17.2
"13301",13,301,2011,2648,2209,439,16.6
"13301",13,301,2012,2653,2256,397,15
"13301",13,301,2013,2728,2400,328,12
"13301",13,301,2014,2714,2452,262,9.7
"13301",13,301,2015,2640,2434,206,7.8
"13301",13,301,2016,2702,2515,187,6.9
"13301",13,301,2017,2725,2563,162,5.9
"13303",13,303,1990,8493,7995,498,5.9
"13303",13,303,1991,8328,7896,432,5.2
"13303",13,303,1992,8824,8337,487,5.5
"13303",13,303,1993,8950,8536,414,4.6
"13303",13,303,1994,9199,8845,354,3.8
"13303",13,303,1995,9362,8851,511,5.5
"13303",13,303,1996,9505,8930,575,6
"13303",13,303,1997,9964,9080,884,8.9
"13303",13,303,1998,9871,9031,840,8.5
"13303",13,303,1999,9882,9152,730,7.4
"13303",13,303,2000,8567,8157,410,4.8
"13303",13,303,2001,8266,7840,426,5.2
"13303",13,303,2002,8274,7789,485,5.9
"13303",13,303,2003,8316,7815,501,6
"13303",13,303,2004,8211,7761,450,5.5
"13303",13,303,2005,8294,7743,551,6.6
"13303",13,303,2006,8430,7935,495,5.9
"13303",13,303,2007,8333,7863,470,5.6
"13303",13,303,2008,8224,7577,647,7.9
"13303",13,303,2009,7917,6831,1086,13.7
"13303",13,303,2010,8124,6943,1181,14.5
"13303",13,303,2011,8116,7082,1034,12.7
"13303",13,303,2012,8083,7247,836,10.3
"13303",13,303,2013,7688,6947,741,9.6
"13303",13,303,2014,7552,6943,609,8.1
"13303",13,303,2015,7198,6695,503,7
"13303",13,303,2016,7191,6737,454,6.3
"13303",13,303,2017,7373,6930,443,6
"13305",13,305,1990,10314,9639,675,6.5
"13305",13,305,1991,10825,10140,685,6.3
"13305",13,305,1992,11184,10022,1162,10.4
"13305",13,305,1993,11196,10090,1106,9.9
"13305",13,305,1994,10946,9961,985,9
"13305",13,305,1995,10939,10162,777,7.1
"13305",13,305,1996,10749,9958,791,7.4
"13305",13,305,1997,11157,10347,810,7.3
"13305",13,305,1998,11472,10627,845,7.4
"13305",13,305,1999,11926,11168,758,6.4
"13305",13,305,2000,11350,10783,567,5
"13305",13,305,2001,10923,10360,563,5.2
"13305",13,305,2002,11093,10482,611,5.5
"13305",13,305,2003,11347,10754,593,5.2
"13305",13,305,2004,11505,10852,653,5.7
"13305",13,305,2005,11789,11058,731,6.2
"13305",13,305,2006,11845,11170,675,5.7
"13305",13,305,2007,12072,11420,652,5.4
"13305",13,305,2008,12251,11309,942,7.7
"13305",13,305,2009,12050,10633,1417,11.8
"13305",13,305,2010,12377,10886,1491,12
"13305",13,305,2011,12504,10985,1519,12.1
"13305",13,305,2012,12611,11262,1349,10.7
"13305",13,305,2013,12292,11091,1201,9.8
"13305",13,305,2014,11830,10799,1031,8.7
"13305",13,305,2015,11568,10731,837,7.2
"13305",13,305,2016,11308,10535,773,6.8
"13305",13,305,2017,11371,10714,657,5.8
"13307",13,307,1990,1064,978,86,8.1
"13307",13,307,1991,1025,954,71,6.9
"13307",13,307,1992,1103,1019,84,7.6
"13307",13,307,1993,1119,1062,57,5.1
"13307",13,307,1994,1093,1030,63,5.8
"13307",13,307,1995,1089,1044,45,4.1
"13307",13,307,1996,1106,1048,58,5.2
"13307",13,307,1997,1185,1116,69,5.8
"13307",13,307,1998,1141,1089,52,4.6
"13307",13,307,1999,1172,1111,61,5.2
"13307",13,307,2000,1069,1028,41,3.8
"13307",13,307,2001,1015,964,51,5
"13307",13,307,2002,1003,953,50,5
"13307",13,307,2003,1061,1006,55,5.2
"13307",13,307,2004,1040,965,75,7.2
"13307",13,307,2005,1120,1048,72,6.4
"13307",13,307,2006,1187,1134,53,4.5
"13307",13,307,2007,1246,1190,56,4.5
"13307",13,307,2008,1307,1239,68,5.2
"13307",13,307,2009,1193,1074,119,10
"13307",13,307,2010,1043,909,134,12.8
"13307",13,307,2011,1067,945,122,11.4
"13307",13,307,2012,1061,956,105,9.9
"13307",13,307,2013,1036,940,96,9.3
"13307",13,307,2014,1016,928,88,8.7
"13307",13,307,2015,968,877,91,9.4
"13307",13,307,2016,967,884,83,8.6
"13307",13,307,2017,988,913,75,7.6
"13309",13,309,1990,2045,1896,149,7.3
"13309",13,309,1991,1972,1860,112,5.7
"13309",13,309,1992,1988,1808,180,9.1
"13309",13,309,1993,2037,1900,137,6.7
"13309",13,309,1994,1950,1776,174,8.9
"13309",13,309,1995,1955,1764,191,9.8
"13309",13,309,1996,1973,1718,255,12.9
"13309",13,309,1997,2078,1871,207,10
"13309",13,309,1998,2075,1871,204,9.8
"13309",13,309,1999,2079,1841,238,11.4
"13309",13,309,2000,2306,2161,145,6.3
"13309",13,309,2001,2266,2099,167,7.4
"13309",13,309,2002,2390,2232,158,6.6
"13309",13,309,2003,2381,2234,147,6.2
"13309",13,309,2004,2409,2265,144,6
"13309",13,309,2005,2575,2410,165,6.4
"13309",13,309,2006,3080,2909,171,5.6
"13309",13,309,2007,2965,2813,152,5.1
"13309",13,309,2008,2932,2725,207,7.1
"13309",13,309,2009,2930,2648,282,9.6
"13309",13,309,2010,1937,1644,293,15.1
"13309",13,309,2011,1981,1690,291,14.7
"13309",13,309,2012,1958,1697,261,13.3
"13309",13,309,2013,1894,1656,238,12.6
"13309",13,309,2014,1865,1636,229,12.3
"13309",13,309,2015,1694,1510,184,10.9
"13309",13,309,2016,1736,1580,156,9
"13309",13,309,2017,1758,1601,157,8.9
"13311",13,311,1990,6831,6510,321,4.7
"13311",13,311,1991,7078,6704,374,5.3
"13311",13,311,1992,7867,7429,438,5.6
"13311",13,311,1993,8109,7750,359,4.4
"13311",13,311,1994,8445,8084,361,4.3
"13311",13,311,1995,8849,8572,277,3.1
"13311",13,311,1996,9352,9026,326,3.5
"13311",13,311,1997,9550,9144,406,4.3
"13311",13,311,1998,9217,8853,364,3.9
"13311",13,311,1999,9393,8969,424,4.5
"13311",13,311,2000,10819,10434,385,3.6
"13311",13,311,2001,10890,10497,393,3.6
"13311",13,311,2002,11085,10629,456,4.1
"13311",13,311,2003,11403,10968,435,3.8
"13311",13,311,2004,11516,11048,468,4.1
"13311",13,311,2005,12000,11463,537,4.5
"13311",13,311,2006,12449,11981,468,3.8
"13311",13,311,2007,12910,12448,462,3.6
"13311",13,311,2008,12672,11977,695,5.5
"13311",13,311,2009,12387,11177,1210,9.8
"13311",13,311,2010,12902,11589,1313,10.2
"13311",13,311,2011,13169,11861,1308,9.9
"13311",13,311,2012,13570,12396,1174,8.7
"13311",13,311,2013,13791,12775,1016,7.4
"13311",13,311,2014,13832,12976,856,6.2
"13311",13,311,2015,13785,13071,714,5.2
"13311",13,311,2016,14498,13828,670,4.6
"13311",13,311,2017,15745,15133,612,3.9
"13313",13,313,1990,39617,37464,2153,5.4
"13313",13,313,1991,39328,37032,2296,5.8
"13313",13,313,1992,41697,39093,2604,6.2
"13313",13,313,1993,42987,40996,1991,4.6
"13313",13,313,1994,44145,42479,1666,3.8
"13313",13,313,1995,44134,42196,1938,4.4
"13313",13,313,1996,45326,43448,1878,4.1
"13313",13,313,1997,47066,45140,1926,4.1
"13313",13,313,1998,47319,45822,1497,3.2
"13313",13,313,1999,46644,45428,1216,2.6
"13313",13,313,2000,43622,42072,1550,3.6
"13313",13,313,2001,43365,41425,1940,4.5
"13313",13,313,2002,44291,42327,1964,4.4
"13313",13,313,2003,44249,42400,1849,4.2
"13313",13,313,2004,44582,42692,1890,4.2
"13313",13,313,2005,45520,43324,2196,4.8
"13313",13,313,2006,46862,44793,2069,4.4
"13313",13,313,2007,47042,44901,2141,4.6
"13313",13,313,2008,46317,42809,3508,7.6
"13313",13,313,2009,44109,38481,5628,12.8
"13313",13,313,2010,47639,41978,5661,11.9
"13313",13,313,2011,47462,41846,5616,11.8
"13313",13,313,2012,45754,40886,4868,10.6
"13313",13,313,2013,44658,40391,4267,9.6
"13313",13,313,2014,44722,41231,3491,7.8
"13313",13,313,2015,45601,42690,2911,6.4
"13313",13,313,2016,44789,42057,2732,6.1
"13313",13,313,2017,45297,42821,2476,5.5
"13315",13,315,1990,2861,2721,140,4.9
"13315",13,315,1991,2830,2687,143,5.1
"13315",13,315,1992,2955,2732,223,7.5
"13315",13,315,1993,3018,2821,197,6.5
"13315",13,315,1994,3094,2941,153,4.9
"13315",13,315,1995,3326,3151,175,5.3
"13315",13,315,1996,3386,3118,268,7.9
"13315",13,315,1997,3577,3194,383,10.7
"13315",13,315,1998,3404,3190,214,6.3
"13315",13,315,1999,3471,3281,190,5.5
"13315",13,315,2000,3251,3096,155,4.8
"13315",13,315,2001,3315,3137,178,5.4
"13315",13,315,2002,3275,3076,199,6.1
"13315",13,315,2003,3286,3074,212,6.5
"13315",13,315,2004,3260,3078,182,5.6
"13315",13,315,2005,3239,3020,219,6.8
"13315",13,315,2006,3284,3088,196,6
"13315",13,315,2007,3302,3109,193,5.8
"13315",13,315,2008,3280,3010,270,8.2
"13315",13,315,2009,3252,2862,390,12
"13315",13,315,2010,2935,2570,365,12.4
"13315",13,315,2011,2933,2558,375,12.8
"13315",13,315,2012,2867,2533,334,11.6
"13315",13,315,2013,2819,2506,313,11.1
"13315",13,315,2014,2841,2582,259,9.1
"13315",13,315,2015,2743,2528,215,7.8
"13315",13,315,2016,2723,2527,196,7.2
"13315",13,315,2017,2742,2579,163,5.9
"13317",13,317,1990,4837,4576,261,5.4
"13317",13,317,1991,4811,4566,245,5.1
"13317",13,317,1992,5160,4871,289,5.6
"13317",13,317,1993,5332,5003,329,6.2
"13317",13,317,1994,5406,5135,271,5
"13317",13,317,1995,5483,5175,308,5.6
"13317",13,317,1996,5560,5202,358,6.4
"13317",13,317,1997,5747,5396,351,6.1
"13317",13,317,1998,5727,5368,359,6.3
"13317",13,317,1999,5694,5366,328,5.8
"13317",13,317,2000,5039,4802,237,4.7
"13317",13,317,2001,4788,4392,396,8.3
"13317",13,317,2002,4891,4501,390,8
"13317",13,317,2003,4700,4345,355,7.6
"13317",13,317,2004,4543,4207,336,7.4
"13317",13,317,2005,4602,4286,316,6.9
"13317",13,317,2006,4710,4421,289,6.1
"13317",13,317,2007,4572,4269,303,6.6
"13317",13,317,2008,4691,4302,389,8.3
"13317",13,317,2009,4495,3959,536,11.9
"13317",13,317,2010,4017,3486,531,13.2
"13317",13,317,2011,3931,3384,547,13.9
"13317",13,317,2012,3841,3372,469,12.2
"13317",13,317,2013,3738,3320,418,11.2
"13317",13,317,2014,3735,3389,346,9.3
"13317",13,317,2015,3890,3609,281,7.2
"13317",13,317,2016,3711,3466,245,6.6
"13317",13,317,2017,3836,3618,218,5.7
"13319",13,319,1990,4623,4439,184,4
"13319",13,319,1991,4547,4353,194,4.3
"13319",13,319,1992,4538,4278,260,5.7
"13319",13,319,1993,4548,4291,257,5.7
"13319",13,319,1994,4499,4294,205,4.6
"13319",13,319,1995,4518,4301,217,4.8
"13319",13,319,1996,4501,4228,273,6.1
"13319",13,319,1997,4564,4299,265,5.8
"13319",13,319,1998,4609,4233,376,8.2
"13319",13,319,1999,4725,4296,429,9.1
"13319",13,319,2000,4510,4315,195,4.3
"13319",13,319,2001,4379,4175,204,4.7
"13319",13,319,2002,4401,4154,247,5.6
"13319",13,319,2003,4448,4204,244,5.5
"13319",13,319,2004,4486,4255,231,5.1
"13319",13,319,2005,4428,4167,261,5.9
"13319",13,319,2006,4570,4308,262,5.7
"13319",13,319,2007,4584,4337,247,5.4
"13319",13,319,2008,4763,4436,327,6.9
"13319",13,319,2009,4627,4113,514,11.1
"13319",13,319,2010,3842,3303,539,14
"13319",13,319,2011,3775,3288,487,12.9
"13319",13,319,2012,3738,3308,430,11.5
"13319",13,319,2013,3717,3333,384,10.3
"13319",13,319,2014,3716,3395,321,8.6
"13319",13,319,2015,3603,3340,263,7.3
"13319",13,319,2016,3654,3423,231,6.3
"13319",13,319,2017,3845,3625,220,5.7
"13321",13,321,1990,8987,8437,550,6.1
"13321",13,321,1991,8997,8576,421,4.7
"13321",13,321,1992,9233,8500,733,7.9
"13321",13,321,1993,9272,8625,647,7
"13321",13,321,1994,9217,8601,616,6.7
"13321",13,321,1995,9053,8482,571,6.3
"13321",13,321,1996,9111,8496,615,6.8
"13321",13,321,1997,9307,8565,742,8
"13321",13,321,1998,9506,8786,720,7.6
"13321",13,321,1999,9475,8768,707,7.5
"13321",13,321,2000,10288,9834,454,4.4
"13321",13,321,2001,10114,9602,512,5.1
"13321",13,321,2002,10034,9519,515,5.1
"13321",13,321,2003,10320,9812,508,4.9
"13321",13,321,2004,10277,9757,520,5.1
"13321",13,321,2005,10352,9783,569,5.5
"13321",13,321,2006,10384,9856,528,5.1
"13321",13,321,2007,10184,9640,544,5.3
"13321",13,321,2008,10253,9567,686,6.7
"13321",13,321,2009,10156,9132,1024,10.1
"13321",13,321,2010,9781,8597,1184,12.1
"13321",13,321,2011,9795,8669,1126,11.5
"13321",13,321,2012,9622,8643,979,10.2
"13321",13,321,2013,9246,8393,853,9.2
"13321",13,321,2014,8941,8240,701,7.8
"13321",13,321,2015,8845,8272,573,6.5
"13321",13,321,2016,9133,8602,531,5.8
"13321",13,321,2017,9353,8893,460,4.9
"15001",15,1,1990,58415,56163,2252,3.9
"15001",15,1,1991,63577,60621,2956,4.6
"15001",15,1,1992,65215,60220,4995,7.7
"15001",15,1,1993,65430,60327,5103,7.8
"15001",15,1,1994,65623,59122,6501,9.9
"15001",15,1,1995,65254,58582,6672,10.2
"15001",15,1,1996,67421,60829,6592,9.8
"15001",15,1,1997,69400,62524,6876,9.9
"15001",15,1,1998,69345,62830,6515,9.4
"15001",15,1,1999,70485,64568,5917,8.4
"15001",15,1,2000,73877,70165,3712,5
"15001",15,1,2001,75746,71762,3984,5.3
"15001",15,1,2002,75449,71841,3608,4.8
"15001",15,1,2003,76757,72980,3777,4.9
"15001",15,1,2004,78351,75166,3185,4.1
"15001",15,1,2005,80769,77983,2786,3.4
"15001",15,1,2006,83833,81216,2617,3.1
"15001",15,1,2007,84784,81772,3012,3.6
"15001",15,1,2008,84886,79796,5090,6
"15001",15,1,2009,83897,75348,8549,10.2
"15001",15,1,2010,87774,79112,8662,9.9
"15001",15,1,2011,88675,79952,8723,9.8
"15001",15,1,2012,86114,78944,7170,8.3
"15001",15,1,2013,86180,80410,5770,6.7
"15001",15,1,2014,87707,82863,4844,5.5
"15001",15,1,2015,88719,84812,3907,4.4
"15001",15,1,2016,91526,88175,3351,3.7
"15001",15,1,2017,91412,88847,2565,2.8
"15003",15,3,1990,408983,400196,8787,2.1
"15003",15,3,1991,418193,409367,8826,2.1
"15003",15,3,1992,423845,411820,12025,2.8
"15003",15,3,1993,426442,412676,13766,3.2
"15003",15,3,1994,424599,406688,17911,4.2
"15003",15,3,1995,425437,405839,19598,4.6
"15003",15,3,1996,430844,408416,22428,5.2
"15003",15,3,1997,432747,410500,22247,5.1
"15003",15,3,1998,432469,409852,22617,5.2
"15003",15,3,1999,430460,410022,20438,4.7
"15003",15,3,2000,430891,413120,17771,4.1
"15003",15,3,2001,431962,413218,18744,4.3
"15003",15,3,2002,424149,406706,17443,4.1
"15003",15,3,2003,424451,407549,16902,4
"15003",15,3,2004,427982,413881,14101,3.3
"15003",15,3,2005,439257,427016,12241,2.8
"15003",15,3,2006,444788,433478,11310,2.5
"15003",15,3,2007,442512,430846,11666,2.6
"15003",15,3,2008,443915,426832,17083,3.8
"15003",15,3,2009,439761,413213,26548,6
"15003",15,3,2010,446189,419631,26558,6
"15003",15,3,2011,456169,429374,26795,5.9
"15003",15,3,2012,448023,423881,24142,5.4
"15003",15,3,2013,451490,431462,20028,4.4
"15003",15,3,2014,461744,442983,18761,4.1
"15003",15,3,2015,467705,452091,15614,3.3
"15003",15,3,2016,470916,457934,12982,2.8
"15003",15,3,2017,471330,460776,10554,2.2
"15007",15,7,1990,26142,25114,1028,3.9
"15007",15,7,1991,28489,27278,1211,4.3
"15007",15,7,1992,29396,26489,2907,9.9
"15007",15,7,1993,28465,24678,3787,13.3
"15007",15,7,1994,28686,24928,3758,13.1
"15007",15,7,1995,28835,25536,3299,11.4
"15007",15,7,1996,29081,25585,3496,12
"15007",15,7,1997,28877,25709,3168,11
"15007",15,7,1998,28977,26178,2799,9.7
"15007",15,7,1999,29362,27188,2174,7.4
"15007",15,7,2000,30231,28769,1462,4.8
"15007",15,7,2001,30261,28642,1619,5.4
"15007",15,7,2002,29979,28605,1374,4.6
"15007",15,7,2003,30644,29350,1294,4.2
"15007",15,7,2004,31200,30098,1102,3.5
"15007",15,7,2005,31895,30992,903,2.8
"15007",15,7,2006,32471,31637,834,2.6
"15007",15,7,2007,32665,31783,882,2.7
"15007",15,7,2008,32661,31077,1584,4.8
"15007",15,7,2009,31990,28865,3125,9.8
"15007",15,7,2010,34321,31317,3004,8.8
"15007",15,7,2011,34904,31869,3035,8.7
"15007",15,7,2012,33878,31393,2485,7.3
"15007",15,7,2013,34000,32070,1930,5.7
"15007",15,7,2014,34792,33111,1681,4.8
"15007",15,7,2015,35153,33738,1415,4
"15007",15,7,2016,35865,34713,1152,3.2
"15007",15,7,2017,36132,35273,859,2.4
"15009",15,9,1990,57382,54743,2639,4.6
"15009",15,9,1991,61330,57922,3408,5.6
"15009",15,9,1992,65796,60406,5390,8.2
"15009",15,9,1993,66067,62433,3634,5.5
"15009",15,9,1994,66308,62180,4128,6.2
"15009",15,9,1995,66955,62052,4903,7.3
"15009",15,9,1996,68253,63338,4915,7.2
"15009",15,9,1997,69930,64847,5083,7.3
"15009",15,9,1998,70792,66097,4695,6.6
"15009",15,9,1999,72599,68616,3983,5.5
"15009",15,9,2000,70949,68160,2789,3.9
"15009",15,9,2001,72661,69566,3095,4.3
"15009",15,9,2002,71349,68443,2906,4.1
"15009",15,9,2003,71272,68445,2827,4
"15009",15,9,2004,73380,71012,2368,3.2
"15009",15,9,2005,74992,72966,2026,2.7
"15009",15,9,2006,77170,75243,1927,2.5
"15009",15,9,2007,78434,76134,2300,2.9
"15009",15,9,2008,78229,74415,3814,4.9
"15009",15,9,2009,76043,69097,6946,9.1
"15009",15,9,2010,78966,72223,6743,8.5
"15009",15,9,2011,80507,74125,6382,7.9
"15009",15,9,2012,79171,74084,5087,6.4
"15009",15,9,2013,79886,75748,4138,5.2
"15009",15,9,2014,82431,78704,3727,4.5
"15009",15,9,2015,83930,80819,3111,3.7
"15009",15,9,2016,85861,83210,2651,3.1
"15009",15,9,2017,86545,84346,2199,2.5
"16001",16,1,1990,110727,106604,4123,3.7
"16001",16,1,1991,115245,110414,4831,4.2
"16001",16,1,1992,122338,117231,5107,4.2
"16001",16,1,1993,129844,124839,5005,3.9
"16001",16,1,1994,138697,134027,4670,3.4
"16001",16,1,1995,143493,138446,5047,3.5
"16001",16,1,1996,150733,145670,5063,3.4
"16001",16,1,1997,156552,151759,4793,3.1
"16001",16,1,1998,163205,157989,5216,3.2
"16001",16,1,1999,166095,160959,5136,3.1
"16001",16,1,2000,169932,164171,5761,3.4
"16001",16,1,2001,175653,168876,6777,3.9
"16001",16,1,2002,175742,167437,8305,4.7
"16001",16,1,2003,177056,168453,8603,4.9
"16001",16,1,2004,178289,171048,7241,4.1
"16001",16,1,2005,187127,180914,6213,3.3
"16001",16,1,2006,193828,188617,5211,2.7
"16001",16,1,2007,196740,191500,5240,2.7
"16001",16,1,2008,196434,186848,9586,4.9
"16001",16,1,2009,196383,178892,17491,8.9
"16001",16,1,2010,196922,180562,16360,8.3
"16001",16,1,2011,200187,185482,14705,7.3
"16001",16,1,2012,204201,191562,12639,6.2
"16001",16,1,2013,206392,195660,10732,5.2
"16001",16,1,2014,211681,202788,8893,4.2
"16001",16,1,2015,217052,209058,7994,3.7
"16001",16,1,2016,224773,217381,7392,3.3
"16001",16,1,2017,232954,226485,6469,2.8
"16003",16,3,1990,1605,1413,192,12
"16003",16,3,1991,1586,1358,228,14.4
"16003",16,3,1992,1663,1437,226,13.6
"16003",16,3,1993,1692,1455,237,14
"16003",16,3,1994,1808,1601,207,11.4
"16003",16,3,1995,1775,1524,251,14.1
"16003",16,3,1996,1833,1568,265,14.5
"16003",16,3,1997,1679,1430,249,14.8
"16003",16,3,1998,1667,1420,247,14.8
"16003",16,3,1999,1607,1378,229,14.3
"16003",16,3,2000,1920,1728,192,10
"16003",16,3,2001,1954,1734,220,11.3
"16003",16,3,2002,1874,1649,225,12
"16003",16,3,2003,1867,1635,232,12.4
"16003",16,3,2004,1860,1638,222,11.9
"16003",16,3,2005,1907,1754,153,8
"16003",16,3,2006,2159,2013,146,6.8
"16003",16,3,2007,1999,1884,115,5.8
"16003",16,3,2008,1913,1710,203,10.6
"16003",16,3,2009,2123,1776,347,16.3
"16003",16,3,2010,1861,1516,345,18.5
"16003",16,3,2011,1744,1432,312,17.9
"16003",16,3,2012,1741,1481,260,14.9
"16003",16,3,2013,1707,1474,233,13.6
"16003",16,3,2014,1676,1508,168,10
"16003",16,3,2015,1715,1583,132,7.7
"16003",16,3,2016,1741,1620,121,7
"16003",16,3,2017,1748,1649,99,5.7
"16005",16,5,1990,31222,29081,2141,6.9
"16005",16,5,1991,31711,29527,2184,6.9
"16005",16,5,1992,31541,29230,2311,7.3
"16005",16,5,1993,35578,33375,2203,6.2
"16005",16,5,1994,36707,34472,2235,6.1
"16005",16,5,1995,36286,34151,2135,5.9
"16005",16,5,1996,35563,33605,1958,5.5
"16005",16,5,1997,38860,36798,2062,5.3
"16005",16,5,1998,39303,37349,1954,5
"16005",16,5,1999,39197,37236,1961,5
"16005",16,5,2000,38180,36401,1779,4.7
"16005",16,5,2001,37879,35999,1880,5
"16005",16,5,2002,38701,36417,2284,5.9
"16005",16,5,2003,39448,37355,2093,5.3
"16005",16,5,2004,39774,37896,1878,4.7
"16005",16,5,2005,40549,38984,1565,3.9
"16005",16,5,2006,40451,39057,1394,3.4
"16005",16,5,2007,41291,40063,1228,3
"16005",16,5,2008,39594,37716,1878,4.7
"16005",16,5,2009,39350,36263,3087,7.8
"16005",16,5,2010,41091,37809,3282,8
"16005",16,5,2011,41041,37956,3085,7.5
"16005",16,5,2012,41173,38319,2854,6.9
"16005",16,5,2013,41377,38962,2415,5.8
"16005",16,5,2014,41518,39612,1906,4.6
"16005",16,5,2015,41861,40167,1694,4
"16005",16,5,2016,41006,39548,1458,3.6
"16005",16,5,2017,41733,40475,1258,3
"16007",16,7,1990,2371,2246,125,5.3
"16007",16,7,1991,2410,2289,121,5
"16007",16,7,1992,2603,2468,135,5.2
"16007",16,7,1993,2751,2594,157,5.7
"16007",16,7,1994,2884,2715,169,5.9
"16007",16,7,1995,2937,2787,150,5.1
"16007",16,7,1996,2918,2772,146,5
"16007",16,7,1997,2662,2540,122,4.6
"16007",16,7,1998,2859,2728,131,4.6
"16007",16,7,1999,2947,2818,129,4.4
"16007",16,7,2000,2947,2802,145,4.9
"16007",16,7,2001,2970,2831,139,4.7
"16007",16,7,2002,2885,2737,148,5.1
"16007",16,7,2003,2895,2730,165,5.7
"16007",16,7,2004,3027,2881,146,4.8
"16007",16,7,2005,3055,2931,124,4.1
"16007",16,7,2006,3050,2961,89,2.9
"16007",16,7,2007,3158,3085,73,2.3
"16007",16,7,2008,3302,3192,110,3.3
"16007",16,7,2009,3365,3165,200,5.9
"16007",16,7,2010,2884,2670,214,7.4
"16007",16,7,2011,2921,2743,178,6.1
"16007",16,7,2012,2880,2719,161,5.6
"16007",16,7,2013,2881,2733,148,5.1
"16007",16,7,2014,2859,2729,130,4.5
"16007",16,7,2015,2828,2700,128,4.5
"16007",16,7,2016,2805,2678,127,4.5
"16007",16,7,2017,2803,2712,91,3.2
"16009",16,9,1990,3543,3161,382,10.8
"16009",16,9,1991,3600,3156,444,12.3
"16009",16,9,1992,3744,3324,420,11.2
"16009",16,9,1993,3940,3529,411,10.4
"16009",16,9,1994,4088,3687,401,9.8
"16009",16,9,1995,4196,3751,445,10.6
"16009",16,9,1996,4326,3822,504,11.7
"16009",16,9,1997,4390,3957,433,9.9
"16009",16,9,1998,4527,3988,539,11.9
"16009",16,9,1999,4411,3882,529,12
"16009",16,9,2000,4003,3560,443,11.1
"16009",16,9,2001,4036,3612,424,10.5
"16009",16,9,2002,4024,3572,452,11.2
"16009",16,9,2003,3963,3524,439,11.1
"16009",16,9,2004,3995,3634,361,9
"16009",16,9,2005,4044,3733,311,7.7
"16009",16,9,2006,3957,3648,309,7.8
"16009",16,9,2007,4061,3811,250,6.2
"16009",16,9,2008,4080,3668,412,10.1
"16009",16,9,2009,4174,3549,625,15
"16009",16,9,2010,4209,3636,573,13.6
"16009",16,9,2011,4149,3597,552,13.3
"16009",16,9,2012,4156,3650,506,12.2
"16009",16,9,2013,3987,3585,402,10.1
"16009",16,9,2014,3967,3645,322,8.1
"16009",16,9,2015,4035,3767,268,6.6
"16009",16,9,2016,4004,3768,236,5.9
"16009",16,9,2017,3993,3772,221,5.5
"16011",16,11,1990,18323,17336,987,5.4
"16011",16,11,1991,19042,17992,1050,5.5
"16011",16,11,1992,19771,18567,1204,6.1
"16011",16,11,1993,20417,19278,1139,5.6
"16011",16,11,1994,20822,19615,1207,5.8
"16011",16,11,1995,20536,19378,1158,5.6
"16011",16,11,1996,21010,19886,1124,5.3
"16011",16,11,1997,21536,20503,1033,4.8
"16011",16,11,1998,21791,20710,1081,5
"16011",16,11,1999,21887,20833,1054,4.8
"16011",16,11,2000,19688,18819,869,4.4
"16011",16,11,2001,19962,19014,948,4.7
"16011",16,11,2002,20285,19350,935,4.6
"16011",16,11,2003,20205,19252,953,4.7
"16011",16,11,2004,20512,19595,917,4.5
"16011",16,11,2005,21049,20266,783,3.7
"16011",16,11,2006,21109,20328,781,3.7
"16011",16,11,2007,22242,21652,590,2.7
"16011",16,11,2008,22383,21482,901,4
"16011",16,11,2009,21828,20393,1435,6.6
"16011",16,11,2010,22845,21198,1647,7.2
"16011",16,11,2011,22836,21207,1629,7.1
"16011",16,11,2012,22757,21302,1455,6.4
"16011",16,11,2013,22282,20975,1307,5.9
"16011",16,11,2014,22057,21053,1004,4.6
"16011",16,11,2015,22039,21126,913,4.1
"16011",16,11,2016,22751,21952,799,3.5
"16011",16,11,2017,22946,22268,678,3
"16013",16,13,1990,8319,8073,246,3
"16013",16,13,1991,8323,7819,504,6.1
"16013",16,13,1992,8729,8095,634,7.3
"16013",16,13,1993,8897,8389,508,5.7
"16013",16,13,1994,9657,9171,486,5
"16013",16,13,1995,10237,9800,437,4.3
"16013",16,13,1996,10676,10238,438,4.1
"16013",16,13,1997,10749,10243,506,4.7
"16013",16,13,1998,10959,10522,437,4
"16013",16,13,1999,11089,10695,394,3.6
"16013",16,13,2000,11800,11380,420,3.6
"16013",16,13,2001,12428,12003,425,3.4
"16013",16,13,2002,12917,12395,522,4
"16013",16,13,2003,12674,12117,557,4.4
"16013",16,13,2004,13343,12858,485,3.6
"16013",16,13,2005,14067,13669,398,2.8
"16013",16,13,2006,14167,13785,382,2.7
"16013",16,13,2007,13677,13356,321,2.3
"16013",16,13,2008,13726,13186,540,3.9
"16013",16,13,2009,13348,12232,1116,8.4
"16013",16,13,2010,11947,10806,1141,9.6
"16013",16,13,2011,11870,10840,1030,8.7
"16013",16,13,2012,11717,10894,823,7
"16013",16,13,2013,11577,10916,661,5.7
"16013",16,13,2014,11456,10941,515,4.5
"16013",16,13,2015,11815,11391,424,3.6
"16013",16,13,2016,11825,11454,371,3.1
"16013",16,13,2017,12277,11966,311,2.5
"16015",16,15,1990,1524,1435,89,5.8
"16015",16,15,1991,1814,1683,131,7.2
"16015",16,15,1992,1863,1723,140,7.5
"16015",16,15,1993,2185,2033,152,7
"16015",16,15,1994,2501,2353,148,5.9
"16015",16,15,1995,2457,2332,125,5.1
"16015",16,15,1996,2474,2324,150,6.1
"16015",16,15,1997,2491,2331,160,6.4
"16015",16,15,1998,2555,2403,152,5.9
"16015",16,15,1999,2462,2285,177,7.2
"16015",16,15,2000,3418,3250,168,4.9
"16015",16,15,2001,3464,3323,141,4.1
"16015",16,15,2002,3457,3286,171,4.9
"16015",16,15,2003,3530,3333,197,5.6
"16015",16,15,2004,3557,3375,182,5.1
"16015",16,15,2005,3683,3516,167,4.5
"16015",16,15,2006,3708,3571,137,3.7
"16015",16,15,2007,3576,3453,123,3.4
"16015",16,15,2008,3482,3274,208,6
"16015",16,15,2009,3384,3080,304,9
"16015",16,15,2010,3048,2726,322,10.6
"16015",16,15,2011,3058,2746,312,10.2
"16015",16,15,2012,2966,2683,283,9.5
"16015",16,15,2013,2919,2681,238,8.2
"16015",16,15,2014,2919,2727,192,6.6
"16015",16,15,2015,3050,2855,195,6.4
"16015",16,15,2016,3092,2928,164,5.3
"16015",16,15,2017,3200,3047,153,4.8
"16017",16,17,1990,11993,10894,1099,9.2
"16017",16,17,1991,12581,11254,1327,10.5
"16017",16,17,1992,13517,12169,1348,10
"16017",16,17,1993,14584,13196,1388,9.5
"16017",16,17,1994,15368,14078,1290,8.4
"16017",16,17,1995,15812,14391,1421,9
"16017",16,17,1996,16413,14864,1549,9.4
"16017",16,17,1997,17075,15627,1448,8.5
"16017",16,17,1998,17299,15869,1430,8.3
"16017",16,17,1999,17373,15800,1573,9.1
"16017",16,17,2000,17617,16256,1361,7.7
"16017",16,17,2001,18079,16639,1440,8
"16017",16,17,2002,18612,17110,1502,8.1
"16017",16,17,2003,18533,17087,1446,7.8
"16017",16,17,2004,19384,18193,1191,6.1
"16017",16,17,2005,20470,19420,1050,5.1
"16017",16,17,2006,20547,19581,966,4.7
"16017",16,17,2007,20645,19845,800,3.9
"16017",16,17,2008,20417,19063,1354,6.6
"16017",16,17,2009,20958,18630,2328,11.1
"16017",16,17,2010,19494,16978,2516,12.9
"16017",16,17,2011,19037,16685,2352,12.4
"16017",16,17,2012,18597,16649,1948,10.5
"16017",16,17,2013,18264,16658,1606,8.8
"16017",16,17,2014,18228,16916,1312,7.2
"16017",16,17,2015,18525,17405,1120,6
"16017",16,17,2016,18852,17835,1017,5.4
"16017",16,17,2017,19131,18272,859,4.5
"16019",16,19,1990,38567,37162,1405,3.6
"16019",16,19,1991,40658,39000,1658,4.1
"16019",16,19,1992,42112,40121,1991,4.7
"16019",16,19,1993,43341,41512,1829,4.2
"16019",16,19,1994,43892,42036,1856,4.2
"16019",16,19,1995,43646,41769,1877,4.3
"16019",16,19,1996,44311,42488,1823,4.1
"16019",16,19,1997,45671,43956,1715,3.8
"16019",16,19,1998,46045,44382,1663,3.6
"16019",16,19,1999,46383,44784,1599,3.4
"16019",16,19,2000,41423,40005,1418,3.4
"16019",16,19,2001,42667,41124,1543,3.6
"16019",16,19,2002,43647,42001,1646,3.8
"16019",16,19,2003,45703,43994,1709,3.7
"16019",16,19,2004,46649,45023,1626,3.5
"16019",16,19,2005,49007,47534,1473,3
"16019",16,19,2006,49797,48466,1331,2.7
"16019",16,19,2007,50283,49166,1117,2.2
"16019",16,19,2008,50146,48346,1800,3.6
"16019",16,19,2009,50059,46872,3187,6.4
"16019",16,19,2010,49093,45677,3416,7
"16019",16,19,2011,49315,45896,3419,6.9
"16019",16,19,2012,49090,45985,3105,6.3
"16019",16,19,2013,48915,46249,2666,5.5
"16019",16,19,2014,49585,47493,2092,4.2
"16019",16,19,2015,50961,49163,1798,3.5
"16019",16,19,2016,52293,50636,1657,3.2
"16019",16,19,2017,53517,52087,1430,2.7
"16021",16,21,1990,3470,3166,304,8.8
"16021",16,21,1991,3499,3145,354,10.1
"16021",16,21,1992,3732,3380,352,9.4
"16021",16,21,1993,3995,3636,359,9
"16021",16,21,1994,4157,3800,357,8.6
"16021",16,21,1995,4284,3906,378,8.8
"16021",16,21,1996,4412,3986,426,9.7
"16021",16,21,1997,4509,4121,388,8.6
"16021",16,21,1998,4522,4108,414,9.2
"16021",16,21,1999,4459,4070,389,8.7
"16021",16,21,2000,4195,3870,325,7.7
"16021",16,21,2001,4041,3661,380,9.4
"16021",16,21,2002,4056,3696,360,8.9
"16021",16,21,2003,4204,3822,382,9.1
"16021",16,21,2004,4306,3998,308,7.2
"16021",16,21,2005,4241,3903,338,8
"16021",16,21,2006,4234,3911,323,7.6
"16021",16,21,2007,4576,4291,285,6.2
"16021",16,21,2008,4589,4186,403,8.8
"16021",16,21,2009,4410,3812,598,13.6
"16021",16,21,2010,5367,4647,720,13.4
"16021",16,21,2011,5383,4760,623,11.6
"16021",16,21,2012,5217,4725,492,9.4
"16021",16,21,2013,4903,4512,391,8
"16021",16,21,2014,4909,4611,298,6.1
"16021",16,21,2015,5088,4805,283,5.6
"16021",16,21,2016,5097,4830,267,5.2
"16021",16,21,2017,5135,4891,244,4.8
"16023",16,23,1990,1444,1382,62,4.3
"16023",16,23,1991,1466,1379,87,5.9
"16023",16,23,1992,1530,1421,109,7.1
"16023",16,23,1993,1572,1477,95,6
"16023",16,23,1994,1573,1496,77,4.9
"16023",16,23,1995,1564,1501,63,4
"16023",16,23,1996,1625,1547,78,4.8
"16023",16,23,1997,1646,1569,77,4.7
"16023",16,23,1998,1617,1548,69,4.3
"16023",16,23,1999,1592,1532,60,3.8
"16023",16,23,2000,1443,1380,63,4.4
"16023",16,23,2001,1460,1396,64,4.4
"16023",16,23,2002,1358,1293,65,4.8
"16023",16,23,2003,1316,1231,85,6.5
"16023",16,23,2004,1290,1205,85,6.6
"16023",16,23,2005,1397,1337,60,4.3
"16023",16,23,2006,1430,1383,47,3.3
"16023",16,23,2007,1369,1335,34,2.5
"16023",16,23,2008,1369,1310,59,4.3
"16023",16,23,2009,1471,1387,84,5.7
"16023",16,23,2010,1352,1254,98,7.2
"16023",16,23,2011,1324,1216,108,8.2
"16023",16,23,2012,1335,1226,109,8.2
"16023",16,23,2013,1295,1206,89,6.9
"16023",16,23,2014,1301,1231,70,5.4
"16023",16,23,2015,1276,1218,58,4.5
"16023",16,23,2016,1291,1238,53,4.1
"16023",16,23,2017,1314,1274,40,3
"16025",16,25,1990,462,434,28,6.1
"16025",16,25,1991,436,414,22,5
"16025",16,25,1992,464,437,27,5.8
"16025",16,25,1993,399,380,19,4.8
"16025",16,25,1994,469,457,12,2.6
"16025",16,25,1995,450,436,14,3.1
"16025",16,25,1996,453,433,20,4.4
"16025",16,25,1997,441,422,19,4.3
"16025",16,25,1998,411,396,15,3.6
"16025",16,25,1999,411,394,17,4.1
"16025",16,25,2000,535,515,20,3.7
"16025",16,25,2001,562,541,21,3.7
"16025",16,25,2002,578,559,19,3.3
"16025",16,25,2003,564,534,30,5.3
"16025",16,25,2004,573,547,26,4.5
"16025",16,25,2005,622,598,24,3.9
"16025",16,25,2006,637,615,22,3.5
"16025",16,25,2007,618,602,16,2.6
"16025",16,25,2008,630,602,28,4.4
"16025",16,25,2009,598,535,63,10.5
"16025",16,25,2010,643,561,82,12.8
"16025",16,25,2011,639,560,79,12.4
"16025",16,25,2012,668,607,61,9.1
"16025",16,25,2013,633,592,41,6.5
"16025",16,25,2014,631,597,34,5.4
"16025",16,25,2015,648,625,23,3.5
"16025",16,25,2016,657,633,24,3.7
"16025",16,25,2017,676,658,18,2.7
"16027",16,27,1990,42644,39903,2741,6.4
"16027",16,27,1991,44216,41086,3130,7.1
"16027",16,27,1992,46443,43387,3056,6.6
"16027",16,27,1993,49089,45955,3134,6.4
"16027",16,27,1994,52202,49229,2973,5.7
"16027",16,27,1995,54418,51336,3082,5.7
"16027",16,27,1996,57108,54038,3070,5.4
"16027",16,27,1997,59921,56736,3185,5.3
"16027",16,27,1998,62279,59149,3130,5
"16027",16,27,1999,63472,60581,2891,4.6
"16027",16,27,2000,65786,62838,2948,4.5
"16027",16,27,2001,69061,65478,3583,5.2
"16027",16,27,2002,70787,66409,4378,6.2
"16027",16,27,2003,73260,68544,4716,6.4
"16027",16,27,2004,75041,70780,4261,5.7
"16027",16,27,2005,78790,75286,3504,4.4
"16027",16,27,2006,82571,79351,3220,3.9
"16027",16,27,2007,83264,80180,3084,3.7
"16027",16,27,2008,84097,78638,5459,6.5
"16027",16,27,2009,85238,75643,9595,11.3
"16027",16,27,2010,84728,75188,9540,11.3
"16027",16,27,2011,85470,76447,9023,10.6
"16027",16,27,2012,86914,78996,7918,9.1
"16027",16,27,2013,87675,81068,6607,7.5
"16027",16,27,2014,89030,83703,5327,6
"16027",16,27,2015,90939,86342,4597,5.1
"16027",16,27,2016,93451,89399,4052,4.3
"16027",16,27,2017,96377,92955,3422,3.6
"16029",16,29,1990,2955,2813,142,4.8
"16029",16,29,1991,3042,2862,180,5.9
"16029",16,29,1992,3330,3114,216,6.5
"16029",16,29,1993,3296,3069,227,6.9
"16029",16,29,1994,3201,2969,232,7.2
"16029",16,29,1995,3253,3033,220,6.8
"16029",16,29,1996,3348,3126,222,6.6
"16029",16,29,1997,3279,3083,196,6
"16029",16,29,1998,3264,3069,195,6
"16029",16,29,1999,3097,2919,178,5.7
"16029",16,29,2000,3259,3092,167,5.1
"16029",16,29,2001,3431,3246,185,5.4
"16029",16,29,2002,3369,3144,225,6.7
"16029",16,29,2003,3405,3172,233,6.8
"16029",16,29,2004,3284,3059,225,6.9
"16029",16,29,2005,3309,3134,175,5.3
"16029",16,29,2006,3344,3209,135,4
"16029",16,29,2007,3863,3752,111,2.9
"16029",16,29,2008,3899,3755,144,3.7
"16029",16,29,2009,3464,3233,231,6.7
"16029",16,29,2010,3841,3541,300,7.8
"16029",16,29,2011,3883,3593,290,7.5
"16029",16,29,2012,3970,3728,242,6.1
"16029",16,29,2013,3895,3689,206,5.3
"16029",16,29,2014,3851,3687,164,4.3
"16029",16,29,2015,3762,3606,156,4.1
"16029",16,29,2016,3787,3652,135,3.6
"16029",16,29,2017,3814,3693,121,3.2
"16031",16,31,1990,8405,7804,601,7.2
"16031",16,31,1991,8629,8081,548,6.4
"16031",16,31,1992,9012,8292,720,8
"16031",16,31,1993,8652,7932,720,8.3
"16031",16,31,1994,9491,8752,739,7.8
"16031",16,31,1995,9577,8944,633,6.6
"16031",16,31,1996,9837,9217,620,6.3
"16031",16,31,1997,9563,8914,649,6.8
"16031",16,31,1998,9655,8964,691,7.2
"16031",16,31,1999,9648,9028,620,6.4
"16031",16,31,2000,10262,9753,509,5
"16031",16,31,2001,10334,9834,500,4.8
"16031",16,31,2002,10340,9791,549,5.3
"16031",16,31,2003,9882,9272,610,6.2
"16031",16,31,2004,9883,9289,594,6
"16031",16,31,2005,10065,9602,463,4.6
"16031",16,31,2006,10449,10019,430,4.1
"16031",16,31,2007,10795,10453,342,3.2
"16031",16,31,2008,10986,10554,432,3.9
"16031",16,31,2009,10190,9581,609,6
"16031",16,31,2010,11113,10326,787,7.1
"16031",16,31,2011,11191,10453,738,6.6
"16031",16,31,2012,11108,10464,644,5.8
"16031",16,31,2013,11109,10528,581,5.2
"16031",16,31,2014,11237,10755,482,4.3
"16031",16,31,2015,11452,11064,388,3.4
"16031",16,31,2016,11569,11226,343,3
"16031",16,31,2017,11718,11429,289,2.5
"16033",16,33,1990,549,534,15,2.7
"16033",16,33,1991,591,575,16,2.7
"16033",16,33,1992,637,609,28,4.4
"16033",16,33,1993,433,409,24,5.5
"16033",16,33,1994,616,589,27,4.4
"16033",16,33,1995,629,601,28,4.5
"16033",16,33,1996,640,617,23,3.6
"16033",16,33,1997,601,574,27,4.5
"16033",16,33,1998,590,567,23,3.9
"16033",16,33,1999,553,535,18,3.3
"16033",16,33,2000,529,501,28,5.3
"16033",16,33,2001,559,529,30,5.4
"16033",16,33,2002,504,474,30,6
"16033",16,33,2003,538,507,31,5.8
"16033",16,33,2004,543,503,40,7.4
"16033",16,33,2005,546,519,27,4.9
"16033",16,33,2006,527,506,21,4
"16033",16,33,2007,554,541,13,2.3
"16033",16,33,2008,596,575,21,3.5
"16033",16,33,2009,549,516,33,6
"16033",16,33,2010,536,486,50,9.3
"16033",16,33,2011,516,470,46,8.9
"16033",16,33,2012,424,392,32,7.5
"16033",16,33,2013,424,397,27,6.4
"16033",16,33,2014,442,421,21,4.8
"16033",16,33,2015,395,380,15,3.8
"16033",16,33,2016,393,380,13,3.3
"16033",16,33,2017,403,392,11,2.7
"16035",16,35,1990,3901,3391,510,13.1
"16035",16,35,1991,4042,3414,628,15.5
"16035",16,35,1992,4051,3438,613,15.1
"16035",16,35,1993,4119,3492,627,15.2
"16035",16,35,1994,4075,3490,585,14.4
"16035",16,35,1995,4063,3527,536,13.2
"16035",16,35,1996,4141,3642,499,12.1
"16035",16,35,1997,4250,3743,507,11.9
"16035",16,35,1998,4307,3748,559,13
"16035",16,35,1999,4060,3540,520,12.8
"16035",16,35,2000,3691,3202,489,13.2
"16035",16,35,2001,3567,3040,527,14.8
"16035",16,35,2002,3495,3022,473,13.5
"16035",16,35,2003,3296,2900,396,12
"16035",16,35,2004,3369,3023,346,10.3
"16035",16,35,2005,3357,3044,313,9.3
"16035",16,35,2006,3318,3040,278,8.4
"16035",16,35,2007,3208,2967,241,7.5
"16035",16,35,2008,3217,2864,353,11
"16035",16,35,2009,3523,3001,522,14.8
"16035",16,35,2010,3422,2921,501,14.6
"16035",16,35,2011,3354,2895,459,13.7
"16035",16,35,2012,3270,2858,412,12.6
"16035",16,35,2013,3185,2825,360,11.3
"16035",16,35,2014,3130,2838,292,9.3
"16035",16,35,2015,3085,2834,251,8.1
"16035",16,35,2016,3044,2822,222,7.3
"16035",16,35,2017,3039,2830,209,6.9
"16037",16,37,1990,2192,2093,99,4.5
"16037",16,37,1991,1976,1847,129,6.5
"16037",16,37,1992,1996,1808,188,9.4
"16037",16,37,1993,1711,1458,253,14.8
"16037",16,37,1994,2376,2185,191,8
"16037",16,37,1995,2519,2372,147,5.8
"16037",16,37,1996,2484,2330,154,6.2
"16037",16,37,1997,2147,1988,159,7.4
"16037",16,37,1998,2135,1950,185,8.7
"16037",16,37,1999,1998,1845,153,7.7
"16037",16,37,2000,2591,2446,145,5.6
"16037",16,37,2001,2692,2524,168,6.2
"16037",16,37,2002,2562,2394,168,6.6
"16037",16,37,2003,2531,2369,162,6.4
"16037",16,37,2004,2565,2413,152,5.9
"16037",16,37,2005,2604,2473,131,5
"16037",16,37,2006,2537,2430,107,4.2
"16037",16,37,2007,2329,2249,80,3.4
"16037",16,37,2008,2438,2326,112,4.6
"16037",16,37,2009,2677,2514,163,6.1
"16037",16,37,2010,2295,2107,188,8.2
"16037",16,37,2011,2300,2117,183,8
"16037",16,37,2012,2334,2145,189,8.1
"16037",16,37,2013,2207,2022,185,8.4
"16037",16,37,2014,2137,1989,148,6.9
"16037",16,37,2015,2129,1986,143,6.7
"16037",16,37,2016,2138,2029,109,5.1
"16037",16,37,2017,2151,2060,91,4.2
"16039",16,39,1990,7931,7480,451,5.7
"16039",16,39,1991,7843,7409,434,5.5
"16039",16,39,1992,7947,7403,544,6.8
"16039",16,39,1993,7750,7211,539,7
"16039",16,39,1994,8207,7678,529,6.4
"16039",16,39,1995,8485,7973,512,6
"16039",16,39,1996,8765,8226,539,6.1
"16039",16,39,1997,8993,8449,544,6
"16039",16,39,1998,9235,8685,550,6
"16039",16,39,1999,9213,8642,571,6.2
"16039",16,39,2000,10598,9990,608,5.7
"16039",16,39,2001,10960,10333,627,5.7
"16039",16,39,2002,10960,10236,724,6.6
"16039",16,39,2003,10698,10016,682,6.4
"16039",16,39,2004,10704,10131,573,5.4
"16039",16,39,2005,10921,10420,501,4.6
"16039",16,39,2006,10931,10476,455,4.2
"16039",16,39,2007,11249,10809,440,3.9
"16039",16,39,2008,11381,10735,646,5.7
"16039",16,39,2009,11408,10435,973,8.5
"16039",16,39,2010,11393,10409,984,8.6
"16039",16,39,2011,10998,10086,912,8.3
"16039",16,39,2012,10670,9866,804,7.5
"16039",16,39,2013,10774,10050,724,6.7
"16039",16,39,2014,11007,10426,581,5.3
"16039",16,39,2015,10734,10222,512,4.8
"16039",16,39,2016,10937,10485,452,4.1
"16039",16,39,2017,11144,10741,403,3.6
"16041",16,41,1990,3809,3679,130,3.4
"16041",16,41,1991,3837,3706,131,3.4
"16041",16,41,1992,4093,3951,142,3.5
"16041",16,41,1993,3988,3855,133,3.3
"16041",16,41,1994,4302,4157,145,3.4
"16041",16,41,1995,4287,4106,181,4.2
"16041",16,41,1996,4589,4383,206,4.5
"16041",16,41,1997,4555,4372,183,4
"16041",16,41,1998,4674,4509,165,3.5
"16041",16,41,1999,4633,4478,155,3.3
"16041",16,41,2000,5205,5036,169,3.2
"16041",16,41,2001,5446,5234,212,3.9
"16041",16,41,2002,5724,5465,259,4.5
"16041",16,41,2003,5800,5546,254,4.4
"16041",16,41,2004,6047,5804,243,4
"16041",16,41,2005,6218,6019,199,3.2
"16041",16,41,2006,6258,6104,154,2.5
"16041",16,41,2007,5751,5626,125,2.2
"16041",16,41,2008,5690,5498,192,3.4
"16041",16,41,2009,5794,5473,321,5.5
"16041",16,41,2010,6194,5867,327,5.3
"16041",16,41,2011,6247,5908,339,5.4
"16041",16,41,2012,6307,6016,291,4.6
"16041",16,41,2013,6259,5999,260,4.2
"16041",16,41,2014,6403,6185,218,3.4
"16041",16,41,2015,6447,6243,204,3.2
"16041",16,41,2016,6628,6426,202,3
"16041",16,41,2017,6723,6570,153,2.3
"16043",16,43,1990,4970,4565,405,8.1
"16043",16,43,1991,5039,4618,421,8.4
"16043",16,43,1992,5212,4779,433,8.3
"16043",16,43,1993,4482,4090,392,8.7
"16043",16,43,1994,4594,4220,374,8.1
"16043",16,43,1995,4594,4207,387,8.4
"16043",16,43,1996,4573,4207,366,8
"16043",16,43,1997,4926,4557,369,7.5
"16043",16,43,1998,4968,4616,352,7.1
"16043",16,43,1999,4805,4492,313,6.5
"16043",16,43,2000,5625,5353,272,4.8
"16043",16,43,2001,5874,5601,273,4.6
"16043",16,43,2002,5880,5608,272,4.6
"16043",16,43,2003,5709,5414,295,5.2
"16043",16,43,2004,5890,5621,269,4.6
"16043",16,43,2005,6093,5856,237,3.9
"16043",16,43,2006,6029,5802,227,3.8
"16043",16,43,2007,5777,5586,191,3.3
"16043",16,43,2008,5763,5477,286,5
"16043",16,43,2009,5553,5059,494,8.9
"16043",16,43,2010,6746,6162,584,8.7
"16043",16,43,2011,6703,6184,519,7.7
"16043",16,43,2012,6923,6495,428,6.2
"16043",16,43,2013,6909,6546,363,5.3
"16043",16,43,2014,6974,6689,285,4.1
"16043",16,43,2015,7170,6907,263,3.7
"16043",16,43,2016,7356,7110,246,3.3
"16043",16,43,2017,7583,7381,202,2.7
"16045",16,45,1990,5223,4878,345,6.6
"16045",16,45,1991,5202,4756,446,8.6
"16045",16,45,1992,5415,4981,434,8
"16045",16,45,1993,5373,4969,404,7.5
"16045",16,45,1994,5802,5427,375,6.5
"16045",16,45,1995,6123,5665,458,7.5
"16045",16,45,1996,6239,5793,446,7.1
"16045",16,45,1997,6331,5919,412,6.5
"16045",16,45,1998,6415,5967,448,7
"16045",16,45,1999,6245,5836,409,6.5
"16045",16,45,2000,7012,6652,360,5.1
"16045",16,45,2001,7227,6728,499,6.9
"16045",16,45,2002,7108,6584,524,7.4
"16045",16,45,2003,7044,6593,451,6.4
"16045",16,45,2004,7020,6624,396,5.6
"16045",16,45,2005,7238,6891,347,4.8
"16045",16,45,2006,7334,7018,316,4.3
"16045",16,45,2007,7098,6826,272,3.8
"16045",16,45,2008,7038,6535,503,7.1
"16045",16,45,2009,6985,6168,817,11.7
"16045",16,45,2010,7680,6802,878,11.4
"16045",16,45,2011,7704,6871,833,10.8
"16045",16,45,2012,7608,6892,716,9.4
"16045",16,45,2013,7493,6906,587,7.8
"16045",16,45,2014,7512,7065,447,6
"16045",16,45,2015,7530,7128,402,5.3
"16045",16,45,2016,7715,7354,361,4.7
"16045",16,45,2017,7934,7623,311,3.9
"16047",16,47,1990,5203,4999,204,3.9
"16047",16,47,1991,5320,5086,234,4.4
"16047",16,47,1992,5500,5226,274,5
"16047",16,47,1993,5444,5163,281,5.2
"16047",16,47,1994,6346,6081,265,4.2
"16047",16,47,1995,6571,6300,271,4.1
"16047",16,47,1996,6757,6470,287,4.2
"16047",16,47,1997,6623,6351,272,4.1
"16047",16,47,1998,6702,6442,260,3.9
"16047",16,47,1999,6604,6379,225,3.4
"16047",16,47,2000,7075,6803,272,3.8
"16047",16,47,2001,7107,6827,280,3.9
"16047",16,47,2002,7243,6959,284,3.9
"16047",16,47,2003,7401,7090,311,4.2
"16047",16,47,2004,7646,7342,304,4
"16047",16,47,2005,8142,7896,246,3
"16047",16,47,2006,8524,8280,244,2.9
"16047",16,47,2007,8805,8612,193,2.2
"16047",16,47,2008,8735,8433,302,3.5
"16047",16,47,2009,8380,7857,523,6.2
"16047",16,47,2010,8498,7864,634,7.5
"16047",16,47,2011,8364,7799,565,6.8
"16047",16,47,2012,8105,7643,462,5.7
"16047",16,47,2013,8046,7651,395,4.9
"16047",16,47,2014,7973,7651,322,4
"16047",16,47,2015,7995,7715,280,3.5
"16047",16,47,2016,8016,7772,244,3
"16047",16,47,2017,8054,7857,197,2.4
"16049",16,49,1990,6079,5568,511,8.4
"16049",16,49,1991,6236,5512,724,11.6
"16049",16,49,1992,6441,5697,744,11.6
"16049",16,49,1993,6549,5727,822,12.6
"16049",16,49,1994,6646,5906,740,11.1
"16049",16,49,1995,6599,5834,765,11.6
"16049",16,49,1996,6571,5833,738,11.2
"16049",16,49,1997,6397,5723,674,10.5
"16049",16,49,1998,6416,5731,685,10.7
"16049",16,49,1999,6244,5608,636,10.2
"16049",16,49,2000,6953,6366,587,8.4
"16049",16,49,2001,7017,6404,613,8.7
"16049",16,49,2002,7089,6476,613,8.6
"16049",16,49,2003,6860,6238,622,9.1
"16049",16,49,2004,7066,6507,559,7.9
"16049",16,49,2005,7135,6658,477,6.7
"16049",16,49,2006,7122,6678,444,6.2
"16049",16,49,2007,7079,6717,362,5.1
"16049",16,49,2008,7134,6591,543,7.6
"16049",16,49,2009,7358,6541,817,11.1
"16049",16,49,2010,6653,5823,830,12.5
"16049",16,49,2011,6683,5858,825,12.3
"16049",16,49,2012,6646,5918,728,11
"16049",16,49,2013,6578,5925,653,9.9
"16049",16,49,2014,6487,5997,490,7.6
"16049",16,49,2015,6396,5993,403,6.3
"16049",16,49,2016,6330,5972,358,5.7
"16049",16,49,2017,6246,5937,309,4.9
"16051",16,51,1990,8053,7640,413,5.1
"16051",16,51,1991,8390,7932,458,5.5
"16051",16,51,1992,8693,8177,516,5.9
"16051",16,51,1993,8995,8524,471,5.2
"16051",16,51,1994,9309,8816,493,5.3
"16051",16,51,1995,9274,8797,477,5.1
"16051",16,51,1996,9502,9048,454,4.8
"16051",16,51,1997,9686,9272,414,4.3
"16051",16,51,1998,10085,9650,435,4.3
"16051",16,51,1999,10274,9843,431,4.2
"16051",16,51,2000,8989,8650,339,3.8
"16051",16,51,2001,9211,8846,365,4
"16051",16,51,2002,9465,9084,381,4
"16051",16,51,2003,9904,9518,386,3.9
"16051",16,51,2004,10132,9741,391,3.9
"16051",16,51,2005,10763,10409,354,3.3
"16051",16,51,2006,11006,10671,335,3
"16051",16,51,2007,11121,10847,274,2.5
"16051",16,51,2008,11279,10847,432,3.8
"16051",16,51,2009,11502,10694,808,7
"16051",16,51,2010,12610,11720,890,7.1
"16051",16,51,2011,12506,11638,868,6.9
"16051",16,51,2012,12188,11438,750,6.2
"16051",16,51,2013,12132,11511,621,5.1
"16051",16,51,2014,12248,11751,497,4.1
"16051",16,51,2015,12459,12028,431,3.5
"16051",16,51,2016,12803,12409,394,3.1
"16051",16,51,2017,13057,12730,327,2.5
"16053",16,53,1990,6953,6632,321,4.6
"16053",16,53,1991,7144,6744,400,5.6
"16053",16,53,1992,7384,6910,474,6.4
"16053",16,53,1993,7313,6852,461,6.3
"16053",16,53,1994,8502,8078,424,5
"16053",16,53,1995,8836,8424,412,4.7
"16053",16,53,1996,9004,8615,389,4.3
"16053",16,53,1997,8754,8352,402,4.6
"16053",16,53,1998,9024,8613,411,4.6
"16053",16,53,1999,8932,8549,383,4.3
"16053",16,53,2000,9136,8737,399,4.4
"16053",16,53,2001,9315,8927,388,4.2
"16053",16,53,2002,9604,9186,418,4.4
"16053",16,53,2003,9527,9077,450,4.7
"16053",16,53,2004,9761,9318,443,4.5
"16053",16,53,2005,9943,9576,367,3.7
"16053",16,53,2006,10203,9867,336,3.3
"16053",16,53,2007,9827,9546,281,2.9
"16053",16,53,2008,9966,9541,425,4.3
"16053",16,53,2009,10447,9705,742,7.1
"16053",16,53,2010,11021,10135,886,8
"16053",16,53,2011,11107,10274,833,7.5
"16053",16,53,2012,10975,10270,705,6.4
"16053",16,53,2013,10943,10364,579,5.3
"16053",16,53,2014,11104,10656,448,4
"16053",16,53,2015,11458,11079,379,3.3
"16053",16,53,2016,11513,11158,355,3.1
"16053",16,53,2017,11763,11442,321,2.7
"16055",16,55,1990,34729,32131,2598,7.5
"16055",16,55,1991,36203,33336,2867,7.9
"16055",16,55,1992,39537,36465,3072,7.8
"16055",16,55,1993,43571,40192,3379,7.8
"16055",16,55,1994,46687,43263,3424,7.3
"16055",16,55,1995,48549,44856,3693,7.6
"16055",16,55,1996,50928,46890,4038,7.9
"16055",16,55,1997,54255,49850,4405,8.1
"16055",16,55,1998,55338,50992,4346,7.9
"16055",16,55,1999,55675,51460,4215,7.6
"16055",16,55,2000,56292,52720,3572,6.3
"16055",16,55,2001,59387,55189,4198,7.1
"16055",16,55,2002,60344,56010,4334,7.2
"16055",16,55,2003,61574,57403,4171,6.8
"16055",16,55,2004,63581,59880,3701,5.8
"16055",16,55,2005,67178,64151,3027,4.5
"16055",16,55,2006,68675,66048,2627,3.8
"16055",16,55,2007,69433,67106,2327,3.4
"16055",16,55,2008,70769,66653,4116,5.8
"16055",16,55,2009,70972,63805,7167,10.1
"16055",16,55,2010,68851,61337,7514,10.9
"16055",16,55,2011,69295,62263,7032,10.1
"16055",16,55,2012,68603,62586,6017,8.8
"16055",16,55,2013,69195,64144,5051,7.3
"16055",16,55,2014,70466,66361,4105,5.8
"16055",16,55,2015,71550,67880,3670,5.1
"16055",16,55,2016,73697,70273,3424,4.6
"16055",16,55,2017,75457,72557,2900,3.8
"16057",16,57,1990,13989,13317,672,4.8
"16057",16,57,1991,13721,13125,596,4.3
"16057",16,57,1992,14095,13577,518,3.7
"16057",16,57,1993,15484,14971,513,3.3
"16057",16,57,1994,15716,15278,438,2.8
"16057",16,57,1995,16194,15711,483,3
"16057",16,57,1996,15017,14524,493,3.3
"16057",16,57,1997,14836,14325,511,3.4
"16057",16,57,1998,15038,14524,514,3.4
"16057",16,57,1999,14847,14386,461,3.1
"16057",16,57,2000,17577,16826,751,4.3
"16057",16,57,2001,17409,16642,767,4.4
"16057",16,57,2002,16641,15871,770,4.6
"16057",16,57,2003,16099,15342,757,4.7
"16057",16,57,2004,17807,17116,691,3.9
"16057",16,57,2005,17947,17314,633,3.5
"16057",16,57,2006,17598,17063,535,3
"16057",16,57,2007,17003,16534,469,2.8
"16057",16,57,2008,17180,16453,727,4.2
"16057",16,57,2009,17794,16583,1211,6.8
"16057",16,57,2010,19280,18000,1280,6.6
"16057",16,57,2011,19244,18032,1212,6.3
"16057",16,57,2012,19619,18474,1145,5.8
"16057",16,57,2013,19405,18451,954,4.9
"16057",16,57,2014,19290,18503,787,4.1
"16057",16,57,2015,19460,18779,681,3.5
"16057",16,57,2016,19859,19232,627,3.2
"16057",16,57,2017,20140,19606,534,2.7
"16059",16,59,1990,3225,2972,253,7.8
"16059",16,59,1991,3234,2873,361,11.2
"16059",16,59,1992,3349,2999,350,10.5
"16059",16,59,1993,3530,3162,368,10.4
"16059",16,59,1994,3875,3563,312,8.1
"16059",16,59,1995,4157,3858,299,7.2
"16059",16,59,1996,4237,3886,351,8.3
"16059",16,59,1997,4130,3750,380,9.2
"16059",16,59,1998,4085,3735,350,8.6
"16059",16,59,1999,3843,3550,293,7.6
"16059",16,59,2000,3808,3502,306,8
"16059",16,59,2001,3888,3596,292,7.5
"16059",16,59,2002,3818,3528,290,7.6
"16059",16,59,2003,3835,3541,294,7.7
"16059",16,59,2004,3956,3676,280,7.1
"16059",16,59,2005,4073,3829,244,6
"16059",16,59,2006,4006,3795,211,5.3
"16059",16,59,2007,3745,3572,173,4.6
"16059",16,59,2008,3664,3413,251,6.9
"16059",16,59,2009,3975,3617,358,9
"16059",16,59,2010,3775,3390,385,10.2
"16059",16,59,2011,3666,3289,377,10.3
"16059",16,59,2012,3566,3215,351,9.8
"16059",16,59,2013,3434,3112,322,9.4
"16059",16,59,2014,3360,3096,264,7.9
"16059",16,59,2015,3376,3137,239,7.1
"16059",16,59,2016,3403,3194,209,6.1
"16059",16,59,2017,3472,3291,181,5.2
"16061",16,61,1990,1502,1385,117,7.8
"16061",16,61,1991,1492,1386,106,7.1
"16061",16,61,1992,1515,1419,96,6.3
"16061",16,61,1993,1591,1461,130,8.2
"16061",16,61,1994,1633,1525,108,6.6
"16061",16,61,1995,1635,1521,114,7
"16061",16,61,1996,1652,1533,119,7.2
"16061",16,61,1997,1622,1501,121,7.5
"16061",16,61,1998,1611,1490,121,7.5
"16061",16,61,1999,1536,1437,99,6.4
"16061",16,61,2000,1745,1631,114,6.5
"16061",16,61,2001,1710,1587,123,7.2
"16061",16,61,2002,1753,1645,108,6.2
"16061",16,61,2003,1673,1598,75,4.5
"16061",16,61,2004,1702,1636,66,3.9
"16061",16,61,2005,1743,1682,61,3.5
"16061",16,61,2006,1732,1684,48,2.8
"16061",16,61,2007,1703,1658,45,2.6
"16061",16,61,2008,1688,1622,66,3.9
"16061",16,61,2009,1779,1671,108,6.1
"16061",16,61,2010,1571,1466,105,6.7
"16061",16,61,2011,1554,1457,97,6.2
"16061",16,61,2012,1596,1510,86,5.4
"16061",16,61,2013,1611,1530,81,5
"16061",16,61,2014,1594,1521,73,4.6
"16061",16,61,2015,1590,1498,92,5.8
"16061",16,61,2016,1622,1520,102,6.3
"16061",16,61,2017,1604,1510,94,5.9
"16063",16,63,1990,2006,1934,72,3.6
"16063",16,63,1991,1968,1853,115,5.8
"16063",16,63,1992,1966,1839,127,6.5
"16063",16,63,1993,1690,1591,99,5.9
"16063",16,63,1994,2116,2018,98,4.6
"16063",16,63,1995,2106,2020,86,4.1
"16063",16,63,1996,2186,2080,106,4.8
"16063",16,63,1997,1829,1726,103,5.6
"16063",16,63,1998,1850,1756,94,5.1
"16063",16,63,1999,1866,1770,96,5.1
"16063",16,63,2000,2157,2062,95,4.4
"16063",16,63,2001,2229,2138,91,4.1
"16063",16,63,2002,2293,2173,120,5.2
"16063",16,63,2003,2269,2138,131,5.8
"16063",16,63,2004,2320,2191,129,5.6
"16063",16,63,2005,2422,2314,108,4.5
"16063",16,63,2006,2577,2460,117,4.5
"16063",16,63,2007,2565,2476,89,3.5
"16063",16,63,2008,2570,2425,145,5.6
"16063",16,63,2009,2584,2275,309,12
"16063",16,63,2010,2709,2355,354,13.1
"16063",16,63,2011,2680,2360,320,11.9
"16063",16,63,2012,2697,2450,247,9.2
"16063",16,63,2013,2645,2444,201,7.6
"16063",16,63,2014,2602,2452,150,5.8
"16063",16,63,2015,2639,2518,121,4.6
"16063",16,63,2016,2636,2519,117,4.4
"16063",16,63,2017,2710,2623,87,3.2
"16065",16,65,1990,8485,8113,372,4.4
"16065",16,65,1991,8663,8284,379,4.4
"16065",16,65,1992,8782,8531,251,2.9
"16065",16,65,1993,8938,8670,268,3
"16065",16,65,1994,9430,9131,299,3.2
"16065",16,65,1995,9810,9485,325,3.3
"16065",16,65,1996,9209,8907,302,3.3
"16065",16,65,1997,9639,9331,308,3.2
"16065",16,65,1998,10193,9902,291,2.9
"16065",16,65,1999,10424,10170,254,2.4
"16065",16,65,2000,12693,12243,450,3.5
"16065",16,65,2001,13161,12738,423,3.2
"16065",16,65,2002,13791,13365,426,3.1
"16065",16,65,2003,13418,13006,412,3.1
"16065",16,65,2004,13994,13563,431,3.1
"16065",16,65,2005,14980,14571,409,2.7
"16065",16,65,2006,14877,14484,393,2.6
"16065",16,65,2007,16441,16085,356,2.2
"16065",16,65,2008,16673,16075,598,3.6
"16065",16,65,2009,16049,15071,978,6.1
"16065",16,65,2010,17484,16545,939,5.4
"16065",16,65,2011,17896,16950,946,5.3
"16065",16,65,2012,18420,17579,841,4.6
"16065",16,65,2013,18431,17679,752,4.1
"16065",16,65,2014,19016,18401,615,3.2
"16065",16,65,2015,19755,19217,538,2.7
"16065",16,65,2016,20527,20033,494,2.4
"16065",16,65,2017,21269,20866,403,1.9
"16067",16,67,1990,8891,8270,621,7
"16067",16,67,1991,9252,8647,605,6.5
"16067",16,67,1992,9696,8873,823,8.5
"16067",16,67,1993,9281,8467,814,8.8
"16067",16,67,1994,10229,9356,873,8.5
"16067",16,67,1995,10215,9430,785,7.7
"16067",16,67,1996,10286,9550,736,7.2
"16067",16,67,1997,9939,9143,796,8
"16067",16,67,1998,9900,9100,800,8.1
"16067",16,67,1999,9798,9095,703,7.2
"16067",16,67,2000,10131,9550,581,5.7
"16067",16,67,2001,9870,9308,562,5.7
"16067",16,67,2002,9838,9212,626,6.4
"16067",16,67,2003,9402,8683,719,7.6
"16067",16,67,2004,9441,8697,744,7.9
"16067",16,67,2005,9476,8932,544,5.7
"16067",16,67,2006,9809,9315,494,5
"16067",16,67,2007,10051,9659,392,3.9
"16067",16,67,2008,10078,9616,462,4.6
"16067",16,67,2009,9494,8857,637,6.7
"16067",16,67,2010,10467,9690,777,7.4
"16067",16,67,2011,10560,9826,734,7
"16067",16,67,2012,10377,9745,632,6.1
"16067",16,67,2013,10374,9800,574,5.5
"16067",16,67,2014,10405,9926,479,4.6
"16067",16,67,2015,10677,10280,397,3.7
"16067",16,67,2016,10854,10509,345,3.2
"16067",16,67,2017,11000,10707,293,2.7
"16069",16,69,1990,19464,18709,755,3.9
"16069",16,69,1991,19794,18855,939,4.7
"16069",16,69,1992,20732,19827,905,4.4
"16069",16,69,1993,21705,20888,817,3.8
"16069",16,69,1994,22075,21331,744,3.4
"16069",16,69,1995,22139,21237,902,4.1
"16069",16,69,1996,22680,21871,809,3.6
"16069",16,69,1997,23258,22455,803,3.5
"16069",16,69,1998,23765,22863,902,3.8
"16069",16,69,1999,23331,22459,872,3.7
"16069",16,69,2000,18878,17890,988,5.2
"16069",16,69,2001,19605,18540,1065,5.4
"16069",16,69,2002,19406,18376,1030,5.3
"16069",16,69,2003,19193,18143,1050,5.5
"16069",16,69,2004,18821,17905,916,4.9
"16069",16,69,2005,19352,18504,848,4.4
"16069",16,69,2006,19025,18347,678,3.6
"16069",16,69,2007,19011,18437,574,3
"16069",16,69,2008,18560,17706,854,4.6
"16069",16,69,2009,18704,17435,1269,6.8
"16069",16,69,2010,20086,18742,1344,6.7
"16069",16,69,2011,20083,18805,1278,6.4
"16069",16,69,2012,19866,18722,1144,5.8
"16069",16,69,2013,20205,19199,1006,5
"16069",16,69,2014,20339,19507,832,4.1
"16069",16,69,2015,20605,19831,774,3.8
"16069",16,69,2016,20828,20147,681,3.3
"16069",16,69,2017,21264,20662,602,2.8
"16071",16,71,1990,1398,1353,45,3.2
"16071",16,71,1991,1426,1375,51,3.6
"16071",16,71,1992,1422,1353,69,4.9
"16071",16,71,1993,1366,1319,47,3.4
"16071",16,71,1994,1447,1395,52,3.6
"16071",16,71,1995,1563,1500,63,4
"16071",16,71,1996,1711,1658,53,3.1
"16071",16,71,1997,1668,1611,57,3.4
"16071",16,71,1998,1762,1698,64,3.6
"16071",16,71,1999,1732,1667,65,3.8
"16071",16,71,2000,1983,1915,68,3.4
"16071",16,71,2001,2001,1928,73,3.6
"16071",16,71,2002,1948,1868,80,4.1
"16071",16,71,2003,1961,1882,79,4
"16071",16,71,2004,1968,1905,63,3.2
"16071",16,71,2005,2148,2093,55,2.6
"16071",16,71,2006,2231,2188,43,1.9
"16071",16,71,2007,2381,2339,42,1.8
"16071",16,71,2008,2304,2223,81,3.5
"16071",16,71,2009,2221,2082,139,6.3
"16071",16,71,2010,2006,1885,121,6
"16071",16,71,2011,2016,1899,117,5.8
"16071",16,71,2012,2091,1988,103,4.9
"16071",16,71,2013,2093,2003,90,4.3
"16071",16,71,2014,2116,2034,82,3.9
"16071",16,71,2015,2124,2048,76,3.6
"16071",16,71,2016,2197,2118,79,3.6
"16071",16,71,2017,2254,2190,64,2.8
"16073",16,73,1990,3726,3546,180,4.8
"16073",16,73,1991,3999,3770,229,5.7
"16073",16,73,1992,4177,3942,235,5.6
"16073",16,73,1993,3460,3273,187,5.4
"16073",16,73,1994,4520,4374,146,3.2
"16073",16,73,1995,4640,4497,143,3.1
"16073",16,73,1996,4729,4583,146,3.1
"16073",16,73,1997,4501,4380,121,2.7
"16073",16,73,1998,4536,4409,127,2.8
"16073",16,73,1999,4394,4212,182,4.1
"16073",16,73,2000,4775,4588,187,3.9
"16073",16,73,2001,4875,4671,204,4.2
"16073",16,73,2002,4748,4533,215,4.5
"16073",16,73,2003,4689,4553,136,2.9
"16073",16,73,2004,4619,4490,129,2.8
"16073",16,73,2005,4719,4603,116,2.5
"16073",16,73,2006,4720,4621,99,2.1
"16073",16,73,2007,4488,4402,86,1.9
"16073",16,73,2008,4363,4226,137,3.1
"16073",16,73,2009,4328,4135,193,4.5
"16073",16,73,2010,5050,4838,212,4.2
"16073",16,73,2011,4885,4673,212,4.3
"16073",16,73,2012,5100,4889,211,4.1
"16073",16,73,2013,5116,4919,197,3.9
"16073",16,73,2014,5019,4833,186,3.7
"16073",16,73,2015,5211,4958,253,4.9
"16073",16,73,2016,5270,5030,240,4.6
"16073",16,73,2017,5178,4971,207,4
"16075",16,75,1990,8640,7906,734,8.5
"16075",16,75,1991,8681,8035,646,7.4
"16075",16,75,1992,8918,8036,882,9.9
"16075",16,75,1993,9641,8841,800,8.3
"16075",16,75,1994,9587,8799,788,8.2
"16075",16,75,1995,9592,8921,671,7
"16075",16,75,1996,9949,9250,699,7
"16075",16,75,1997,10151,9382,769,7.6
"16075",16,75,1998,10226,9490,736,7.2
"16075",16,75,1999,10157,9440,717,7.1
"16075",16,75,2000,9789,9126,663,6.8
"16075",16,75,2001,9927,9133,794,8
"16075",16,75,2002,10069,9222,847,8.4
"16075",16,75,2003,10469,9534,935,8.9
"16075",16,75,2004,10295,9441,854,8.3
"16075",16,75,2005,10415,9689,726,7
"16075",16,75,2006,10391,9869,522,5
"16075",16,75,2007,10520,10076,444,4.2
"16075",16,75,2008,10446,9822,624,6
"16075",16,75,2009,11007,9915,1092,9.9
"16075",16,75,2010,11144,10066,1078,9.7
"16075",16,75,2011,11159,10156,1003,9
"16075",16,75,2012,10835,9983,852,7.9
"16075",16,75,2013,10808,10106,702,6.5
"16075",16,75,2014,10957,10333,624,5.7
"16075",16,75,2015,11092,10535,557,5
"16075",16,75,2016,11235,10716,519,4.6
"16075",16,75,2017,11512,11061,451,3.9
"16077",16,77,1990,3300,3016,284,8.6
"16077",16,77,1991,3334,3102,232,7
"16077",16,77,1992,3348,3106,242,7.2
"16077",16,77,1993,3757,3560,197,5.2
"16077",16,77,1994,3191,2966,225,7.1
"16077",16,77,1995,3514,3272,242,6.9
"16077",16,77,1996,3545,3324,221,6.2
"16077",16,77,1997,3513,3298,215,6.1
"16077",16,77,1998,3653,3444,209,5.7
"16077",16,77,1999,3457,3219,238,6.9
"16077",16,77,2000,3591,3384,207,5.8
"16077",16,77,2001,3529,3324,205,5.8
"16077",16,77,2002,3563,3336,227,6.4
"16077",16,77,2003,3660,3401,259,7.1
"16077",16,77,2004,3743,3509,234,6.3
"16077",16,77,2005,3794,3617,177,4.7
"16077",16,77,2006,3873,3685,188,4.9
"16077",16,77,2007,3753,3602,151,4
"16077",16,77,2008,3541,3353,188,5.3
"16077",16,77,2009,3458,3177,281,8.1
"16077",16,77,2010,3872,3515,357,9.2
"16077",16,77,2011,3927,3582,345,8.8
"16077",16,77,2012,4086,3768,318,7.8
"16077",16,77,2013,3977,3715,262,6.6
"16077",16,77,2014,3976,3781,195,4.9
"16077",16,77,2015,3874,3691,183,4.7
"16077",16,77,2016,3923,3763,160,4.1
"16077",16,77,2017,3952,3818,134,3.4
"16079",16,79,1990,6088,5523,565,9.3
"16079",16,79,1991,6643,5506,1137,17.1
"16079",16,79,1992,6608,5564,1044,15.8
"16079",16,79,1993,6793,5853,940,13.8
"16079",16,79,1994,6725,5965,760,11.3
"16079",16,79,1995,6648,5948,700,10.5
"16079",16,79,1996,6617,5944,673,10.2
"16079",16,79,1997,6775,6096,679,10
"16079",16,79,1998,6813,6048,765,11.2
"16079",16,79,1999,6531,5810,721,11
"16079",16,79,2000,6036,5441,595,9.9
"16079",16,79,2001,5755,5039,716,12.4
"16079",16,79,2002,5463,4791,672,12.3
"16079",16,79,2003,5494,4802,692,12.6
"16079",16,79,2004,5532,4989,543,9.8
"16079",16,79,2005,5693,5249,444,7.8
"16079",16,79,2006,5630,5224,406,7.2
"16079",16,79,2007,5864,5552,312,5.3
"16079",16,79,2008,6192,5671,521,8.4
"16079",16,79,2009,6304,5414,890,14.1
"16079",16,79,2010,5488,4615,873,15.9
"16079",16,79,2011,5511,4712,799,14.5
"16079",16,79,2012,5605,4869,736,13.1
"16079",16,79,2013,5488,4823,665,12.1
"16079",16,79,2014,5204,4683,521,10
"16079",16,79,2015,5126,4722,404,7.9
"16079",16,79,2016,5106,4745,361,7.1
"16079",16,79,2017,5041,4725,316,6.3
"16081",16,81,1990,1820,1748,72,4
"16081",16,81,1991,1921,1851,70,3.6
"16081",16,81,1992,2119,2036,83,3.9
"16081",16,81,1993,2008,1929,79,3.9
"16081",16,81,1994,2351,2266,85,3.6
"16081",16,81,1995,2591,2504,87,3.4
"16081",16,81,1996,2690,2562,128,4.8
"16081",16,81,1997,2783,2656,127,4.6
"16081",16,81,1998,2933,2826,107,3.6
"16081",16,81,1999,3087,2983,104,3.4
"16081",16,81,2000,3652,3544,108,3
"16081",16,81,2001,3833,3732,101,2.6
"16081",16,81,2002,4023,3888,135,3.4
"16081",16,81,2003,4169,4016,153,3.7
"16081",16,81,2004,4228,4095,133,3.1
"16081",16,81,2005,4518,4384,134,3
"16081",16,81,2006,4737,4641,96,2
"16081",16,81,2007,5069,4983,86,1.7
"16081",16,81,2008,5304,5149,155,2.9
"16081",16,81,2009,5287,4920,367,6.9
"16081",16,81,2010,5446,5018,428,7.9
"16081",16,81,2011,5325,4966,359,6.7
"16081",16,81,2012,5311,4998,313,5.9
"16081",16,81,2013,5450,5177,273,5
"16081",16,81,2014,5619,5392,227,4
"16081",16,81,2015,5819,5616,203,3.5
"16081",16,81,2016,5971,5779,192,3.2
"16081",16,81,2017,6088,5922,166,2.7
"16083",16,83,1990,25373,24228,1145,4.5
"16083",16,83,1991,26223,24722,1501,5.7
"16083",16,83,1992,27318,25429,1889,6.9
"16083",16,83,1993,26587,24879,1708,6.4
"16083",16,83,1994,30985,29484,1501,4.8
"16083",16,83,1995,31981,30452,1529,4.8
"16083",16,83,1996,32315,30850,1465,4.5
"16083",16,83,1997,31689,30262,1427,4.5
"16083",16,83,1998,32394,30842,1552,4.8
"16083",16,83,1999,32193,30714,1479,4.6
"16083",16,83,2000,33608,32192,1416,4.2
"16083",16,83,2001,34414,32946,1468,4.3
"16083",16,83,2002,35494,33960,1534,4.3
"16083",16,83,2003,35545,33937,1608,4.5
"16083",16,83,2004,36315,34700,1615,4.4
"16083",16,83,2005,37105,35743,1362,3.7
"16083",16,83,2006,38341,37045,1296,3.4
"16083",16,83,2007,37746,36699,1047,2.8
"16083",16,83,2008,38108,36563,1545,4.1
"16083",16,83,2009,39024,36292,2732,7
"16083",16,83,2010,36930,33783,3147,8.5
"16083",16,83,2011,37466,34519,2947,7.9
"16083",16,83,2012,38089,35481,2608,6.8
"16083",16,83,2013,38544,36363,2181,5.7
"16083",16,83,2014,38211,36553,1658,4.3
"16083",16,83,2015,39586,38126,1460,3.7
"16083",16,83,2016,40319,38980,1339,3.3
"16083",16,83,2017,41351,40156,1195,2.9
"16085",16,85,1990,3253,2979,274,8.4
"16085",16,85,1991,3325,2978,347,10.4
"16085",16,85,1992,3702,3330,372,10
"16085",16,85,1993,3914,3489,425,10.9
"16085",16,85,1994,4007,3667,340,8.5
"16085",16,85,1995,4098,3726,372,9.1
"16085",16,85,1996,4207,3813,394,9.4
"16085",16,85,1997,4237,3832,405,9.6
"16085",16,85,1998,4165,3774,391,9.4
"16085",16,85,1999,4036,3680,356,8.8
"16085",16,85,2000,4111,3834,277,6.7
"16085",16,85,2001,4036,3724,312,7.7
"16085",16,85,2002,4014,3678,336,8.4
"16085",16,85,2003,4013,3678,335,8.3
"16085",16,85,2004,4217,3928,289,6.9
"16085",16,85,2005,4687,4463,224,4.8
"16085",16,85,2006,4978,4761,217,4.4
"16085",16,85,2007,5021,4812,209,4.2
"16085",16,85,2008,4781,4350,431,9
"16085",16,85,2009,4710,4031,679,14.4
"16085",16,85,2010,4692,3956,736,15.7
"16085",16,85,2011,4653,3996,657,14.1
"16085",16,85,2012,4670,4146,524,11.2
"16085",16,85,2013,4538,4075,463,10.2
"16085",16,85,2014,4557,4211,346,7.6
"16085",16,85,2015,4790,4492,298,6.2
"16085",16,85,2016,4959,4690,269,5.4
"16085",16,85,2017,5131,4906,225,4.4
"16087",16,87,1990,4168,3762,406,9.7
"16087",16,87,1991,4330,3751,579,13.4
"16087",16,87,1992,4082,3672,410,10
"16087",16,87,1993,4400,4018,382,8.7
"16087",16,87,1994,4277,3878,399,9.3
"16087",16,87,1995,4375,3991,384,8.8
"16087",16,87,1996,4535,4167,368,8.1
"16087",16,87,1997,4610,4247,363,7.9
"16087",16,87,1998,4669,4319,350,7.5
"16087",16,87,1999,4615,4247,368,8
"16087",16,87,2000,5196,4843,353,6.8
"16087",16,87,2001,5079,4742,337,6.6
"16087",16,87,2002,5117,4761,356,7
"16087",16,87,2003,4737,4358,379,8
"16087",16,87,2004,5016,4676,340,6.8
"16087",16,87,2005,5079,4809,270,5.3
"16087",16,87,2006,4952,4729,223,4.5
"16087",16,87,2007,4687,4489,198,4.2
"16087",16,87,2008,4645,4376,269,5.8
"16087",16,87,2009,4921,4433,488,9.9
"16087",16,87,2010,4726,4238,488,10.3
"16087",16,87,2011,4733,4271,462,9.8
"16087",16,87,2012,4783,4380,403,8.4
"16087",16,87,2013,4760,4409,351,7.4
"16087",16,87,2014,4582,4275,307,6.7
"16087",16,87,2015,4564,4295,269,5.9
"16087",16,87,2016,4592,4339,253,5.5
"16087",16,87,2017,4611,4396,215,4.7
"17001",17,1,1990,34115,32478,1637,4.8
"17001",17,1,1991,33791,31913,1878,5.6
"17001",17,1,1992,34640,32289,2351,6.8
"17001",17,1,1993,35672,33560,2112,5.9
"17001",17,1,1994,35824,34504,1320,3.7
"17001",17,1,1995,35873,34429,1444,4
"17001",17,1,1996,35558,34122,1436,4
"17001",17,1,1997,36079,34918,1161,3.2
"17001",17,1,1998,37274,36053,1221,3.3
"17001",17,1,1999,37500,36310,1190,3.2
"17001",17,1,2000,36253,35001,1252,3.5
"17001",17,1,2001,35846,34330,1516,4.2
"17001",17,1,2002,35779,34173,1606,4.5
"17001",17,1,2003,35240,33362,1878,5.3
"17001",17,1,2004,35601,34014,1587,4.5
"17001",17,1,2005,37713,36305,1408,3.7
"17001",17,1,2006,39326,38001,1325,3.4
"17001",17,1,2007,39619,38088,1531,3.9
"17001",17,1,2008,38756,36907,1849,4.8
"17001",17,1,2009,38261,35468,2793,7.3
"17001",17,1,2010,34907,32210,2697,7.7
"17001",17,1,2011,34384,32011,2373,6.9
"17001",17,1,2012,33912,31700,2212,6.5
"17001",17,1,2013,32956,30722,2234,6.8
"17001",17,1,2014,32635,30894,1741,5.3
"17001",17,1,2015,32515,30895,1620,5
"17001",17,1,2016,32425,30897,1528,4.7
"17001",17,1,2017,32237,31008,1229,3.8
"17003",17,3,1990,4118,3625,493,12
"17003",17,3,1991,4325,3780,545,12.6
"17003",17,3,1992,4195,3710,485,11.6
"17003",17,3,1993,4179,3665,514,12.3
"17003",17,3,1994,3937,3501,436,11.1
"17003",17,3,1995,3893,3554,339,8.7
"17003",17,3,1996,4046,3704,342,8.5
"17003",17,3,1997,3839,3506,333,8.7
"17003",17,3,1998,4078,3760,318,7.8
"17003",17,3,1999,4259,3986,273,6.4
"17003",17,3,2000,3651,3387,264,7.2
"17003",17,3,2001,3506,3231,275,7.8
"17003",17,3,2002,3460,3146,314,9.1
"17003",17,3,2003,3470,3101,369,10.6
"17003",17,3,2004,3378,3069,309,9.1
"17003",17,3,2005,3319,3032,287,8.6
"17003",17,3,2006,3297,3033,264,8
"17003",17,3,2007,3279,3011,268,8.2
"17003",17,3,2008,3108,2814,294,9.5
"17003",17,3,2009,3000,2632,368,12.3
"17003",17,3,2010,2971,2622,349,11.7
"17003",17,3,2011,2889,2516,373,12.9
"17003",17,3,2012,2761,2432,329,11.9
"17003",17,3,2013,2690,2349,341,12.7
"17003",17,3,2014,2556,2283,273,10.7
"17003",17,3,2015,2291,2081,210,9.2
"17003",17,3,2016,2200,1997,203,9.2
"17003",17,3,2017,2161,1989,172,8
"17005",17,5,1990,7689,7129,560,7.3
"17005",17,5,1991,7588,6959,629,8.3
"17005",17,5,1992,7556,6926,630,8.3
"17005",17,5,1993,7551,7016,535,7.1
"17005",17,5,1994,7712,7285,427,5.5
"17005",17,5,1995,7941,7529,412,5.2
"17005",17,5,1996,8105,7665,440,5.4
"17005",17,5,1997,8185,7818,367,4.5
"17005",17,5,1998,8255,7879,376,4.6
"17005",17,5,1999,8333,8025,308,3.7
"17005",17,5,2000,8371,8030,341,4.1
"17005",17,5,2001,8212,7820,392,4.8
"17005",17,5,2002,8230,7781,449,5.5
"17005",17,5,2003,8204,7699,505,6.2
"17005",17,5,2004,8297,7797,500,6
"17005",17,5,2005,8460,8003,457,5.4
"17005",17,5,2006,8639,8221,418,4.8
"17005",17,5,2007,8771,8320,451,5.1
"17005",17,5,2008,8779,8196,583,6.6
"17005",17,5,2009,8563,7717,846,9.9
"17005",17,5,2010,8535,7678,857,10
"17005",17,5,2011,8486,7696,790,9.3
"17005",17,5,2012,8284,7543,741,8.9
"17005",17,5,2013,8035,7339,696,8.7
"17005",17,5,2014,7893,7376,517,6.6
"17005",17,5,2015,7779,7366,413,5.3
"17005",17,5,2016,7864,7465,399,5.1
"17005",17,5,2017,7817,7478,339,4.3
"17007",17,7,1990,17706,16492,1214,6.9
"17007",17,7,1991,18151,16370,1781,9.8
"17007",17,7,1992,18750,16759,1991,10.6
"17007",17,7,1993,19316,17142,2174,11.3
"17007",17,7,1994,19269,18237,1032,5.4
"17007",17,7,1995,20280,19423,857,4.2
"17007",17,7,1996,20978,19940,1038,4.9
"17007",17,7,1997,21650,20600,1050,4.8
"17007",17,7,1998,21689,20845,844,3.9
"17007",17,7,1999,22298,21418,880,3.9
"17007",17,7,2000,22241,21232,1009,4.5
"17007",17,7,2001,22201,20854,1347,6.1
"17007",17,7,2002,22299,20654,1645,7.4
"17007",17,7,2003,22656,20847,1809,8
"17007",17,7,2004,23519,21798,1721,7.3
"17007",17,7,2005,24516,22889,1627,6.6
"17007",17,7,2006,25735,24314,1421,5.5
"17007",17,7,2007,26764,25014,1750,6.5
"17007",17,7,2008,26752,24270,2482,9.3
"17007",17,7,2009,26118,22086,4032,15.4
"17007",17,7,2010,27438,23649,3789,13.8
"17007",17,7,2011,27172,23976,3196,11.8
"17007",17,7,2012,26900,24105,2795,10.4
"17007",17,7,2013,26424,23748,2676,10.1
"17007",17,7,2014,26324,24271,2053,7.8
"17007",17,7,2015,26333,24616,1717,6.5
"17007",17,7,2016,26320,24665,1655,6.3
"17007",17,7,2017,25978,24269,1709,6.6
"17009",17,9,1990,2482,2330,152,6.1
"17009",17,9,1991,2428,2290,138,5.7
"17009",17,9,1992,2488,2334,154,6.2
"17009",17,9,1993,2542,2409,133,5.2
"17009",17,9,1994,2710,2604,106,3.9
"17009",17,9,1995,2707,2627,80,3
"17009",17,9,1996,2705,2607,98,3.6
"17009",17,9,1997,2749,2672,77,2.8
"17009",17,9,1998,3058,2985,73,2.4
"17009",17,9,1999,3131,3039,92,2.9
"17009",17,9,2000,2812,2722,90,3.2
"17009",17,9,2001,3002,2907,95,3.2
"17009",17,9,2002,3031,2924,107,3.5
"17009",17,9,2003,3046,2914,132,4.3
"17009",17,9,2004,3141,3015,126,4
"17009",17,9,2005,3306,3182,124,3.8
"17009",17,9,2006,3372,3272,100,3
"17009",17,9,2007,3479,3384,95,2.7
"17009",17,9,2008,3537,3404,133,3.8
"17009",17,9,2009,3465,3309,156,4.5
"17009",17,9,2010,2587,2407,180,7
"17009",17,9,2011,2590,2429,161,6.2
"17009",17,9,2012,2630,2474,156,5.9
"17009",17,9,2013,2614,2453,161,6.2
"17009",17,9,2014,2734,2620,114,4.2
"17009",17,9,2015,2777,2678,99,3.6
"17009",17,9,2016,2851,2756,95,3.3
"17009",17,9,2017,2842,2761,81,2.9
"17011",17,11,1990,17653,16725,928,5.3
"17011",17,11,1991,18225,16999,1226,6.7
"17011",17,11,1992,18383,17183,1200,6.5
"17011",17,11,1993,18859,17667,1192,6.3
"17011",17,11,1994,18702,17706,996,5.3
"17011",17,11,1995,18659,17685,974,5.2
"17011",17,11,1996,18508,17488,1020,5.5
"17011",17,11,1997,18574,17719,855,4.6
"17011",17,11,1998,18982,18250,732,3.9
"17011",17,11,1999,19306,18493,813,4.2
"17011",17,11,2000,19286,18401,885,4.6
"17011",17,11,2001,18766,17839,927,4.9
"17011",17,11,2002,18366,17304,1062,5.8
"17011",17,11,2003,18128,16831,1297,7.2
"17011",17,11,2004,18218,17132,1086,6
"17011",17,11,2005,18817,17892,925,4.9
"17011",17,11,2006,19043,18215,828,4.3
"17011",17,11,2007,19494,18551,943,4.8
"17011",17,11,2008,19294,18126,1168,6.1
"17011",17,11,2009,19259,17230,2029,10.5
"17011",17,11,2010,19168,17098,2070,10.8
"17011",17,11,2011,18739,16886,1853,9.9
"17011",17,11,2012,18220,16547,1673,9.2
"17011",17,11,2013,17732,16105,1627,9.2
"17011",17,11,2014,17475,16198,1277,7.3
"17011",17,11,2015,17105,16005,1100,6.4
"17011",17,11,2016,17340,16303,1037,6
"17011",17,11,2017,17319,16490,829,4.8
"17013",17,13,1990,2252,2014,238,10.6
"17013",17,13,1991,2713,2458,255,9.4
"17013",17,13,1992,2723,2461,262,9.6
"17013",17,13,1993,2855,2472,383,13.4
"17013",17,13,1994,2875,2667,208,7.2
"17013",17,13,1995,3008,2835,173,5.8
"17013",17,13,1996,3014,2847,167,5.5
"17013",17,13,1997,3223,3069,154,4.8
"17013",17,13,1998,3364,3227,137,4.1
"17013",17,13,1999,3387,3244,143,4.2
"17013",17,13,2000,2559,2428,131,5.1
"17013",17,13,2001,2503,2356,147,5.9
"17013",17,13,2002,2438,2286,152,6.2
"17013",17,13,2003,2485,2307,178,7.2
"17013",17,13,2004,2496,2330,166,6.7
"17013",17,13,2005,2552,2397,155,6.1
"17013",17,13,2006,2622,2465,157,6
"17013",17,13,2007,2656,2482,174,6.6
"17013",17,13,2008,2578,2392,186,7.2
"17013",17,13,2009,2485,2236,249,10
"17013",17,13,2010,2499,2248,251,10
"17013",17,13,2011,2497,2254,243,9.7
"17013",17,13,2012,2449,2204,245,10
"17013",17,13,2013,2416,2179,237,9.8
"17013",17,13,2014,2365,2171,194,8.2
"17013",17,13,2015,2341,2183,158,6.7
"17013",17,13,2016,2369,2224,145,6.1
"17013",17,13,2017,2352,2227,125,5.3
"17015",17,15,1990,8518,8072,446,5.2
"17015",17,15,1991,8371,7797,574,6.9
"17015",17,15,1992,8487,7940,547,6.4
"17015",17,15,1993,8827,8239,588,6.7
"17015",17,15,1994,8808,8334,474,5.4
"17015",17,15,1995,9255,8720,535,5.8
"17015",17,15,1996,8947,8441,506,5.7
"17015",17,15,1997,8961,8514,447,5
"17015",17,15,1998,9178,8805,373,4.1
"17015",17,15,1999,9149,8672,477,5.2
"17015",17,15,2000,8688,8222,466,5.4
"17015",17,15,2001,8545,7973,572,6.7
"17015",17,15,2002,8268,7701,567,6.9
"17015",17,15,2003,8194,7535,659,8
"17015",17,15,2004,8096,7522,574,7.1
"17015",17,15,2005,8364,7898,466,5.6
"17015",17,15,2006,8586,8176,410,4.8
"17015",17,15,2007,8768,8330,438,5
"17015",17,15,2008,8507,7955,552,6.5
"17015",17,15,2009,8289,7388,901,10.9
"17015",17,15,2010,8544,7654,890,10.4
"17015",17,15,2011,8301,7555,746,9
"17015",17,15,2012,8068,7409,659,8.2
"17015",17,15,2013,7880,7253,627,8
"17015",17,15,2014,7849,7347,502,6.4
"17015",17,15,2015,7934,7501,433,5.5
"17015",17,15,2016,7850,7411,439,5.6
"17015",17,15,2017,7607,7263,344,4.5
"17017",17,17,1990,6800,6237,563,8.3
"17017",17,17,1991,6934,6393,541,7.8
"17017",17,17,1992,7177,6600,577,8
"17017",17,17,1993,7369,6912,457,6.2
"17017",17,17,1994,7194,6826,368,5.1
"17017",17,17,1995,7428,7059,369,5
"17017",17,17,1996,7543,7167,376,5
"17017",17,17,1997,7497,7160,337,4.5
"17017",17,17,1998,7377,7048,329,4.5
"17017",17,17,1999,7447,7092,355,4.8
"17017",17,17,2000,7155,6847,308,4.3
"17017",17,17,2001,7156,6841,315,4.4
"17017",17,17,2002,7188,6840,348,4.8
"17017",17,17,2003,7142,6733,409,5.7
"17017",17,17,2004,7410,7037,373,5
"17017",17,17,2005,7598,7241,357,4.7
"17017",17,17,2006,7644,7333,311,4.1
"17017",17,17,2007,7713,7384,329,4.3
"17017",17,17,2008,7610,7210,400,5.3
"17017",17,17,2009,7683,7150,533,6.9
"17017",17,17,2010,7011,6430,581,8.3
"17017",17,17,2011,6910,6345,565,8.2
"17017",17,17,2012,6629,6070,559,8.4
"17017",17,17,2013,6455,5868,587,9.1
"17017",17,17,2014,6432,5989,443,6.9
"17017",17,17,2015,6446,6082,364,5.6
"17017",17,17,2016,6226,5884,342,5.5
"17017",17,17,2017,6157,5882,275,4.5
"17019",17,19,1990,94613,91909,2704,2.9
"17019",17,19,1991,95230,91869,3361,3.5
"17019",17,19,1992,95418,91666,3752,3.9
"17019",17,19,1993,94348,90296,4052,4.3
"17019",17,19,1994,93084,90054,3030,3.3
"17019",17,19,1995,93153,90675,2478,2.7
"17019",17,19,1996,95128,92463,2665,2.8
"17019",17,19,1997,95632,93254,2378,2.5
"17019",17,19,1998,95786,93504,2282,2.4
"17019",17,19,1999,98260,96044,2216,2.3
"17019",17,19,2000,100039,96792,3247,3.2
"17019",17,19,2001,99742,96206,3536,3.5
"17019",17,19,2002,99242,95219,4023,4.1
"17019",17,19,2003,98703,94298,4405,4.5
"17019",17,19,2004,99010,94679,4331,4.4
"17019",17,19,2005,101124,96973,4151,4.1
"17019",17,19,2006,102819,99078,3741,3.6
"17019",17,19,2007,105132,100739,4393,4.2
"17019",17,19,2008,105661,99814,5847,5.5
"17019",17,19,2009,105240,96480,8760,8.3
"17019",17,19,2010,108984,100042,8942,8.2
"17019",17,19,2011,105700,97479,8221,7.8
"17019",17,19,2012,104117,96516,7601,7.3
"17019",17,19,2013,103064,95394,7670,7.4
"17019",17,19,2014,103402,97193,6209,6
"17019",17,19,2015,104621,99199,5422,5.2
"17019",17,19,2016,105228,99913,5315,5.1
"17019",17,19,2017,104527,100100,4427,4.2
"17021",17,21,1990,18293,17391,902,4.9
"17021",17,21,1991,17622,16415,1207,6.8
"17021",17,21,1992,18411,16972,1439,7.8
"17021",17,21,1993,18414,17158,1256,6.8
"17021",17,21,1994,19769,18581,1188,6
"17021",17,21,1995,19599,18349,1250,6.4
"17021",17,21,1996,19361,18212,1149,5.9
"17021",17,21,1997,19372,18473,899,4.6
"17021",17,21,1998,19205,18387,818,4.3
"17021",17,21,1999,19378,18426,952,4.9
"17021",17,21,2000,17606,16730,876,5
"17021",17,21,2001,17081,16191,890,5.2
"17021",17,21,2002,17149,16135,1014,5.9
"17021",17,21,2003,16784,15655,1129,6.7
"17021",17,21,2004,16842,15809,1033,6.1
"17021",17,21,2005,16967,15989,978,5.8
"17021",17,21,2006,17576,16752,824,4.7
"17021",17,21,2007,17998,17103,895,5
"17021",17,21,2008,17945,16778,1167,6.5
"17021",17,21,2009,17721,15949,1772,10
"17021",17,21,2010,17212,15470,1742,10.1
"17021",17,21,2011,16892,15274,1618,9.6
"17021",17,21,2012,16578,15035,1543,9.3
"17021",17,21,2013,16052,14498,1554,9.7
"17021",17,21,2014,15788,14591,1197,7.6
"17021",17,21,2015,15458,14441,1017,6.6
"17021",17,21,2016,15337,14373,964,6.3
"17021",17,21,2017,14687,13919,768,5.2
"17023",17,23,1990,8677,8068,609,7
"17023",17,23,1991,8906,8276,630,7.1
"17023",17,23,1992,9347,8687,660,7.1
"17023",17,23,1993,9593,9077,516,5.4
"17023",17,23,1994,9472,9042,430,4.5
"17023",17,23,1995,9427,9058,369,3.9
"17023",17,23,1996,9550,9144,406,4.3
"17023",17,23,1997,9842,9440,402,4.1
"17023",17,23,1998,10242,9864,378,3.7
"17023",17,23,1999,10539,10181,358,3.4
"17023",17,23,2000,8791,8389,402,4.6
"17023",17,23,2001,8804,8310,494,5.6
"17023",17,23,2002,8549,7982,567,6.6
"17023",17,23,2003,8372,7778,594,7.1
"17023",17,23,2004,8484,7945,539,6.4
"17023",17,23,2005,8512,8044,468,5.5
"17023",17,23,2006,8913,8485,428,4.8
"17023",17,23,2007,8979,8484,495,5.5
"17023",17,23,2008,8588,7912,676,7.9
"17023",17,23,2009,8112,7053,1059,13.1
"17023",17,23,2010,8322,7349,973,11.7
"17023",17,23,2011,8115,7274,841,10.4
"17023",17,23,2012,8038,7268,770,9.6
"17023",17,23,2013,7942,7203,739,9.3
"17023",17,23,2014,7964,7396,568,7.1
"17023",17,23,2015,8078,7576,502,6.2
"17023",17,23,2016,8146,7677,469,5.8
"17023",17,23,2017,7845,7470,375,4.8
"17025",17,25,1990,6761,6128,633,9.4
"17025",17,25,1991,6948,6355,593,8.5
"17025",17,25,1992,7009,6395,614,8.8
"17025",17,25,1993,6656,6106,550,8.3
"17025",17,25,1994,6673,6179,494,7.4
"17025",17,25,1995,6948,6561,387,5.6
"17025",17,25,1996,6851,6487,364,5.3
"17025",17,25,1997,7159,6799,360,5
"17025",17,25,1998,7434,6986,448,6
"17025",17,25,1999,7398,6874,524,7.1
"17025",17,25,2000,7231,6824,407,5.6
"17025",17,25,2001,6995,6545,450,6.4
"17025",17,25,2002,6822,6382,440,6.4
"17025",17,25,2003,6872,6384,488,7.1
"17025",17,25,2004,6865,6410,455,6.6
"17025",17,25,2005,6859,6441,418,6.1
"17025",17,25,2006,6977,6631,346,5
"17025",17,25,2007,7003,6618,385,5.5
"17025",17,25,2008,6766,6279,487,7.2
"17025",17,25,2009,6467,5654,813,12.6
"17025",17,25,2010,6827,6055,772,11.3
"17025",17,25,2011,6689,5979,710,10.6
"17025",17,25,2012,6656,6016,640,9.6
"17025",17,25,2013,6318,5692,626,9.9
"17025",17,25,2014,6439,5925,514,8
"17025",17,25,2015,6616,6147,469,7.1
"17025",17,25,2016,6691,6239,452,6.8
"17025",17,25,2017,6623,6277,346,5.2
"17027",17,27,1990,17027,15994,1033,6.1
"17027",17,27,1991,16706,15528,1178,7.1
"17027",17,27,1992,16700,15584,1116,6.7
"17027",17,27,1993,16712,15635,1077,6.4
"17027",17,27,1994,16770,15957,813,4.8
"17027",17,27,1995,16832,16096,736,4.4
"17027",17,27,1996,17238,16373,865,5
"17027",17,27,1997,17539,16784,755,4.3
"17027",17,27,1998,17556,16860,696,4
"17027",17,27,1999,17552,16943,609,3.5
"17027",17,27,2000,18499,17845,654,3.5
"17027",17,27,2001,18251,17480,771,4.2
"17027",17,27,2002,18044,17195,849,4.7
"17027",17,27,2003,18082,17052,1030,5.7
"17027",17,27,2004,18108,17182,926,5.1
"17027",17,27,2005,18508,17645,863,4.7
"17027",17,27,2006,19220,18378,842,4.4
"17027",17,27,2007,19352,18446,906,4.7
"17027",17,27,2008,19322,18143,1179,6.1
"17027",17,27,2009,18650,17070,1580,8.5
"17027",17,27,2010,20551,19052,1499,7.3
"17027",17,27,2011,20701,19307,1394,6.7
"17027",17,27,2012,20383,19030,1353,6.6
"17027",17,27,2013,19947,18593,1354,6.8
"17027",17,27,2014,19954,18872,1082,5.4
"17027",17,27,2015,20073,19168,905,4.5
"17027",17,27,2016,20415,19513,902,4.4
"17027",17,27,2017,20251,19547,704,3.5
"17029",17,29,1990,26300,24913,1387,5.3
"17029",17,29,1991,26395,24970,1425,5.4
"17029",17,29,1992,26748,25145,1603,6
"17029",17,29,1993,26816,25481,1335,5
"17029",17,29,1994,27048,26075,973,3.6
"17029",17,29,1995,27579,26591,988,3.6
"17029",17,29,1996,27798,26646,1152,4.1
"17029",17,29,1997,27587,26683,904,3.3
"17029",17,29,1998,27732,26802,930,3.4
"17029",17,29,1999,28352,27508,844,3
"17029",17,29,2000,28403,27309,1094,3.9
"17029",17,29,2001,27995,26665,1330,4.8
"17029",17,29,2002,27134,25627,1507,5.6
"17029",17,29,2003,26759,25211,1548,5.8
"17029",17,29,2004,26842,25428,1414,5.3
"17029",17,29,2005,26352,25120,1232,4.7
"17029",17,29,2006,27241,26130,1111,4.1
"17029",17,29,2007,27971,26756,1215,4.3
"17029",17,29,2008,27740,26049,1691,6.1
"17029",17,29,2009,27673,25159,2514,9.1
"17029",17,29,2010,25673,23154,2519,9.8
"17029",17,29,2011,24782,22457,2325,9.4
"17029",17,29,2012,24862,22684,2178,8.8
"17029",17,29,2013,24416,22272,2144,8.8
"17029",17,29,2014,24280,22637,1643,6.8
"17029",17,29,2015,24079,22622,1457,6.1
"17029",17,29,2016,24474,23046,1428,5.8
"17029",17,29,2017,24429,23308,1121,4.6
"17031",17,31,1990,2616824,2431472,185352,7.1
"17031",17,31,1991,2592809,2379989,212820,8.2
"17031",17,31,1992,2623242,2390292,232950,8.9
"17031",17,31,1993,2636393,2410985,225408,8.5
"17031",17,31,1994,2645707,2471602,174105,6.6
"17031",17,31,1995,2657730,2499818,157912,5.9
"17031",17,31,1996,2667162,2507161,160001,6
"17031",17,31,1997,2686465,2534529,151936,5.7
"17031",17,31,1998,2680537,2541090,139447,5.2
"17031",17,31,1999,2723536,2586017,137519,5
"17031",17,31,2000,2729293,2597449,131844,4.8
"17031",17,31,2001,2711546,2547153,164393,6.1
"17031",17,31,2002,2633014,2431773,201241,7.6
"17031",17,31,2003,2585535,2392771,192764,7.5
"17031",17,31,2004,2559761,2384824,174937,6.8
"17031",17,31,2005,2548067,2384929,163138,6.4
"17031",17,31,2006,2566657,2441887,124770,4.9
"17031",17,31,2007,2615750,2478215,137535,5.3
"17031",17,31,2008,2615675,2447178,168497,6.4
"17031",17,31,2009,2604692,2330033,274659,10.5
"17031",17,31,2010,2643833,2356472,287361,10.9
"17031",17,31,2011,2636434,2360934,275500,10.4
"17031",17,31,2012,2653326,2397792,255534,9.6
"17031",17,31,2013,2671904,2414722,257182,9.6
"17031",17,31,2014,2653342,2455149,198193,7.5
"17031",17,31,2015,2648861,2484494,164367,6.2
"17031",17,31,2016,2669585,2507250,162335,6.1
"17031",17,31,2017,2653153,2514113,139040,5.2
"17033",17,33,1990,9055,8280,775,8.6
"17033",17,33,1991,8968,8120,848,9.5
"17033",17,33,1992,10010,9229,781,7.8
"17033",17,33,1993,10644,9968,676,6.4
"17033",17,33,1994,9834,9086,748,7.6
"17033",17,33,1995,9602,8935,667,6.9
"17033",17,33,1996,9546,8895,651,6.8
"17033",17,33,1997,9603,8975,628,6.5
"17033",17,33,1998,10094,9472,622,6.2
"17033",17,33,1999,9998,9427,571,5.7
"17033",17,33,2000,9665,9153,512,5.3
"17033",17,33,2001,9646,9081,565,5.9
"17033",17,33,2002,9335,8745,590,6.3
"17033",17,33,2003,9027,8368,659,7.3
"17033",17,33,2004,9152,8600,552,6
"17033",17,33,2005,9290,8748,542,5.8
"17033",17,33,2006,9624,9136,488,5.1
"17033",17,33,2007,9821,9290,531,5.4
"17033",17,33,2008,9706,9072,634,6.5
"17033",17,33,2009,9721,8755,966,9.9
"17033",17,33,2010,10389,9501,888,8.5
"17033",17,33,2011,10817,10030,787,7.3
"17033",17,33,2012,10451,9647,804,7.7
"17033",17,33,2013,9964,9135,829,8.3
"17033",17,33,2014,9744,9113,631,6.5
"17033",17,33,2015,9629,9059,570,5.9
"17033",17,33,2016,9008,8452,556,6.2
"17033",17,33,2017,8778,8323,455,5.2
"17035",17,35,1990,5301,4846,455,8.6
"17035",17,35,1991,5340,4890,450,8.4
"17035",17,35,1992,5369,4924,445,8.3
"17035",17,35,1993,5353,5024,329,6.1
"17035",17,35,1994,5428,5175,253,4.7
"17035",17,35,1995,5638,5385,253,4.5
"17035",17,35,1996,5709,5433,276,4.8
"17035",17,35,1997,5710,5460,250,4.4
"17035",17,35,1998,5623,5385,238,4.2
"17035",17,35,1999,5742,5535,207,3.6
"17035",17,35,2000,5886,5623,263,4.5
"17035",17,35,2001,5870,5529,341,5.8
"17035",17,35,2002,5674,5319,355,6.3
"17035",17,35,2003,5597,5218,379,6.8
"17035",17,35,2004,5665,5294,371,6.5
"17035",17,35,2005,5519,5233,286,5.2
"17035",17,35,2006,5721,5470,251,4.4
"17035",17,35,2007,5806,5513,293,5
"17035",17,35,2008,5653,5250,403,7.1
"17035",17,35,2009,5568,5021,547,9.8
"17035",17,35,2010,6069,5512,557,9.2
"17035",17,35,2011,5940,5427,513,8.6
"17035",17,35,2012,5966,5503,463,7.8
"17035",17,35,2013,5818,5363,455,7.8
"17035",17,35,2014,5859,5514,345,5.9
"17035",17,35,2015,5904,5593,311,5.3
"17035",17,35,2016,5970,5663,307,5.1
"17035",17,35,2017,6096,5858,238,3.9
"17037",17,37,1990,42616,40571,2045,4.8
"17037",17,37,1991,42863,40070,2793,6.5
"17037",17,37,1992,43318,40426,2892,6.7
"17037",17,37,1993,43829,41190,2639,6
"17037",17,37,1994,44042,42121,1921,4.4
"17037",17,37,1995,45610,43914,1696,3.7
"17037",17,37,1996,47036,45002,2034,4.3
"17037",17,37,1997,46484,44861,1623,3.5
"17037",17,37,1998,47937,46374,1563,3.3
"17037",17,37,1999,49619,47924,1695,3.4
"17037",17,37,2000,51750,50031,1719,3.3
"17037",17,37,2001,51485,49251,2234,4.3
"17037",17,37,2002,50787,48143,2644,5.2
"17037",17,37,2003,51256,48330,2926,5.7
"17037",17,37,2004,52292,49589,2703,5.2
"17037",17,37,2005,53459,50744,2715,5.1
"17037",17,37,2006,55695,53663,2032,3.6
"17037",17,37,2007,59179,56635,2544,4.3
"17037",17,37,2008,60336,56851,3485,5.8
"17037",17,37,2009,60157,54136,6021,10
"17037",17,37,2010,56383,50454,5929,10.5
"17037",17,37,2011,55673,50494,5179,9.3
"17037",17,37,2012,55613,50920,4693,8.4
"17037",17,37,2013,54783,50298,4485,8.2
"17037",17,37,2014,54928,51333,3595,6.5
"17037",17,37,2015,54601,51549,3052,5.6
"17037",17,37,2016,54979,52066,2913,5.3
"17037",17,37,2017,54651,52180,2471,4.5
"17039",17,39,1990,8426,7971,455,5.4
"17039",17,39,1991,8810,8194,616,7
"17039",17,39,1992,8968,8327,641,7.1
"17039",17,39,1993,9564,8975,589,6.2
"17039",17,39,1994,9315,8825,490,5.3
"17039",17,39,1995,9386,8975,411,4.4
"17039",17,39,1996,9167,8702,465,5.1
"17039",17,39,1997,8414,8004,410,4.9
"17039",17,39,1998,8440,8071,369,4.4
"17039",17,39,1999,8439,7987,452,5.4
"17039",17,39,2000,9237,8765,472,5.1
"17039",17,39,2001,8767,8336,431,4.9
"17039",17,39,2002,8373,7841,532,6.4
"17039",17,39,2003,8132,7602,530,6.5
"17039",17,39,2004,8168,7685,483,5.9
"17039",17,39,2005,8381,7932,449,5.4
"17039",17,39,2006,8364,8007,357,4.3
"17039",17,39,2007,8604,8191,413,4.8
"17039",17,39,2008,8651,8141,510,5.9
"17039",17,39,2009,8817,8066,751,8.5
"17039",17,39,2010,8812,8045,767,8.7
"17039",17,39,2011,8699,7960,739,8.5
"17039",17,39,2012,8488,7803,685,8.1
"17039",17,39,2013,8149,7469,680,8.3
"17039",17,39,2014,7935,7410,525,6.6
"17039",17,39,2015,7931,7489,442,5.6
"17039",17,39,2016,7895,7448,447,5.7
"17039",17,39,2017,7740,7386,354,4.6
"17041",17,41,1990,10080,9664,416,4.1
"17041",17,41,1991,10819,10245,574,5.3
"17041",17,41,1992,10529,9792,737,7
"17041",17,41,1993,10722,10073,649,6.1
"17041",17,41,1994,11234,10714,520,4.6
"17041",17,41,1995,11539,11134,405,3.5
"17041",17,41,1996,11831,11402,429,3.6
"17041",17,41,1997,11968,11588,380,3.2
"17041",17,41,1998,12595,12229,366,2.9
"17041",17,41,1999,12825,12442,383,3
"17041",17,41,2000,10432,10050,382,3.7
"17041",17,41,2001,10536,10097,439,4.2
"17041",17,41,2002,10601,10096,505,4.8
"17041",17,41,2003,10406,9859,547,5.3
"17041",17,41,2004,10506,9996,510,4.9
"17041",17,41,2005,10478,9991,487,4.6
"17041",17,41,2006,10302,9886,416,4
"17041",17,41,2007,10561,10114,447,4.2
"17041",17,41,2008,10467,9856,611,5.8
"17041",17,41,2009,10219,9326,893,8.7
"17041",17,41,2010,10339,9433,906,8.8
"17041",17,41,2011,10128,9306,822,8.1
"17041",17,41,2012,9937,9217,720,7.2
"17041",17,41,2013,9781,9099,682,7
"17041",17,41,2014,9861,9282,579,5.9
"17041",17,41,2015,10082,9586,496,4.9
"17041",17,41,2016,10212,9733,479,4.7
"17041",17,41,2017,10120,9714,406,4
"17043",17,43,1990,455650,437811,17839,3.9
"17043",17,43,1991,459527,435787,23740,5.2
"17043",17,43,1992,470571,443352,27219,5.8
"17043",17,43,1993,481359,454734,26625,5.5
"17043",17,43,1994,495531,474823,20708,4.2
"17043",17,43,1995,506107,487741,18366,3.6
"17043",17,43,1996,514763,496110,18653,3.6
"17043",17,43,1997,514063,496922,17141,3.3
"17043",17,43,1998,520022,504543,15479,3
"17043",17,43,1999,536116,520202,15914,3
"17043",17,43,2000,529864,512199,17665,3.3
"17043",17,43,2001,530060,506811,23249,4.4
"17043",17,43,2002,517534,488180,29354,5.7
"17043",17,43,2003,512204,483622,28582,5.6
"17043",17,43,2004,511962,485912,26050,5.1
"17043",17,43,2005,512686,488605,24081,4.7
"17043",17,43,2006,521776,503616,18160,3.5
"17043",17,43,2007,530011,509543,20468,3.9
"17043",17,43,2008,529285,502976,26309,5
"17043",17,43,2009,525702,480627,45075,8.6
"17043",17,43,2010,502807,458264,44543,8.9
"17043",17,43,2011,501986,460854,41132,8.2
"17043",17,43,2012,506425,468487,37938,7.5
"17043",17,43,2013,510632,473038,37594,7.4
"17043",17,43,2014,509913,480727,29186,5.7
"17043",17,43,2015,512100,487789,24311,4.7
"17043",17,43,2016,517781,493261,24520,4.7
"17043",17,43,2017,515683,494644,21039,4.1
"17045",17,45,1990,9679,8950,729,7.5
"17045",17,45,1991,9670,8930,740,7.7
"17045",17,45,1992,9034,8245,789,8.7
"17045",17,45,1993,8961,8276,685,7.6
"17045",17,45,1994,9296,8744,552,5.9
"17045",17,45,1995,9772,9359,413,4.2
"17045",17,45,1996,10015,9540,475,4.7
"17045",17,45,1997,10048,9648,400,4
"17045",17,45,1998,10296,9910,386,3.7
"17045",17,45,1999,10642,10258,384,3.6
"17045",17,45,2000,9955,9539,416,4.2
"17045",17,45,2001,9917,9427,490,4.9
"17045",17,45,2002,9786,9217,569,5.8
"17045",17,45,2003,9952,9353,599,6
"17045",17,45,2004,10151,9585,566,5.6
"17045",17,45,2005,10283,9737,546,5.3
"17045",17,45,2006,10515,10021,494,4.7
"17045",17,45,2007,10614,10072,542,5.1
"17045",17,45,2008,10278,9571,707,6.9
"17045",17,45,2009,10173,9128,1045,10.3
"17045",17,45,2010,9466,8406,1060,11.2
"17045",17,45,2011,9329,8351,978,10.5
"17045",17,45,2012,9133,8250,883,9.7
"17045",17,45,2013,9033,8179,854,9.5
"17045",17,45,2014,9133,8478,655,7.2
"17045",17,45,2015,9428,8839,589,6.2
"17045",17,45,2016,9686,9112,574,5.9
"17045",17,45,2017,9426,8974,452,4.8
"17047",17,47,1990,3685,3453,232,6.3
"17047",17,47,1991,3722,3378,344,9.2
"17047",17,47,1992,3688,3413,275,7.5
"17047",17,47,1993,3739,3516,223,6
"17047",17,47,1994,3897,3671,226,5.8
"17047",17,47,1995,3686,3493,193,5.2
"17047",17,47,1996,3845,3639,206,5.4
"17047",17,47,1997,3853,3663,190,4.9
"17047",17,47,1998,3797,3586,211,5.6
"17047",17,47,1999,3803,3580,223,5.9
"17047",17,47,2000,3676,3497,179,4.9
"17047",17,47,2001,3580,3408,172,4.8
"17047",17,47,2002,3498,3327,171,4.9
"17047",17,47,2003,3461,3289,172,5
"17047",17,47,2004,3533,3377,156,4.4
"17047",17,47,2005,3420,3259,161,4.7
"17047",17,47,2006,3435,3291,144,4.2
"17047",17,47,2007,3457,3289,168,4.9
"17047",17,47,2008,3284,3076,208,6.3
"17047",17,47,2009,3108,2824,284,9.1
"17047",17,47,2010,3230,2948,282,8.7
"17047",17,47,2011,3136,2881,255,8.1
"17047",17,47,2012,3061,2822,239,7.8
"17047",17,47,2013,2869,2623,246,8.6
"17047",17,47,2014,2851,2659,192,6.7
"17047",17,47,2015,2943,2768,175,5.9
"17047",17,47,2016,2966,2795,171,5.8
"17047",17,47,2017,2838,2710,128,4.5
"17049",17,49,1990,16631,15543,1088,6.5
"17049",17,49,1991,16942,15646,1296,7.6
"17049",17,49,1992,17299,15751,1548,8.9
"17049",17,49,1993,17124,16056,1068,6.2
"17049",17,49,1994,17335,16544,791,4.6
"17049",17,49,1995,17999,17290,709,3.9
"17049",17,49,1996,18237,17479,758,4.2
"17049",17,49,1997,18413,17645,768,4.2
"17049",17,49,1998,18318,17540,778,4.2
"17049",17,49,1999,18917,18189,728,3.8
"17049",17,49,2000,18507,17744,763,4.1
"17049",17,49,2001,17907,17067,840,4.7
"17049",17,49,2002,17658,16725,933,5.3
"17049",17,49,2003,17448,16421,1027,5.9
"17049",17,49,2004,17915,16824,1091,6.1
"17049",17,49,2005,17736,16771,965,5.4
"17049",17,49,2006,18355,17615,740,4
"17049",17,49,2007,18869,18109,760,4
"17049",17,49,2008,18542,17528,1014,5.5
"17049",17,49,2009,18145,16685,1460,8
"17049",17,49,2010,18667,17195,1472,7.9
"17049",17,49,2011,18649,17367,1282,6.9
"17049",17,49,2012,18532,17321,1211,6.5
"17049",17,49,2013,18070,16820,1250,6.9
"17049",17,49,2014,18361,17364,997,5.4
"17049",17,49,2015,18410,17527,883,4.8
"17049",17,49,2016,18654,17781,873,4.7
"17049",17,49,2017,18787,18083,704,3.7
"17051",17,51,1990,9661,8827,834,8.6
"17051",17,51,1991,9917,9080,837,8.4
"17051",17,51,1992,10184,9255,929,9.1
"17051",17,51,1993,10312,9509,803,7.8
"17051",17,51,1994,10034,9385,649,6.5
"17051",17,51,1995,9975,9413,562,5.6
"17051",17,51,1996,10151,9577,574,5.7
"17051",17,51,1997,10526,9957,569,5.4
"17051",17,51,1998,10993,10359,634,5.8
"17051",17,51,1999,10881,10244,637,5.9
"17051",17,51,2000,10323,9722,601,5.8
"17051",17,51,2001,10081,9439,642,6.4
"17051",17,51,2002,9835,9166,669,6.8
"17051",17,51,2003,9840,9075,765,7.8
"17051",17,51,2004,10018,9254,764,7.6
"17051",17,51,2005,10132,9478,654,6.5
"17051",17,51,2006,10202,9632,570,5.6
"17051",17,51,2007,10344,9698,646,6.2
"17051",17,51,2008,10234,9435,799,7.8
"17051",17,51,2009,10119,9005,1114,11
"17051",17,51,2010,11243,10111,1132,10.1
"17051",17,51,2011,11159,10128,1031,9.2
"17051",17,51,2012,10703,9743,960,9
"17051",17,51,2013,10132,9198,934,9.2
"17051",17,51,2014,9754,9013,741,7.6
"17051",17,51,2015,9698,9060,638,6.6
"17051",17,51,2016,9734,9098,636,6.5
"17051",17,51,2017,9585,9065,520,5.4
"17053",17,53,1990,7164,6867,297,4.1
"17053",17,53,1991,6918,6514,404,5.8
"17053",17,53,1992,7085,6684,401,5.7
"17053",17,53,1993,6996,6521,475,6.8
"17053",17,53,1994,6966,6578,388,5.6
"17053",17,53,1995,6928,6627,301,4.3
"17053",17,53,1996,6724,6443,281,4.2
"17053",17,53,1997,6644,6381,263,4
"17053",17,53,1998,6706,6450,256,3.8
"17053",17,53,1999,6773,6535,238,3.5
"17053",17,53,2000,7387,7130,257,3.5
"17053",17,53,2001,7361,7042,319,4.3
"17053",17,53,2002,7217,6888,329,4.6
"17053",17,53,2003,7125,6755,370,5.2
"17053",17,53,2004,7174,6808,366,5.1
"17053",17,53,2005,7262,6915,347,4.8
"17053",17,53,2006,7381,7063,318,4.3
"17053",17,53,2007,7350,6988,362,4.9
"17053",17,53,2008,7182,6746,436,6.1
"17053",17,53,2009,7098,6389,709,10
"17053",17,53,2010,7293,6604,689,9.4
"17053",17,53,2011,6985,6376,609,8.7
"17053",17,53,2012,6787,6267,520,7.7
"17053",17,53,2013,6554,6056,498,7.6
"17053",17,53,2014,6452,6061,391,6.1
"17053",17,53,2015,6508,6156,352,5.4
"17053",17,53,2016,6533,6176,357,5.5
"17053",17,53,2017,6483,6178,305,4.7
"17055",17,55,1990,17498,15160,2338,13.4
"17055",17,55,1991,16925,14816,2109,12.5
"17055",17,55,1992,16871,14654,2217,13.1
"17055",17,55,1993,16798,14665,2133,12.7
"17055",17,55,1994,16597,14821,1776,10.7
"17055",17,55,1995,16351,14707,1644,10.1
"17055",17,55,1996,16816,14945,1871,11.1
"17055",17,55,1997,16886,15188,1698,10.1
"17055",17,55,1998,16913,15452,1461,8.6
"17055",17,55,1999,17091,15891,1200,7
"17055",17,55,2000,17682,16546,1136,6.4
"17055",17,55,2001,17103,15817,1286,7.5
"17055",17,55,2002,16985,15657,1328,7.8
"17055",17,55,2003,17080,15579,1501,8.8
"17055",17,55,2004,17466,16104,1362,7.8
"17055",17,55,2005,17537,16294,1243,7.1
"17055",17,55,2006,17923,16747,1176,6.6
"17055",17,55,2007,18270,16848,1422,7.8
"17055",17,55,2008,17928,16281,1647,9.2
"17055",17,55,2009,17682,15376,2306,13
"17055",17,55,2010,18005,15784,2221,12.3
"17055",17,55,2011,17606,15642,1964,11.2
"17055",17,55,2012,17414,15564,1850,10.6
"17055",17,55,2013,16924,14914,2010,11.9
"17055",17,55,2014,16640,15102,1538,9.2
"17055",17,55,2015,16482,15150,1332,8.1
"17055",17,55,2016,16656,15321,1335,8
"17055",17,55,2017,16425,15380,1045,6.4
"17057",17,57,1990,15071,13878,1193,7.9
"17057",17,57,1991,14799,13370,1429,9.7
"17057",17,57,1992,14842,13245,1597,10.8
"17057",17,57,1993,15144,13736,1408,9.3
"17057",17,57,1994,14795,13737,1058,7.2
"17057",17,57,1995,14753,13757,996,6.8
"17057",17,57,1996,14825,13560,1265,8.5
"17057",17,57,1997,14243,13297,946,6.6
"17057",17,57,1998,14557,13693,864,5.9
"17057",17,57,1999,14507,13583,924,6.4
"17057",17,57,2000,17802,16879,923,5.2
"17057",17,57,2001,17442,16412,1030,5.9
"17057",17,57,2002,17351,16194,1157,6.7
"17057",17,57,2003,17139,15802,1337,7.8
"17057",17,57,2004,17218,16082,1136,6.6
"17057",17,57,2005,17566,16518,1048,6
"17057",17,57,2006,17820,16918,902,5.1
"17057",17,57,2007,17927,16985,942,5.3
"17057",17,57,2008,17958,16784,1174,6.5
"17057",17,57,2009,18498,16395,2103,11.4
"17057",17,57,2010,17593,15535,2058,11.7
"17057",17,57,2011,17422,15596,1826,10.5
"17057",17,57,2012,16965,15286,1679,9.9
"17057",17,57,2013,16215,14444,1771,10.9
"17057",17,57,2014,15753,14402,1351,8.6
"17057",17,57,2015,15785,14582,1203,7.6
"17057",17,57,2016,15770,14616,1154,7.3
"17057",17,57,2017,15430,14464,966,6.3
"17059",17,59,1990,2925,2687,238,8.1
"17059",17,59,1991,3016,2750,266,8.8
"17059",17,59,1992,3057,2686,371,12.1
"17059",17,59,1993,3032,2631,401,13.2
"17059",17,59,1994,3018,2614,404,13.4
"17059",17,59,1995,2850,2585,265,9.3
"17059",17,59,1996,2726,2516,210,7.7
"17059",17,59,1997,2719,2535,184,6.8
"17059",17,59,1998,2903,2698,205,7.1
"17059",17,59,1999,2853,2681,172,6
"17059",17,59,2000,2896,2730,166,5.7
"17059",17,59,2001,2752,2591,161,5.9
"17059",17,59,2002,2732,2537,195,7.1
"17059",17,59,2003,2687,2452,235,8.7
"17059",17,59,2004,2702,2511,191,7.1
"17059",17,59,2005,2647,2480,167,6.3
"17059",17,59,2006,2662,2515,147,5.5
"17059",17,59,2007,2666,2502,164,6.2
"17059",17,59,2008,2614,2405,209,8
"17059",17,59,2009,2628,2365,263,10
"17059",17,59,2010,2637,2384,253,9.6
"17059",17,59,2011,2577,2348,229,8.9
"17059",17,59,2012,2528,2316,212,8.4
"17059",17,59,2013,2480,2246,234,9.4
"17059",17,59,2014,2463,2288,175,7.1
"17059",17,59,2015,2465,2300,165,6.7
"17059",17,59,2016,2528,2339,189,7.5
"17059",17,59,2017,2455,2316,139,5.7
"17061",17,61,1990,7216,6812,404,5.6
"17061",17,61,1991,7230,6751,479,6.6
"17061",17,61,1992,7009,6541,468,6.7
"17061",17,61,1993,7093,6666,427,6
"17061",17,61,1994,7038,6677,361,5.1
"17061",17,61,1995,6981,6608,373,5.3
"17061",17,61,1996,7013,6599,414,5.9
"17061",17,61,1997,7092,6705,387,5.5
"17061",17,61,1998,7370,7043,327,4.4
"17061",17,61,1999,7628,7311,317,4.2
"17061",17,61,2000,7001,6653,348,5
"17061",17,61,2001,6955,6578,377,5.4
"17061",17,61,2002,6983,6576,407,5.8
"17061",17,61,2003,6939,6522,417,6
"17061",17,61,2004,6936,6528,408,5.9
"17061",17,61,2005,7243,6852,391,5.4
"17061",17,61,2006,7424,7090,334,4.5
"17061",17,61,2007,7183,6827,356,5
"17061",17,61,2008,6945,6530,415,6
"17061",17,61,2009,6775,6208,567,8.4
"17061",17,61,2010,6817,6184,633,9.3
"17061",17,61,2011,6704,6118,586,8.7
"17061",17,61,2012,6487,5941,546,8.4
"17061",17,61,2013,6318,5772,546,8.6
"17061",17,61,2014,6178,5760,418,6.8
"17061",17,61,2015,6045,5674,371,6.1
"17061",17,61,2016,6056,5708,348,5.7
"17061",17,61,2017,5965,5666,299,5
"17063",17,63,1990,16788,15304,1484,8.8
"17063",17,63,1991,17128,15311,1817,10.6
"17063",17,63,1992,17667,15562,2105,11.9
"17063",17,63,1993,17934,15919,2015,11.2
"17063",17,63,1994,18086,16541,1545,8.5
"17063",17,63,1995,18495,16987,1508,8.2
"17063",17,63,1996,18715,17382,1333,7.1
"17063",17,63,1997,18935,17498,1437,7.6
"17063",17,63,1998,19124,17783,1341,7
"17063",17,63,1999,19680,18311,1369,7
"17063",17,63,2000,21100,19993,1107,5.2
"17063",17,63,2001,21197,19920,1277,6
"17063",17,63,2002,20857,19285,1572,7.5
"17063",17,63,2003,21161,19458,1703,8
"17063",17,63,2004,21973,20249,1724,7.8
"17063",17,63,2005,23302,21653,1649,7.1
"17063",17,63,2006,24510,23243,1267,5.2
"17063",17,63,2007,25757,24282,1475,5.7
"17063",17,63,2008,26237,24348,1889,7.2
"17063",17,63,2009,26702,23440,3262,12.2
"17063",17,63,2010,25953,22505,3448,13.3
"17063",17,63,2011,25752,22470,3282,12.7
"17063",17,63,2012,25755,22797,2958,11.5
"17063",17,63,2013,25906,22898,3008,11.6
"17063",17,63,2014,25583,23352,2231,8.7
"17063",17,63,2015,25486,23722,1764,6.9
"17063",17,63,2016,25810,24068,1742,6.7
"17063",17,63,2017,25658,24136,1522,5.9
"17065",17,65,1990,3608,3259,349,9.7
"17065",17,65,1991,3651,3234,417,11.4
"17065",17,65,1992,3660,3215,445,12.2
"17065",17,65,1993,3751,3341,410,10.9
"17065",17,65,1994,3577,3203,374,10.5
"17065",17,65,1995,3603,3313,290,8
"17065",17,65,1996,3633,3272,361,9.9
"17065",17,65,1997,3710,3414,296,8
"17065",17,65,1998,3840,3517,323,8.4
"17065",17,65,1999,3754,3511,243,6.5
"17065",17,65,2000,4026,3835,191,4.7
"17065",17,65,2001,4022,3798,224,5.6
"17065",17,65,2002,3990,3745,245,6.1
"17065",17,65,2003,3916,3640,276,7
"17065",17,65,2004,3948,3712,236,6
"17065",17,65,2005,4089,3865,224,5.5
"17065",17,65,2006,4255,4028,227,5.3
"17065",17,65,2007,4312,4072,240,5.6
"17065",17,65,2008,4223,3935,288,6.8
"17065",17,65,2009,4070,3687,383,9.4
"17065",17,65,2010,4015,3637,378,9.4
"17065",17,65,2011,3915,3577,338,8.6
"17065",17,65,2012,3927,3615,312,7.9
"17065",17,65,2013,4087,3769,318,7.8
"17065",17,65,2014,4332,4075,257,5.9
"17065",17,65,2015,4375,4135,240,5.5
"17065",17,65,2016,4249,3985,264,6.2
"17065",17,65,2017,4416,4221,195,4.4
"17067",17,67,1990,10949,10423,526,4.8
"17067",17,67,1991,11355,10737,618,5.4
"17067",17,67,1992,10937,10200,737,6.7
"17067",17,67,1993,11387,10707,680,6
"17067",17,67,1994,12083,11591,492,4.1
"17067",17,67,1995,12312,11819,493,4
"17067",17,67,1996,12362,11916,446,3.6
"17067",17,67,1997,12371,11934,437,3.5
"17067",17,67,1998,12727,12321,406,3.2
"17067",17,67,1999,12928,12513,415,3.2
"17067",17,67,2000,10949,10490,459,4.2
"17067",17,67,2001,10774,10150,624,5.8
"17067",17,67,2002,10512,9913,599,5.7
"17067",17,67,2003,10171,9458,713,7
"17067",17,67,2004,9966,9363,603,6.1
"17067",17,67,2005,9943,9444,499,5
"17067",17,67,2006,9888,9431,457,4.6
"17067",17,67,2007,9979,9443,536,5.4
"17067",17,67,2008,9859,9189,670,6.8
"17067",17,67,2009,9438,8389,1049,11.1
"17067",17,67,2010,9960,8907,1053,10.6
"17067",17,67,2011,9624,8742,882,9.2
"17067",17,67,2012,9282,8514,768,8.3
"17067",17,67,2013,8897,8143,754,8.5
"17067",17,67,2014,8883,8308,575,6.5
"17067",17,67,2015,8910,8359,551,6.2
"17067",17,67,2016,8812,8243,569,6.5
"17067",17,67,2017,8483,8051,432,5.1
"17069",17,69,1990,1948,1790,158,8.1
"17069",17,69,1991,1975,1839,136,6.9
"17069",17,69,1992,1987,1822,165,8.3
"17069",17,69,1993,1978,1789,189,9.6
"17069",17,69,1994,1915,1764,151,7.9
"17069",17,69,1995,1867,1746,121,6.5
"17069",17,69,1996,1903,1673,230,12.1
"17069",17,69,1997,1865,1680,185,9.9
"17069",17,69,1998,1903,1782,121,6.4
"17069",17,69,1999,1889,1773,116,6.1
"17069",17,69,2000,1963,1842,121,6.2
"17069",17,69,2001,1920,1791,129,6.7
"17069",17,69,2002,1930,1781,149,7.7
"17069",17,69,2003,1896,1730,166,8.8
"17069",17,69,2004,1870,1712,158,8.4
"17069",17,69,2005,1758,1619,139,7.9
"17069",17,69,2006,1756,1628,128,7.3
"17069",17,69,2007,1712,1574,138,8.1
"17069",17,69,2008,1712,1554,158,9.2
"17069",17,69,2009,1760,1567,193,11
"17069",17,69,2010,1795,1601,194,10.8
"17069",17,69,2011,1749,1560,189,10.8
"17069",17,69,2012,1737,1554,183,10.5
"17069",17,69,2013,1734,1537,197,11.4
"17069",17,69,2014,1639,1496,143,8.7
"17069",17,69,2015,1527,1398,129,8.4
"17069",17,69,2016,1396,1262,134,9.6
"17069",17,69,2017,1336,1234,102,7.6
"17071",17,71,1990,4194,3951,243,5.8
"17071",17,71,1991,4614,4320,294,6.4
"17071",17,71,1992,4740,4450,290,6.1
"17071",17,71,1993,4916,4622,294,6
"17071",17,71,1994,4783,4578,205,4.3
"17071",17,71,1995,4750,4582,168,3.5
"17071",17,71,1996,4737,4520,217,4.6
"17071",17,71,1997,4619,4431,188,4.1
"17071",17,71,1998,5027,4862,165,3.3
"17071",17,71,1999,5161,4991,170,3.3
"17071",17,71,2000,4328,4162,166,3.8
"17071",17,71,2001,4247,4050,197,4.6
"17071",17,71,2002,4089,3830,259,6.3
"17071",17,71,2003,3994,3703,291,7.3
"17071",17,71,2004,4010,3746,264,6.6
"17071",17,71,2005,4066,3830,236,5.8
"17071",17,71,2006,4090,3876,214,5.2
"17071",17,71,2007,4059,3844,215,5.3
"17071",17,71,2008,3909,3629,280,7.2
"17071",17,71,2009,3800,3437,363,9.6
"17071",17,71,2010,3930,3564,366,9.3
"17071",17,71,2011,3854,3547,307,8
"17071",17,71,2012,3733,3436,297,8
"17071",17,71,2013,3671,3382,289,7.9
"17071",17,71,2014,3739,3502,237,6.3
"17071",17,71,2015,3748,3523,225,6
"17071",17,71,2016,3710,3486,224,6
"17071",17,71,2017,3643,3461,182,5
"17073",17,73,1990,26314,24918,1396,5.3
"17073",17,73,1991,26554,24699,1855,7
"17073",17,73,1992,26627,24744,1883,7.1
"17073",17,73,1993,25996,24461,1535,5.9
"17073",17,73,1994,25563,24364,1199,4.7
"17073",17,73,1995,25736,24582,1154,4.5
"17073",17,73,1996,26287,25029,1258,4.8
"17073",17,73,1997,26711,25830,881,3.3
"17073",17,73,1998,27072,26192,880,3.3
"17073",17,73,1999,27619,26346,1273,4.6
"17073",17,73,2000,27554,26305,1249,4.5
"17073",17,73,2001,26850,25519,1331,5
"17073",17,73,2002,26087,24678,1409,5.4
"17073",17,73,2003,26167,24602,1565,6
"17073",17,73,2004,26462,25080,1382,5.2
"17073",17,73,2005,27308,26074,1234,4.5
"17073",17,73,2006,27646,26507,1139,4.1
"17073",17,73,2007,27831,26504,1327,4.8
"17073",17,73,2008,27596,25928,1668,6
"17073",17,73,2009,26772,24315,2457,9.2
"17073",17,73,2010,26720,24283,2437,9.1
"17073",17,73,2011,26495,24416,2079,7.8
"17073",17,73,2012,26179,24239,1940,7.4
"17073",17,73,2013,25415,23442,1973,7.8
"17073",17,73,2014,25236,23555,1681,6.7
"17073",17,73,2015,25072,23532,1540,6.1
"17073",17,73,2016,25056,23553,1503,6
"17073",17,73,2017,24790,23545,1245,5
"17075",17,75,1990,15311,14594,717,4.7
"17075",17,75,1991,16645,15821,824,5
"17075",17,75,1992,16940,15944,996,5.9
"17075",17,75,1993,17474,16609,865,5
"17075",17,75,1994,17776,17073,703,4
"17075",17,75,1995,17568,16751,817,4.7
"17075",17,75,1996,16630,15907,723,4.3
"17075",17,75,1997,16004,15393,611,3.8
"17075",17,75,1998,16258,15581,677,4.2
"17075",17,75,1999,16402,15678,724,4.4
"17075",17,75,2000,16559,15890,669,4
"17075",17,75,2001,16370,15506,864,5.3
"17075",17,75,2002,15830,14914,916,5.8
"17075",17,75,2003,15767,14822,945,6
"17075",17,75,2004,15933,15074,859,5.4
"17075",17,75,2005,16516,15742,774,4.7
"17075",17,75,2006,16452,15723,729,4.4
"17075",17,75,2007,16821,15985,836,5
"17075",17,75,2008,16753,15643,1110,6.6
"17075",17,75,2009,16749,15144,1605,9.6
"17075",17,75,2010,16075,14459,1616,10.1
"17075",17,75,2011,15724,14279,1445,9.2
"17075",17,75,2012,15327,14022,1305,8.5
"17075",17,75,2013,15025,13756,1269,8.4
"17075",17,75,2014,15006,14049,957,6.4
"17075",17,75,2015,14823,13985,838,5.7
"17075",17,75,2016,14845,14040,805,5.4
"17075",17,75,2017,14668,14014,654,4.5
"17077",17,77,1990,30323,28484,1839,6.1
"17077",17,77,1991,29685,27739,1946,6.6
"17077",17,77,1992,29879,27662,2217,7.4
"17077",17,77,1993,29702,27768,1934,6.5
"17077",17,77,1994,29364,27781,1583,5.4
"17077",17,77,1995,28818,27411,1407,4.9
"17077",17,77,1996,29024,27598,1426,4.9
"17077",17,77,1997,29445,28172,1273,4.3
"17077",17,77,1998,29973,28807,1166,3.9
"17077",17,77,1999,30673,29595,1078,3.5
"17077",17,77,2000,30584,29343,1241,4.1
"17077",17,77,2001,30651,29373,1278,4.2
"17077",17,77,2002,30563,29106,1457,4.8
"17077",17,77,2003,30608,28958,1650,5.4
"17077",17,77,2004,31475,29884,1591,5.1
"17077",17,77,2005,31477,30038,1439,4.6
"17077",17,77,2006,32813,31515,1298,4
"17077",17,77,2007,33163,31649,1514,4.6
"17077",17,77,2008,32470,30647,1823,5.6
"17077",17,77,2009,32119,29774,2345,7.3
"17077",17,77,2010,29863,27405,2458,8.2
"17077",17,77,2011,29633,27269,2364,8
"17077",17,77,2012,29218,26935,2283,7.8
"17077",17,77,2013,28532,26266,2266,7.9
"17077",17,77,2014,28466,26641,1825,6.4
"17077",17,77,2015,28620,27029,1591,5.6
"17077",17,77,2016,28626,27099,1527,5.3
"17077",17,77,2017,27990,26759,1231,4.4
"17079",17,79,1990,5008,4729,279,5.6
"17079",17,79,1991,4883,4547,336,6.9
"17079",17,79,1992,4947,4593,354,7.2
"17079",17,79,1993,4979,4671,308,6.2
"17079",17,79,1994,4920,4653,267,5.4
"17079",17,79,1995,4727,4493,234,5
"17079",17,79,1996,4367,4074,293,6.7
"17079",17,79,1997,4026,3602,424,10.5
"17079",17,79,1998,4016,3662,354,8.8
"17079",17,79,1999,4046,3767,279,6.9
"17079",17,79,2000,5378,5127,251,4.7
"17079",17,79,2001,5349,5071,278,5.2
"17079",17,79,2002,5223,4935,288,5.5
"17079",17,79,2003,5098,4752,346,6.8
"17079",17,79,2004,5128,4816,312,6.1
"17079",17,79,2005,5190,4880,310,6
"17079",17,79,2006,5077,4830,247,4.9
"17079",17,79,2007,5207,4941,266,5.1
"17079",17,79,2008,5201,4864,337,6.5
"17079",17,79,2009,4942,4488,454,9.2
"17079",17,79,2010,5100,4646,454,8.9
"17079",17,79,2011,5001,4609,392,7.8
"17079",17,79,2012,4943,4566,377,7.6
"17079",17,79,2013,4729,4354,375,7.9
"17079",17,79,2014,4645,4348,297,6.4
"17079",17,79,2015,4638,4349,289,6.2
"17079",17,79,2016,4637,4349,288,6.2
"17079",17,79,2017,4520,4302,218,4.8
"17081",17,81,1990,17726,15935,1791,10.1
"17081",17,81,1991,17827,15842,1985,11.1
"17081",17,81,1992,17791,15797,1994,11.2
"17081",17,81,1993,18117,16431,1686,9.3
"17081",17,81,1994,17869,16472,1397,7.8
"17081",17,81,1995,18091,16914,1177,6.5
"17081",17,81,1996,18061,16653,1408,7.8
"17081",17,81,1997,17769,16588,1181,6.6
"17081",17,81,1998,18889,17833,1056,5.6
"17081",17,81,1999,18938,17932,1006,5.3
"17081",17,81,2000,19260,18303,957,5
"17081",17,81,2001,19457,18374,1083,5.6
"17081",17,81,2002,19475,18360,1115,5.7
"17081",17,81,2003,19149,17960,1189,6.2
"17081",17,81,2004,19401,18267,1134,5.8
"17081",17,81,2005,20333,19290,1043,5.1
"17081",17,81,2006,21036,20069,967,4.6
"17081",17,81,2007,21365,20318,1047,4.9
"17081",17,81,2008,20827,19542,1285,6.2
"17081",17,81,2009,20595,18627,1968,9.6
"17081",17,81,2010,18235,16374,1861,10.2
"17081",17,81,2011,18173,16479,1694,9.3
"17081",17,81,2012,17905,16260,1645,9.2
"17081",17,81,2013,17832,16134,1698,9.5
"17081",17,81,2014,17617,16300,1317,7.5
"17081",17,81,2015,17168,16008,1160,6.8
"17081",17,81,2016,17533,16421,1112,6.3
"17081",17,81,2017,17341,16406,935,5.4
"17083",17,83,1990,10290,9721,569,5.5
"17083",17,83,1991,10216,9510,706,6.9
"17083",17,83,1992,10301,9579,722,7
"17083",17,83,1993,10420,9617,803,7.7
"17083",17,83,1994,10094,9584,510,5.1
"17083",17,83,1995,10256,9689,567,5.5
"17083",17,83,1996,10465,9886,579,5.5
"17083",17,83,1997,10647,10148,499,4.7
"17083",17,83,1998,10704,10221,483,4.5
"17083",17,83,1999,10776,10297,479,4.4
"17083",17,83,2000,11234,10758,476,4.2
"17083",17,83,2001,11071,10528,543,4.9
"17083",17,83,2002,11046,10446,600,5.4
"17083",17,83,2003,10988,10347,641,5.8
"17083",17,83,2004,11140,10512,628,5.6
"17083",17,83,2005,11464,10853,611,5.3
"17083",17,83,2006,11774,11216,558,4.7
"17083",17,83,2007,11867,11230,637,5.4
"17083",17,83,2008,11790,11045,745,6.3
"17083",17,83,2009,11544,10460,1084,9.4
"17083",17,83,2010,11613,10550,1063,9.2
"17083",17,83,2011,11582,10547,1035,8.9
"17083",17,83,2012,11406,10379,1027,9
"17083",17,83,2013,11152,10153,999,9
"17083",17,83,2014,11077,10283,794,7.2
"17083",17,83,2015,11074,10372,702,6.3
"17083",17,83,2016,11035,10397,638,5.8
"17083",17,83,2017,10931,10413,518,4.7
"17085",17,85,1990,11478,11008,470,4.1
"17085",17,85,1991,11136,10513,623,5.6
"17085",17,85,1992,11892,11271,621,5.2
"17085",17,85,1993,12959,12382,577,4.5
"17085",17,85,1994,13421,12961,460,3.4
"17085",17,85,1995,13506,12980,526,3.9
"17085",17,85,1996,13310,12745,565,4.2
"17085",17,85,1997,12726,12241,485,3.8
"17085",17,85,1998,12831,12429,402,3.1
"17085",17,85,1999,13342,12837,505,3.8
"17085",17,85,2000,12900,12383,517,4
"17085",17,85,2001,12810,12184,626,4.9
"17085",17,85,2002,12561,11963,598,4.8
"17085",17,85,2003,12344,11657,687,5.6
"17085",17,85,2004,12463,11827,636,5.1
"17085",17,85,2005,12973,12431,542,4.2
"17085",17,85,2006,13514,13005,509,3.8
"17085",17,85,2007,13790,13237,553,4
"17085",17,85,2008,13420,12676,744,5.5
"17085",17,85,2009,13081,11908,1173,9
"17085",17,85,2010,12451,11343,1108,8.9
"17085",17,85,2011,12130,11170,960,7.9
"17085",17,85,2012,11891,10993,898,7.6
"17085",17,85,2013,11593,10709,884,7.6
"17085",17,85,2014,11562,10851,711,6.1
"17085",17,85,2015,11447,10820,627,5.5
"17085",17,85,2016,11355,10750,605,5.3
"17085",17,85,2017,11002,10518,484,4.4
"17087",17,87,1990,4304,3858,446,10.4
"17087",17,87,1991,4297,3810,487,11.3
"17087",17,87,1992,4337,3840,497,11.5
"17087",17,87,1993,4403,3886,517,11.7
"17087",17,87,1994,4433,4017,416,9.4
"17087",17,87,1995,4526,4171,355,7.8
"17087",17,87,1996,4643,4252,391,8.4
"17087",17,87,1997,4762,4428,334,7
"17087",17,87,1998,5029,4676,353,7
"17087",17,87,1999,5115,4839,276,5.4
"17087",17,87,2000,4892,4606,286,5.8
"17087",17,87,2001,4956,4676,280,5.6
"17087",17,87,2002,5005,4720,285,5.7
"17087",17,87,2003,4938,4600,338,6.8
"17087",17,87,2004,5029,4686,343,6.8
"17087",17,87,2005,5095,4786,309,6.1
"17087",17,87,2006,5249,4977,272,5.2
"17087",17,87,2007,5286,4954,332,6.3
"17087",17,87,2008,5121,4713,408,8
"17087",17,87,2009,5095,4559,536,10.5
"17087",17,87,2010,4454,3898,556,12.5
"17087",17,87,2011,4392,3878,514,11.7
"17087",17,87,2012,4308,3810,498,11.6
"17087",17,87,2013,4287,3764,523,12.2
"17087",17,87,2014,4160,3764,396,9.5
"17087",17,87,2015,4133,3780,353,8.5
"17087",17,87,2016,4200,3837,363,8.6
"17087",17,87,2017,4084,3785,299,7.3
"17089",17,89,1990,173189,163138,10051,5.8
"17089",17,89,1991,176389,162727,13662,7.7
"17089",17,89,1992,181681,166407,15274,8.4
"17089",17,89,1993,185224,171508,13716,7.4
"17089",17,89,1994,187071,176254,10817,5.8
"17089",17,89,1995,199838,190498,9340,4.7
"17089",17,89,1996,208099,198053,10046,4.8
"17089",17,89,1997,210872,202381,8491,4
"17089",17,89,1998,216216,208239,7977,3.7
"17089",17,89,1999,227055,218418,8637,3.8
"17089",17,89,2000,223778,214910,8868,4
"17089",17,89,2001,229200,217540,11660,5.1
"17089",17,89,2002,232350,217927,14423,6.2
"17089",17,89,2003,238534,222593,15941,6.7
"17089",17,89,2004,245845,231422,14423,5.9
"17089",17,89,2005,249485,235662,13823,5.5
"17089",17,89,2006,259217,248918,10299,4
"17089",17,89,2007,269449,257360,12089,4.5
"17089",17,89,2008,271767,255338,16429,6
"17089",17,89,2009,271256,242898,28358,10.5
"17089",17,89,2010,267214,237746,29468,11
"17089",17,89,2011,267240,241171,26069,9.8
"17089",17,89,2012,267616,243818,23798,8.9
"17089",17,89,2013,264804,241769,23035,8.7
"17089",17,89,2014,264897,246677,18220,6.9
"17089",17,89,2015,267465,252049,15416,5.8
"17089",17,89,2016,269190,254401,14789,5.5
"17089",17,89,2017,267675,255037,12638,4.7
"17091",17,91,1990,48910,45815,3095,6.3
"17091",17,91,1991,50202,46456,3746,7.5
"17091",17,91,1992,49997,45828,4169,8.3
"17091",17,91,1993,50361,46662,3699,7.3
"17091",17,91,1994,51572,48320,3252,6.3
"17091",17,91,1995,52313,49276,3037,5.8
"17091",17,91,1996,52620,49865,2755,5.2
"17091",17,91,1997,52942,50379,2563,4.8
"17091",17,91,1998,52602,49852,2750,5.2
"17091",17,91,1999,52658,50099,2559,4.9
"17091",17,91,2000,52870,50620,2250,4.3
"17091",17,91,2001,52155,49522,2633,5
"17091",17,91,2002,51698,48376,3322,6.4
"17091",17,91,2003,51211,47472,3739,7.3
"17091",17,91,2004,51532,47783,3749,7.3
"17091",17,91,2005,52672,49324,3348,6.4
"17091",17,91,2006,54299,51295,3004,5.5
"17091",17,91,2007,55889,52393,3496,6.3
"17091",17,91,2008,55903,51242,4661,8.3
"17091",17,91,2009,56196,49319,6877,12.2
"17091",17,91,2010,57454,50385,7069,12.3
"17091",17,91,2011,56864,50377,6487,11.4
"17091",17,91,2012,56653,50780,5873,10.4
"17091",17,91,2013,56153,50343,5810,10.3
"17091",17,91,2014,55811,51378,4433,7.9
"17091",17,91,2015,55189,51470,3719,6.7
"17091",17,91,2016,55571,52075,3496,6.3
"17091",17,91,2017,55854,52935,2919,5.2
"17093",17,93,1990,21914,20955,959,4.4
"17093",17,93,1991,22274,20942,1332,6
"17093",17,93,1992,22863,21392,1471,6.4
"17093",17,93,1993,23462,22152,1310,5.6
"17093",17,93,1994,24792,23593,1199,4.8
"17093",17,93,1995,25835,24765,1070,4.1
"17093",17,93,1996,27387,26222,1165,4.3
"17093",17,93,1997,28115,27114,1001,3.6
"17093",17,93,1998,29126,28211,915,3.1
"17093",17,93,1999,30683,29745,938,3.1
"17093",17,93,2000,32368,31303,1065,3.3
"17093",17,93,2001,33731,32294,1437,4.3
"17093",17,93,2002,34833,32870,1963,5.6
"17093",17,93,2003,37374,35219,2155,5.8
"17093",17,93,2004,40386,38218,2168,5.4
"17093",17,93,2005,44205,41985,2220,5
"17093",17,93,2006,49722,47797,1925,3.9
"17093",17,93,2007,55716,53308,2408,4.3
"17093",17,93,2008,59585,56150,3435,5.8
"17093",17,93,2009,60357,54244,6113,10.1
"17093",17,93,2010,62410,56085,6325,10.1
"17093",17,93,2011,62634,56793,5841,9.3
"17093",17,93,2012,63486,58179,5307,8.4
"17093",17,93,2013,64445,59053,5392,8.4
"17093",17,93,2014,65164,60981,4183,6.4
"17093",17,93,2015,66278,62846,3432,5.2
"17093",17,93,2016,68095,64598,3497,5.1
"17093",17,93,2017,67862,64820,3042,4.5
"17095",17,95,1990,29357,27525,1832,6.2
"17095",17,95,1991,29199,27246,1953,6.7
"17095",17,95,1992,29797,27788,2009,6.7
"17095",17,95,1993,29571,27774,1797,6.1
"17095",17,95,1994,29033,27622,1411,4.9
"17095",17,95,1995,28643,27369,1274,4.4
"17095",17,95,1996,28702,27345,1357,4.7
"17095",17,95,1997,29069,27942,1127,3.9
"17095",17,95,1998,29469,28424,1045,3.5
"17095",17,95,1999,29902,28855,1047,3.5
"17095",17,95,2000,28228,26959,1269,4.5
"17095",17,95,2001,27231,25739,1492,5.5
"17095",17,95,2002,26568,24734,1834,6.9
"17095",17,95,2003,25870,23866,2004,7.7
"17095",17,95,2004,25644,23679,1965,7.7
"17095",17,95,2005,25341,23503,1838,7.3
"17095",17,95,2006,25580,24253,1327,5.2
"17095",17,95,2007,25636,24356,1280,5
"17095",17,95,2008,25565,23925,1640,6.4
"17095",17,95,2009,25980,23477,2503,9.6
"17095",17,95,2010,25353,22931,2422,9.6
"17095",17,95,2011,24853,22667,2186,8.8
"17095",17,95,2012,24417,22388,2029,8.3
"17095",17,95,2013,23673,21576,2097,8.9
"17095",17,95,2014,23586,21952,1634,6.9
"17095",17,95,2015,23199,21787,1412,6.1
"17095",17,95,2016,22895,21500,1395,6.1
"17095",17,95,2017,22472,21328,1144,5.1
"17097",17,97,1990,288664,277909,10755,3.7
"17097",17,97,1991,288382,274628,13754,4.8
"17097",17,97,1992,291994,276566,15428,5.3
"17097",17,97,1993,296228,281108,15120,5.1
"17097",17,97,1994,299088,285565,13523,4.5
"17097",17,97,1995,305213,294225,10988,3.6
"17097",17,97,1996,314769,303626,11143,3.5
"17097",17,97,1997,321733,311828,9905,3.1
"17097",17,97,1998,329066,318690,10376,3.2
"17097",17,97,1999,333093,323136,9957,3
"17097",17,97,2000,341564,330057,11507,3.4
"17097",17,97,2001,338306,324133,14173,4.2
"17097",17,97,2002,339373,321542,17831,5.3
"17097",17,97,2003,341104,321483,19621,5.8
"17097",17,97,2004,345512,327384,18128,5.2
"17097",17,97,2005,355521,339088,16433,4.6
"17097",17,97,2006,365625,350304,15321,4.2
"17097",17,97,2007,372457,354669,17788,4.8
"17097",17,97,2008,371016,347350,23666,6.4
"17097",17,97,2009,363170,327443,35727,9.8
"17097",17,97,2010,369868,333465,36403,9.8
"17097",17,97,2011,368282,335755,32527,8.8
"17097",17,97,2012,367964,338183,29781,8.1
"17097",17,97,2013,364318,335522,28796,7.9
"17097",17,97,2014,365199,341670,23529,6.4
"17097",17,97,2015,367049,347276,19773,5.4
"17097",17,97,2016,371647,352394,19253,5.2
"17097",17,97,2017,370972,354622,16350,4.4
"17099",17,99,1990,51555,47488,4067,7.9
"17099",17,99,1991,52989,48434,4555,8.6
"17099",17,99,1992,54473,49132,5341,9.8
"17099",17,99,1993,55732,50529,5203,9.3
"17099",17,99,1994,55029,50840,4189,7.6
"17099",17,99,1995,54793,50904,3889,7.1
"17099",17,99,1996,54641,50713,3928,7.2
"17099",17,99,1997,54806,51415,3391,6.2
"17099",17,99,1998,56677,53621,3056,5.4
"17099",17,99,1999,57829,54546,3283,5.7
"17099",17,99,2000,56839,54009,2830,5
"17099",17,99,2001,56125,52943,3182,5.7
"17099",17,99,2002,55065,51232,3833,7
"17099",17,99,2003,54081,49889,4192,7.8
"17099",17,99,2004,54954,51054,3900,7.1
"17099",17,99,2005,56714,53276,3438,6.1
"17099",17,99,2006,57613,54572,3041,5.3
"17099",17,99,2007,59225,55708,3517,5.9
"17099",17,99,2008,59085,54522,4563,7.7
"17099",17,99,2009,59434,52189,7245,12.2
"17099",17,99,2010,61857,54429,7428,12
"17099",17,99,2011,60829,54345,6484,10.7
"17099",17,99,2012,59584,53608,5976,10
"17099",17,99,2013,58114,52108,6006,10.3
"17099",17,99,2014,57202,52544,4658,8.1
"17099",17,99,2015,57378,53378,4000,7
"17099",17,99,2016,56996,53179,3817,6.7
"17099",17,99,2017,55642,52569,3073,5.5
"17101",17,101,1990,7116,6523,593,8.3
"17101",17,101,1991,7497,6798,699,9.3
"17101",17,101,1992,7212,6540,672,9.3
"17101",17,101,1993,7248,6714,534,7.4
"17101",17,101,1994,7140,6584,556,7.8
"17101",17,101,1995,6967,6435,532,7.6
"17101",17,101,1996,7046,6320,726,10.3
"17101",17,101,1997,6800,6260,540,7.9
"17101",17,101,1998,7154,6683,471,6.6
"17101",17,101,1999,6805,6358,447,6.6
"17101",17,101,2000,8162,7734,428,5.2
"17101",17,101,2001,8131,7692,439,5.4
"17101",17,101,2002,8233,7799,434,5.3
"17101",17,101,2003,8162,7668,494,6.1
"17101",17,101,2004,8265,7786,479,5.8
"17101",17,101,2005,8359,7929,430,5.1
"17101",17,101,2006,8421,8021,400,4.8
"17101",17,101,2007,8422,8020,402,4.8
"17101",17,101,2008,8290,7682,608,7.3
"17101",17,101,2009,8182,7362,820,10
"17101",17,101,2010,6707,5988,719,10.7
"17101",17,101,2011,6572,5873,699,10.6
"17101",17,101,2012,6484,5824,660,10.2
"17101",17,101,2013,6328,5682,646,10.2
"17101",17,101,2014,6347,5854,493,7.8
"17101",17,101,2015,6142,5706,436,7.1
"17101",17,101,2016,6163,5710,453,7.4
"17101",17,101,2017,6042,5681,361,6
"17103",17,103,1990,16734,15941,793,4.7
"17103",17,103,1991,16825,15723,1102,6.5
"17103",17,103,1992,16847,15787,1060,6.3
"17103",17,103,1993,17207,16185,1022,5.9
"17103",17,103,1994,17365,16611,754,4.3
"17103",17,103,1995,17383,16612,771,4.4
"17103",17,103,1996,17876,17167,709,4
"17103",17,103,1997,18006,17373,633,3.5
"17103",17,103,1998,18294,17701,593,3.2
"17103",17,103,1999,18431,17763,668,3.6
"17103",17,103,2000,17855,17144,711,4
"17103",17,103,2001,17609,16768,841,4.8
"17103",17,103,2002,17317,16390,927,5.4
"17103",17,103,2003,17156,16086,1070,6.2
"17103",17,103,2004,17507,16519,988,5.6
"17103",17,103,2005,17993,17088,905,5
"17103",17,103,2006,18524,17717,807,4.4
"17103",17,103,2007,18624,17687,937,5
"17103",17,103,2008,18220,16977,1243,6.8
"17103",17,103,2009,18308,16391,1917,10.5
"17103",17,103,2010,19239,17311,1928,10
"17103",17,103,2011,18831,17124,1707,9.1
"17103",17,103,2012,18247,16736,1511,8.3
"17103",17,103,2013,18094,16644,1450,8
"17103",17,103,2014,18142,17007,1135,6.3
"17103",17,103,2015,17839,16887,952,5.3
"17103",17,103,2016,17987,17074,913,5.1
"17103",17,103,2017,17784,17028,756,4.3
"17105",17,105,1990,19400,18809,591,3
"17105",17,105,1991,19810,18966,844,4.3
"17105",17,105,1992,20001,19011,990,4.9
"17105",17,105,1993,20219,19332,887,4.4
"17105",17,105,1994,19638,19003,635,3.2
"17105",17,105,1995,19316,18668,648,3.4
"17105",17,105,1996,19519,18682,837,4.3
"17105",17,105,1997,19276,18666,610,3.2
"17105",17,105,1998,20305,19743,562,2.8
"17105",17,105,1999,20840,20237,603,2.9
"17105",17,105,2000,19677,18977,700,3.6
"17105",17,105,2001,19455,18622,833,4.3
"17105",17,105,2002,18933,17958,975,5.1
"17105",17,105,2003,18590,17516,1074,5.8
"17105",17,105,2004,18435,17464,971,5.3
"17105",17,105,2005,18393,17488,905,4.9
"17105",17,105,2006,18872,18098,774,4.1
"17105",17,105,2007,19679,18808,871,4.4
"17105",17,105,2008,19387,18258,1129,5.8
"17105",17,105,2009,19293,17310,1983,10.3
"17105",17,105,2010,19316,17390,1926,10
"17105",17,105,2011,18826,17238,1588,8.4
"17105",17,105,2012,18228,16819,1409,7.7
"17105",17,105,2013,17691,16262,1429,8.1
"17105",17,105,2014,17468,16351,1117,6.4
"17105",17,105,2015,17243,16315,928,5.4
"17105",17,105,2016,16986,16076,910,5.4
"17105",17,105,2017,16611,15882,729,4.4
"17107",17,107,1990,14195,13463,732,5.2
"17107",17,107,1991,14139,13298,841,5.9
"17107",17,107,1992,13838,12891,947,6.8
"17107",17,107,1993,13632,12877,755,5.5
"17107",17,107,1994,13210,12661,549,4.2
"17107",17,107,1995,12865,12339,526,4.1
"17107",17,107,1996,12978,12259,719,5.5
"17107",17,107,1997,12707,12116,591,4.7
"17107",17,107,1998,13637,13154,483,3.5
"17107",17,107,1999,14486,14019,467,3.2
"17107",17,107,2000,15173,14617,556,3.7
"17107",17,107,2001,14505,13890,615,4.2
"17107",17,107,2002,14133,13353,780,5.5
"17107",17,107,2003,13256,12364,892,6.7
"17107",17,107,2004,13285,12509,776,5.8
"17107",17,107,2005,13311,12574,737,5.5
"17107",17,107,2006,13372,12762,610,4.6
"17107",17,107,2007,13537,12891,646,4.8
"17107",17,107,2008,13397,12516,881,6.6
"17107",17,107,2009,13354,12116,1238,9.3
"17107",17,107,2010,13959,12748,1211,8.7
"17107",17,107,2011,13716,12652,1064,7.8
"17107",17,107,2012,13546,12533,1013,7.5
"17107",17,107,2013,13094,12037,1057,8.1
"17107",17,107,2014,13024,12192,832,6.4
"17107",17,107,2015,13008,12305,703,5.4
"17107",17,107,2016,13051,12364,687,5.3
"17107",17,107,2017,12827,12246,581,4.5
"17109",17,109,1990,16865,16320,545,3.2
"17109",17,109,1991,18096,17418,678,3.7
"17109",17,109,1992,18375,17720,655,3.6
"17109",17,109,1993,18619,18031,588,3.2
"17109",17,109,1994,18964,18495,469,2.5
"17109",17,109,1995,18761,18329,432,2.3
"17109",17,109,1996,19143,18726,417,2.2
"17109",17,109,1997,18869,18492,377,2
"17109",17,109,1998,17929,17561,368,2.1
"17109",17,109,1999,17017,16632,385,2.3
"17109",17,109,2000,16993,16313,680,4
"17109",17,109,2001,16601,15875,726,4.4
"17109",17,109,2002,16536,15748,788,4.8
"17109",17,109,2003,16143,15200,943,5.8
"17109",17,109,2004,16621,15788,833,5
"17109",17,109,2005,16500,15737,763,4.6
"17109",17,109,2006,17275,16584,691,4
"17109",17,109,2007,17292,16563,729,4.2
"17109",17,109,2008,16892,15972,920,5.4
"17109",17,109,2009,16951,15496,1455,8.6
"17109",17,109,2010,15646,14311,1335,8.5
"17109",17,109,2011,15143,13945,1198,7.9
"17109",17,109,2012,15025,13876,1149,7.6
"17109",17,109,2013,14635,13421,1214,8.3
"17109",17,109,2014,14292,13316,976,6.8
"17109",17,109,2015,14066,13210,856,6.1
"17109",17,109,2016,14001,13131,870,6.2
"17109",17,109,2017,13485,12827,658,4.9
"17111",17,111,1990,102855,97430,5425,5.3
"17111",17,111,1991,106223,98966,7257,6.8
"17111",17,111,1992,110699,102679,8020,7.2
"17111",17,111,1993,115325,107773,7552,6.5
"17111",17,111,1994,121004,114951,6053,5
"17111",17,111,1995,126843,121453,5390,4.2
"17111",17,111,1996,131338,125769,5569,4.2
"17111",17,111,1997,132770,127387,5383,4.1
"17111",17,111,1998,135462,130285,5177,3.8
"17111",17,111,1999,140756,135762,4994,3.5
"17111",17,111,2000,151416,145988,5428,3.6
"17111",17,111,2001,154979,147730,7249,4.7
"17111",17,111,2002,154970,146051,8919,5.8
"17111",17,111,2003,158544,149079,9465,6
"17111",17,111,2004,161777,153180,8597,5.3
"17111",17,111,2005,166361,157880,8481,5.1
"17111",17,111,2006,173192,166580,6612,3.8
"17111",17,111,2007,178885,171106,7779,4.3
"17111",17,111,2008,180529,170098,10431,5.8
"17111",17,111,2009,181149,163369,17780,9.8
"17111",17,111,2010,168798,151014,17784,10.5
"17111",17,111,2011,166760,150286,16474,9.9
"17111",17,111,2012,167014,152016,14998,9
"17111",17,111,2013,166937,152512,14425,8.6
"17111",17,111,2014,165732,154853,10879,6.6
"17111",17,111,2015,165957,156973,8984,5.4
"17111",17,111,2016,168203,159347,8856,5.3
"17111",17,111,2017,167389,159780,7609,4.5
"17113",17,113,1990,74590,72175,2415,3.2
"17113",17,113,1991,75827,73023,2804,3.7
"17113",17,113,1992,77678,74633,3045,3.9
"17113",17,113,1993,77113,74337,2776,3.6
"17113",17,113,1994,78905,76820,2085,2.6
"17113",17,113,1995,79960,77852,2108,2.6
"17113",17,113,1996,80993,78725,2268,2.8
"17113",17,113,1997,84048,82177,1871,2.2
"17113",17,113,1998,87765,86011,1754,2
"17113",17,113,1999,92222,90398,1824,2
"17113",17,113,2000,86307,83643,2664,3.1
"17113",17,113,2001,86175,83420,2755,3.2
"17113",17,113,2002,86495,83348,3147,3.6
"17113",17,113,2003,85369,81892,3477,4.1
"17113",17,113,2004,85117,81409,3708,4.4
"17113",17,113,2005,87165,83611,3554,4.1
"17113",17,113,2006,88820,85830,2990,3.4
"17113",17,113,2007,90552,87179,3373,3.7
"17113",17,113,2008,90615,86181,4434,4.9
"17113",17,113,2009,91493,84871,6622,7.2
"17113",17,113,2010,96144,89357,6787,7.1
"17113",17,113,2011,95328,89019,6309,6.6
"17113",17,113,2012,94562,88530,6032,6.4
"17113",17,113,2013,92348,86251,6097,6.6
"17113",17,113,2014,90778,85807,4971,5.5
"17113",17,113,2015,90841,86482,4359,4.8
"17113",17,113,2016,89977,85453,4524,5
"17113",17,113,2017,88354,84768,3586,4.1
"17115",17,115,1990,60236,56438,3798,6.3
"17115",17,115,1991,61257,56263,4994,8.2
"17115",17,115,1992,61691,56300,5391,8.7
"17115",17,115,1993,60810,55596,5214,8.6
"17115",17,115,1994,60548,56187,4361,7.2
"17115",17,115,1995,60597,56460,4137,6.8
"17115",17,115,1996,60486,56046,4440,7.3
"17115",17,115,1997,60067,56407,3660,6.1
"17115",17,115,1998,59330,56510,2820,4.8
"17115",17,115,1999,61212,58567,2645,4.3
"17115",17,115,2000,56346,53613,2733,4.9
"17115",17,115,2001,54019,50795,3224,6
"17115",17,115,2002,52545,48539,4006,7.6
"17115",17,115,2003,51487,47547,3940,7.7
"17115",17,115,2004,51838,48332,3506,6.8
"17115",17,115,2005,52836,49634,3202,6.1
"17115",17,115,2006,53750,50935,2815,5.2
"17115",17,115,2007,54603,51550,3053,5.6
"17115",17,115,2008,54586,50876,3710,6.8
"17115",17,115,2009,54824,48534,6290,11.5
"17115",17,115,2010,55196,49034,6162,11.2
"17115",17,115,2011,54902,49416,5486,10
"17115",17,115,2012,54313,48928,5385,9.9
"17115",17,115,2013,52457,46506,5951,11.3
"17115",17,115,2014,50797,46459,4338,8.5
"17115",17,115,2015,50527,46989,3538,7
"17115",17,115,2016,50182,46888,3294,6.6
"17115",17,115,2017,49202,46514,2688,5.5
"17117",17,117,1990,23460,22021,1439,6.1
"17117",17,117,1991,22953,21223,1730,7.5
"17117",17,117,1992,23495,21618,1877,8
"17117",17,117,1993,23551,21733,1818,7.7
"17117",17,117,1994,22657,21263,1394,6.2
"17117",17,117,1995,22708,21412,1296,5.7
"17117",17,117,1996,23032,21672,1360,5.9
"17117",17,117,1997,22908,21775,1133,4.9
"17117",17,117,1998,23120,22055,1065,4.6
"17117",17,117,1999,23416,22340,1076,4.6
"17117",17,117,2000,24597,23566,1031,4.2
"17117",17,117,2001,24218,22982,1236,5.1
"17117",17,117,2002,23908,22556,1352,5.7
"17117",17,117,2003,23812,22242,1570,6.6
"17117",17,117,2004,23843,22359,1484,6.2
"17117",17,117,2005,24383,22987,1396,5.7
"17117",17,117,2006,24718,23447,1271,5.1
"17117",17,117,2007,24830,23361,1469,5.9
"17117",17,117,2008,24577,22762,1815,7.4
"17117",17,117,2009,24007,21463,2544,10.6
"17117",17,117,2010,24784,22230,2554,10.3
"17117",17,117,2011,24754,22352,2402,9.7
"17117",17,117,2012,24081,21799,2282,9.5
"17117",17,117,2013,23472,21253,2219,9.5
"17117",17,117,2014,23130,21403,1727,7.5
"17117",17,117,2015,23044,21587,1457,6.3
"17117",17,117,2016,23313,21938,1375,5.9
"17117",17,117,2017,23071,21971,1100,4.8
"17119",17,119,1990,128227,120551,7676,6
"17119",17,119,1991,126714,117653,9061,7.2
"17119",17,119,1992,127195,117795,9400,7.4
"17119",17,119,1993,126392,117801,8591,6.8
"17119",17,119,1994,125615,119161,6454,5.1
"17119",17,119,1995,126054,119559,6495,5.2
"17119",17,119,1996,128880,122430,6450,5
"17119",17,119,1997,131275,125913,5362,4.1
"17119",17,119,1998,130960,125557,5403,4.1
"17119",17,119,1999,131523,126275,5248,4
"17119",17,119,2000,133862,128440,5422,4.1
"17119",17,119,2001,132161,125872,6289,4.8
"17119",17,119,2002,130915,123800,7115,5.4
"17119",17,119,2003,131111,123036,8075,6.2
"17119",17,119,2004,131636,123744,7892,6
"17119",17,119,2005,134905,127539,7366,5.5
"17119",17,119,2006,138025,131298,6727,4.9
"17119",17,119,2007,141006,133485,7521,5.3
"17119",17,119,2008,139675,130675,9000,6.4
"17119",17,119,2009,138514,124337,14177,10.2
"17119",17,119,2010,138772,125142,13630,9.8
"17119",17,119,2011,137725,125400,12325,8.9
"17119",17,119,2012,135756,123818,11938,8.8
"17119",17,119,2013,133228,121394,11834,8.9
"17119",17,119,2014,132268,122960,9308,7
"17119",17,119,2015,132970,124983,7987,6
"17119",17,119,2016,134851,126988,7863,5.8
"17119",17,119,2017,133452,127266,6186,4.6
"17121",17,121,1990,19778,17595,2183,11
"17121",17,121,1991,19973,17817,2156,10.8
"17121",17,121,1992,20780,18678,2102,10.1
"17121",17,121,1993,21246,19117,2129,10
"17121",17,121,1994,20941,19319,1622,7.7
"17121",17,121,1995,21197,19630,1567,7.4
"17121",17,121,1996,21049,19401,1648,7.8
"17121",17,121,1997,21116,19580,1536,7.3
"17121",17,121,1998,20831,19511,1320,6.3
"17121",17,121,1999,21139,19936,1203,5.7
"17121",17,121,2000,20892,19780,1112,5.3
"17121",17,121,2001,19987,18362,1625,8.1
"17121",17,121,2002,18750,17173,1577,8.4
"17121",17,121,2003,18313,16626,1687,9.2
"17121",17,121,2004,17752,16351,1401,7.9
"17121",17,121,2005,17961,16830,1131,6.3
"17121",17,121,2006,18557,17496,1061,5.7
"17121",17,121,2007,18907,17709,1198,6.3
"17121",17,121,2008,18550,17022,1528,8.2
"17121",17,121,2009,18338,16151,2187,11.9
"17121",17,121,2010,19396,17297,2099,10.8
"17121",17,121,2011,19114,17202,1912,10
"17121",17,121,2012,18683,16857,1826,9.8
"17121",17,121,2013,18113,16291,1822,10.1
"17121",17,121,2014,18043,16669,1374,7.6
"17121",17,121,2015,18088,16865,1223,6.8
"17121",17,121,2016,17990,16853,1137,6.3
"17121",17,121,2017,17637,16730,907,5.1
"17123",17,123,1990,6393,6126,267,4.2
"17123",17,123,1991,6592,6211,381,5.8
"17123",17,123,1992,6988,6564,424,6.1
"17123",17,123,1993,6631,6265,366,5.5
"17123",17,123,1994,6529,6210,319,4.9
"17123",17,123,1995,6405,6124,281,4.4
"17123",17,123,1996,6622,6196,426,6.4
"17123",17,123,1997,6550,6299,251,3.8
"17123",17,123,1998,7005,6771,234,3.3
"17123",17,123,1999,6709,6452,257,3.8
"17123",17,123,2000,7065,6793,272,3.8
"17123",17,123,2001,6893,6567,326,4.7
"17123",17,123,2002,6812,6404,408,6
"17123",17,123,2003,6694,6311,383,5.7
"17123",17,123,2004,6841,6503,338,4.9
"17123",17,123,2005,7115,6805,310,4.4
"17123",17,123,2006,7243,6966,277,3.8
"17123",17,123,2007,7345,7027,318,4.3
"17123",17,123,2008,7235,6844,391,5.4
"17123",17,123,2009,7117,6370,747,10.5
"17123",17,123,2010,6428,5769,659,10.3
"17123",17,123,2011,6342,5779,563,8.9
"17123",17,123,2012,6227,5711,516,8.3
"17123",17,123,2013,5907,5368,539,9.1
"17123",17,123,2014,5755,5352,403,7
"17123",17,123,2015,5708,5330,378,6.6
"17123",17,123,2016,5619,5250,369,6.6
"17123",17,123,2017,5470,5180,290,5.3
"17125",17,125,1990,7696,7168,528,6.9
"17125",17,125,1991,8032,7243,789,9.8
"17125",17,125,1992,7850,6999,851,10.8
"17125",17,125,1993,8246,7489,757,9.2
"17125",17,125,1994,8377,7804,573,6.8
"17125",17,125,1995,8077,7571,506,6.3
"17125",17,125,1996,8252,7594,658,8
"17125",17,125,1997,8172,7653,519,6.4
"17125",17,125,1998,8426,7960,466,5.5
"17125",17,125,1999,8482,7987,495,5.8
"17125",17,125,2000,7971,7540,431,5.4
"17125",17,125,2001,8008,7521,487,6.1
"17125",17,125,2002,7893,7344,549,7
"17125",17,125,2003,7624,7004,620,8.1
"17125",17,125,2004,7617,7030,587,7.7
"17125",17,125,2005,7594,7094,500,6.6
"17125",17,125,2006,7466,7039,427,5.7
"17125",17,125,2007,7425,6943,482,6.5
"17125",17,125,2008,7388,6811,577,7.8
"17125",17,125,2009,7573,6642,931,12.3
"17125",17,125,2010,7433,6525,908,12.2
"17125",17,125,2011,7169,6407,762,10.6
"17125",17,125,2012,7018,6315,703,10
"17125",17,125,2013,6735,5998,737,10.9
"17125",17,125,2014,6636,6066,570,8.6
"17125",17,125,2015,6607,6136,471,7.1
"17125",17,125,2016,6426,5972,454,7.1
"17125",17,125,2017,6375,5995,380,6
"17127",17,127,1990,6615,6167,448,6.8
"17127",17,127,1991,6751,6274,477,7.1
"17127",17,127,1992,6999,6395,604,8.6
"17127",17,127,1993,7724,7219,505,6.5
"17127",17,127,1994,7558,7144,414,5.5
"17127",17,127,1995,7809,7436,373,4.8
"17127",17,127,1996,7619,7264,355,4.7
"17127",17,127,1997,7863,7565,298,3.8
"17127",17,127,1998,8227,7895,332,4
"17127",17,127,1999,8142,7807,335,4.1
"17127",17,127,2000,7274,6914,360,4.9
"17127",17,127,2001,7172,6800,372,5.2
"17127",17,127,2002,7172,6743,429,6
"17127",17,127,2003,7105,6659,446,6.3
"17127",17,127,2004,7191,6761,430,6
"17127",17,127,2005,7387,6986,401,5.4
"17127",17,127,2006,7460,7066,394,5.3
"17127",17,127,2007,7668,7240,428,5.6
"17127",17,127,2008,7412,6893,519,7
"17127",17,127,2009,7161,6518,643,9
"17127",17,127,2010,7072,6401,671,9.5
"17127",17,127,2011,7117,6488,629,8.8
"17127",17,127,2012,6579,5948,631,9.6
"17127",17,127,2013,6407,5779,628,9.8
"17127",17,127,2014,6318,5814,504,8
"17127",17,127,2015,6107,5664,443,7.3
"17127",17,127,2016,6022,5600,422,7
"17127",17,127,2017,5875,5503,372,6.3
"17129",17,129,1990,6089,5847,242,4
"17129",17,129,1991,6210,5923,287,4.6
"17129",17,129,1992,6160,5860,300,4.9
"17129",17,129,1993,6129,5838,291,4.7
"17129",17,129,1994,6147,5908,239,3.9
"17129",17,129,1995,6035,5799,236,3.9
"17129",17,129,1996,6141,5880,261,4.3
"17129",17,129,1997,6221,5994,227,3.6
"17129",17,129,1998,6263,6056,207,3.3
"17129",17,129,1999,6316,6111,205,3.2
"17129",17,129,2000,7081,6846,235,3.3
"17129",17,129,2001,7003,6728,275,3.9
"17129",17,129,2002,6878,6584,294,4.3
"17129",17,129,2003,6679,6361,318,4.8
"17129",17,129,2004,6809,6468,341,5
"17129",17,129,2005,6982,6675,307,4.4
"17129",17,129,2006,6969,6695,274,3.9
"17129",17,129,2007,6978,6671,307,4.4
"17129",17,129,2008,6926,6547,379,5.5
"17129",17,129,2009,6905,6394,511,7.4
"17129",17,129,2010,7151,6613,538,7.5
"17129",17,129,2011,7138,6623,515,7.2
"17129",17,129,2012,7013,6522,491,7
"17129",17,129,2013,6730,6256,474,7
"17129",17,129,2014,6748,6368,380,5.6
"17129",17,129,2015,6738,6421,317,4.7
"17129",17,129,2016,6883,6571,312,4.5
"17129",17,129,2017,6723,6453,270,4
"17131",17,131,1990,8632,8108,524,6.1
"17131",17,131,1991,8697,8076,621,7.1
"17131",17,131,1992,8598,7857,741,8.6
"17131",17,131,1993,8843,8170,673,7.6
"17131",17,131,1994,8543,8018,525,6.1
"17131",17,131,1995,8408,7931,477,5.7
"17131",17,131,1996,8379,7924,455,5.4
"17131",17,131,1997,9112,8697,415,4.6
"17131",17,131,1998,9248,8840,408,4.4
"17131",17,131,1999,9432,8868,564,6
"17131",17,131,2000,8910,8448,462,5.2
"17131",17,131,2001,8712,8241,471,5.4
"17131",17,131,2002,8606,8038,568,6.6
"17131",17,131,2003,8535,7932,603,7.1
"17131",17,131,2004,8713,8145,568,6.5
"17131",17,131,2005,8911,8425,486,5.5
"17131",17,131,2006,9020,8544,476,5.3
"17131",17,131,2007,8990,8508,482,5.4
"17131",17,131,2008,8928,8333,595,6.7
"17131",17,131,2009,8648,7756,892,10.3
"17131",17,131,2010,8955,8062,893,10
"17131",17,131,2011,8834,8096,738,8.4
"17131",17,131,2012,8645,7976,669,7.7
"17131",17,131,2013,8396,7736,660,7.9
"17131",17,131,2014,8285,7703,582,7
"17131",17,131,2015,8192,7679,513,6.3
"17131",17,131,2016,8172,7667,505,6.2
"17131",17,131,2017,8067,7662,405,5
"17133",17,133,1990,12341,11631,710,5.8
"17133",17,133,1991,12163,11483,680,5.6
"17133",17,133,1992,12504,11684,820,6.6
"17133",17,133,1993,12495,11861,634,5.1
"17133",17,133,1994,12467,12059,408,3.3
"17133",17,133,1995,12821,12399,422,3.3
"17133",17,133,1996,13328,12899,429,3.2
"17133",17,133,1997,13832,13444,388,2.8
"17133",17,133,1998,14186,13785,401,2.8
"17133",17,133,1999,14567,14189,378,2.6
"17133",17,133,2000,15662,15184,478,3.1
"17133",17,133,2001,15680,15107,573,3.7
"17133",17,133,2002,15848,15204,644,4.1
"17133",17,133,2003,16079,15335,744,4.6
"17133",17,133,2004,16521,15798,723,4.4
"17133",17,133,2005,17252,16521,731,4.2
"17133",17,133,2006,18091,17400,691,3.8
"17133",17,133,2007,18611,17829,782,4.2
"17133",17,133,2008,18600,17638,962,5.2
"17133",17,133,2009,18415,16979,1436,7.8
"17133",17,133,2010,18009,16694,1315,7.3
"17133",17,133,2011,18117,16898,1219,6.7
"17133",17,133,2012,17954,16746,1208,6.7
"17133",17,133,2013,17731,16545,1186,6.7
"17133",17,133,2014,17877,16917,960,5.4
"17133",17,133,2015,18090,17298,792,4.4
"17133",17,133,2016,18454,17712,742,4
"17133",17,133,2017,18356,17752,604,3.3
"17135",17,135,1990,14170,13154,1016,7.2
"17135",17,135,1991,14177,13070,1107,7.8
"17135",17,135,1992,15017,13743,1274,8.5
"17135",17,135,1993,14541,13238,1303,9
"17135",17,135,1994,14455,13434,1021,7.1
"17135",17,135,1995,14475,13469,1006,6.9
"17135",17,135,1996,15190,14079,1111,7.3
"17135",17,135,1997,14996,14039,957,6.4
"17135",17,135,1998,15655,14546,1109,7.1
"17135",17,135,1999,15814,14892,922,5.8
"17135",17,135,2000,14267,13516,751,5.3
"17135",17,135,2001,13838,12999,839,6.1
"17135",17,135,2002,13459,12525,934,6.9
"17135",17,135,2003,13184,12037,1147,8.7
"17135",17,135,2004,13167,12127,1040,7.9
"17135",17,135,2005,13439,12509,930,6.9
"17135",17,135,2006,13594,12773,821,6
"17135",17,135,2007,13676,12784,892,6.5
"17135",17,135,2008,13443,12295,1148,8.5
"17135",17,135,2009,13332,11749,1583,11.9
"17135",17,135,2010,13903,12195,1708,12.3
"17135",17,135,2011,13651,12030,1621,11.9
"17135",17,135,2012,13202,11727,1475,11.2
"17135",17,135,2013,12603,11228,1375,10.9
"17135",17,135,2014,12138,11077,1061,8.7
"17135",17,135,2015,12036,11126,910,7.6
"17135",17,135,2016,12115,11265,850,7
"17135",17,135,2017,11886,11218,668,5.6
"17137",17,137,1990,19173,18423,750,3.9
"17137",17,137,1991,19262,18363,899,4.7
"17137",17,137,1992,18786,17696,1090,5.8
"17137",17,137,1993,18908,17996,912,4.8
"17137",17,137,1994,18586,17815,771,4.1
"17137",17,137,1995,18276,17414,862,4.7
"17137",17,137,1996,18232,17388,844,4.6
"17137",17,137,1997,18386,17647,739,4
"17137",17,137,1998,18730,18062,668,3.6
"17137",17,137,1999,19264,18612,652,3.4
"17137",17,137,2000,18995,18256,739,3.9
"17137",17,137,2001,18186,17382,804,4.4
"17137",17,137,2002,17920,17015,905,5.1
"17137",17,137,2003,17845,16805,1040,5.8
"17137",17,137,2004,17664,16583,1081,6.1
"17137",17,137,2005,17624,16651,973,5.5
"17137",17,137,2006,17737,16895,842,4.7
"17137",17,137,2007,18106,17225,881,4.9
"17137",17,137,2008,17943,16859,1084,6
"17137",17,137,2009,17572,16153,1419,8.1
"17137",17,137,2010,18416,16865,1551,8.4
"17137",17,137,2011,18132,16676,1456,8
"17137",17,137,2012,17794,16427,1367,7.7
"17137",17,137,2013,17403,16038,1365,7.8
"17137",17,137,2014,17214,16189,1025,6
"17137",17,137,2015,16978,16129,849,5
"17137",17,137,2016,16968,16141,827,4.9
"17137",17,137,2017,16437,15732,705,4.3
"17139",17,139,1990,6875,6486,389,5.7
"17139",17,139,1991,7203,6738,465,6.5
"17139",17,139,1992,7594,7083,511,6.7
"17139",17,139,1993,7927,7448,479,6
"17139",17,139,1994,7975,7623,352,4.4
"17139",17,139,1995,7983,7658,325,4.1
"17139",17,139,1996,7968,7671,297,3.7
"17139",17,139,1997,7849,7593,256,3.3
"17139",17,139,1998,7701,7477,224,2.9
"17139",17,139,1999,8179,7960,219,2.7
"17139",17,139,2000,7524,7230,294,3.9
"17139",17,139,2001,7456,7118,338,4.5
"17139",17,139,2002,7360,6974,386,5.2
"17139",17,139,2003,7224,6824,400,5.5
"17139",17,139,2004,7633,7256,377,4.9
"17139",17,139,2005,8021,7696,325,4.1
"17139",17,139,2006,8174,7893,281,3.4
"17139",17,139,2007,8192,7897,295,3.6
"17139",17,139,2008,8014,7609,405,5.1
"17139",17,139,2009,7857,7173,684,8.7
"17139",17,139,2010,7678,7022,656,8.5
"17139",17,139,2011,7456,6888,568,7.6
"17139",17,139,2012,7395,6868,527,7.1
"17139",17,139,2013,7095,6584,511,7.2
"17139",17,139,2014,7045,6663,382,5.4
"17139",17,139,2015,7362,7041,321,4.4
"17139",17,139,2016,7422,7086,336,4.5
"17139",17,139,2017,7269,6990,279,3.8
"17141",17,141,1990,25607,24335,1272,5
"17141",17,141,1991,25689,24036,1653,6.4
"17141",17,141,1992,25866,24135,1731,6.7
"17141",17,141,1993,26156,24351,1805,6.9
"17141",17,141,1994,26623,25301,1322,5
"17141",17,141,1995,27390,26215,1175,4.3
"17141",17,141,1996,27676,26591,1085,3.9
"17141",17,141,1997,28004,27031,973,3.5
"17141",17,141,1998,27860,26948,912,3.3
"17141",17,141,1999,28405,27354,1051,3.7
"17141",17,141,2000,27240,26147,1093,4
"17141",17,141,2001,26193,24887,1306,5
"17141",17,141,2002,25707,24162,1545,6
"17141",17,141,2003,25517,23758,1759,6.9
"17141",17,141,2004,25778,24208,1570,6.1
"17141",17,141,2005,26459,25055,1404,5.3
"17141",17,141,2006,27336,25991,1345,4.9
"17141",17,141,2007,28026,26481,1545,5.5
"17141",17,141,2008,27925,25786,2139,7.7
"17141",17,141,2009,27507,24082,3425,12.5
"17141",17,141,2010,28216,24710,3506,12.4
"17141",17,141,2011,27428,24293,3135,11.4
"17141",17,141,2012,26672,23984,2688,10.1
"17141",17,141,2013,25787,23247,2540,9.8
"17141",17,141,2014,25933,24013,1920,7.4
"17141",17,141,2015,25909,24311,1598,6.2
"17141",17,141,2016,25755,24249,1506,5.8
"17141",17,141,2017,25178,23911,1267,5
"17143",17,143,1990,92529,87834,4695,5.1
"17143",17,143,1991,92461,86767,5694,6.2
"17143",17,143,1992,93080,86615,6465,6.9
"17143",17,143,1993,92465,86752,5713,6.2
"17143",17,143,1994,92868,88645,4223,4.5
"17143",17,143,1995,94018,90076,3942,4.2
"17143",17,143,1996,95238,89603,5635,5.9
"17143",17,143,1997,96654,92640,4014,4.2
"17143",17,143,1998,96394,93122,3272,3.4
"17143",17,143,1999,95969,92294,3675,3.8
"17143",17,143,2000,92142,88277,3865,4.2
"17143",17,143,2001,90438,86024,4414,4.9
"17143",17,143,2002,88873,83775,5098,5.7
"17143",17,143,2003,87735,82075,5660,6.5
"17143",17,143,2004,88807,83756,5051,5.7
"17143",17,143,2005,92082,87555,4527,4.9
"17143",17,143,2006,95139,91183,3956,4.2
"17143",17,143,2007,97797,93323,4474,4.6
"17143",17,143,2008,98134,92524,5610,5.7
"17143",17,143,2009,97678,86910,10768,11
"17143",17,143,2010,96024,85939,10085,10.5
"17143",17,143,2011,96184,87318,8866,9.2
"17143",17,143,2012,96291,88235,8056,8.4
"17143",17,143,2013,93532,84525,9007,9.6
"17143",17,143,2014,91556,84524,7032,7.7
"17143",17,143,2015,89973,83805,6168,6.9
"17143",17,143,2016,87850,81852,5998,6.8
"17143",17,143,2017,85721,80773,4948,5.8
"17145",17,145,1990,9505,8349,1156,12.2
"17145",17,145,1991,8950,7608,1342,15
"17145",17,145,1992,8521,7155,1366,16
"17145",17,145,1993,8288,7014,1274,15.4
"17145",17,145,1994,7764,6816,948,12.2
"17145",17,145,1995,7882,7070,812,10.3
"17145",17,145,1996,8525,7570,955,11.2
"17145",17,145,1997,8331,7551,780,9.4
"17145",17,145,1998,8303,7596,707,8.5
"17145",17,145,1999,9044,8357,687,7.6
"17145",17,145,2000,10374,9694,680,6.6
"17145",17,145,2001,10347,9695,652,6.3
"17145",17,145,2002,10323,9585,738,7.1
"17145",17,145,2003,10337,9522,815,7.9
"17145",17,145,2004,10460,9706,754,7.2
"17145",17,145,2005,10371,9679,692,6.7
"17145",17,145,2006,10247,9565,682,6.7
"17145",17,145,2007,10033,9209,824,8.2
"17145",17,145,2008,9578,8668,910,9.5
"17145",17,145,2009,9411,8283,1128,12
"17145",17,145,2010,9594,8535,1059,11
"17145",17,145,2011,9461,8498,963,10.2
"17145",17,145,2012,9236,8258,978,10.6
"17145",17,145,2013,9023,8027,996,11
"17145",17,145,2014,8883,8132,751,8.5
"17145",17,145,2015,8854,8223,631,7.1
"17145",17,145,2016,8687,8076,611,7
"17145",17,145,2017,8319,7828,491,5.9
"17147",17,147,1990,8529,8135,394,4.6
"17147",17,147,1991,8353,7882,471,5.6
"17147",17,147,1992,8810,8215,595,6.8
"17147",17,147,1993,8649,8086,563,6.5
"17147",17,147,1994,8290,7838,452,5.5
"17147",17,147,1995,7913,7515,398,5
"17147",17,147,1996,7756,7350,406,5.2
"17147",17,147,1997,7874,7515,359,4.6
"17147",17,147,1998,8229,7953,276,3.4
"17147",17,147,1999,8436,8172,264,3.1
"17147",17,147,2000,9130,8824,306,3.4
"17147",17,147,2001,9043,8705,338,3.7
"17147",17,147,2002,8915,8499,416,4.7
"17147",17,147,2003,8876,8433,443,5
"17147",17,147,2004,8884,8486,398,4.5
"17147",17,147,2005,9119,8758,361,4
"17147",17,147,2006,9249,8915,334,3.6
"17147",17,147,2007,9084,8742,342,3.8
"17147",17,147,2008,8957,8518,439,4.9
"17147",17,147,2009,8881,8170,711,8
"17147",17,147,2010,9177,8458,719,7.8
"17147",17,147,2011,8818,8194,624,7.1
"17147",17,147,2012,8572,7977,595,6.9
"17147",17,147,2013,8377,7777,600,7.2
"17147",17,147,2014,8323,7851,472,5.7
"17147",17,147,2015,8345,7925,420,5
"17147",17,147,2016,8525,8107,418,4.9
"17147",17,147,2017,8453,8116,337,4
"17149",17,149,1990,8728,8165,563,6.5
"17149",17,149,1991,8524,7952,572,6.7
"17149",17,149,1992,8678,8014,664,7.7
"17149",17,149,1993,8896,8263,633,7.1
"17149",17,149,1994,8761,8295,466,5.3
"17149",17,149,1995,8755,8303,452,5.2
"17149",17,149,1996,8740,8256,484,5.5
"17149",17,149,1997,8907,8490,417,4.7
"17149",17,149,1998,9173,8755,418,4.6
"17149",17,149,1999,9262,8836,426,4.6
"17149",17,149,2000,8579,8146,433,5
"17149",17,149,2001,8574,8108,466,5.4
"17149",17,149,2002,8539,8062,477,5.6
"17149",17,149,2003,8372,7867,505,6
"17149",17,149,2004,8428,7974,454,5.4
"17149",17,149,2005,8700,8279,421,4.8
"17149",17,149,2006,8731,8361,370,4.2
"17149",17,149,2007,8797,8400,397,4.5
"17149",17,149,2008,8541,8049,492,5.8
"17149",17,149,2009,8469,7787,682,8.1
"17149",17,149,2010,8126,7398,728,9
"17149",17,149,2011,7914,7279,635,8
"17149",17,149,2012,7803,7215,588,7.5
"17149",17,149,2013,7692,7114,578,7.5
"17149",17,149,2014,7748,7303,445,5.7
"17149",17,149,2015,7612,7218,394,5.2
"17149",17,149,2016,7495,7116,379,5.1
"17149",17,149,2017,7192,6872,320,4.4
"17151",17,151,1990,1620,1462,158,9.8
"17151",17,151,1991,1713,1529,184,10.7
"17151",17,151,1992,1673,1478,195,11.7
"17151",17,151,1993,1686,1481,205,12.2
"17151",17,151,1994,1700,1524,176,10.4
"17151",17,151,1995,1647,1541,106,6.4
"17151",17,151,1996,1673,1513,160,9.6
"17151",17,151,1997,1699,1555,144,8.5
"17151",17,151,1998,1823,1673,150,8.2
"17151",17,151,1999,1810,1685,125,6.9
"17151",17,151,2000,2051,1924,127,6.2
"17151",17,151,2001,1996,1865,131,6.6
"17151",17,151,2002,1983,1843,140,7.1
"17151",17,151,2003,1906,1749,157,8.2
"17151",17,151,2004,1978,1828,150,7.6
"17151",17,151,2005,1971,1848,123,6.2
"17151",17,151,2006,1953,1831,122,6.2
"17151",17,151,2007,1976,1839,137,6.9
"17151",17,151,2008,1937,1777,160,8.3
"17151",17,151,2009,1901,1704,197,10.4
"17151",17,151,2010,2032,1840,192,9.4
"17151",17,151,2011,1971,1796,175,8.9
"17151",17,151,2012,1893,1731,162,8.6
"17151",17,151,2013,1831,1662,169,9.2
"17151",17,151,2014,1796,1647,149,8.3
"17151",17,151,2015,1768,1644,124,7
"17151",17,151,2016,1761,1641,120,6.8
"17151",17,151,2017,1754,1646,108,6.2
"17153",17,153,1990,2892,2583,309,10.7
"17153",17,153,1991,3009,2671,338,11.2
"17153",17,153,1992,2988,2626,362,12.1
"17153",17,153,1993,2975,2592,383,12.9
"17153",17,153,1994,2796,2524,272,9.7
"17153",17,153,1995,2845,2555,290,10.2
"17153",17,153,1996,2933,2669,264,9
"17153",17,153,1997,2826,2582,244,8.6
"17153",17,153,1998,3011,2739,272,9
"17153",17,153,1999,3193,2952,241,7.5
"17153",17,153,2000,3120,2914,206,6.6
"17153",17,153,2001,3036,2808,228,7.5
"17153",17,153,2002,3032,2801,231,7.6
"17153",17,153,2003,2990,2707,283,9.5
"17153",17,153,2004,2900,2647,253,8.7
"17153",17,153,2005,2931,2700,231,7.9
"17153",17,153,2006,2928,2733,195,6.7
"17153",17,153,2007,2946,2738,208,7.1
"17153",17,153,2008,2894,2628,266,9.2
"17153",17,153,2009,2845,2529,316,11.1
"17153",17,153,2010,2480,2172,308,12.4
"17153",17,153,2011,2358,2076,282,12
"17153",17,153,2012,2378,2108,270,11.4
"17153",17,153,2013,2217,1939,278,12.5
"17153",17,153,2014,2139,1916,223,10.4
"17153",17,153,2015,2089,1904,185,8.9
"17153",17,153,2016,2190,2006,184,8.4
"17153",17,153,2017,2098,1934,164,7.8
"17155",17,155,1990,2930,2733,197,6.7
"17155",17,155,1991,3016,2784,232,7.7
"17155",17,155,1992,3042,2807,235,7.7
"17155",17,155,1993,3094,2863,231,7.5
"17155",17,155,1994,3096,2893,203,6.6
"17155",17,155,1995,3057,2874,183,6
"17155",17,155,1996,3074,2860,214,7
"17155",17,155,1997,3098,2929,169,5.5
"17155",17,155,1998,3181,3036,145,4.6
"17155",17,155,1999,3259,3114,145,4.4
"17155",17,155,2000,3171,3023,148,4.7
"17155",17,155,2001,3116,2942,174,5.6
"17155",17,155,2002,3113,2870,243,7.8
"17155",17,155,2003,3014,2793,221,7.3
"17155",17,155,2004,3039,2843,196,6.4
"17155",17,155,2005,3127,2955,172,5.5
"17155",17,155,2006,3125,2970,155,5
"17155",17,155,2007,3235,3049,186,5.7
"17155",17,155,2008,3206,2982,224,7
"17155",17,155,2009,3306,2857,449,13.6
"17155",17,155,2010,3311,2913,398,12
"17155",17,155,2011,3198,2870,328,10.3
"17155",17,155,2012,3138,2846,292,9.3
"17155",17,155,2013,3054,2751,303,9.9
"17155",17,155,2014,3033,2801,232,7.6
"17155",17,155,2015,3040,2852,188,6.2
"17155",17,155,2016,3101,2929,172,5.5
"17155",17,155,2017,2985,2842,143,4.8
"17157",17,157,1990,15754,14551,1203,7.6
"17157",17,157,1991,15935,14738,1197,7.5
"17157",17,157,1992,15729,14133,1596,10.1
"17157",17,157,1993,15136,13636,1500,9.9
"17157",17,157,1994,14580,13413,1167,8
"17157",17,157,1995,14235,13333,902,6.3
"17157",17,157,1996,14365,12917,1448,10.1
"17157",17,157,1997,13990,13093,897,6.4
"17157",17,157,1998,14182,13452,730,5.1
"17157",17,157,1999,14337,13685,652,4.5
"17157",17,157,2000,15339,14620,719,4.7
"17157",17,157,2001,15502,14735,767,4.9
"17157",17,157,2002,15403,14566,837,5.4
"17157",17,157,2003,15132,14210,922,6.1
"17157",17,157,2004,15158,14308,850,5.6
"17157",17,157,2005,15119,14304,815,5.4
"17157",17,157,2006,15409,14696,713,4.6
"17157",17,157,2007,15727,14913,814,5.2
"17157",17,157,2008,15327,14324,1003,6.5
"17157",17,157,2009,15203,13798,1405,9.2
"17157",17,157,2010,15027,13709,1318,8.8
"17157",17,157,2011,14797,13577,1220,8.2
"17157",17,157,2012,14622,13399,1223,8.4
"17157",17,157,2013,14378,13175,1203,8.4
"17157",17,157,2014,14161,13224,937,6.6
"17157",17,157,2015,14299,13523,776,5.4
"17157",17,157,2016,14521,13801,720,5
"17157",17,157,2017,14114,13501,613,4.3
"17159",17,159,1990,8311,7751,560,6.7
"17159",17,159,1991,8557,8007,550,6.4
"17159",17,159,1992,9155,8626,529,5.8
"17159",17,159,1993,9901,9461,440,4.4
"17159",17,159,1994,10009,9549,460,4.6
"17159",17,159,1995,9763,9384,379,3.9
"17159",17,159,1996,9887,9446,441,4.5
"17159",17,159,1997,10134,9681,453,4.5
"17159",17,159,1998,9121,8651,470,5.2
"17159",17,159,1999,9183,8616,567,6.2
"17159",17,159,2000,7921,7467,454,5.7
"17159",17,159,2001,7556,7103,453,6
"17159",17,159,2002,7471,7043,428,5.7
"17159",17,159,2003,7234,6728,506,7
"17159",17,159,2004,7215,6765,450,6.2
"17159",17,159,2005,7315,6905,410,5.6
"17159",17,159,2006,7662,7315,347,4.5
"17159",17,159,2007,7836,7471,365,4.7
"17159",17,159,2008,7529,7044,485,6.4
"17159",17,159,2009,7275,6543,732,10.1
"17159",17,159,2010,8016,7301,715,8.9
"17159",17,159,2011,7805,7162,643,8.2
"17159",17,159,2012,7554,6949,605,8
"17159",17,159,2013,7372,6757,615,8.3
"17159",17,159,2014,7230,6766,464,6.4
"17159",17,159,2015,7461,7024,437,5.9
"17159",17,159,2016,7525,7084,441,5.9
"17159",17,159,2017,7535,7182,353,4.7
"17161",17,161,1990,74740,71055,3685,4.9
"17161",17,161,1991,75424,70726,4698,6.2
"17161",17,161,1992,76468,70909,5559,7.3
"17161",17,161,1993,75191,70343,4848,6.4
"17161",17,161,1994,73352,69680,3672,5
"17161",17,161,1995,72991,69589,3402,4.7
"17161",17,161,1996,73561,70504,3057,4.2
"17161",17,161,1997,75321,72668,2653,3.5
"17161",17,161,1998,76271,73683,2588,3.4
"17161",17,161,1999,77408,73464,3944,5.1
"17161",17,161,2000,78310,75000,3310,4.2
"17161",17,161,2001,76505,73048,3457,4.5
"17161",17,161,2002,74830,70840,3990,5.3
"17161",17,161,2003,74394,69932,4462,6
"17161",17,161,2004,75362,71462,3900,5.2
"17161",17,161,2005,77924,74361,3563,4.6
"17161",17,161,2006,79227,75841,3386,4.3
"17161",17,161,2007,80369,76766,3603,4.5
"17161",17,161,2008,79328,74998,4330,5.5
"17161",17,161,2009,77840,70668,7172,9.2
"17161",17,161,2010,76298,69020,7278,9.5
"17161",17,161,2011,75965,69489,6476,8.5
"17161",17,161,2012,75408,69358,6050,8
"17161",17,161,2013,73581,67462,6119,8.3
"17161",17,161,2014,72601,67464,5137,7.1
"17161",17,161,2015,72233,67608,4625,6.4
"17161",17,161,2016,71616,67150,4466,6.2
"17161",17,161,2017,70698,67147,3551,5
"17163",17,163,1990,120946,112239,8707,7.2
"17163",17,163,1991,117636,108540,9096,7.7
"17163",17,163,1992,118055,108302,9753,8.3
"17163",17,163,1993,117480,108975,8505,7.2
"17163",17,163,1994,116939,109730,7209,6.2
"17163",17,163,1995,116217,109757,6460,5.6
"17163",17,163,1996,117608,111244,6364,5.4
"17163",17,163,1997,119495,113580,5915,4.9
"17163",17,163,1998,118306,112235,6071,5.1
"17163",17,163,1999,117912,112019,5893,5
"17163",17,163,2000,120586,114930,5656,4.7
"17163",17,163,2001,118199,112105,6094,5.2
"17163",17,163,2002,117891,110542,7349,6.2
"17163",17,163,2003,117650,109343,8307,7.1
"17163",17,163,2004,118211,110152,8059,6.8
"17163",17,163,2005,121152,113571,7581,6.3
"17163",17,163,2006,123965,116861,7104,5.7
"17163",17,163,2007,125692,118080,7612,6.1
"17163",17,163,2008,125059,115708,9351,7.5
"17163",17,163,2009,124016,110497,13519,10.9
"17163",17,163,2010,133105,119422,13683,10.3
"17163",17,163,2011,132793,119880,12913,9.7
"17163",17,163,2012,130479,118036,12443,9.5
"17163",17,163,2013,127785,115272,12513,9.8
"17163",17,163,2014,126416,116508,9908,7.8
"17163",17,163,2015,126135,117831,8304,6.6
"17163",17,163,2016,126941,119311,7630,6
"17163",17,163,2017,125758,119566,6192,4.9
"17165",17,165,1990,10665,9653,1012,9.5
"17165",17,165,1991,11075,9984,1091,9.9
"17165",17,165,1992,11115,9795,1320,11.9
"17165",17,165,1993,11239,9628,1611,14.3
"17165",17,165,1994,11038,9616,1422,12.9
"17165",17,165,1995,10618,9494,1124,10.6
"17165",17,165,1996,10169,9276,893,8.8
"17165",17,165,1997,10178,9368,810,8
"17165",17,165,1998,10797,9990,807,7.5
"17165",17,165,1999,10656,9937,719,6.7
"17165",17,165,2000,11870,11099,771,6.5
"17165",17,165,2001,11545,10832,713,6.2
"17165",17,165,2002,11703,10915,788,6.7
"17165",17,165,2003,11968,11056,912,7.6
"17165",17,165,2004,11912,11086,826,6.9
"17165",17,165,2005,12399,11668,731,5.9
"17165",17,165,2006,12446,11784,662,5.3
"17165",17,165,2007,12751,11941,810,6.4
"17165",17,165,2008,12526,11521,1005,8
"17165",17,165,2009,12658,11404,1254,9.9
"17165",17,165,2010,11635,10450,1185,10.2
"17165",17,165,2011,11653,10546,1107,9.5
"17165",17,165,2012,11659,10602,1057,9.1
"17165",17,165,2013,11280,10087,1193,10.6
"17165",17,165,2014,10767,9885,882,8.2
"17165",17,165,2015,10344,9544,800,7.7
"17165",17,165,2016,10025,9177,848,8.5
"17165",17,165,2017,9694,9077,617,6.4
"17167",17,167,1990,103866,100333,3533,3.4
"17167",17,167,1991,105411,101177,4234,4
"17167",17,167,1992,104739,99609,5130,4.9
"17167",17,167,1993,102535,97832,4703,4.6
"17167",17,167,1994,101147,97144,4003,4
"17167",17,167,1995,101284,97258,4026,4
"17167",17,167,1996,101932,97866,4066,4
"17167",17,167,1997,102492,98722,3770,3.7
"17167",17,167,1998,102439,98978,3461,3.4
"17167",17,167,1999,101530,98219,3311,3.3
"17167",17,167,2000,106380,102745,3635,3.4
"17167",17,167,2001,105107,101110,3997,3.8
"17167",17,167,2002,104225,99509,4716,4.5
"17167",17,167,2003,101339,95863,5476,5.4
"17167",17,167,2004,102264,97016,5248,5.1
"17167",17,167,2005,105121,100375,4746,4.5
"17167",17,167,2006,106674,102268,4406,4.1
"17167",17,167,2007,108005,103218,4787,4.4
"17167",17,167,2008,107713,101724,5989,5.6
"17167",17,167,2009,107780,99740,8040,7.5
"17167",17,167,2010,108728,100315,8413,7.7
"17167",17,167,2011,108909,100825,8084,7.4
"17167",17,167,2012,107446,99661,7785,7.2
"17167",17,167,2013,103979,96323,7656,7.4
"17167",17,167,2014,104386,98232,6154,5.9
"17167",17,167,2015,105388,99920,5468,5.2
"17167",17,167,2016,106024,100912,5112,4.8
"17167",17,167,2017,103457,99077,4380,4.2
"17169",17,169,1990,3552,3257,295,8.3
"17169",17,169,1991,3686,3423,263,7.1
"17169",17,169,1992,3851,3572,279,7.2
"17169",17,169,1993,3697,3461,236,6.4
"17169",17,169,1994,3737,3536,201,5.4
"17169",17,169,1995,3854,3659,195,5.1
"17169",17,169,1996,3779,3582,197,5.2
"17169",17,169,1997,3917,3713,204,5.2
"17169",17,169,1998,4353,4170,183,4.2
"17169",17,169,1999,4444,4252,192,4.3
"17169",17,169,2000,4020,3828,192,4.8
"17169",17,169,2001,4142,3964,178,4.3
"17169",17,169,2002,4228,4040,188,4.4
"17169",17,169,2003,4115,3884,231,5.6
"17169",17,169,2004,4202,3984,218,5.2
"17169",17,169,2005,4334,4130,204,4.7
"17169",17,169,2006,4447,4271,176,4
"17169",17,169,2007,4447,4269,178,4
"17169",17,169,2008,4346,4126,220,5.1
"17169",17,169,2009,4229,3945,284,6.7
"17169",17,169,2010,3867,3548,319,8.2
"17169",17,169,2011,3771,3469,302,8
"17169",17,169,2012,3631,3346,285,7.8
"17169",17,169,2013,3476,3187,289,8.3
"17169",17,169,2014,3458,3225,233,6.7
"17169",17,169,2015,3481,3278,203,5.8
"17169",17,169,2016,3353,3166,187,5.6
"17169",17,169,2017,3286,3141,145,4.4
"17171",17,171,1990,2890,2726,164,5.7
"17171",17,171,1991,2883,2690,193,6.7
"17171",17,171,1992,2855,2634,221,7.7
"17171",17,171,1993,2845,2660,185,6.5
"17171",17,171,1994,2761,2625,136,4.9
"17171",17,171,1995,2758,2592,166,6
"17171",17,171,1996,2736,2570,166,6.1
"17171",17,171,1997,2796,2640,156,5.6
"17171",17,171,1998,2877,2737,140,4.9
"17171",17,171,1999,2978,2841,137,4.6
"17171",17,171,2000,3009,2873,136,4.5
"17171",17,171,2001,2888,2745,143,5
"17171",17,171,2002,2853,2693,160,5.6
"17171",17,171,2003,2840,2664,176,6.2
"17171",17,171,2004,2781,2597,184,6.6
"17171",17,171,2005,2792,2619,173,6.2
"17171",17,171,2006,2789,2645,144,5.2
"17171",17,171,2007,2790,2648,142,5.1
"17171",17,171,2008,2737,2576,161,5.9
"17171",17,171,2009,2710,2499,211,7.8
"17171",17,171,2010,2886,2635,251,8.7
"17171",17,171,2011,2847,2613,234,8.2
"17171",17,171,2012,2713,2478,235,8.7
"17171",17,171,2013,2606,2375,231,8.9
"17171",17,171,2014,2560,2384,176,6.9
"17171",17,171,2015,2556,2407,149,5.8
"17171",17,171,2016,2529,2388,141,5.6
"17171",17,171,2017,2457,2331,126,5.1
"17173",17,173,1990,10764,10091,673,6.3
"17173",17,173,1991,10998,10123,875,8
"17173",17,173,1992,11045,10165,880,8
"17173",17,173,1993,10998,10279,719,6.5
"17173",17,173,1994,11019,10491,528,4.8
"17173",17,173,1995,11502,10934,568,4.9
"17173",17,173,1996,11647,11019,628,5.4
"17173",17,173,1997,11622,11101,521,4.5
"17173",17,173,1998,11441,10972,469,4.1
"17173",17,173,1999,11769,11205,564,4.8
"17173",17,173,2000,11810,11266,544,4.6
"17173",17,173,2001,11651,11024,627,5.4
"17173",17,173,2002,11439,10767,672,5.9
"17173",17,173,2003,11075,10371,704,6.4
"17173",17,173,2004,11159,10504,655,5.9
"17173",17,173,2005,11213,10628,585,5.2
"17173",17,173,2006,11163,10651,512,4.6
"17173",17,173,2007,11259,10721,538,4.8
"17173",17,173,2008,11164,10443,721,6.5
"17173",17,173,2009,11139,10042,1097,9.8
"17173",17,173,2010,11207,10117,1090,9.7
"17173",17,173,2011,11016,10014,1002,9.1
"17173",17,173,2012,10797,9873,924,8.6
"17173",17,173,2013,10297,9398,899,8.7
"17173",17,173,2014,10147,9460,687,6.8
"17173",17,173,2015,10226,9624,602,5.9
"17173",17,173,2016,10364,9776,588,5.7
"17173",17,173,2017,10235,9784,451,4.4
"17175",17,175,1990,2945,2763,182,6.2
"17175",17,175,1991,2701,2479,222,8.2
"17175",17,175,1992,3055,2808,247,8.1
"17175",17,175,1993,2848,2646,202,7.1
"17175",17,175,1994,2884,2736,148,5.1
"17175",17,175,1995,2877,2726,151,5.2
"17175",17,175,1996,2997,2759,238,7.9
"17175",17,175,1997,2906,2746,160,5.5
"17175",17,175,1998,2985,2856,129,4.3
"17175",17,175,1999,2996,2856,140,4.7
"17175",17,175,2000,2914,2750,164,5.6
"17175",17,175,2001,2885,2692,193,6.7
"17175",17,175,2002,2795,2590,205,7.3
"17175",17,175,2003,2733,2524,209,7.6
"17175",17,175,2004,2747,2570,177,6.4
"17175",17,175,2005,2833,2676,157,5.5
"17175",17,175,2006,2947,2812,135,4.6
"17175",17,175,2007,3004,2852,152,5.1
"17175",17,175,2008,2980,2792,188,6.3
"17175",17,175,2009,2837,2543,294,10.4
"17175",17,175,2010,3029,2734,295,9.7
"17175",17,175,2011,2973,2713,260,8.7
"17175",17,175,2012,3005,2761,244,8.1
"17175",17,175,2013,2885,2610,275,9.5
"17175",17,175,2014,2803,2592,211,7.5
"17175",17,175,2015,2761,2578,183,6.6
"17175",17,175,2016,2752,2553,199,7.2
"17175",17,175,2017,2682,2520,162,6
"17177",17,177,1990,25993,24491,1502,5.8
"17177",17,177,1991,25547,23892,1655,6.5
"17177",17,177,1992,26345,24407,1938,7.4
"17177",17,177,1993,26326,24727,1599,6.1
"17177",17,177,1994,25800,24480,1320,5.1
"17177",17,177,1995,25542,24376,1166,4.6
"17177",17,177,1996,25746,24655,1091,4.2
"17177",17,177,1997,25507,24347,1160,4.5
"17177",17,177,1998,25630,24600,1030,4
"17177",17,177,1999,25771,24473,1298,5
"17177",17,177,2000,26204,24917,1287,4.9
"17177",17,177,2001,25607,24167,1440,5.6
"17177",17,177,2002,25277,23706,1571,6.2
"17177",17,177,2003,24655,22910,1745,7.1
"17177",17,177,2004,24453,22851,1602,6.6
"17177",17,177,2005,25082,23775,1307,5.2
"17177",17,177,2006,25422,24226,1196,4.7
"17177",17,177,2007,25541,24248,1293,5.1
"17177",17,177,2008,25454,23742,1712,6.7
"17177",17,177,2009,25080,22221,2859,11.4
"17177",17,177,2010,24686,21956,2730,11.1
"17177",17,177,2011,24200,21835,2365,9.8
"17177",17,177,2012,23534,21414,2120,9
"17177",17,177,2013,22740,20605,2135,9.4
"17177",17,177,2014,22238,20604,1634,7.3
"17177",17,177,2015,21537,20115,1422,6.6
"17177",17,177,2016,21371,20132,1239,5.8
"17177",17,177,2017,21537,20544,993,4.6
"17179",17,179,1990,65306,62229,3077,4.7
"17179",17,179,1991,65526,61561,3965,6.1
"17179",17,179,1992,66495,61912,4583,6.9
"17179",17,179,1993,66220,62175,4045,6.1
"17179",17,179,1994,67037,64059,2978,4.4
"17179",17,179,1995,68553,65834,2719,4
"17179",17,179,1996,69570,65787,3783,5.4
"17179",17,179,1997,70428,67826,2602,3.7
"17179",17,179,1998,71608,69454,2154,3
"17179",17,179,1999,71826,69235,2591,3.6
"17179",17,179,2000,67858,65294,2564,3.8
"17179",17,179,2001,66809,63821,2988,4.5
"17179",17,179,2002,65499,62114,3385,5.2
"17179",17,179,2003,64755,60985,3770,5.8
"17179",17,179,2004,66067,62573,3494,5.3
"17179",17,179,2005,69006,65851,3155,4.6
"17179",17,179,2006,71492,68815,2677,3.7
"17179",17,179,2007,73660,70563,3097,4.2
"17179",17,179,2008,73747,69906,3841,5.2
"17179",17,179,2009,73081,65372,7709,10.5
"17179",17,179,2010,71672,64566,7106,9.9
"17179",17,179,2011,71538,65596,5942,8.3
"17179",17,179,2012,71552,66211,5341,7.5
"17179",17,179,2013,69103,63131,5972,8.6
"17179",17,179,2014,67789,63227,4562,6.7
"17179",17,179,2015,66832,62647,4185,6.3
"17179",17,179,2016,65635,61460,4175,6.4
"17179",17,179,2017,64033,60655,3378,5.3
"17181",17,181,1990,8349,7484,865,10.4
"17181",17,181,1991,8237,7352,885,10.7
"17181",17,181,1992,8333,7364,969,11.6
"17181",17,181,1993,8546,7369,1177,13.8
"17181",17,181,1994,8212,7398,814,9.9
"17181",17,181,1995,7957,7345,612,7.7
"17181",17,181,1996,8144,7443,701,8.6
"17181",17,181,1997,8189,7633,556,6.8
"17181",17,181,1998,8301,7767,534,6.4
"17181",17,181,1999,8570,8015,555,6.5
"17181",17,181,2000,8428,7918,510,6.1
"17181",17,181,2001,8193,7722,471,5.7
"17181",17,181,2002,8277,7709,568,6.9
"17181",17,181,2003,8198,7553,645,7.9
"17181",17,181,2004,8221,7599,622,7.6
"17181",17,181,2005,8260,7700,560,6.8
"17181",17,181,2006,8485,7990,495,5.8
"17181",17,181,2007,8437,7863,574,6.8
"17181",17,181,2008,8331,7621,710,8.5
"17181",17,181,2009,8112,7204,908,11.2
"17181",17,181,2010,7971,7017,954,12
"17181",17,181,2011,7755,6853,902,11.6
"17181",17,181,2012,7587,6759,828,10.9
"17181",17,181,2013,7414,6582,832,11.2
"17181",17,181,2014,7293,6651,642,8.8
"17181",17,181,2015,7352,6787,565,7.7
"17181",17,181,2016,7508,6957,551,7.3
"17181",17,181,2017,7354,6891,463,6.3
"17183",17,183,1990,42408,38755,3653,8.6
"17183",17,183,1991,41713,38003,3710,8.9
"17183",17,183,1992,41977,37769,4208,10
"17183",17,183,1993,41917,37853,4064,9.7
"17183",17,183,1994,41302,38090,3212,7.8
"17183",17,183,1995,40473,37602,2871,7.1
"17183",17,183,1996,40373,37460,2913,7.2
"17183",17,183,1997,39978,37474,2504,6.3
"17183",17,183,1998,39350,37079,2271,5.8
"17183",17,183,1999,39334,37252,2082,5.3
"17183",17,183,2000,39183,37040,2143,5.5
"17183",17,183,2001,37919,35482,2437,6.4
"17183",17,183,2002,37305,34600,2705,7.3
"17183",17,183,2003,37268,34280,2988,8
"17183",17,183,2004,37341,34406,2935,7.9
"17183",17,183,2005,37822,35444,2378,6.3
"17183",17,183,2006,37720,35619,2101,5.6
"17183",17,183,2007,37863,35545,2318,6.1
"17183",17,183,2008,37389,34506,2883,7.7
"17183",17,183,2009,37138,32854,4284,11.5
"17183",17,183,2010,37960,33619,4341,11.4
"17183",17,183,2011,37475,33753,3722,9.9
"17183",17,183,2012,37032,33606,3426,9.3
"17183",17,183,2013,35948,32142,3806,10.6
"17183",17,183,2014,35526,32525,3001,8.4
"17183",17,183,2015,35440,32934,2506,7.1
"17183",17,183,2016,35005,32506,2499,7.1
"17183",17,183,2017,34070,31928,2142,6.3
"17185",17,185,1990,6360,5908,452,7.1
"17185",17,185,1991,6118,5283,835,13.6
"17185",17,185,1992,6050,5339,711,11.8
"17185",17,185,1993,6159,5612,547,8.9
"17185",17,185,1994,6062,5581,481,7.9
"17185",17,185,1995,5489,5130,359,6.5
"17185",17,185,1996,5543,5144,399,7.2
"17185",17,185,1997,5214,4772,442,8.5
"17185",17,185,1998,5013,4615,398,7.9
"17185",17,185,1999,4999,4580,419,8.4
"17185",17,185,2000,6946,6608,338,4.9
"17185",17,185,2001,6867,6514,353,5.1
"17185",17,185,2002,6710,6353,357,5.3
"17185",17,185,2003,6508,6114,394,6.1
"17185",17,185,2004,6526,6098,428,6.6
"17185",17,185,2005,6581,6209,372,5.7
"17185",17,185,2006,6678,6373,305,4.6
"17185",17,185,2007,6438,6088,350,5.4
"17185",17,185,2008,6128,5687,441,7.2
"17185",17,185,2009,6047,5419,628,10.4
"17185",17,185,2010,5863,5290,573,9.8
"17185",17,185,2011,5810,5294,516,8.9
"17185",17,185,2012,5778,5320,458,7.9
"17185",17,185,2013,5642,5218,424,7.5
"17185",17,185,2014,5565,5233,332,6
"17185",17,185,2015,5620,5303,317,5.6
"17185",17,185,2016,5741,5385,356,6.2
"17185",17,185,2017,5596,5322,274,4.9
"17187",17,187,1990,10003,9445,558,5.6
"17187",17,187,1991,9943,9376,567,5.7
"17187",17,187,1992,10115,9562,553,5.5
"17187",17,187,1993,10112,9483,629,6.2
"17187",17,187,1994,9975,9420,555,5.6
"17187",17,187,1995,9848,9417,431,4.4
"17187",17,187,1996,9751,9316,435,4.5
"17187",17,187,1997,9884,9534,350,3.5
"17187",17,187,1998,10083,9765,318,3.2
"17187",17,187,1999,10281,9961,320,3.1
"17187",17,187,2000,10150,9728,422,4.2
"17187",17,187,2001,9712,9271,441,4.5
"17187",17,187,2002,9445,8922,523,5.5
"17187",17,187,2003,9200,8617,583,6.3
"17187",17,187,2004,8920,8403,517,5.8
"17187",17,187,2005,8833,8347,486,5.5
"17187",17,187,2006,9047,8642,405,4.5
"17187",17,187,2007,9232,8822,410,4.4
"17187",17,187,2008,9250,8735,515,5.6
"17187",17,187,2009,9232,8543,689,7.5
"17187",17,187,2010,9298,8576,722,7.8
"17187",17,187,2011,9127,8467,660,7.2
"17187",17,187,2012,8939,8305,634,7.1
"17187",17,187,2013,8823,8174,649,7.4
"17187",17,187,2014,8734,8225,509,5.8
"17187",17,187,2015,8563,8116,447,5.2
"17187",17,187,2016,8680,8227,453,5.2
"17187",17,187,2017,8643,8286,357,4.1
"17189",17,189,1990,7609,7112,497,6.5
"17189",17,189,1991,7691,7085,606,7.9
"17189",17,189,1992,7522,7025,497,6.6
"17189",17,189,1993,7915,7430,485,6.1
"17189",17,189,1994,7853,7481,372,4.7
"17189",17,189,1995,8010,7697,313,3.9
"17189",17,189,1996,8275,7905,370,4.5
"17189",17,189,1997,8873,8521,352,4
"17189",17,189,1998,9320,9002,318,3.4
"17189",17,189,1999,9389,9089,300,3.2
"17189",17,189,2000,8432,8120,312,3.7
"17189",17,189,2001,8623,8276,347,4
"17189",17,189,2002,8405,8018,387,4.6
"17189",17,189,2003,8313,7876,437,5.3
"17189",17,189,2004,8412,8005,407,4.8
"17189",17,189,2005,8592,8216,376,4.4
"17189",17,189,2006,8495,8174,321,3.8
"17189",17,189,2007,8553,8165,388,4.5
"17189",17,189,2008,8337,7842,495,5.9
"17189",17,189,2009,8070,7417,653,8.1
"17189",17,189,2010,8499,7883,616,7.2
"17189",17,189,2011,8714,8140,574,6.6
"17189",17,189,2012,9157,8577,580,6.3
"17189",17,189,2013,8920,8366,554,6.2
"17189",17,189,2014,9021,8593,428,4.7
"17189",17,189,2015,9352,8998,354,3.8
"17189",17,189,2016,9629,9270,359,3.7
"17189",17,189,2017,9542,9262,280,2.9
"17191",17,191,1990,8376,7606,770,9.2
"17191",17,191,1991,8336,7596,740,8.9
"17191",17,191,1992,8332,7584,748,9
"17191",17,191,1993,8223,7543,680,8.3
"17191",17,191,1994,8323,7726,597,7.2
"17191",17,191,1995,8195,7728,467,5.7
"17191",17,191,1996,7989,7531,458,5.7
"17191",17,191,1997,8107,7713,394,4.9
"17191",17,191,1998,8519,7996,523,6.1
"17191",17,191,1999,8418,7881,537,6.4
"17191",17,191,2000,8472,8004,468,5.5
"17191",17,191,2001,8462,7988,474,5.6
"17191",17,191,2002,8026,7587,439,5.5
"17191",17,191,2003,7871,7377,494,6.3
"17191",17,191,2004,7971,7540,431,5.4
"17191",17,191,2005,8152,7745,407,5
"17191",17,191,2006,8221,7875,346,4.2
"17191",17,191,2007,8444,8048,396,4.7
"17191",17,191,2008,8313,7790,523,6.3
"17191",17,191,2009,8135,7324,811,10
"17191",17,191,2010,8398,7650,748,8.9
"17191",17,191,2011,8205,7548,657,8
"17191",17,191,2012,8037,7421,616,7.7
"17191",17,191,2013,7883,7270,613,7.8
"17191",17,191,2014,7672,7164,508,6.6
"17191",17,191,2015,7498,6982,516,6.9
"17191",17,191,2016,7284,6670,614,8.4
"17191",17,191,2017,6868,6451,417,6.1
"17193",17,193,1990,7319,6684,635,8.7
"17193",17,193,1991,7500,6845,655,8.7
"17193",17,193,1992,7861,7188,673,8.6
"17193",17,193,1993,7561,6833,728,9.6
"17193",17,193,1994,7419,6789,630,8.5
"17193",17,193,1995,7490,6981,509,6.8
"17193",17,193,1996,7274,6796,478,6.6
"17193",17,193,1997,7411,6965,446,6
"17193",17,193,1998,7608,7080,528,6.9
"17193",17,193,1999,7426,6989,437,5.9
"17193",17,193,2000,7556,7200,356,4.7
"17193",17,193,2001,7705,7324,381,4.9
"17193",17,193,2002,7808,7414,394,5
"17193",17,193,2003,7778,7340,438,5.6
"17193",17,193,2004,7851,7461,390,5
"17193",17,193,2005,7921,7534,387,4.9
"17193",17,193,2006,8001,7632,369,4.6
"17193",17,193,2007,8035,7626,409,5.1
"17193",17,193,2008,7829,7333,496,6.3
"17193",17,193,2009,7697,7035,662,8.6
"17193",17,193,2010,7583,6939,644,8.5
"17193",17,193,2011,7422,6836,586,7.9
"17193",17,193,2012,7284,6734,550,7.6
"17193",17,193,2013,7029,6489,540,7.7
"17193",17,193,2014,7071,6657,414,5.9
"17193",17,193,2015,6926,6529,397,5.7
"17193",17,193,2016,6875,6429,446,6.5
"17193",17,193,2017,6645,6327,318,4.8
"17195",17,195,1990,30964,29295,1669,5.4
"17195",17,195,1991,31471,29309,2162,6.9
"17195",17,195,1992,31714,29778,1936,6.1
"17195",17,195,1993,31119,29271,1848,5.9
"17195",17,195,1994,31173,29901,1272,4.1
"17195",17,195,1995,31087,29918,1169,3.8
"17195",17,195,1996,31713,30547,1166,3.7
"17195",17,195,1997,32411,31397,1014,3.1
"17195",17,195,1998,32470,31498,972,3
"17195",17,195,1999,32489,31244,1245,3.8
"17195",17,195,2000,31166,29937,1229,3.9
"17195",17,195,2001,30448,28607,1841,6
"17195",17,195,2002,29317,27421,1896,6.5
"17195",17,195,2003,28859,26813,2046,7.1
"17195",17,195,2004,29125,27311,1814,6.2
"17195",17,195,2005,29808,28110,1698,5.7
"17195",17,195,2006,30395,28843,1552,5.1
"17195",17,195,2007,30904,29275,1629,5.3
"17195",17,195,2008,30286,28251,2035,6.7
"17195",17,195,2009,30420,27271,3149,10.4
"17195",17,195,2010,29906,26822,3084,10.3
"17195",17,195,2011,29658,26852,2806,9.5
"17195",17,195,2012,29521,26928,2593,8.8
"17195",17,195,2013,29388,26824,2564,8.7
"17195",17,195,2014,28579,26600,1979,6.9
"17195",17,195,2015,28506,26743,1763,6.2
"17195",17,195,2016,28672,27027,1645,5.7
"17195",17,195,2017,28039,26712,1327,4.7
"17197",17,197,1990,187116,175176,11940,6.4
"17197",17,197,1991,189245,174825,14420,7.6
"17197",17,197,1992,195838,178664,17174,8.8
"17197",17,197,1993,201255,185570,15685,7.8
"17197",17,197,1994,209402,196494,12908,6.2
"17197",17,197,1995,219174,207112,12062,5.5
"17197",17,197,1996,229181,216856,12325,5.4
"17197",17,197,1997,234076,222377,11699,5
"17197",17,197,1998,241575,230600,10975,4.5
"17197",17,197,1999,255041,243944,11097,4.4
"17197",17,197,2000,278890,267518,11372,4.1
"17197",17,197,2001,289741,275134,14607,5
"17197",17,197,2002,295338,276216,19122,6.5
"17197",17,197,2003,305756,285399,20357,6.7
"17197",17,197,2004,321433,301180,20253,6.3
"17197",17,197,2005,334294,314932,19362,5.8
"17197",17,197,2006,351244,336149,15095,4.3
"17197",17,197,2007,361414,344122,17292,4.8
"17197",17,197,2008,365147,342981,22166,6.1
"17197",17,197,2009,366938,329028,37910,10.3
"17197",17,197,2010,355644,316210,39434,11.1
"17197",17,197,2011,354426,316754,37672,10.6
"17197",17,197,2012,356091,321288,34803,9.8
"17197",17,197,2013,358406,323345,35061,9.8
"17197",17,197,2014,356697,329629,27068,7.6
"17197",17,197,2015,357074,335079,21995,6.2
"17197",17,197,2016,363533,341759,21774,6
"17197",17,197,2017,361592,342895,18697,5.2
"17199",17,199,1990,27138,24701,2437,9
"17199",17,199,1991,26763,24251,2512,9.4
"17199",17,199,1992,27256,24352,2904,10.7
"17199",17,199,1993,27552,24465,3087,11.2
"17199",17,199,1994,27114,24608,2506,9.2
"17199",17,199,1995,26958,24864,2094,7.8
"17199",17,199,1996,27415,25131,2284,8.3
"17199",17,199,1997,27662,25752,1910,6.9
"17199",17,199,1998,28580,26638,1942,6.8
"17199",17,199,1999,29091,27548,1543,5.3
"17199",17,199,2000,30161,28448,1713,5.7
"17199",17,199,2001,29893,28247,1646,5.5
"17199",17,199,2002,30393,28676,1717,5.6
"17199",17,199,2003,30950,28837,2113,6.8
"17199",17,199,2004,31485,29448,2037,6.5
"17199",17,199,2005,33363,31589,1774,5.3
"17199",17,199,2006,35563,33916,1647,4.6
"17199",17,199,2007,36347,34021,2326,6.4
"17199",17,199,2008,35360,32921,2439,6.9
"17199",17,199,2009,34652,31447,3205,9.2
"17199",17,199,2010,32532,29374,3158,9.7
"17199",17,199,2011,32315,29394,2921,9
"17199",17,199,2012,31881,29131,2750,8.6
"17199",17,199,2013,31482,28647,2835,9
"17199",17,199,2014,31390,29153,2237,7.1
"17199",17,199,2015,31915,29942,1973,6.2
"17199",17,199,2016,32261,30297,1964,6.1
"17199",17,199,2017,31519,29918,1601,5.1
"17201",17,201,1990,142507,134961,7546,5.3
"17201",17,201,1991,142637,132515,10122,7.1
"17201",17,201,1992,144149,132665,11484,8
"17201",17,201,1993,143982,133052,10930,7.6
"17201",17,201,1994,144868,137379,7489,5.2
"17201",17,201,1995,146434,141032,5402,3.7
"17201",17,201,1996,148691,142350,6341,4.3
"17201",17,201,1997,150917,144865,6052,4
"17201",17,201,1998,149730,143879,5851,3.9
"17201",17,201,1999,151295,145059,6236,4.1
"17201",17,201,2000,147775,141496,6279,4.2
"17201",17,201,2001,143685,135499,8186,5.7
"17201",17,201,2002,140569,130715,9854,7
"17201",17,201,2003,139186,127977,11209,8.1
"17201",17,201,2004,139505,129422,10083,7.2
"17201",17,201,2005,140493,131577,8916,6.3
"17201",17,201,2006,144868,137319,7549,5.2
"17201",17,201,2007,149201,140334,8867,5.9
"17201",17,201,2008,147735,135296,12439,8.4
"17201",17,201,2009,144984,123174,21810,15
"17201",17,201,2010,150085,129021,21064,14
"17201",17,201,2011,147452,129963,17489,11.9
"17201",17,201,2012,146257,130873,15384,10.5
"17201",17,201,2013,143275,128247,15028,10.5
"17201",17,201,2014,142061,130296,11765,8.3
"17201",17,201,2015,142138,132182,9956,7
"17201",17,201,2016,141281,131980,9301,6.6
"17201",17,201,2017,138602,129843,8759,6.3
"17203",17,203,1990,17036,16521,515,3
"17203",17,203,1991,17140,16535,605,3.5
"17203",17,203,1992,17288,16544,744,4.3
"17203",17,203,1993,17361,16717,644,3.7
"17203",17,203,1994,17742,17266,476,2.7
"17203",17,203,1995,18207,17788,419,2.3
"17203",17,203,1996,18570,17818,752,4
"17203",17,203,1997,19062,18567,495,2.6
"17203",17,203,1998,19384,18948,436,2.2
"17203",17,203,1999,19526,19011,515,2.6
"17203",17,203,2000,18952,18350,602,3.2
"17203",17,203,2001,18720,18068,652,3.5
"17203",17,203,2002,18458,17714,744,4
"17203",17,203,2003,18458,17598,860,4.7
"17203",17,203,2004,19024,18219,805,4.2
"17203",17,203,2005,20036,19287,749,3.7
"17203",17,203,2006,20953,20312,641,3.1
"17203",17,203,2007,21530,20794,736,3.4
"17203",17,203,2008,21724,20804,920,4.2
"17203",17,203,2009,21245,19494,1751,8.2
"17203",17,203,2010,20340,18780,1560,7.7
"17203",17,203,2011,20503,19181,1322,6.4
"17203",17,203,2012,20526,19299,1227,6
"17203",17,203,2013,19933,18517,1416,7.1
"17203",17,203,2014,19692,18602,1090,5.5
"17203",17,203,2015,19571,18579,992,5.1
"17203",17,203,2016,19314,18265,1049,5.4
"17203",17,203,2017,18837,18025,812,4.3
"18001",18,1,1990,15287,14289,998,6.5
"18001",18,1,1991,15125,14018,1107,7.3
"18001",18,1,1992,15351,14228,1123,7.3
"18001",18,1,1993,15544,14757,787,5.1
"18001",18,1,1994,16090,15477,613,3.8
"18001",18,1,1995,16845,16005,840,5
"18001",18,1,1996,16668,16005,663,4
"18001",18,1,1997,16706,16224,482,2.9
"18001",18,1,1998,16674,16310,364,2.2
"18001",18,1,1999,16492,16124,368,2.2
"18001",18,1,2000,16558,16092,466,2.8
"18001",18,1,2001,15663,14887,776,5
"18001",18,1,2002,15885,15151,734,4.6
"18001",18,1,2003,16096,15404,692,4.3
"18001",18,1,2004,16458,15781,677,4.1
"18001",18,1,2005,16555,15756,799,4.8
"18001",18,1,2006,16223,15512,711,4.4
"18001",18,1,2007,15959,15277,682,4.3
"18001",18,1,2008,15521,14334,1187,7.6
"18001",18,1,2009,15118,12911,2207,14.6
"18001",18,1,2010,16399,14745,1654,10.1
"18001",18,1,2011,16154,14891,1263,7.8
"18001",18,1,2012,15884,14765,1119,7
"18001",18,1,2013,15888,14922,966,6.1
"18001",18,1,2014,16404,15653,751,4.6
"18001",18,1,2015,16900,16254,646,3.8
"18001",18,1,2016,17030,16420,610,3.6
"18001",18,1,2017,17235,16784,451,2.6
"18003",18,3,1990,162422,154105,8317,5.1
"18003",18,3,1991,160641,151062,9579,6
"18003",18,3,1992,163856,153471,10385,6.3
"18003",18,3,1993,167741,159081,8660,5.2
"18003",18,3,1994,172729,165235,7494,4.3
"18003",18,3,1995,176444,169801,6643,3.8
"18003",18,3,1996,175551,169432,6119,3.5
"18003",18,3,1997,177144,172074,5070,2.9
"18003",18,3,1998,178153,173139,5014,2.8
"18003",18,3,1999,176753,171515,5238,3
"18003",18,3,2000,175714,170831,4883,2.8
"18003",18,3,2001,175142,167870,7272,4.2
"18003",18,3,2002,176968,168157,8811,5
"18003",18,3,2003,179084,169628,9456,5.3
"18003",18,3,2004,176997,167643,9354,5.3
"18003",18,3,2005,178905,169461,9444,5.3
"18003",18,3,2006,182227,173072,9155,5
"18003",18,3,2007,180707,172101,8606,4.8
"18003",18,3,2008,181298,170481,10817,6
"18003",18,3,2009,178193,159522,18671,10.5
"18003",18,3,2010,175944,157115,18829,10.7
"18003",18,3,2011,176123,159786,16337,9.3
"18003",18,3,2012,173801,159248,14553,8.4
"18003",18,3,2013,174131,161049,13082,7.5
"18003",18,3,2014,175539,165499,10040,5.7
"18003",18,3,2015,178025,169826,8199,4.6
"18003",18,3,2016,180761,173061,7700,4.3
"18003",18,3,2017,180751,174761,5990,3.3
"18005",18,5,1990,33801,32169,1632,4.8
"18005",18,5,1991,33440,31469,1971,5.9
"18005",18,5,1992,34666,32817,1849,5.3
"18005",18,5,1993,36802,35331,1471,4
"18005",18,5,1994,38952,37627,1325,3.4
"18005",18,5,1995,40205,38986,1219,3
"18005",18,5,1996,39758,38638,1120,2.8
"18005",18,5,1997,39798,38901,897,2.3
"18005",18,5,1998,40042,39175,867,2.2
"18005",18,5,1999,39671,38832,839,2.1
"18005",18,5,2000,37297,36292,1005,2.7
"18005",18,5,2001,36363,34880,1483,4.1
"18005",18,5,2002,35917,34195,1722,4.8
"18005",18,5,2003,35692,33990,1702,4.8
"18005",18,5,2004,36157,34548,1609,4.5
"18005",18,5,2005,37388,35576,1812,4.8
"18005",18,5,2006,38176,36566,1610,4.2
"18005",18,5,2007,38544,37156,1388,3.6
"18005",18,5,2008,39559,37724,1835,4.6
"18005",18,5,2009,38446,34763,3683,9.6
"18005",18,5,2010,38388,34728,3660,9.5
"18005",18,5,2011,40025,36982,3043,7.6
"18005",18,5,2012,41409,38763,2646,6.4
"18005",18,5,2013,41587,39102,2485,6
"18005",18,5,2014,42577,40713,1864,4.4
"18005",18,5,2015,43580,42004,1576,3.6
"18005",18,5,2016,44425,42921,1504,3.4
"18005",18,5,2017,44516,43307,1209,2.7
"18007",18,7,1990,4643,4487,156,3.4
"18007",18,7,1991,4637,4457,180,3.9
"18007",18,7,1992,4782,4539,243,5.1
"18007",18,7,1993,5100,4833,267,5.2
"18007",18,7,1994,5306,4999,307,5.8
"18007",18,7,1995,5415,5152,263,4.9
"18007",18,7,1996,5272,5046,226,4.3
"18007",18,7,1997,5158,4968,190,3.7
"18007",18,7,1998,5071,4903,168,3.3
"18007",18,7,1999,5466,5295,171,3.1
"18007",18,7,2000,4829,4686,143,3
"18007",18,7,2001,4827,4659,168,3.5
"18007",18,7,2002,4900,4653,247,5
"18007",18,7,2003,4693,4438,255,5.4
"18007",18,7,2004,4605,4358,247,5.4
"18007",18,7,2005,4599,4356,243,5.3
"18007",18,7,2006,4612,4383,229,5
"18007",18,7,2007,4337,4146,191,4.4
"18007",18,7,2008,4405,4174,231,5.2
"18007",18,7,2009,4284,3857,427,10
"18007",18,7,2010,4662,4232,430,9.2
"18007",18,7,2011,4644,4277,367,7.9
"18007",18,7,2012,4550,4211,339,7.5
"18007",18,7,2013,4462,4147,315,7.1
"18007",18,7,2014,4470,4228,242,5.4
"18007",18,7,2015,4578,4373,205,4.5
"18007",18,7,2016,4563,4370,193,4.2
"18007",18,7,2017,4510,4357,153,3.4
"18009",18,9,1990,6966,6323,643,9.2
"18009",18,9,1991,6466,5668,798,12.3
"18009",18,9,1992,6245,5487,758,12.1
"18009",18,9,1993,6138,5504,634,10.3
"18009",18,9,1994,6415,5964,451,7
"18009",18,9,1995,6499,6085,414,6.4
"18009",18,9,1996,6519,6162,357,5.5
"18009",18,9,1997,6581,6277,304,4.6
"18009",18,9,1998,6614,6288,326,4.9
"18009",18,9,1999,6494,6205,289,4.5
"18009",18,9,2000,7031,6719,312,4.4
"18009",18,9,2001,7070,6674,396,5.6
"18009",18,9,2002,7020,6577,443,6.3
"18009",18,9,2003,6916,6406,510,7.4
"18009",18,9,2004,6729,6248,481,7.1
"18009",18,9,2005,6817,6330,487,7.1
"18009",18,9,2006,6717,6277,440,6.6
"18009",18,9,2007,6550,6172,378,5.8
"18009",18,9,2008,6484,5989,495,7.6
"18009",18,9,2009,6413,5512,901,14
"18009",18,9,2010,5847,5007,840,14.4
"18009",18,9,2011,5624,4933,691,12.3
"18009",18,9,2012,5461,4836,625,11.4
"18009",18,9,2013,5440,4902,538,9.9
"18009",18,9,2014,5260,4871,389,7.4
"18009",18,9,2015,5242,4926,316,6
"18009",18,9,2016,5333,5048,285,5.3
"18009",18,9,2017,5372,5156,216,4
"18011",18,11,1990,20418,19935,483,2.4
"18011",18,11,1991,20371,19730,641,3.1
"18011",18,11,1992,20907,20068,839,4
"18011",18,11,1993,21689,21016,673,3.1
"18011",18,11,1994,22817,22115,702,3.1
"18011",18,11,1995,23550,22923,627,2.7
"18011",18,11,1996,23702,23161,541,2.3
"18011",18,11,1997,24071,23623,448,1.9
"18011",18,11,1998,24549,24149,400,1.6
"18011",18,11,1999,24983,24556,427,1.7
"18011",18,11,2000,24257,23735,522,2.2
"18011",18,11,2001,24722,24024,698,2.8
"18011",18,11,2002,25483,24513,970,3.8
"18011",18,11,2003,26153,25100,1053,4
"18011",18,11,2004,26523,25476,1047,3.9
"18011",18,11,2005,27178,26054,1124,4.1
"18011",18,11,2006,28042,26994,1048,3.7
"18011",18,11,2007,27960,26995,965,3.5
"18011",18,11,2008,28429,27197,1232,4.3
"18011",18,11,2009,28281,26091,2190,7.7
"18011",18,11,2010,29395,27163,2232,7.6
"18011",18,11,2011,29815,27812,2003,6.7
"18011",18,11,2012,30227,28388,1839,6.1
"18011",18,11,2013,31079,29308,1771,5.7
"18011",18,11,2014,32166,30755,1411,4.4
"18011",18,11,2015,33494,32258,1236,3.7
"18011",18,11,2016,34838,33663,1175,3.4
"18011",18,11,2017,34993,34001,992,2.8
"18013",18,13,1990,7272,6944,328,4.5
"18013",18,13,1991,7142,6815,327,4.6
"18013",18,13,1992,7438,7163,275,3.7
"18013",18,13,1993,7973,7747,226,2.8
"18013",18,13,1994,8372,8140,232,2.8
"18013",18,13,1995,8716,8469,247,2.8
"18013",18,13,1996,8614,8431,183,2.1
"18013",18,13,1997,8745,8564,181,2.1
"18013",18,13,1998,8904,8758,146,1.6
"18013",18,13,1999,8878,8670,208,2.3
"18013",18,13,2000,7871,7638,233,3
"18013",18,13,2001,7998,7681,317,4
"18013",18,13,2002,8085,7683,402,5
"18013",18,13,2003,8119,7710,409,5
"18013",18,13,2004,8027,7591,436,5.4
"18013",18,13,2005,8002,7548,454,5.7
"18013",18,13,2006,7957,7565,392,4.9
"18013",18,13,2007,7614,7280,334,4.4
"18013",18,13,2008,7587,7157,430,5.7
"18013",18,13,2009,7450,6711,739,9.9
"18013",18,13,2010,7566,6781,785,10.4
"18013",18,13,2011,7430,6746,684,9.2
"18013",18,13,2012,7323,6737,586,8
"18013",18,13,2013,7317,6774,543,7.4
"18013",18,13,2014,7352,6913,439,6
"18013",18,13,2015,7443,7087,356,4.8
"18013",18,13,2016,7518,7216,302,4
"18013",18,13,2017,7547,7292,255,3.4
"18015",18,15,1990,9541,9152,389,4.1
"18015",18,15,1991,9939,9505,434,4.4
"18015",18,15,1992,10654,10137,517,4.9
"18015",18,15,1993,11018,10532,486,4.4
"18015",18,15,1994,11700,11213,487,4.2
"18015",18,15,1995,12155,11752,403,3.3
"18015",18,15,1996,11988,11656,332,2.8
"18015",18,15,1997,12213,11913,300,2.5
"18015",18,15,1998,12384,12148,236,1.9
"18015",18,15,1999,12505,12234,271,2.2
"18015",18,15,2000,10496,10195,301,2.9
"18015",18,15,2001,10720,10262,458,4.3
"18015",18,15,2002,10863,10338,525,4.8
"18015",18,15,2003,10633,9987,646,6.1
"18015",18,15,2004,10431,9830,601,5.8
"18015",18,15,2005,10515,9967,548,5.2
"18015",18,15,2006,10559,10063,496,4.7
"18015",18,15,2007,9926,9523,403,4.1
"18015",18,15,2008,10170,9573,597,5.9
"18015",18,15,2009,10015,8953,1062,10.6
"18015",18,15,2010,10254,9239,1015,9.9
"18015",18,15,2011,10125,9282,843,8.3
"18015",18,15,2012,9985,9251,734,7.4
"18015",18,15,2013,9906,9209,697,7
"18015",18,15,2014,9875,9359,516,5.2
"18015",18,15,2015,10022,9587,435,4.3
"18015",18,15,2016,10103,9675,428,4.2
"18015",18,15,2017,10027,9684,343,3.4
"18017",18,17,1990,18833,17545,1288,6.8
"18017",18,17,1991,18659,17377,1282,6.9
"18017",18,17,1992,18883,17511,1372,7.3
"18017",18,17,1993,18902,17522,1380,7.3
"18017",18,17,1994,18906,17221,1685,8.9
"18017",18,17,1995,19224,17924,1300,6.8
"18017",18,17,1996,19647,18556,1091,5.6
"18017",18,17,1997,20044,19198,846,4.2
"18017",18,17,1998,20182,19572,610,3
"18017",18,17,1999,20163,19517,646,3.2
"18017",18,17,2000,20652,20003,649,3.1
"18017",18,17,2001,20479,19463,1016,5
"18017",18,17,2002,20592,19405,1187,5.8
"18017",18,17,2003,20040,18788,1252,6.2
"18017",18,17,2004,19741,18425,1316,6.7
"18017",18,17,2005,19274,18161,1113,5.8
"18017",18,17,2006,18917,17888,1029,5.4
"18017",18,17,2007,18673,17758,915,4.9
"18017",18,17,2008,18803,17623,1180,6.3
"18017",18,17,2009,18725,16477,2248,12
"18017",18,17,2010,18851,16810,2041,10.8
"18017",18,17,2011,18181,16467,1714,9.4
"18017",18,17,2012,17782,16250,1532,8.6
"18017",18,17,2013,17672,16310,1362,7.7
"18017",18,17,2014,17720,16700,1020,5.8
"18017",18,17,2015,17760,16944,816,4.6
"18017",18,17,2016,18039,17202,837,4.6
"18017",18,17,2017,17811,17130,681,3.8
"18019",18,19,1990,45884,43188,2696,5.9
"18019",18,19,1991,45173,42608,2565,5.7
"18019",18,19,1992,46736,43837,2899,6.2
"18019",18,19,1993,47886,45425,2461,5.1
"18019",18,19,1994,50062,47446,2616,5.2
"18019",18,19,1995,50909,48551,2358,4.6
"18019",18,19,1996,51297,49180,2117,4.1
"18019",18,19,1997,52008,50252,1756,3.4
"18019",18,19,1998,52697,51274,1423,2.7
"18019",18,19,1999,53451,51978,1473,2.8
"18019",18,19,2000,52473,50559,1914,3.6
"18019",18,19,2001,52119,49807,2312,4.4
"18019",18,19,2002,52321,49569,2752,5.3
"18019",18,19,2003,52949,50345,2604,4.9
"18019",18,19,2004,52493,49791,2702,5.1
"18019",18,19,2005,53370,50569,2801,5.2
"18019",18,19,2006,54998,52255,2743,5
"18019",18,19,2007,55140,52748,2392,4.3
"18019",18,19,2008,56064,53075,2989,5.3
"18019",18,19,2009,56018,51137,4881,8.7
"18019",18,19,2010,55317,50043,5274,9.5
"18019",18,19,2011,55551,50607,4944,8.9
"18019",18,19,2012,55405,51071,4334,7.8
"18019",18,19,2013,56230,52343,3887,6.9
"18019",18,19,2014,57572,54466,3106,5.4
"18019",18,19,2015,58893,56244,2649,4.5
"18019",18,19,2016,60642,58124,2518,4.2
"18019",18,19,2017,60858,58747,2111,3.5
"18021",18,21,1990,11193,10628,565,5
"18021",18,21,1991,11480,10695,785,6.8
"18021",18,21,1992,11803,10925,878,7.4
"18021",18,21,1993,12269,11552,717,5.8
"18021",18,21,1994,12699,11952,747,5.9
"18021",18,21,1995,13307,12497,810,6.1
"18021",18,21,1996,13045,12267,778,6
"18021",18,21,1997,12642,11944,698,5.5
"18021",18,21,1998,12427,11905,522,4.2
"18021",18,21,1999,12549,12031,518,4.1
"18021",18,21,2000,12852,12309,543,4.2
"18021",18,21,2001,12962,12247,715,5.5
"18021",18,21,2002,13144,12343,801,6.1
"18021",18,21,2003,13020,12268,752,5.8
"18021",18,21,2004,13237,12367,870,6.6
"18021",18,21,2005,13314,12379,935,7
"18021",18,21,2006,13167,12419,748,5.7
"18021",18,21,2007,12878,12132,746,5.8
"18021",18,21,2008,12870,11959,911,7.1
"18021",18,21,2009,13005,11542,1463,11.2
"18021",18,21,2010,13180,11712,1468,11.1
"18021",18,21,2011,12995,11646,1349,10.4
"18021",18,21,2012,12808,11545,1263,9.9
"18021",18,21,2013,12582,11459,1123,8.9
"18021",18,21,2014,12428,11589,839,6.8
"18021",18,21,2015,12368,11713,655,5.3
"18021",18,21,2016,12379,11801,578,4.7
"18021",18,21,2017,12204,11743,461,3.8
"18023",18,23,1990,14590,13915,675,4.6
"18023",18,23,1991,14517,13824,693,4.8
"18023",18,23,1992,14662,13976,686,4.7
"18023",18,23,1993,15194,14520,674,4.4
"18023",18,23,1994,15620,15034,586,3.8
"18023",18,23,1995,15955,15401,554,3.5
"18023",18,23,1996,16101,15570,531,3.3
"18023",18,23,1997,16330,15798,532,3.3
"18023",18,23,1998,16142,15645,497,3.1
"18023",18,23,1999,16009,15607,402,2.5
"18023",18,23,2000,16464,15970,494,3
"18023",18,23,2001,16555,15883,672,4.1
"18023",18,23,2002,16670,15879,791,4.7
"18023",18,23,2003,16863,15977,886,5.3
"18023",18,23,2004,16762,15806,956,5.7
"18023",18,23,2005,17007,16042,965,5.7
"18023",18,23,2006,16998,16139,859,5.1
"18023",18,23,2007,16769,16013,756,4.5
"18023",18,23,2008,16879,15956,923,5.5
"18023",18,23,2009,16947,15123,1824,10.8
"18023",18,23,2010,16899,15185,1714,10.1
"18023",18,23,2011,16749,15305,1444,8.6
"18023",18,23,2012,16568,15239,1329,8
"18023",18,23,2013,16421,15256,1165,7.1
"18023",18,23,2014,16642,15791,851,5.1
"18023",18,23,2015,16919,16238,681,4
"18023",18,23,2016,17143,16477,666,3.9
"18023",18,23,2017,16913,16392,521,3.1
"18025",18,25,1990,4411,3976,435,9.9
"18025",18,25,1991,4407,3943,464,10.5
"18025",18,25,1992,4496,3979,517,11.5
"18025",18,25,1993,4730,4204,526,11.1
"18025",18,25,1994,4812,4300,512,10.6
"18025",18,25,1995,4899,4427,472,9.6
"18025",18,25,1996,4794,4338,456,9.5
"18025",18,25,1997,4802,4423,379,7.9
"18025",18,25,1998,4784,4499,285,6
"18025",18,25,1999,5384,5076,308,5.7
"18025",18,25,2000,5113,4861,252,4.9
"18025",18,25,2001,5240,4949,291,5.6
"18025",18,25,2002,5337,4959,378,7.1
"18025",18,25,2003,5350,4984,366,6.8
"18025",18,25,2004,5410,5030,380,7
"18025",18,25,2005,5431,5014,417,7.7
"18025",18,25,2006,5307,4928,379,7.1
"18025",18,25,2007,5238,4920,318,6.1
"18025",18,25,2008,5388,4983,405,7.5
"18025",18,25,2009,5214,4575,639,12.3
"18025",18,25,2010,4919,4283,636,12.9
"18025",18,25,2011,4866,4289,577,11.9
"18025",18,25,2012,4791,4282,509,10.6
"18025",18,25,2013,4841,4356,485,10
"18025",18,25,2014,4889,4515,374,7.6
"18025",18,25,2015,4918,4621,297,6
"18025",18,25,2016,5002,4720,282,5.6
"18025",18,25,2017,4923,4705,218,4.4
"18027",18,27,1990,12402,11905,497,4
"18027",18,27,1991,12359,11772,587,4.7
"18027",18,27,1992,12724,12008,716,5.6
"18027",18,27,1993,13122,12453,669,5.1
"18027",18,27,1994,13326,12744,582,4.4
"18027",18,27,1995,13849,13179,670,4.8
"18027",18,27,1996,13627,13108,519,3.8
"18027",18,27,1997,13761,13287,474,3.4
"18027",18,27,1998,13772,13368,404,2.9
"18027",18,27,1999,13891,13434,457,3.3
"18027",18,27,2000,14093,13661,432,3.1
"18027",18,27,2001,13901,13366,535,3.8
"18027",18,27,2002,14096,13486,610,4.3
"18027",18,27,2003,14358,13772,586,4.1
"18027",18,27,2004,14466,13888,578,4
"18027",18,27,2005,14884,14269,615,4.1
"18027",18,27,2006,15096,14549,547,3.6
"18027",18,27,2007,15123,14660,463,3.1
"18027",18,27,2008,15202,14620,582,3.8
"18027",18,27,2009,14933,14056,877,5.9
"18027",18,27,2010,14747,13790,957,6.5
"18027",18,27,2011,14887,13978,909,6.1
"18027",18,27,2012,14790,13900,890,6
"18027",18,27,2013,14869,14028,841,5.7
"18027",18,27,2014,15165,14488,677,4.5
"18027",18,27,2015,15695,15101,594,3.8
"18027",18,27,2016,15964,15400,564,3.5
"18027",18,27,2017,15846,15404,442,2.8
"18029",18,29,1990,19533,17937,1596,8.2
"18029",18,29,1991,19498,17836,1662,8.5
"18029",18,29,1992,20138,18379,1759,8.7
"18029",18,29,1993,20646,19184,1462,7.1
"18029",18,29,1994,21544,20186,1358,6.3
"18029",18,29,1995,22610,21133,1477,6.5
"18029",18,29,1996,22902,21717,1185,5.2
"18029",18,29,1997,23358,22485,873,3.7
"18029",18,29,1998,23710,22917,793,3.3
"18029",18,29,1999,23970,23195,775,3.2
"18029",18,29,2000,24464,23639,825,3.4
"18029",18,29,2001,24645,23683,962,3.9
"18029",18,29,2002,25254,23940,1314,5.2
"18029",18,29,2003,25885,24550,1335,5.2
"18029",18,29,2004,26016,24618,1398,5.4
"18029",18,29,2005,26428,24916,1512,5.7
"18029",18,29,2006,26478,25053,1425,5.4
"18029",18,29,2007,26093,24778,1315,5
"18029",18,29,2008,26244,24707,1537,5.9
"18029",18,29,2009,26096,23533,2563,9.8
"18029",18,29,2010,25524,22752,2772,10.9
"18029",18,29,2011,25339,22898,2441,9.6
"18029",18,29,2012,24980,22756,2224,8.9
"18029",18,29,2013,25174,23043,2131,8.5
"18029",18,29,2014,25097,23449,1648,6.6
"18029",18,29,2015,25214,23920,1294,5.1
"18029",18,29,2016,25585,24380,1205,4.7
"18029",18,29,2017,25591,24605,986,3.9
"18031",18,31,1990,12002,11503,499,4.2
"18031",18,31,1991,11945,11433,512,4.3
"18031",18,31,1992,12877,12251,626,4.9
"18031",18,31,1993,14047,13512,535,3.8
"18031",18,31,1994,15218,14636,582,3.8
"18031",18,31,1995,15444,14836,608,3.9
"18031",18,31,1996,15358,14905,453,2.9
"18031",18,31,1997,16349,15953,396,2.4
"18031",18,31,1998,16087,15717,370,2.3
"18031",18,31,1999,17104,16777,327,1.9
"18031",18,31,2000,13427,13117,310,2.3
"18031",18,31,2001,12999,12578,421,3.2
"18031",18,31,2002,13429,12915,514,3.8
"18031",18,31,2003,12526,11954,572,4.6
"18031",18,31,2004,12539,11859,680,5.4
"18031",18,31,2005,12695,12051,644,5.1
"18031",18,31,2006,12505,11959,546,4.4
"18031",18,31,2007,12309,11751,558,4.5
"18031",18,31,2008,12681,11886,795,6.3
"18031",18,31,2009,12627,11061,1566,12.4
"18031",18,31,2010,12919,11415,1504,11.6
"18031",18,31,2011,13014,11741,1273,9.8
"18031",18,31,2012,13583,12481,1102,8.1
"18031",18,31,2013,13861,12933,928,6.7
"18031",18,31,2014,14172,13476,696,4.9
"18031",18,31,2015,14293,13711,582,4.1
"18031",18,31,2016,14546,14029,517,3.6
"18031",18,31,2017,14681,14254,427,2.9
"18033",18,33,1990,19140,17993,1147,6
"18033",18,33,1991,19157,17780,1377,7.2
"18033",18,33,1992,19609,18310,1299,6.6
"18033",18,33,1993,20081,19084,997,5
"18033",18,33,1994,20974,20024,950,4.5
"18033",18,33,1995,21490,20669,821,3.8
"18033",18,33,1996,21421,20677,744,3.5
"18033",18,33,1997,21944,21304,640,2.9
"18033",18,33,1998,22041,21481,560,2.5
"18033",18,33,1999,22037,21343,694,3.1
"18033",18,33,2000,21700,21033,667,3.1
"18033",18,33,2001,21500,20430,1070,5
"18033",18,33,2002,21807,20623,1184,5.4
"18033",18,33,2003,22044,20795,1249,5.7
"18033",18,33,2004,21819,20595,1224,5.6
"18033",18,33,2005,21911,20531,1380,6.3
"18033",18,33,2006,21504,20190,1314,6.1
"18033",18,33,2007,20698,19564,1134,5.5
"18033",18,33,2008,20618,19119,1499,7.3
"18033",18,33,2009,20352,17572,2780,13.7
"18033",18,33,2010,20595,18138,2457,11.9
"18033",18,33,2011,20488,18501,1987,9.7
"18033",18,33,2012,20569,18852,1717,8.3
"18033",18,33,2013,20941,19443,1498,7.2
"18033",18,33,2014,21244,20138,1106,5.2
"18033",18,33,2015,21784,20887,897,4.1
"18033",18,33,2016,22222,21352,870,3.9
"18033",18,33,2017,22211,21561,650,2.9
"18035",18,35,1990,58791,55518,3273,5.6
"18035",18,35,1991,58592,54714,3878,6.6
"18035",18,35,1992,61762,57233,4529,7.3
"18035",18,35,1993,62614,58663,3951,6.3
"18035",18,35,1994,65546,61877,3669,5.6
"18035",18,35,1995,67153,63871,3282,4.9
"18035",18,35,1996,63999,61096,2903,4.5
"18035",18,35,1997,63147,60677,2470,3.9
"18035",18,35,1998,62509,59942,2567,4.1
"18035",18,35,1999,61373,59298,2075,3.4
"18035",18,35,2000,58650,56569,2081,3.5
"18035",18,35,2001,59499,56621,2878,4.8
"18035",18,35,2002,59148,55635,3513,5.9
"18035",18,35,2003,59032,55339,3693,6.3
"18035",18,35,2004,56970,53417,3553,6.2
"18035",18,35,2005,56113,52262,3851,6.9
"18035",18,35,2006,56847,53442,3405,6
"18035",18,35,2007,55139,52222,2917,5.3
"18035",18,35,2008,55469,51756,3713,6.7
"18035",18,35,2009,55337,49432,5905,10.7
"18035",18,35,2010,54724,48402,6322,11.6
"18035",18,35,2011,54650,49103,5547,10.2
"18035",18,35,2012,54899,49756,5143,9.4
"18035",18,35,2013,54167,49496,4671,8.6
"18035",18,35,2014,53553,49804,3749,7
"18035",18,35,2015,54442,51339,3103,5.7
"18035",18,35,2016,55054,52233,2821,5.1
"18035",18,35,2017,55024,52708,2316,4.2
"18037",18,37,1990,20212,19571,641,3.2
"18037",18,37,1991,20278,19557,721,3.6
"18037",18,37,1992,20697,19927,770,3.7
"18037",18,37,1993,21372,20700,672,3.1
"18037",18,37,1994,22010,21314,696,3.2
"18037",18,37,1995,22833,22111,722,3.2
"18037",18,37,1996,22692,22057,635,2.8
"18037",18,37,1997,22753,22217,536,2.4
"18037",18,37,1998,23026,22625,401,1.7
"18037",18,37,1999,23371,22881,490,2.1
"18037",18,37,2000,22149,21645,504,2.3
"18037",18,37,2001,22103,21453,650,2.9
"18037",18,37,2002,22106,21277,829,3.8
"18037",18,37,2003,22469,21657,812,3.6
"18037",18,37,2004,21914,21072,842,3.8
"18037",18,37,2005,22402,21523,879,3.9
"18037",18,37,2006,22377,21567,810,3.6
"18037",18,37,2007,22150,21470,680,3.1
"18037",18,37,2008,22293,21435,858,3.8
"18037",18,37,2009,22056,20410,1646,7.5
"18037",18,37,2010,21927,20285,1642,7.5
"18037",18,37,2011,21938,20606,1332,6.1
"18037",18,37,2012,21583,20352,1231,5.7
"18037",18,37,2013,21629,20480,1149,5.3
"18037",18,37,2014,22024,21129,895,4.1
"18037",18,37,2015,22675,21906,769,3.4
"18037",18,37,2016,23382,22655,727,3.1
"18037",18,37,2017,23194,22594,600,2.6
"18039",18,39,1990,85232,80539,4693,5.5
"18039",18,39,1991,82245,76544,5701,6.9
"18039",18,39,1992,84420,79490,4930,5.8
"18039",18,39,1993,88372,85001,3371,3.8
"18039",18,39,1994,93771,90858,2913,3.1
"18039",18,39,1995,97032,93478,3554,3.7
"18039",18,39,1996,95322,91639,3683,3.9
"18039",18,39,1997,94780,91688,3092,3.3
"18039",18,39,1998,96097,93762,2335,2.4
"18039",18,39,1999,98089,95947,2142,2.2
"18039",18,39,2000,96750,94152,2598,2.7
"18039",18,39,2001,95337,90863,4474,4.7
"18039",18,39,2002,94888,90372,4516,4.8
"18039",18,39,2003,96260,91732,4528,4.7
"18039",18,39,2004,99462,95201,4261,4.3
"18039",18,39,2005,101915,97189,4726,4.6
"18039",18,39,2006,104165,99257,4908,4.7
"18039",18,39,2007,101303,96658,4645,4.6
"18039",18,39,2008,97832,89437,8395,8.6
"18039",18,39,2009,90688,74478,16210,17.9
"18039",18,39,2010,94499,81900,12599,13.3
"18039",18,39,2011,95376,85122,10254,10.8
"18039",18,39,2012,96848,88195,8653,8.9
"18039",18,39,2013,98970,91805,7165,7.2
"18039",18,39,2014,102097,96915,5182,5.1
"18039",18,39,2015,104716,100644,4072,3.9
"18039",18,39,2016,108409,104636,3773,3.5
"18039",18,39,2017,111740,108915,2825,2.5
"18041",18,41,1990,13207,11476,1731,13.1
"18041",18,41,1991,12538,10925,1613,12.9
"18041",18,41,1992,12665,10856,1809,14.3
"18041",18,41,1993,12784,11613,1171,9.2
"18041",18,41,1994,12887,11671,1216,9.4
"18041",18,41,1995,12596,11312,1284,10.2
"18041",18,41,1996,11972,11193,779,6.5
"18041",18,41,1997,11718,11073,645,5.5
"18041",18,41,1998,11430,10803,627,5.5
"18041",18,41,1999,11076,10508,568,5.1
"18041",18,41,2000,12407,11854,553,4.5
"18041",18,41,2001,12137,11308,829,6.8
"18041",18,41,2002,11928,11024,904,7.6
"18041",18,41,2003,11637,10708,929,8
"18041",18,41,2004,11230,10326,904,8
"18041",18,41,2005,11451,10526,925,8.1
"18041",18,41,2006,10829,9961,868,8
"18041",18,41,2007,10431,9675,756,7.2
"18041",18,41,2008,10078,8933,1145,11.4
"18041",18,41,2009,9852,8359,1493,15.2
"18041",18,41,2010,9770,8342,1428,14.6
"18041",18,41,2011,9512,8317,1195,12.6
"18041",18,41,2012,9165,8144,1021,11.1
"18041",18,41,2013,9023,8091,932,10.3
"18041",18,41,2014,9083,8375,708,7.8
"18041",18,41,2015,8990,8399,591,6.6
"18041",18,41,2016,9345,8808,537,5.7
"18041",18,41,2017,9042,8588,454,5
"18043",18,43,1990,32695,31057,1638,5
"18043",18,43,1991,32513,31016,1497,4.6
"18043",18,43,1992,33838,32060,1778,5.3
"18043",18,43,1993,34890,33443,1447,4.1
"18043",18,43,1994,36625,35063,1562,4.3
"18043",18,43,1995,37656,36104,1552,4.1
"18043",18,43,1996,38007,36613,1394,3.7
"18043",18,43,1997,38678,37529,1149,3
"18043",18,43,1998,39037,38122,915,2.3
"18043",18,43,1999,39337,38413,924,2.3
"18043",18,43,2000,38036,36709,1327,3.5
"18043",18,43,2001,37799,36267,1532,4.1
"18043",18,43,2002,37662,35834,1828,4.9
"18043",18,43,2003,37514,35776,1738,4.6
"18043",18,43,2004,36977,35136,1841,5
"18043",18,43,2005,37486,35528,1958,5.2
"18043",18,43,2006,38179,36298,1881,4.9
"18043",18,43,2007,37949,36375,1574,4.1
"18043",18,43,2008,38348,36392,1956,5.1
"18043",18,43,2009,37975,34731,3244,8.5
"18043",18,43,2010,37858,34505,3353,8.9
"18043",18,43,2011,37767,34753,3014,8
"18043",18,43,2012,37784,35095,2689,7.1
"18043",18,43,2013,38502,36061,2441,6.3
"18043",18,43,2014,39044,37065,1979,5.1
"18043",18,43,2015,39932,38222,1710,4.3
"18043",18,43,2016,41056,39381,1675,4.1
"18043",18,43,2017,41151,39793,1358,3.3
"18045",18,45,1990,8314,7772,542,6.5
"18045",18,45,1991,8296,7624,672,8.1
"18045",18,45,1992,8475,7672,803,9.5
"18045",18,45,1993,8614,7945,669,7.8
"18045",18,45,1994,8844,8245,599,6.8
"18045",18,45,1995,8817,8365,452,5.1
"18045",18,45,1996,8877,8444,433,4.9
"18045",18,45,1997,8760,8348,412,4.7
"18045",18,45,1998,8796,8376,420,4.8
"18045",18,45,1999,8757,8411,346,4
"18045",18,45,2000,8654,8377,277,3.2
"18045",18,45,2001,8599,8206,393,4.6
"18045",18,45,2002,8514,8004,510,6
"18045",18,45,2003,8412,7933,479,5.7
"18045",18,45,2004,8495,8014,481,5.7
"18045",18,45,2005,8803,8324,479,5.4
"18045",18,45,2006,8750,8326,424,4.8
"18045",18,45,2007,8652,8289,363,4.2
"18045",18,45,2008,8652,8191,461,5.3
"18045",18,45,2009,8407,7341,1066,12.7
"18045",18,45,2010,8608,7593,1015,11.8
"18045",18,45,2011,8630,7802,828,9.6
"18045",18,45,2012,8539,7822,717,8.4
"18045",18,45,2013,8320,7504,816,9.8
"18045",18,45,2014,8191,7620,571,7
"18045",18,45,2015,8049,7572,477,5.9
"18045",18,45,2016,7975,7513,462,5.8
"18045",18,45,2017,7882,7565,317,4
"18047",18,47,1990,9792,8993,799,8.2
"18047",18,47,1991,9680,8870,810,8.4
"18047",18,47,1992,9825,8942,883,9
"18047",18,47,1993,10016,9314,702,7
"18047",18,47,1994,10513,9814,699,6.6
"18047",18,47,1995,11050,10344,706,6.4
"18047",18,47,1996,10832,10332,500,4.6
"18047",18,47,1997,10750,10343,407,3.8
"18047",18,47,1998,10957,10617,340,3.1
"18047",18,47,1999,11091,10716,375,3.4
"18047",18,47,2000,11316,10911,405,3.6
"18047",18,47,2001,11355,10849,506,4.5
"18047",18,47,2002,11646,10980,666,5.7
"18047",18,47,2003,11890,11205,685,5.8
"18047",18,47,2004,11818,11149,669,5.7
"18047",18,47,2005,12052,11278,774,6.4
"18047",18,47,2006,12051,11347,704,5.8
"18047",18,47,2007,11785,11135,650,5.5
"18047",18,47,2008,11887,11104,783,6.6
"18047",18,47,2009,11598,10381,1217,10.5
"18047",18,47,2010,11395,10088,1307,11.5
"18047",18,47,2011,11221,10094,1127,10
"18047",18,47,2012,10558,9553,1005,9.5
"18047",18,47,2013,10769,9835,934,8.7
"18047",18,47,2014,10875,10166,709,6.5
"18047",18,47,2015,11387,10809,578,5.1
"18047",18,47,2016,11473,10975,498,4.3
"18047",18,47,2017,11169,10765,404,3.6
"18049",18,49,1990,9308,8848,460,4.9
"18049",18,49,1991,9310,8723,587,6.3
"18049",18,49,1992,9484,8837,647,6.8
"18049",18,49,1993,9904,9333,571,5.8
"18049",18,49,1994,10157,9669,488,4.8
"18049",18,49,1995,10829,10352,477,4.4
"18049",18,49,1996,10520,10093,427,4.1
"18049",18,49,1997,10533,10076,457,4.3
"18049",18,49,1998,10261,9826,435,4.2
"18049",18,49,1999,10076,9677,399,4
"18049",18,49,2000,10764,10318,446,4.1
"18049",18,49,2001,10425,9821,604,5.8
"18049",18,49,2002,10440,9800,640,6.1
"18049",18,49,2003,10375,9740,635,6.1
"18049",18,49,2004,10227,9640,587,5.7
"18049",18,49,2005,10464,9900,564,5.4
"18049",18,49,2006,10467,9906,561,5.4
"18049",18,49,2007,10364,9863,501,4.8
"18049",18,49,2008,10276,9602,674,6.6
"18049",18,49,2009,9999,8726,1273,12.7
"18049",18,49,2010,10284,9109,1175,11.4
"18049",18,49,2011,10200,9258,942,9.2
"18049",18,49,2012,10083,9238,845,8.4
"18049",18,49,2013,9884,9067,817,8.3
"18049",18,49,2014,9785,9172,613,6.3
"18049",18,49,2015,9862,9389,473,4.8
"18049",18,49,2016,9883,9420,463,4.7
"18049",18,49,2017,9696,9355,341,3.5
"18051",18,51,1990,15891,14879,1012,6.4
"18051",18,51,1991,15675,14697,978,6.2
"18051",18,51,1992,16374,15140,1234,7.5
"18051",18,51,1993,16506,15266,1240,7.5
"18051",18,51,1994,16422,15201,1221,7.4
"18051",18,51,1995,16211,15205,1006,6.2
"18051",18,51,1996,15818,15010,808,5.1
"18051",18,51,1997,15758,14876,882,5.6
"18051",18,51,1998,16180,15533,647,4
"18051",18,51,1999,16925,16169,756,4.5
"18051",18,51,2000,16736,16167,569,3.4
"18051",18,51,2001,17052,16369,683,4
"18051",18,51,2002,17271,16510,761,4.4
"18051",18,51,2003,17384,16577,807,4.6
"18051",18,51,2004,17089,16277,812,4.8
"18051",18,51,2005,17306,16447,859,5
"18051",18,51,2006,17282,16501,781,4.5
"18051",18,51,2007,16759,15994,765,4.6
"18051",18,51,2008,16830,15956,874,5.2
"18051",18,51,2009,16738,15275,1463,8.7
"18051",18,51,2010,16897,15543,1354,8
"18051",18,51,2011,17282,16015,1267,7.3
"18051",18,51,2012,17396,16205,1191,6.8
"18051",18,51,2013,18014,16959,1055,5.9
"18051",18,51,2014,18418,17592,826,4.5
"18051",18,51,2015,18860,18143,717,3.8
"18051",18,51,2016,19188,18493,695,3.6
"18051",18,51,2017,19037,18475,562,3
"18053",18,53,1990,36566,33714,2852,7.8
"18053",18,53,1991,35608,32442,3166,8.9
"18053",18,53,1992,35943,32563,3380,9.4
"18053",18,53,1993,35890,33067,2823,7.9
"18053",18,53,1994,37104,34259,2845,7.7
"18053",18,53,1995,37006,34385,2621,7.1
"18053",18,53,1996,35864,33806,2058,5.7
"18053",18,53,1997,34690,33129,1561,4.5
"18053",18,53,1998,33691,32396,1295,3.8
"18053",18,53,1999,33297,31962,1335,4
"18053",18,53,2000,34828,33419,1409,4
"18053",18,53,2001,34848,32764,2084,6
"18053",18,53,2002,34986,32702,2284,6.5
"18053",18,53,2003,34814,32207,2607,7.5
"18053",18,53,2004,33721,30828,2893,8.6
"18053",18,53,2005,33333,30514,2819,8.5
"18053",18,53,2006,32880,30550,2330,7.1
"18053",18,53,2007,31680,29731,1949,6.2
"18053",18,53,2008,32384,29924,2460,7.6
"18053",18,53,2009,33063,29181,3882,11.7
"18053",18,53,2010,33554,29667,3887,11.6
"18053",18,53,2011,33438,29968,3470,10.4
"18053",18,53,2012,32336,29189,3147,9.7
"18053",18,53,2013,32463,29532,2931,9
"18053",18,53,2014,32633,30397,2236,6.9
"18053",18,53,2015,32522,30760,1762,5.4
"18053",18,53,2016,32123,30543,1580,4.9
"18053",18,53,2017,31781,30540,1241,3.9
"18055",18,55,1990,14075,12924,1151,8.2
"18055",18,55,1991,14069,12886,1183,8.4
"18055",18,55,1992,14841,13376,1465,9.9
"18055",18,55,1993,15289,13946,1343,8.8
"18055",18,55,1994,15641,14182,1459,9.3
"18055",18,55,1995,15884,14422,1462,9.2
"18055",18,55,1996,15184,13976,1208,8
"18055",18,55,1997,14751,13717,1034,7
"18055",18,55,1998,14760,13854,906,6.1
"18055",18,55,1999,14542,13649,893,6.1
"18055",18,55,2000,16023,15241,782,4.9
"18055",18,55,2001,16311,15365,946,5.8
"18055",18,55,2002,16421,15434,987,6
"18055",18,55,2003,16588,15542,1046,6.3
"18055",18,55,2004,16528,15536,992,6
"18055",18,55,2005,16736,15620,1116,6.7
"18055",18,55,2006,16639,15692,947,5.7
"18055",18,55,2007,15810,15000,810,5.1
"18055",18,55,2008,16012,15025,987,6.2
"18055",18,55,2009,15988,14627,1361,8.5
"18055",18,55,2010,14391,12857,1534,10.7
"18055",18,55,2011,14180,12710,1470,10.4
"18055",18,55,2012,13811,12367,1444,10.5
"18055",18,55,2013,13758,12352,1406,10.2
"18055",18,55,2014,13843,12744,1099,7.9
"18055",18,55,2015,13754,12808,946,6.9
"18055",18,55,2016,13734,12837,897,6.5
"18055",18,55,2017,13480,12838,642,4.8
"18057",18,57,1990,61006,59638,1368,2.2
"18057",18,57,1991,62723,61167,1556,2.5
"18057",18,57,1992,65640,63881,1759,2.7
"18057",18,57,1993,70904,69277,1627,2.3
"18057",18,57,1994,76954,75260,1694,2.2
"18057",18,57,1995,81995,80315,1680,2
"18057",18,57,1996,85242,83872,1370,1.6
"18057",18,57,1997,89660,88508,1152,1.3
"18057",18,57,1998,94188,93103,1085,1.2
"18057",18,57,1999,99091,97896,1195,1.2
"18057",18,57,2000,101251,99314,1937,1.9
"18057",18,57,2001,107256,104621,2635,2.5
"18057",18,57,2002,113436,109722,3714,3.3
"18057",18,57,2003,121206,117220,3986,3.3
"18057",18,57,2004,124903,120641,4262,3.4
"18057",18,57,2005,130720,126120,4600,3.5
"18057",18,57,2006,137011,132532,4479,3.3
"18057",18,57,2007,140741,136618,4123,2.9
"18057",18,57,2008,145147,139618,5529,3.8
"18057",18,57,2009,145126,135556,9570,6.6
"18057",18,57,2010,144863,135160,9703,6.7
"18057",18,57,2011,148121,139512,8609,5.8
"18057",18,57,2012,151114,143093,8021,5.3
"18057",18,57,2013,155749,147899,7850,5
"18057",18,57,2014,160997,154456,6541,4.1
"18057",18,57,2015,167234,161577,5657,3.4
"18057",18,57,2016,174397,168815,5582,3.2
"18057",18,57,2017,175574,170775,4799,2.7
"18059",18,59,1990,24329,23569,760,3.1
"18059",18,59,1991,24426,23393,1033,4.2
"18059",18,59,1992,24940,23867,1073,4.3
"18059",18,59,1993,25872,24952,920,3.6
"18059",18,59,1994,27285,26397,888,3.3
"18059",18,59,1995,28567,27679,888,3.1
"18059",18,59,1996,28952,28149,803,2.8
"18059",18,59,1997,29651,28963,688,2.3
"18059",18,59,1998,30331,29728,603,2
"18059",18,59,1999,30777,30173,604,2
"18059",18,59,2000,30389,29686,703,2.3
"18059",18,59,2001,31060,30135,925,3
"18059",18,59,2002,31996,30726,1270,4
"18059",18,59,2003,32857,31511,1346,4.1
"18059",18,59,2004,33192,31862,1330,4
"18059",18,59,2005,34425,32941,1484,4.3
"18059",18,59,2006,35660,34202,1458,4.1
"18059",18,59,2007,35818,34470,1348,3.8
"18059",18,59,2008,36422,34669,1753,4.8
"18059",18,59,2009,36104,33024,3080,8.5
"18059",18,59,2010,35810,32492,3318,9.3
"18059",18,59,2011,35797,32847,2950,8.2
"18059",18,59,2012,35729,33107,2622,7.3
"18059",18,59,2013,36065,33673,2392,6.6
"18059",18,59,2014,36584,34692,1892,5.2
"18059",18,59,2015,37370,35792,1578,4.2
"18059",18,59,2016,38666,37203,1463,3.8
"18059",18,59,2017,38770,37601,1169,3
"18061",18,61,1990,15009,14211,798,5.3
"18061",18,61,1991,14902,14124,778,5.2
"18061",18,61,1992,15340,14512,828,5.4
"18061",18,61,1993,15924,15218,706,4.4
"18061",18,61,1994,16783,16057,726,4.3
"18061",18,61,1995,17489,16669,820,4.7
"18061",18,61,1996,17795,17061,734,4.1
"18061",18,61,1997,18341,17713,628,3.4
"18061",18,61,1998,18729,18204,525,2.8
"18061",18,61,1999,19133,18634,499,2.6
"18061",18,61,2000,18715,18075,640,3.4
"18061",18,61,2001,18669,17893,776,4.2
"18061",18,61,2002,18778,17891,887,4.7
"18061",18,61,2003,19064,18128,936,4.9
"18061",18,61,2004,19112,18063,1049,5.5
"18061",18,61,2005,19628,18383,1245,6.3
"18061",18,61,2006,19789,18716,1073,5.4
"18061",18,61,2007,19410,18538,872,4.5
"18061",18,61,2008,19652,18495,1157,5.9
"18061",18,61,2009,19525,17731,1794,9.2
"18061",18,61,2010,18990,17119,1871,9.9
"18061",18,61,2011,18773,17095,1678,8.9
"18061",18,61,2012,18557,17124,1433,7.7
"18061",18,61,2013,18704,17399,1305,7
"18061",18,61,2014,19028,17965,1063,5.6
"18061",18,61,2015,19417,18527,890,4.6
"18061",18,61,2016,19992,19154,838,4.2
"18061",18,61,2017,20035,19345,690,3.4
"18063",18,63,1990,40469,39497,972,2.4
"18063",18,63,1991,40508,39333,1175,2.9
"18063",18,63,1992,41651,40321,1330,3.2
"18063",18,63,1993,43836,42746,1090,2.5
"18063",18,63,1994,46464,45306,1158,2.5
"18063",18,63,1995,48558,47417,1141,2.3
"18063",18,63,1996,49629,48653,976,2
"18063",18,63,1997,51552,50658,894,1.7
"18063",18,63,1998,53238,52473,765,1.4
"18063",18,63,1999,54868,53984,884,1.6
"18063",18,63,2000,57464,56303,1161,2
"18063",18,63,2001,60082,58470,1612,2.7
"18063",18,63,2002,63082,60699,2383,3.8
"18063",18,63,2003,65540,62833,2707,4.1
"18063",18,63,2004,67227,64617,2610,3.9
"18063",18,63,2005,69433,66604,2829,4.1
"18063",18,63,2006,71703,69080,2623,3.7
"18063",18,63,2007,72418,70048,2370,3.3
"18063",18,63,2008,74001,70815,3186,4.3
"18063",18,63,2009,73661,68044,5617,7.6
"18063",18,63,2010,74719,68853,5866,7.9
"18063",18,63,2011,76017,70712,5305,7
"18063",18,63,2012,76894,72028,4866,6.3
"18063",18,63,2013,78649,74096,4553,5.8
"18063",18,63,2014,80633,76928,3705,4.6
"18063",18,63,2015,82861,79688,3173,3.8
"18063",18,63,2016,85739,82747,2992,3.5
"18063",18,63,2017,86205,83723,2482,2.9
"18065",18,65,1990,23865,21679,2186,9.2
"18065",18,65,1991,23039,21058,1981,8.6
"18065",18,65,1992,23860,21376,2484,10.4
"18065",18,65,1993,24308,22364,1944,8
"18065",18,65,1994,25338,23624,1714,6.8
"18065",18,65,1995,25471,23990,1481,5.8
"18065",18,65,1996,25239,23951,1288,5.1
"18065",18,65,1997,25714,24563,1151,4.5
"18065",18,65,1998,24838,23800,1038,4.2
"18065",18,65,1999,24544,23532,1012,4.1
"18065",18,65,2000,23348,22420,928,4
"18065",18,65,2001,23269,22055,1214,5.2
"18065",18,65,2002,23366,21909,1457,6.2
"18065",18,65,2003,23523,22121,1402,6
"18065",18,65,2004,23387,21726,1661,7.1
"18065",18,65,2005,23047,21473,1574,6.8
"18065",18,65,2006,22774,21443,1331,5.8
"18065",18,65,2007,22464,21164,1300,5.8
"18065",18,65,2008,22721,21133,1588,7
"18065",18,65,2009,22785,19898,2887,12.7
"18065",18,65,2010,21391,18426,2965,13.9
"18065",18,65,2011,21288,18838,2450,11.5
"18065",18,65,2012,21143,19018,2125,10.1
"18065",18,65,2013,21311,19427,1884,8.8
"18065",18,65,2014,21449,19989,1460,6.8
"18065",18,65,2015,21664,20511,1153,5.3
"18065",18,65,2016,22104,21084,1020,4.6
"18065",18,65,2017,22122,21312,810,3.7
"18067",18,67,1990,40171,37284,2887,7.2
"18067",18,67,1991,39877,36585,3292,8.3
"18067",18,67,1992,40711,37794,2917,7.2
"18067",18,67,1993,42425,39882,2543,6
"18067",18,67,1994,43089,40675,2414,5.6
"18067",18,67,1995,44547,42594,1953,4.4
"18067",18,67,1996,43982,42391,1591,3.6
"18067",18,67,1997,42552,41112,1440,3.4
"18067",18,67,1998,42487,41085,1402,3.3
"18067",18,67,1999,42366,41236,1130,2.7
"18067",18,67,2000,41485,40135,1350,3.3
"18067",18,67,2001,41175,38815,2360,5.7
"18067",18,67,2002,40867,38490,2377,5.8
"18067",18,67,2003,40158,37413,2745,6.8
"18067",18,67,2004,39281,36617,2664,6.8
"18067",18,67,2005,39174,36607,2567,6.6
"18067",18,67,2006,38857,36295,2562,6.6
"18067",18,67,2007,37588,35523,2065,5.5
"18067",18,67,2008,37112,34221,2891,7.8
"18067",18,67,2009,35612,30352,5260,14.8
"18067",18,67,2010,35806,31300,4506,12.6
"18067",18,67,2011,36051,32289,3762,10.4
"18067",18,67,2012,35916,32658,3258,9.1
"18067",18,67,2013,36412,33448,2964,8.1
"18067",18,67,2014,36907,34595,2312,6.3
"18067",18,67,2015,36987,35140,1847,5
"18067",18,67,2016,38061,36289,1772,4.7
"18067",18,67,2017,37983,36534,1449,3.8
"18069",18,69,1990,18795,17828,967,5.1
"18069",18,69,1991,19036,17523,1513,7.9
"18069",18,69,1992,18920,17713,1207,6.4
"18069",18,69,1993,19433,18483,950,4.9
"18069",18,69,1994,20312,19256,1056,5.2
"18069",18,69,1995,20778,19887,891,4.3
"18069",18,69,1996,20623,19830,793,3.8
"18069",18,69,1997,20869,20125,744,3.6
"18069",18,69,1998,20967,20174,793,3.8
"18069",18,69,1999,20521,19902,619,3
"18069",18,69,2000,20784,20130,654,3.1
"18069",18,69,2001,20611,19676,935,4.5
"18069",18,69,2002,20669,19604,1065,5.2
"18069",18,69,2003,20684,19565,1119,5.4
"18069",18,69,2004,20517,19384,1133,5.5
"18069",18,69,2005,20622,19457,1165,5.6
"18069",18,69,2006,20601,19511,1090,5.3
"18069",18,69,2007,20025,19076,949,4.7
"18069",18,69,2008,20177,18830,1347,6.7
"18069",18,69,2009,19731,17203,2528,12.8
"18069",18,69,2010,19039,16774,2265,11.9
"18069",18,69,2011,19150,17270,1880,9.8
"18069",18,69,2012,18587,16950,1637,8.8
"18069",18,69,2013,18520,17092,1428,7.7
"18069",18,69,2014,18538,17464,1074,5.8
"18069",18,69,2015,18641,17825,816,4.4
"18069",18,69,2016,18676,17920,756,4
"18069",18,69,2017,18387,17728,659,3.6
"18071",18,71,1990,18819,17640,1179,6.3
"18071",18,71,1991,18985,17520,1465,7.7
"18071",18,71,1992,19626,18268,1358,6.9
"18071",18,71,1993,20185,19084,1101,5.5
"18071",18,71,1994,20943,20051,892,4.3
"18071",18,71,1995,22162,21299,863,3.9
"18071",18,71,1996,21221,20375,846,4
"18071",18,71,1997,21104,20236,868,4.1
"18071",18,71,1998,21141,20509,632,3
"18071",18,71,1999,21805,21282,523,2.4
"18071",18,71,2000,21696,21102,594,2.7
"18071",18,71,2001,21928,21018,910,4.1
"18071",18,71,2002,22048,20966,1082,4.9
"18071",18,71,2003,21979,20935,1044,4.7
"18071",18,71,2004,21993,20969,1024,4.7
"18071",18,71,2005,22193,21113,1080,4.9
"18071",18,71,2006,22152,21178,974,4.4
"18071",18,71,2007,21892,21036,856,3.9
"18071",18,71,2008,21790,20629,1161,5.3
"18071",18,71,2009,21252,18886,2366,11.1
"18071",18,71,2010,20476,18323,2153,10.5
"18071",18,71,2011,20549,18752,1797,8.7
"18071",18,71,2012,20486,18957,1529,7.5
"18071",18,71,2013,20848,19494,1354,6.5
"18071",18,71,2014,21304,20241,1063,5
"18071",18,71,2015,21786,20918,868,4
"18071",18,71,2016,22334,21518,816,3.7
"18071",18,71,2017,22363,21698,665,3
"18073",18,73,1990,12055,11266,789,6.5
"18073",18,73,1991,11844,11038,806,6.8
"18073",18,73,1992,12175,11220,955,7.8
"18073",18,73,1993,13029,12136,893,6.9
"18073",18,73,1994,13991,13210,781,5.6
"18073",18,73,1995,14565,13685,880,6
"18073",18,73,1996,14503,13686,817,5.6
"18073",18,73,1997,14487,13837,650,4.5
"18073",18,73,1998,14279,13721,558,3.9
"18073",18,73,1999,14529,13938,591,4.1
"18073",18,73,2000,14701,14186,515,3.5
"18073",18,73,2001,14928,14208,720,4.8
"18073",18,73,2002,15042,14186,856,5.7
"18073",18,73,2003,15099,14245,854,5.7
"18073",18,73,2004,15054,14185,869,5.8
"18073",18,73,2005,15224,14356,868,5.7
"18073",18,73,2006,15485,14696,789,5.1
"18073",18,73,2007,15511,14775,736,4.7
"18073",18,73,2008,15750,14832,918,5.8
"18073",18,73,2009,15686,14090,1596,10.2
"18073",18,73,2010,16140,14455,1685,10.4
"18073",18,73,2011,16094,14634,1460,9.1
"18073",18,73,2012,15968,14672,1296,8.1
"18073",18,73,2013,15937,14703,1234,7.7
"18073",18,73,2014,16128,15053,1075,6.7
"18073",18,73,2015,16357,15405,952,5.8
"18073",18,73,2016,16560,15680,880,5.3
"18073",18,73,2017,16348,15641,707,4.3
"18075",18,75,1990,10786,9905,881,8.2
"18075",18,75,1991,10585,9601,984,9.3
"18075",18,75,1992,11072,9991,1081,9.8
"18075",18,75,1993,11168,10292,876,7.8
"18075",18,75,1994,11515,10848,667,5.8
"18075",18,75,1995,12130,11455,675,5.6
"18075",18,75,1996,12326,11735,591,4.8
"18075",18,75,1997,11907,11327,580,4.9
"18075",18,75,1998,11280,10793,487,4.3
"18075",18,75,1999,10903,10450,453,4.2
"18075",18,75,2000,10978,10600,378,3.4
"18075",18,75,2001,11000,10376,624,5.7
"18075",18,75,2002,10851,10190,661,6.1
"18075",18,75,2003,10735,9938,797,7.4
"18075",18,75,2004,11088,10453,635,5.7
"18075",18,75,2005,11639,11010,629,5.4
"18075",18,75,2006,11759,11226,533,4.5
"18075",18,75,2007,11609,11105,504,4.3
"18075",18,75,2008,11751,11070,681,5.8
"18075",18,75,2009,11365,10084,1281,11.3
"18075",18,75,2010,10627,9494,1133,10.7
"18075",18,75,2011,10528,9583,945,9
"18075",18,75,2012,10084,9285,799,7.9
"18075",18,75,2013,10047,9271,776,7.7
"18075",18,75,2014,10094,9509,585,5.8
"18075",18,75,2015,9946,9449,497,5
"18075",18,75,2016,9940,9490,450,4.5
"18075",18,75,2017,9731,9385,346,3.6
"18077",18,77,1990,14903,13885,1018,6.8
"18077",18,77,1991,14481,13253,1228,8.5
"18077",18,77,1992,14656,13624,1032,7
"18077",18,77,1993,14616,13784,832,5.7
"18077",18,77,1994,14997,14273,724,4.8
"18077",18,77,1995,15201,14490,711,4.7
"18077",18,77,1996,14798,14012,786,5.3
"18077",18,77,1997,14753,14012,741,5
"18077",18,77,1998,13926,13361,565,4.1
"18077",18,77,1999,13703,13213,490,3.6
"18077",18,77,2000,16169,15625,544,3.4
"18077",18,77,2001,16267,15570,697,4.3
"18077",18,77,2002,16732,15892,840,5
"18077",18,77,2003,16842,16036,806,4.8
"18077",18,77,2004,17078,16260,818,4.8
"18077",18,77,2005,17393,16459,934,5.4
"18077",18,77,2006,17371,16521,850,4.9
"18077",18,77,2007,17081,16243,838,4.9
"18077",18,77,2008,16745,15727,1018,6.1
"18077",18,77,2009,16573,14772,1801,10.9
"18077",18,77,2010,15464,13709,1755,11.3
"18077",18,77,2011,15170,13687,1483,9.8
"18077",18,77,2012,15221,13930,1291,8.5
"18077",18,77,2013,15307,14101,1206,7.9
"18077",18,77,2014,15050,14138,912,6.1
"18077",18,77,2015,15326,14583,743,4.8
"18077",18,77,2016,15278,14567,711,4.7
"18077",18,77,2017,15031,14470,561,3.7
"18079",18,79,1990,11645,10990,655,5.6
"18079",18,79,1991,11552,10719,833,7.2
"18079",18,79,1992,11992,11265,727,6.1
"18079",18,79,1993,12836,12265,571,4.4
"18079",18,79,1994,13647,13201,446,3.3
"18079",18,79,1995,14238,13789,449,3.2
"18079",18,79,1996,14335,13879,456,3.2
"18079",18,79,1997,14565,14146,419,2.9
"18079",18,79,1998,14741,14414,327,2.2
"18079",18,79,1999,14743,14410,333,2.3
"18079",18,79,2000,14048,13639,409,2.9
"18079",18,79,2001,14034,13362,672,4.8
"18079",18,79,2002,13536,12669,867,6.4
"18079",18,79,2003,13925,13038,887,6.4
"18079",18,79,2004,13983,13151,832,6
"18079",18,79,2005,13989,13045,944,6.7
"18079",18,79,2006,13828,13020,808,5.8
"18079",18,79,2007,13665,12964,701,5.1
"18079",18,79,2008,13793,12806,987,7.2
"18079",18,79,2009,13626,11773,1853,13.6
"18079",18,79,2010,13303,11581,1722,12.9
"18079",18,79,2011,13341,11804,1537,11.5
"18079",18,79,2012,13111,11760,1351,10.3
"18079",18,79,2013,13033,11835,1198,9.2
"18079",18,79,2014,13079,12205,874,6.7
"18079",18,79,2015,13167,12491,676,5.1
"18079",18,79,2016,13258,12629,629,4.7
"18079",18,79,2017,13162,12657,505,3.8
"18081",18,81,1990,48000,46554,1446,3
"18081",18,81,1991,48883,47137,1746,3.6
"18081",18,81,1992,49972,47971,2001,4
"18081",18,81,1993,52690,50958,1732,3.3
"18081",18,81,1994,55639,53856,1783,3.2
"18081",18,81,1995,57910,56301,1609,2.8
"18081",18,81,1996,58947,57543,1404,2.4
"18081",18,81,1997,60401,59132,1269,2.1
"18081",18,81,1998,61950,60796,1154,1.9
"18081",18,81,1999,63468,62306,1162,1.8
"18081",18,81,2000,63225,61843,1382,2.2
"18081",18,81,2001,64848,63036,1812,2.8
"18081",18,81,2002,66700,64093,2607,3.9
"18081",18,81,2003,67982,65252,2730,4
"18081",18,81,2004,68615,65660,2955,4.3
"18081",18,81,2005,70047,66984,3063,4.4
"18081",18,81,2006,72913,70068,2845,3.9
"18081",18,81,2007,73207,70649,2558,3.5
"18081",18,81,2008,75191,71678,3513,4.7
"18081",18,81,2009,74520,68356,6164,8.3
"18081",18,81,2010,71599,65284,6315,8.8
"18081",18,81,2011,72053,66470,5583,7.7
"18081",18,81,2012,72544,67492,5052,7
"18081",18,81,2013,73664,69068,4596,6.2
"18081",18,81,2014,75466,71714,3752,5
"18081",18,81,2015,77588,74422,3166,4.1
"18081",18,81,2016,80210,77298,2912,3.6
"18081",18,81,2017,80529,78158,2371,2.9
"18083",18,83,1990,18611,17234,1377,7.4
"18083",18,83,1991,18459,17113,1346,7.3
"18083",18,83,1992,18648,17642,1006,5.4
"18083",18,83,1993,19756,18843,913,4.6
"18083",18,83,1994,20452,19522,930,4.5
"18083",18,83,1995,21093,20202,891,4.2
"18083",18,83,1996,21510,20514,996,4.6
"18083",18,83,1997,20202,19385,817,4
"18083",18,83,1998,19724,19029,695,3.5
"18083",18,83,1999,19296,18646,650,3.4
"18083",18,83,2000,19478,18741,737,3.8
"18083",18,83,2001,19429,18696,733,3.8
"18083",18,83,2002,19715,18847,868,4.4
"18083",18,83,2003,19634,18767,867,4.4
"18083",18,83,2004,19128,18227,901,4.7
"18083",18,83,2005,19258,18266,992,5.2
"18083",18,83,2006,19427,18502,925,4.8
"18083",18,83,2007,19724,18934,790,4
"18083",18,83,2008,20188,19172,1016,5
"18083",18,83,2009,19814,18345,1469,7.4
"18083",18,83,2010,18521,17007,1514,8.2
"18083",18,83,2011,18459,17084,1375,7.4
"18083",18,83,2012,18717,17381,1336,7.1
"18083",18,83,2013,18626,17372,1254,6.7
"18083",18,83,2014,18829,17847,982,5.2
"18083",18,83,2015,19027,18154,873,4.6
"18083",18,83,2016,19055,18223,832,4.4
"18083",18,83,2017,18645,18006,639,3.4
"18085",18,85,1990,34168,32874,1294,3.8
"18085",18,85,1991,34061,32350,1711,5
"18085",18,85,1992,34909,33099,1810,5.2
"18085",18,85,1993,35516,33887,1629,4.6
"18085",18,85,1994,36608,35436,1172,3.2
"18085",18,85,1995,39804,38502,1302,3.3
"18085",18,85,1996,39222,37943,1279,3.3
"18085",18,85,1997,38359,37107,1252,3.3
"18085",18,85,1998,38074,37079,995,2.6
"18085",18,85,1999,38461,37566,895,2.3
"18085",18,85,2000,39242,38248,994,2.5
"18085",18,85,2001,38626,37004,1622,4.2
"18085",18,85,2002,39254,37407,1847,4.7
"18085",18,85,2003,39671,37937,1734,4.4
"18085",18,85,2004,39819,38166,1653,4.2
"18085",18,85,2005,41334,39539,1795,4.3
"18085",18,85,2006,41891,39840,2051,4.9
"18085",18,85,2007,41085,39272,1813,4.4
"18085",18,85,2008,42069,39317,2752,6.5
"18085",18,85,2009,41388,36272,5116,12.4
"18085",18,85,2010,39227,34900,4327,11
"18085",18,85,2011,38972,35490,3482,8.9
"18085",18,85,2012,38740,35758,2982,7.7
"18085",18,85,2013,39729,37112,2617,6.6
"18085",18,85,2014,40293,38325,1968,4.9
"18085",18,85,2015,40662,39008,1654,4.1
"18085",18,85,2016,41475,39924,1551,3.7
"18085",18,85,2017,41408,40280,1128,2.7
"18087",18,87,1990,14059,13189,870,6.2
"18087",18,87,1991,13940,12898,1042,7.5
"18087",18,87,1992,14217,13335,882,6.2
"18087",18,87,1993,15055,14379,676,4.5
"18087",18,87,1994,16522,15913,609,3.7
"18087",18,87,1995,18980,18315,665,3.5
"18087",18,87,1996,17225,16529,696,4
"18087",18,87,1997,17176,16656,520,3
"18087",18,87,1998,17412,16949,463,2.7
"18087",18,87,1999,17615,17159,456,2.6
"18087",18,87,2000,16887,16479,408,2.4
"18087",18,87,2001,16497,15703,794,4.8
"18087",18,87,2002,16587,15802,785,4.7
"18087",18,87,2003,16552,15812,740,4.5
"18087",18,87,2004,16761,16037,724,4.3
"18087",18,87,2005,17339,16482,857,4.9
"18087",18,87,2006,17512,16604,908,5.2
"18087",18,87,2007,17028,16196,832,4.9
"18087",18,87,2008,16600,15170,1430,8.6
"18087",18,87,2009,15541,12838,2703,17.4
"18087",18,87,2010,16570,14574,1996,12
"18087",18,87,2011,16666,15168,1498,9
"18087",18,87,2012,17001,15792,1209,7.1
"18087",18,87,2013,17610,16570,1040,5.9
"18087",18,87,2014,18209,17397,812,4.5
"18087",18,87,2015,18900,18209,691,3.7
"18087",18,87,2016,19414,18745,669,3.4
"18087",18,87,2017,19815,19309,506,2.6
"18089",18,89,1990,222677,208343,14334,6.4
"18089",18,89,1991,221896,206205,15691,7.1
"18089",18,89,1992,224492,205006,19486,8.7
"18089",18,89,1993,227001,209571,17430,7.7
"18089",18,89,1994,229734,213640,16094,7
"18089",18,89,1995,230374,214582,15792,6.9
"18089",18,89,1996,229252,216469,12783,5.6
"18089",18,89,1997,230347,220017,10330,4.5
"18089",18,89,1998,229974,220358,9616,4.2
"18089",18,89,1999,226465,216753,9712,4.3
"18089",18,89,2000,225445,216712,8733,3.9
"18089",18,89,2001,226943,215748,11195,4.9
"18089",18,89,2002,228389,213640,14749,6.5
"18089",18,89,2003,225896,212063,13833,6.1
"18089",18,89,2004,223573,209360,14213,6.4
"18089",18,89,2005,225412,211454,13958,6.2
"18089",18,89,2006,227320,214057,13263,5.8
"18089",18,89,2007,226108,214416,11692,5.2
"18089",18,89,2008,228369,214202,14167,6.2
"18089",18,89,2009,226034,201966,24068,10.6
"18089",18,89,2010,229124,204390,24734,10.8
"18089",18,89,2011,229318,207352,21966,9.6
"18089",18,89,2012,228880,208007,20873,9.1
"18089",18,89,2013,229941,209097,20844,9.1
"18089",18,89,2014,230390,212208,18182,7.9
"18089",18,89,2015,229689,214013,15676,6.8
"18089",18,89,2016,232103,217432,14671,6.3
"18089",18,89,2017,229520,217832,11688,5.1
"18091",18,91,1990,52201,49382,2819,5.4
"18091",18,91,1991,51511,48586,2925,5.7
"18091",18,91,1992,52473,48830,3643,6.9
"18091",18,91,1993,53897,50561,3336,6.2
"18091",18,91,1994,54765,52021,2744,5
"18091",18,91,1995,56155,53076,3079,5.5
"18091",18,91,1996,54871,52135,2736,5
"18091",18,91,1997,54679,52529,2150,3.9
"18091",18,91,1998,54177,52378,1799,3.3
"18091",18,91,1999,53656,51736,1920,3.6
"18091",18,91,2000,53804,51890,1914,3.6
"18091",18,91,2001,53928,51298,2630,4.9
"18091",18,91,2002,54189,50476,3713,6.9
"18091",18,91,2003,53847,50198,3649,6.8
"18091",18,91,2004,52594,49339,3255,6.2
"18091",18,91,2005,53070,49849,3221,6.1
"18091",18,91,2006,53223,50165,3058,5.7
"18091",18,91,2007,52577,49915,2662,5.1
"18091",18,91,2008,52700,49417,3283,6.2
"18091",18,91,2009,52587,46350,6237,11.9
"18091",18,91,2010,51337,45159,6178,12
"18091",18,91,2011,50457,45219,5238,10.4
"18091",18,91,2012,49698,44850,4848,9.8
"18091",18,91,2013,48938,44379,4559,9.3
"18091",18,91,2014,48844,45116,3728,7.6
"18091",18,91,2015,48522,45477,3045,6.3
"18091",18,91,2016,48624,45767,2857,5.9
"18091",18,91,2017,47624,45495,2129,4.5
"18093",18,93,1990,21649,19576,2073,9.6
"18093",18,93,1991,21084,19190,1894,9
"18093",18,93,1992,21808,19574,2234,10.2
"18093",18,93,1993,22780,20976,1804,7.9
"18093",18,93,1994,23959,22203,1756,7.3
"18093",18,93,1995,25171,23529,1642,6.5
"18093",18,93,1996,24537,22821,1716,7
"18093",18,93,1997,24487,23200,1287,5.3
"18093",18,93,1998,23778,22295,1483,6.2
"18093",18,93,1999,22964,21777,1187,5.2
"18093",18,93,2000,22922,21971,951,4.1
"18093",18,93,2001,23130,21532,1598,6.9
"18093",18,93,2002,23083,21337,1746,7.6
"18093",18,93,2003,22708,21100,1608,7.1
"18093",18,93,2004,22312,20727,1585,7.1
"18093",18,93,2005,22448,20700,1748,7.8
"18093",18,93,2006,22817,21225,1592,7
"18093",18,93,2007,22133,20696,1437,6.5
"18093",18,93,2008,22064,20234,1830,8.3
"18093",18,93,2009,21768,18901,2867,13.2
"18093",18,93,2010,20728,18100,2628,12.7
"18093",18,93,2011,20791,18375,2416,11.6
"18093",18,93,2012,20554,18301,2253,11
"18093",18,93,2013,20657,18571,2086,10.1
"18093",18,93,2014,20366,18722,1644,8.1
"18093",18,93,2015,20278,18949,1329,6.6
"18093",18,93,2016,20584,19415,1169,5.7
"18093",18,93,2017,20776,19864,912,4.4
"18095",18,95,1990,63886,60069,3817,6
"18095",18,95,1991,63284,58969,4315,6.8
"18095",18,95,1992,63830,58900,4930,7.7
"18095",18,95,1993,64765,60800,3965,6.1
"18095",18,95,1994,66613,63166,3447,5.2
"18095",18,95,1995,67388,64172,3216,4.8
"18095",18,95,1996,66764,63808,2956,4.4
"18095",18,95,1997,66534,64043,2491,3.7
"18095",18,95,1998,66263,63724,2539,3.8
"18095",18,95,1999,65388,63257,2131,3.3
"18095",18,95,2000,63445,61399,2046,3.2
"18095",18,95,2001,63832,60919,2913,4.6
"18095",18,95,2002,64092,60358,3734,5.8
"18095",18,95,2003,64539,60677,3862,6
"18095",18,95,2004,63114,59295,3819,6.1
"18095",18,95,2005,63209,59035,4174,6.6
"18095",18,95,2006,62274,58472,3802,6.1
"18095",18,95,2007,60540,56701,3839,6.3
"18095",18,95,2008,61422,57161,4261,6.9
"18095",18,95,2009,62377,55572,6805,10.9
"18095",18,95,2010,59407,52243,7164,12.1
"18095",18,95,2011,58819,52409,6410,10.9
"18095",18,95,2012,57995,52201,5794,10
"18095",18,95,2013,58069,52653,5416,9.3
"18095",18,95,2014,57897,53773,4124,7.1
"18095",18,95,2015,58222,54917,3305,5.7
"18095",18,95,2016,58937,55968,2969,5
"18095",18,95,2017,58889,56567,2322,3.9
"18097",18,97,1990,424053,408409,15644,3.7
"18097",18,97,1991,421789,402517,19272,4.6
"18097",18,97,1992,429239,404860,24379,5.7
"18097",18,97,1993,438377,418102,20275,4.6
"18097",18,97,1994,453457,432801,20656,4.6
"18097",18,97,1995,459603,439938,19665,4.3
"18097",18,97,1996,453728,437397,16331,3.6
"18097",18,97,1997,453928,439576,14352,3.2
"18097",18,97,1998,452412,439422,12990,2.9
"18097",18,97,1999,448732,436093,12639,2.8
"18097",18,97,2000,455135,442211,12924,2.8
"18097",18,97,2001,459505,442014,17491,3.8
"18097",18,97,2002,462330,438222,24108,5.2
"18097",18,97,2003,464331,439470,24861,5.4
"18097",18,97,2004,459140,434021,25119,5.5
"18097",18,97,2005,459492,433930,25562,5.6
"18097",18,97,2006,461468,438492,22976,5
"18097",18,97,2007,460046,439218,20828,4.5
"18097",18,97,2008,463200,437123,26077,5.6
"18097",18,97,2009,457524,414853,42671,9.3
"18097",18,97,2010,452840,405075,47765,10.5
"18097",18,97,2011,456014,410961,45053,9.9
"18097",18,97,2012,458381,416091,42290,9.2
"18097",18,97,2013,463352,423967,39385,8.5
"18097",18,97,2014,467242,436752,30490,6.5
"18097",18,97,2015,472332,448369,23963,5.1
"18097",18,97,2016,481213,459700,21513,4.5
"18097",18,97,2017,482568,465230,17338,3.6
"18099",18,99,1990,22436,21241,1195,5.3
"18099",18,99,1991,22220,20928,1292,5.8
"18099",18,99,1992,23007,21673,1334,5.8
"18099",18,99,1993,24410,23301,1109,4.5
"18099",18,99,1994,26180,25303,877,3.3
"18099",18,99,1995,26619,25724,895,3.4
"18099",18,99,1996,26192,25242,950,3.6
"18099",18,99,1997,25889,25066,823,3.2
"18099",18,99,1998,24752,24076,676,2.7
"18099",18,99,1999,25035,24390,645,2.6
"18099",18,99,2000,23304,22564,740,3.2
"18099",18,99,2001,22575,21602,973,4.3
"18099",18,99,2002,22309,21169,1140,5.1
"18099",18,99,2003,22225,21020,1205,5.4
"18099",18,99,2004,22377,21209,1168,5.2
"18099",18,99,2005,22737,21543,1194,5.3
"18099",18,99,2006,23038,21800,1238,5.4
"18099",18,99,2007,22795,21693,1102,4.8
"18099",18,99,2008,23183,21490,1693,7.3
"18099",18,99,2009,22539,19497,3042,13.5
"18099",18,99,2010,23476,20823,2653,11.3
"18099",18,99,2011,23453,21231,2222,9.5
"18099",18,99,2012,22963,21074,1889,8.2
"18099",18,99,2013,23096,21386,1710,7.4
"18099",18,99,2014,23704,22407,1297,5.5
"18099",18,99,2015,24009,23006,1003,4.2
"18099",18,99,2016,24312,23402,910,3.7
"18099",18,99,2017,23768,23044,724,3
"18101",18,101,1990,4945,4633,312,6.3
"18101",18,101,1991,4919,4554,365,7.4
"18101",18,101,1992,5021,4650,371,7.4
"18101",18,101,1993,5098,4790,308,6
"18101",18,101,1994,5218,4938,280,5.4
"18101",18,101,1995,5347,5018,329,6.2
"18101",18,101,1996,5316,5010,306,5.8
"18101",18,101,1997,5224,5030,194,3.7
"18101",18,101,1998,5186,5003,183,3.5
"18101",18,101,1999,5165,4960,205,4
"18101",18,101,2000,5073,4897,176,3.5
"18101",18,101,2001,5127,4886,241,4.7
"18101",18,101,2002,5219,4943,276,5.3
"18101",18,101,2003,5385,5116,269,5
"18101",18,101,2004,5145,4868,277,5.4
"18101",18,101,2005,5161,4879,282,5.5
"18101",18,101,2006,5301,5041,260,4.9
"18101",18,101,2007,5133,4933,200,3.9
"18101",18,101,2008,5144,4894,250,4.9
"18101",18,101,2009,5221,4841,380,7.3
"18101",18,101,2010,5262,4865,397,7.5
"18101",18,101,2011,5344,4943,401,7.5
"18101",18,101,2012,5077,4717,360,7.1
"18101",18,101,2013,4950,4637,313,6.3
"18101",18,101,2014,4951,4687,264,5.3
"18101",18,101,2015,5047,4834,213,4.2
"18101",18,101,2016,5147,4937,210,4.1
"18101",18,101,2017,5114,4960,154,3
"18103",18,103,1990,15956,14959,997,6.2
"18103",18,103,1991,15809,14464,1345,8.5
"18103",18,103,1992,16028,14724,1304,8.1
"18103",18,103,1993,16153,15118,1035,6.4
"18103",18,103,1994,16626,15597,1029,6.2
"18103",18,103,1995,15701,14658,1043,6.6
"18103",18,103,1996,15359,14458,901,5.9
"18103",18,103,1997,15471,14689,782,5.1
"18103",18,103,1998,15559,14902,657,4.2
"18103",18,103,1999,15704,15113,591,3.8
"18103",18,103,2000,17567,16957,610,3.5
"18103",18,103,2001,17519,16597,922,5.3
"18103",18,103,2002,17474,16391,1083,6.2
"18103",18,103,2003,17414,16142,1272,7.3
"18103",18,103,2004,17194,16043,1151,6.7
"18103",18,103,2005,17376,16291,1085,6.2
"18103",18,103,2006,17090,16025,1065,6.2
"18103",18,103,2007,16465,15532,933,5.7
"18103",18,103,2008,16602,15283,1319,7.9
"18103",18,103,2009,16177,13838,2339,14.5
"18103",18,103,2010,15947,13956,1991,12.5
"18103",18,103,2011,15937,14272,1665,10.4
"18103",18,103,2012,15634,14114,1520,9.7
"18103",18,103,2013,15606,14251,1355,8.7
"18103",18,103,2014,15661,14627,1034,6.6
"18103",18,103,2015,15751,14931,820,5.2
"18103",18,103,2016,16078,15319,759,4.7
"18103",18,103,2017,15795,15177,618,3.9
"18105",18,105,1990,54722,52975,1747,3.2
"18105",18,105,1991,53991,52150,1841,3.4
"18105",18,105,1992,55034,52696,2338,4.2
"18105",18,105,1993,57773,55488,2285,4
"18105",18,105,1994,60892,58540,2352,3.9
"18105",18,105,1995,61144,59084,2060,3.4
"18105",18,105,1996,61463,59796,1667,2.7
"18105",18,105,1997,62259,60794,1465,2.4
"18105",18,105,1998,61943,60353,1590,2.6
"18105",18,105,1999,61817,60380,1437,2.3
"18105",18,105,2000,63749,61992,1757,2.8
"18105",18,105,2001,64688,62249,2439,3.8
"18105",18,105,2002,65423,62563,2860,4.4
"18105",18,105,2003,65677,62901,2776,4.2
"18105",18,105,2004,65794,62876,2918,4.4
"18105",18,105,2005,66680,63451,3229,4.8
"18105",18,105,2006,67510,64605,2905,4.3
"18105",18,105,2007,68676,66116,2560,3.7
"18105",18,105,2008,69809,66641,3168,4.5
"18105",18,105,2009,70550,65986,4564,6.5
"18105",18,105,2010,67737,62376,5361,7.9
"18105",18,105,2011,67562,62474,5088,7.5
"18105",18,105,2012,66748,61900,4848,7.3
"18105",18,105,2013,66654,62096,4558,6.8
"18105",18,105,2014,67448,63593,3855,5.7
"18105",18,105,2015,67370,64057,3313,4.9
"18105",18,105,2016,67952,64798,3154,4.6
"18105",18,105,2017,67577,65112,2465,3.6
"18107",18,107,1990,17404,16773,631,3.6
"18107",18,107,1991,17436,16739,697,4
"18107",18,107,1992,18497,17853,644,3.5
"18107",18,107,1993,19529,18896,633,3.2
"18107",18,107,1994,20633,20064,569,2.8
"18107",18,107,1995,20355,19801,554,2.7
"18107",18,107,1996,19823,19233,590,3
"18107",18,107,1997,19727,19147,580,2.9
"18107",18,107,1998,18862,18357,505,2.7
"18107",18,107,1999,18105,17521,584,3.2
"18107",18,107,2000,19663,19134,529,2.7
"18107",18,107,2001,19533,18801,732,3.7
"18107",18,107,2002,19530,18700,830,4.2
"18107",18,107,2003,19603,18764,839,4.3
"18107",18,107,2004,19632,18768,864,4.4
"18107",18,107,2005,19879,18946,933,4.7
"18107",18,107,2006,19721,18894,827,4.2
"18107",18,107,2007,19251,18509,742,3.9
"18107",18,107,2008,19090,18148,942,4.9
"18107",18,107,2009,18789,16882,1907,10.1
"18107",18,107,2010,18896,16970,1926,10.2
"18107",18,107,2011,18713,17054,1659,8.9
"18107",18,107,2012,18594,17072,1522,8.2
"18107",18,107,2013,18400,17079,1321,7.2
"18107",18,107,2014,18681,17672,1009,5.4
"18107",18,107,2015,19266,18496,770,4
"18107",18,107,2016,19148,18412,736,3.8
"18107",18,107,2017,18927,18353,574,3
"18109",18,109,1990,29221,27995,1226,4.2
"18109",18,109,1991,29337,27808,1529,5.2
"18109",18,109,1992,30210,28430,1780,5.9
"18109",18,109,1993,31083,29705,1378,4.4
"18109",18,109,1994,32875,31474,1401,4.3
"18109",18,109,1995,33782,32543,1239,3.7
"18109",18,109,1996,34175,33053,1122,3.3
"18109",18,109,1997,35076,34057,1019,2.9
"18109",18,109,1998,35529,34530,999,2.8
"18109",18,109,1999,35983,35097,886,2.5
"18109",18,109,2000,35539,34647,892,2.5
"18109",18,109,2001,35889,34689,1200,3.3
"18109",18,109,2002,36515,34806,1709,4.7
"18109",18,109,2003,36996,35221,1775,4.8
"18109",18,109,2004,36838,35111,1727,4.7
"18109",18,109,2005,37206,35351,1855,5
"18109",18,109,2006,37596,35886,1710,4.5
"18109",18,109,2007,36810,35273,1537,4.2
"18109",18,109,2008,37519,35359,2160,5.8
"18109",18,109,2009,36623,33260,3363,9.2
"18109",18,109,2010,35026,31394,3632,10.4
"18109",18,109,2011,34902,31637,3265,9.4
"18109",18,109,2012,34688,31769,2919,8.4
"18109",18,109,2013,34826,32193,2633,7.6
"18109",18,109,2014,34969,32939,2030,5.8
"18109",18,109,2015,35368,33702,1666,4.7
"18109",18,109,2016,36019,34489,1530,4.2
"18109",18,109,2017,36114,34859,1255,3.5
"18111",18,111,1990,6603,6304,299,4.5
"18111",18,111,1991,6371,6062,309,4.9
"18111",18,111,1992,6637,6222,415,6.3
"18111",18,111,1993,6764,6379,385,5.7
"18111",18,111,1994,6796,6421,375,5.5
"18111",18,111,1995,6941,6569,372,5.4
"18111",18,111,1996,6555,6194,361,5.5
"18111",18,111,1997,6624,6341,283,4.3
"18111",18,111,1998,6771,6535,236,3.5
"18111",18,111,1999,6521,6280,241,3.7
"18111",18,111,2000,7256,7036,220,3
"18111",18,111,2001,7227,6915,312,4.3
"18111",18,111,2002,7227,6827,400,5.5
"18111",18,111,2003,7166,6783,383,5.3
"18111",18,111,2004,6997,6638,359,5.1
"18111",18,111,2005,7083,6700,383,5.4
"18111",18,111,2006,7046,6693,353,5
"18111",18,111,2007,6967,6601,366,5.3
"18111",18,111,2008,6971,6535,436,6.3
"18111",18,111,2009,6834,6070,764,11.2
"18111",18,111,2010,7075,6272,803,11.3
"18111",18,111,2011,6989,6299,690,9.9
"18111",18,111,2012,6922,6257,665,9.6
"18111",18,111,2013,6909,6289,620,9
"18111",18,111,2014,6942,6458,484,7
"18111",18,111,2015,6961,6556,405,5.8
"18111",18,111,2016,7034,6641,393,5.6
"18111",18,111,2017,6957,6619,338,4.9
"18113",18,113,1990,20114,18535,1579,7.9
"18113",18,113,1991,19463,17659,1804,9.3
"18113",18,113,1992,20960,19487,1473,7
"18113",18,113,1993,21998,20930,1068,4.9
"18113",18,113,1994,23923,23077,846,3.5
"18113",18,113,1995,24714,23798,916,3.7
"18113",18,113,1996,25274,24340,934,3.7
"18113",18,113,1997,25067,24203,864,3.4
"18113",18,113,1998,24762,24049,713,2.9
"18113",18,113,1999,24611,23744,867,3.5
"18113",18,113,2000,24416,23697,719,2.9
"18113",18,113,2001,23937,22593,1344,5.6
"18113",18,113,2002,23729,22370,1359,5.7
"18113",18,113,2003,23760,22293,1467,6.2
"18113",18,113,2004,23478,22096,1382,5.9
"18113",18,113,2005,23786,22320,1466,6.2
"18113",18,113,2006,23628,22180,1448,6.1
"18113",18,113,2007,23161,21903,1258,5.4
"18113",18,113,2008,22750,20822,1928,8.5
"18113",18,113,2009,22161,18358,3803,17.2
"18113",18,113,2010,23011,19984,3027,13.2
"18113",18,113,2011,23132,20801,2331,10.1
"18113",18,113,2012,22618,20671,1947,8.6
"18113",18,113,2013,22617,20960,1657,7.3
"18113",18,113,2014,23119,21919,1200,5.2
"18113",18,113,2015,23651,22642,1009,4.3
"18113",18,113,2016,23317,22372,945,4.1
"18113",18,113,2017,23050,22336,714,3.1
"18115",18,115,1990,2629,2418,211,8
"18115",18,115,1991,2541,2356,185,7.3
"18115",18,115,1992,2550,2342,208,8.2
"18115",18,115,1993,2607,2457,150,5.8
"18115",18,115,1994,2681,2511,170,6.3
"18115",18,115,1995,2714,2555,159,5.9
"18115",18,115,1996,2724,2580,144,5.3
"18115",18,115,1997,2698,2603,95,3.5
"18115",18,115,1998,2701,2613,88,3.3
"18115",18,115,1999,2691,2603,88,3.3
"18115",18,115,2000,2985,2881,104,3.5
"18115",18,115,2001,2982,2871,111,3.7
"18115",18,115,2002,3051,2919,132,4.3
"18115",18,115,2003,3092,2941,151,4.9
"18115",18,115,2004,3109,2938,171,5.5
"18115",18,115,2005,3152,2984,168,5.3
"18115",18,115,2006,3107,2941,166,5.3
"18115",18,115,2007,3026,2877,149,4.9
"18115",18,115,2008,3044,2855,189,6.2
"18115",18,115,2009,3088,2755,333,10.8
"18115",18,115,2010,3263,2902,361,11.1
"18115",18,115,2011,3210,2905,305,9.5
"18115",18,115,2012,3181,2898,283,8.9
"18115",18,115,2013,3165,2902,263,8.3
"18115",18,115,2014,3217,2995,222,6.9
"18115",18,115,2015,3179,3003,176,5.5
"18115",18,115,2016,3225,3066,159,4.9
"18115",18,115,2017,3213,3097,116,3.6
"18117",18,117,1990,8754,7767,987,11.3
"18117",18,117,1991,8309,7381,928,11.2
"18117",18,117,1992,8822,7676,1146,13
"18117",18,117,1993,9216,8331,885,9.6
"18117",18,117,1994,9636,8771,865,9
"18117",18,117,1995,9505,8624,881,9.3
"18117",18,117,1996,9173,8310,863,9.4
"18117",18,117,1997,9068,8413,655,7.2
"18117",18,117,1998,9153,8537,616,6.7
"18117",18,117,1999,8903,8281,622,7
"18117",18,117,2000,9587,9154,433,4.5
"18117",18,117,2001,9492,8834,658,6.9
"18117",18,117,2002,9361,8631,730,7.8
"18117",18,117,2003,9200,8474,726,7.9
"18117",18,117,2004,9091,8411,680,7.5
"18117",18,117,2005,9313,8622,691,7.4
"18117",18,117,2006,9591,8898,693,7.2
"18117",18,117,2007,10455,9918,537,5.1
"18117",18,117,2008,10401,9738,663,6.4
"18117",18,117,2009,10450,9333,1117,10.7
"18117",18,117,2010,9110,7948,1162,12.8
"18117",18,117,2011,8865,7816,1049,11.8
"18117",18,117,2012,8776,7831,945,10.8
"18117",18,117,2013,8755,7887,868,9.9
"18117",18,117,2014,8534,7875,659,7.7
"18117",18,117,2015,8725,8205,520,6
"18117",18,117,2016,8874,8425,449,5.1
"18117",18,117,2017,8750,8406,344,3.9
"18119",18,119,1990,8156,7698,458,5.6
"18119",18,119,1991,8163,7688,475,5.8
"18119",18,119,1992,8972,8329,643,7.2
"18119",18,119,1993,9802,9226,576,5.9
"18119",18,119,1994,9909,9301,608,6.1
"18119",18,119,1995,10115,9554,561,5.5
"18119",18,119,1996,10429,9945,484,4.6
"18119",18,119,1997,10737,10260,477,4.4
"18119",18,119,1998,10696,10269,427,4
"18119",18,119,1999,11014,10608,406,3.7
"18119",18,119,2000,10742,10405,337,3.1
"18119",18,119,2001,11102,10594,508,4.6
"18119",18,119,2002,11504,10842,662,5.8
"18119",18,119,2003,11704,11052,652,5.6
"18119",18,119,2004,11644,11019,625,5.4
"18119",18,119,2005,11766,11026,740,6.3
"18119",18,119,2006,11701,11076,625,5.3
"18119",18,119,2007,11192,10641,551,4.9
"18119",18,119,2008,11415,10685,730,6.4
"18119",18,119,2009,11537,10449,1088,9.4
"18119",18,119,2010,10316,9126,1190,11.5
"18119",18,119,2011,10137,8999,1138,11.2
"18119",18,119,2012,9827,8762,1065,10.8
"18119",18,119,2013,9638,8668,970,10.1
"18119",18,119,2014,9475,8708,767,8.1
"18119",18,119,2015,9285,8700,585,6.3
"18119",18,119,2016,9255,8741,514,5.6
"18119",18,119,2017,9162,8763,399,4.4
"18121",18,121,1990,7211,6769,442,6.1
"18121",18,121,1991,7043,6622,421,6
"18121",18,121,1992,7303,6770,533,7.3
"18121",18,121,1993,7642,7135,507,6.6
"18121",18,121,1994,7937,7467,470,5.9
"18121",18,121,1995,7789,7348,441,5.7
"18121",18,121,1996,7806,7407,399,5.1
"18121",18,121,1997,7396,7027,369,5
"18121",18,121,1998,7759,7448,311,4
"18121",18,121,1999,7786,7520,266,3.4
"18121",18,121,2000,8017,7728,289,3.6
"18121",18,121,2001,8044,7673,371,4.6
"18121",18,121,2002,8044,7603,441,5.5
"18121",18,121,2003,8049,7586,463,5.8
"18121",18,121,2004,8007,7506,501,6.3
"18121",18,121,2005,8111,7587,524,6.5
"18121",18,121,2006,7939,7499,440,5.5
"18121",18,121,2007,8025,7626,399,5
"18121",18,121,2008,8053,7568,485,6
"18121",18,121,2009,8032,7229,803,10
"18121",18,121,2010,7332,6530,802,10.9
"18121",18,121,2011,7195,6443,752,10.5
"18121",18,121,2012,6990,6274,716,10.2
"18121",18,121,2013,6931,6292,639,9.2
"18121",18,121,2014,6945,6461,484,7
"18121",18,121,2015,7053,6654,399,5.7
"18121",18,121,2016,7263,6885,378,5.2
"18121",18,121,2017,7172,6884,288,4
"18123",18,123,1990,8570,7758,812,9.5
"18123",18,123,1991,8446,7630,816,9.7
"18123",18,123,1992,8843,8001,842,9.5
"18123",18,123,1993,9203,8418,785,8.5
"18123",18,123,1994,9645,8788,857,8.9
"18123",18,123,1995,9370,8606,764,8.2
"18123",18,123,1996,9204,8516,688,7.5
"18123",18,123,1997,9289,8607,682,7.3
"18123",18,123,1998,8962,8503,459,5.1
"18123",18,123,1999,9148,8613,535,5.8
"18123",18,123,2000,9492,9036,456,4.8
"18123",18,123,2001,9172,8683,489,5.3
"18123",18,123,2002,9439,8946,493,5.2
"18123",18,123,2003,9626,9102,524,5.4
"18123",18,123,2004,9673,9137,536,5.5
"18123",18,123,2005,9730,9159,571,5.9
"18123",18,123,2006,9757,9255,502,5.1
"18123",18,123,2007,9706,9275,431,4.4
"18123",18,123,2008,9706,9204,502,5.2
"18123",18,123,2009,9616,8635,981,10.2
"18123",18,123,2010,8931,7987,944,10.6
"18123",18,123,2011,9062,8237,825,9.1
"18123",18,123,2012,8873,8128,745,8.4
"18123",18,123,2013,8931,8237,694,7.8
"18123",18,123,2014,9171,8635,536,5.8
"18123",18,123,2015,9231,8796,435,4.7
"18123",18,123,2016,9456,9025,431,4.6
"18123",18,123,2017,9235,8883,352,3.8
"18125",18,125,1990,5941,5540,401,6.7
"18125",18,125,1991,5764,5399,365,6.3
"18125",18,125,1992,5983,5492,491,8.2
"18125",18,125,1993,6071,5694,377,6.2
"18125",18,125,1994,6228,5848,380,6.1
"18125",18,125,1995,6366,5939,427,6.7
"18125",18,125,1996,6233,5903,330,5.3
"18125",18,125,1997,6352,6048,304,4.8
"18125",18,125,1998,6327,6121,206,3.3
"18125",18,125,1999,6428,6179,249,3.9
"18125",18,125,2000,6349,6120,229,3.6
"18125",18,125,2001,6303,6058,245,3.9
"18125",18,125,2002,6347,6029,318,5
"18125",18,125,2003,6433,6090,343,5.3
"18125",18,125,2004,6216,5876,340,5.5
"18125",18,125,2005,6237,5889,348,5.6
"18125",18,125,2006,6174,5891,283,4.6
"18125",18,125,2007,6007,5749,258,4.3
"18125",18,125,2008,6032,5692,340,5.6
"18125",18,125,2009,5850,5291,559,9.6
"18125",18,125,2010,6199,5611,588,9.5
"18125",18,125,2011,6232,5745,487,7.8
"18125",18,125,2012,6130,5679,451,7.4
"18125",18,125,2013,6261,5836,425,6.8
"18125",18,125,2014,6342,6021,321,5.1
"18125",18,125,2015,6189,5919,270,4.4
"18125",18,125,2016,6328,6053,275,4.3
"18125",18,125,2017,6477,6262,215,3.3
"18127",18,127,1990,65856,63253,2603,4
"18127",18,127,1991,66597,63651,2946,4.4
"18127",18,127,1992,67957,64127,3830,5.6
"18127",18,127,1993,70091,66375,3716,5.3
"18127",18,127,1994,71774,68379,3395,4.7
"18127",18,127,1995,73463,70032,3431,4.7
"18127",18,127,1996,74554,71805,2749,3.7
"18127",18,127,1997,76300,74055,2245,2.9
"18127",18,127,1998,77030,74918,2112,2.7
"18127",18,127,1999,76839,74504,2335,3
"18127",18,127,2000,77453,75181,2272,2.9
"18127",18,127,2001,78553,75533,3020,3.8
"18127",18,127,2002,79613,75632,3981,5
"18127",18,127,2003,79859,75808,4051,5.1
"18127",18,127,2004,79393,75523,3870,4.9
"18127",18,127,2005,81102,77225,3877,4.8
"18127",18,127,2006,82837,79186,3651,4.4
"18127",18,127,2007,83076,79893,3183,3.8
"18127",18,127,2008,84369,80333,4036,4.8
"18127",18,127,2009,84211,76343,7868,9.3
"18127",18,127,2010,81600,73869,7731,9.5
"18127",18,127,2011,82283,75561,6722,8.2
"18127",18,127,2012,82373,76107,6266,7.6
"18127",18,127,2013,83161,77162,5999,7.2
"18127",18,127,2014,83965,78763,5202,6.2
"18127",18,127,2015,84691,80142,4549,5.4
"18127",18,127,2016,86221,81811,4410,5.1
"18127",18,127,2017,85418,81948,3470,4.1
"18129",18,129,1990,12925,12322,603,4.7
"18129",18,129,1991,12687,12040,647,5.1
"18129",18,129,1992,12743,12075,668,5.2
"18129",18,129,1993,13352,12796,556,4.2
"18129",18,129,1994,13904,13329,575,4.1
"18129",18,129,1995,14074,13504,570,4.1
"18129",18,129,1996,14085,13578,507,3.6
"18129",18,129,1997,14126,13650,476,3.4
"18129",18,129,1998,13946,13556,390,2.8
"18129",18,129,1999,14006,13593,413,2.9
"18129",18,129,2000,13852,13419,433,3.1
"18129",18,129,2001,13956,13471,485,3.5
"18129",18,129,2002,14260,13635,625,4.4
"18129",18,129,2003,14086,13474,612,4.3
"18129",18,129,2004,13761,13138,623,4.5
"18129",18,129,2005,13870,13190,680,4.9
"18129",18,129,2006,13805,13196,609,4.4
"18129",18,129,2007,13364,12796,568,4.3
"18129",18,129,2008,13361,12711,650,4.9
"18129",18,129,2009,13176,12102,1074,8.2
"18129",18,129,2010,13494,12440,1054,7.8
"18129",18,129,2011,13421,12498,923,6.9
"18129",18,129,2012,13190,12299,891,6.8
"18129",18,129,2013,12946,12126,820,6.3
"18129",18,129,2014,13146,12518,628,4.8
"18129",18,129,2015,13299,12771,528,4
"18129",18,129,2016,13444,12914,530,3.9
"18129",18,129,2017,13388,12983,405,3
"18131",18,131,1990,5888,5525,363,6.2
"18131",18,131,1991,5838,5457,381,6.5
"18131",18,131,1992,5925,5443,482,8.1
"18131",18,131,1993,6024,5605,419,7
"18131",18,131,1994,6225,5859,366,5.9
"18131",18,131,1995,6360,6037,323,5.1
"18131",18,131,1996,6185,5841,344,5.6
"18131",18,131,1997,6310,5882,428,6.8
"18131",18,131,1998,6240,5932,308,4.9
"18131",18,131,1999,6243,5808,435,7
"18131",18,131,2000,6760,6455,305,4.5
"18131",18,131,2001,6776,6456,320,4.7
"18131",18,131,2002,6822,6429,393,5.8
"18131",18,131,2003,6699,6322,377,5.6
"18131",18,131,2004,6795,6437,358,5.3
"18131",18,131,2005,7075,6720,355,5
"18131",18,131,2006,6865,6548,317,4.6
"18131",18,131,2007,6800,6518,282,4.1
"18131",18,131,2008,6799,6416,383,5.6
"18131",18,131,2009,6750,6046,704,10.4
"18131",18,131,2010,6370,5736,634,10
"18131",18,131,2011,6401,5884,517,8.1
"18131",18,131,2012,6271,5808,463,7.4
"18131",18,131,2013,6117,5687,430,7
"18131",18,131,2014,6191,5857,334,5.4
"18131",18,131,2015,6274,5990,284,4.5
"18131",18,131,2016,6376,6091,285,4.5
"18131",18,131,2017,6357,6135,222,3.5
"18133",18,133,1990,13866,13171,695,5
"18133",18,133,1991,14189,13412,777,5.5
"18133",18,133,1992,14999,14280,719,4.8
"18133",18,133,1993,15761,15152,609,3.9
"18133",18,133,1994,17015,16451,564,3.3
"18133",18,133,1995,17324,16686,638,3.7
"18133",18,133,1996,16860,16250,610,3.6
"18133",18,133,1997,16755,16171,584,3.5
"18133",18,133,1998,16646,16252,394,2.4
"18133",18,133,1999,16992,16660,332,2
"18133",18,133,2000,17104,16599,505,3
"18133",18,133,2001,17278,16626,652,3.8
"18133",18,133,2002,17424,16542,882,5.1
"18133",18,133,2003,17671,16693,978,5.5
"18133",18,133,2004,17499,16519,980,5.6
"18133",18,133,2005,17804,16615,1189,6.7
"18133",18,133,2006,17716,16754,962,5.4
"18133",18,133,2007,17518,16581,937,5.3
"18133",18,133,2008,17701,16510,1191,6.7
"18133",18,133,2009,17218,15341,1877,10.9
"18133",18,133,2010,16674,14732,1942,11.6
"18133",18,133,2011,16596,14799,1797,10.8
"18133",18,133,2012,16338,14721,1617,9.9
"18133",18,133,2013,16159,14760,1399,8.7
"18133",18,133,2014,16258,15180,1078,6.6
"18133",18,133,2015,16401,15562,839,5.1
"18133",18,133,2016,16594,15847,747,4.5
"18133",18,133,2017,16601,15999,602,3.6
"18135",18,135,1990,13134,11803,1331,10.1
"18135",18,135,1991,12099,10682,1417,11.7
"18135",18,135,1992,12011,10368,1643,13.7
"18135",18,135,1993,12072,10779,1293,10.7
"18135",18,135,1994,12327,11202,1125,9.1
"18135",18,135,1995,12844,11887,957,7.5
"18135",18,135,1996,12556,11538,1018,8.1
"18135",18,135,1997,11831,10780,1051,8.9
"18135",18,135,1998,11473,10586,887,7.7
"18135",18,135,1999,11541,10779,762,6.6
"18135",18,135,2000,13531,13004,527,3.9
"18135",18,135,2001,13752,13020,732,5.3
"18135",18,135,2002,13777,12959,818,5.9
"18135",18,135,2003,13552,12621,931,6.9
"18135",18,135,2004,13147,12222,925,7
"18135",18,135,2005,13101,12131,970,7.4
"18135",18,135,2006,12897,12009,888,6.9
"18135",18,135,2007,12656,11942,714,5.6
"18135",18,135,2008,12716,11839,877,6.9
"18135",18,135,2009,12847,11311,1536,12
"18135",18,135,2010,13019,11486,1533,11.8
"18135",18,135,2011,13023,11672,1351,10.4
"18135",18,135,2012,12761,11541,1220,9.6
"18135",18,135,2013,12576,11488,1088,8.7
"18135",18,135,2014,12480,11672,808,6.5
"18135",18,135,2015,12686,12056,630,5
"18135",18,135,2016,12662,12093,569,4.5
"18135",18,135,2017,11801,11312,489,4.1
"18137",18,137,1990,11932,11235,697,5.8
"18137",18,137,1991,12173,11190,983,8.1
"18137",18,137,1992,12348,11352,996,8.1
"18137",18,137,1993,12816,11984,832,6.5
"18137",18,137,1994,13429,12710,719,5.4
"18137",18,137,1995,13814,13022,792,5.7
"18137",18,137,1996,13542,12935,607,4.5
"18137",18,137,1997,13396,12945,451,3.4
"18137",18,137,1998,13580,13146,434,3.2
"18137",18,137,1999,13732,13284,448,3.3
"18137",18,137,2000,13712,13349,363,2.6
"18137",18,137,2001,13987,13499,488,3.5
"18137",18,137,2002,14065,13454,611,4.3
"18137",18,137,2003,14720,14045,675,4.6
"18137",18,137,2004,14847,14087,760,5.1
"18137",18,137,2005,14876,14086,790,5.3
"18137",18,137,2006,14405,13710,695,4.8
"18137",18,137,2007,13911,13280,631,4.5
"18137",18,137,2008,14051,13214,837,6
"18137",18,137,2009,13765,12275,1490,10.8
"18137",18,137,2010,14528,12899,1629,11.2
"18137",18,137,2011,14938,13526,1412,9.5
"18137",18,137,2012,13847,12602,1245,9
"18137",18,137,2013,13634,12464,1170,8.6
"18137",18,137,2014,13629,12731,898,6.6
"18137",18,137,2015,13634,12903,731,5.4
"18137",18,137,2016,14057,13414,643,4.6
"18137",18,137,2017,14017,13516,501,3.6
"18139",18,139,1990,8814,8229,585,6.6
"18139",18,139,1991,8778,8168,610,6.9
"18139",18,139,1992,9031,8333,698,7.7
"18139",18,139,1993,9471,8910,561,5.9
"18139",18,139,1994,9815,9351,464,4.7
"18139",18,139,1995,10307,9838,469,4.6
"18139",18,139,1996,10245,9859,386,3.8
"18139",18,139,1997,10265,9965,300,2.9
"18139",18,139,1998,10100,9827,273,2.7
"18139",18,139,1999,10147,9852,295,2.9
"18139",18,139,2000,9459,9203,256,2.7
"18139",18,139,2001,9643,9287,356,3.7
"18139",18,139,2002,9538,9105,433,4.5
"18139",18,139,2003,9279,8824,455,4.9
"18139",18,139,2004,9254,8802,452,4.9
"18139",18,139,2005,9556,9105,451,4.7
"18139",18,139,2006,9502,9072,430,4.5
"18139",18,139,2007,9448,9020,428,4.5
"18139",18,139,2008,9232,8663,569,6.2
"18139",18,139,2009,9086,8132,954,10.5
"18139",18,139,2010,8683,7716,967,11.1
"18139",18,139,2011,8584,7766,818,9.5
"18139",18,139,2012,8377,7665,712,8.5
"18139",18,139,2013,8335,7718,617,7.4
"18139",18,139,2014,8525,8046,479,5.6
"18139",18,139,2015,8838,8456,382,4.3
"18139",18,139,2016,8973,8636,337,3.8
"18139",18,139,2017,8909,8637,272,3.1
"18141",18,141,1990,125573,118247,7326,5.8
"18141",18,141,1991,123587,115925,7662,6.2
"18141",18,141,1992,125095,116383,8712,7
"18141",18,141,1993,128351,121481,6870,5.4
"18141",18,141,1994,134936,129074,5862,4.3
"18141",18,141,1995,138221,132433,5788,4.2
"18141",18,141,1996,136672,131291,5381,3.9
"18141",18,141,1997,138162,133603,4559,3.3
"18141",18,141,1998,137507,133663,3844,2.8
"18141",18,141,1999,136517,132256,4261,3.1
"18141",18,141,2000,134193,129774,4419,3.3
"18141",18,141,2001,132924,126831,6093,4.6
"18141",18,141,2002,133666,126501,7165,5.4
"18141",18,141,2003,132464,125425,7039,5.3
"18141",18,141,2004,132651,125770,6881,5.2
"18141",18,141,2005,134160,126995,7165,5.3
"18141",18,141,2006,134792,127805,6987,5.2
"18141",18,141,2007,132785,126293,6492,4.9
"18141",18,141,2008,132903,124176,8727,6.6
"18141",18,141,2009,129097,114259,14838,11.5
"18141",18,141,2010,130463,115385,15078,11.6
"18141",18,141,2011,130605,117385,13220,10.1
"18141",18,141,2012,127770,115690,12080,9.5
"18141",18,141,2013,127097,116038,11059,8.7
"18141",18,141,2014,128667,120252,8415,6.5
"18141",18,141,2015,130406,123843,6563,5
"18141",18,141,2016,134050,127987,6063,4.5
"18141",18,141,2017,133864,129085,4779,3.6
"18143",18,143,1990,9643,8820,823,8.5
"18143",18,143,1991,9502,8743,759,8
"18143",18,143,1992,9635,8992,643,6.7
"18143",18,143,1993,10045,9417,628,6.3
"18143",18,143,1994,10383,9874,509,4.9
"18143",18,143,1995,10703,10125,578,5.4
"18143",18,143,1996,10814,10272,542,5
"18143",18,143,1997,11038,10481,557,5
"18143",18,143,1998,11082,10714,368,3.3
"18143",18,143,1999,11250,10909,341,3
"18143",18,143,2000,11277,10894,383,3.4
"18143",18,143,2001,11117,10557,560,5
"18143",18,143,2002,11095,10413,682,6.1
"18143",18,143,2003,11092,10375,717,6.5
"18143",18,143,2004,11225,10577,648,5.8
"18143",18,143,2005,11393,10682,711,6.2
"18143",18,143,2006,11393,10652,741,6.5
"18143",18,143,2007,11053,10473,580,5.2
"18143",18,143,2008,11099,10379,720,6.5
"18143",18,143,2009,10951,9534,1417,12.9
"18143",18,143,2010,10590,9195,1395,13.2
"18143",18,143,2011,10378,9146,1232,11.9
"18143",18,143,2012,10181,9133,1048,10.3
"18143",18,143,2013,10239,9325,914,8.9
"18143",18,143,2014,10182,9490,692,6.8
"18143",18,143,2015,10286,9726,560,5.4
"18143",18,143,2016,10495,9987,508,4.8
"18143",18,143,2017,10486,10089,397,3.8
"18145",18,145,1990,21404,20181,1223,5.7
"18145",18,145,1991,21216,19920,1296,6.1
"18145",18,145,1992,21290,20090,1200,5.6
"18145",18,145,1993,22096,20995,1101,5
"18145",18,145,1994,22885,21850,1035,4.5
"18145",18,145,1995,23852,22556,1296,5.4
"18145",18,145,1996,23319,22465,854,3.7
"18145",18,145,1997,23572,22793,779,3.3
"18145",18,145,1998,23551,22900,651,2.8
"18145",18,145,1999,23650,22933,717,3
"18145",18,145,2000,23544,22906,638,2.7
"18145",18,145,2001,23864,22982,882,3.7
"18145",18,145,2002,23881,22736,1145,4.8
"18145",18,145,2003,23825,22683,1142,4.8
"18145",18,145,2004,23659,22497,1162,4.9
"18145",18,145,2005,23676,22487,1189,5
"18145",18,145,2006,23906,22841,1065,4.5
"18145",18,145,2007,23582,22557,1025,4.3
"18145",18,145,2008,23816,22421,1395,5.9
"18145",18,145,2009,23647,21179,2468,10.4
"18145",18,145,2010,22714,20223,2491,11
"18145",18,145,2011,22512,20380,2132,9.5
"18145",18,145,2012,22318,20453,1865,8.4
"18145",18,145,2013,22345,20705,1640,7.3
"18145",18,145,2014,22420,21146,1274,5.7
"18145",18,145,2015,22626,21619,1007,4.5
"18145",18,145,2016,22943,22028,915,4
"18145",18,145,2017,23016,22256,760,3.3
"18147",18,147,1990,9820,9188,632,6.4
"18147",18,147,1991,9414,8735,679,7.2
"18147",18,147,1992,9557,8730,827,8.7
"18147",18,147,1993,10375,9673,702,6.8
"18147",18,147,1994,10916,10232,684,6.3
"18147",18,147,1995,11278,10643,635,5.6
"18147",18,147,1996,11140,10604,536,4.8
"18147",18,147,1997,11291,10784,507,4.5
"18147",18,147,1998,12140,11746,394,3.2
"18147",18,147,1999,11990,11508,482,4
"18147",18,147,2000,10979,10580,399,3.6
"18147",18,147,2001,10517,10048,469,4.5
"18147",18,147,2002,10634,10131,503,4.7
"18147",18,147,2003,10794,10234,560,5.2
"18147",18,147,2004,10566,10004,562,5.3
"18147",18,147,2005,10725,10112,613,5.7
"18147",18,147,2006,10632,10101,531,5
"18147",18,147,2007,10427,9992,435,4.2
"18147",18,147,2008,10517,9985,532,5.1
"18147",18,147,2009,10387,9431,956,9.2
"18147",18,147,2010,10996,10030,966,8.8
"18147",18,147,2011,11031,10185,846,7.7
"18147",18,147,2012,10791,10012,779,7.2
"18147",18,147,2013,10690,9978,712,6.7
"18147",18,147,2014,10739,10188,551,5.1
"18147",18,147,2015,10974,10520,454,4.1
"18147",18,147,2016,10970,10520,450,4.1
"18147",18,147,2017,10912,10545,367,3.4
"18149",18,149,1990,10312,9557,755,7.3
"18149",18,149,1991,10047,9282,765,7.6
"18149",18,149,1992,10342,9409,933,9
"18149",18,149,1993,10677,9914,763,7.1
"18149",18,149,1994,11264,10619,645,5.7
"18149",18,149,1995,11523,10805,718,6.2
"18149",18,149,1996,11536,10862,674,5.8
"18149",18,149,1997,11527,10928,599,5.2
"18149",18,149,1998,11026,10525,501,4.5
"18149",18,149,1999,10905,10384,521,4.8
"18149",18,149,2000,10834,10300,534,4.9
"18149",18,149,2001,10676,10042,634,5.9
"18149",18,149,2002,10658,9865,793,7.4
"18149",18,149,2003,10543,9777,766,7.3
"18149",18,149,2004,10490,9757,733,7
"18149",18,149,2005,10636,9889,747,7
"18149",18,149,2006,10586,9887,699,6.6
"18149",18,149,2007,10453,9835,618,5.9
"18149",18,149,2008,10701,9871,830,7.8
"18149",18,149,2009,10729,9207,1522,14.2
"18149",18,149,2010,10444,9052,1392,13.3
"18149",18,149,2011,10332,9153,1179,11.4
"18149",18,149,2012,10108,9036,1072,10.6
"18149",18,149,2013,10213,9247,966,9.5
"18149",18,149,2014,10225,9485,740,7.2
"18149",18,149,2015,10548,9921,627,5.9
"18149",18,149,2016,10855,10267,588,5.4
"18149",18,149,2017,10449,9990,459,4.4
"18151",18,151,1990,14814,13981,833,5.6
"18151",18,151,1991,14752,13724,1028,7
"18151",18,151,1992,15517,14602,915,5.9
"18151",18,151,1993,16084,15333,751,4.7
"18151",18,151,1994,16896,16258,638,3.8
"18151",18,151,1995,17926,17340,586,3.3
"18151",18,151,1996,17403,16773,630,3.6
"18151",18,151,1997,18018,17486,532,3
"18151",18,151,1998,18256,17732,524,2.9
"18151",18,151,1999,17909,17387,522,2.9
"18151",18,151,2000,18468,17897,571,3.1
"18151",18,151,2001,17498,16569,929,5.3
"18151",18,151,2002,17218,16106,1112,6.5
"18151",18,151,2003,17014,15916,1098,6.5
"18151",18,151,2004,16994,15997,997,5.9
"18151",18,151,2005,17012,15940,1072,6.3
"18151",18,151,2006,16623,15562,1061,6.4
"18151",18,151,2007,16494,15506,988,6
"18151",18,151,2008,16177,14965,1212,7.5
"18151",18,151,2009,16301,13930,2371,14.5
"18151",18,151,2010,18439,16386,2053,11.1
"18151",18,151,2011,18565,16902,1663,9
"18151",18,151,2012,18914,17536,1378,7.3
"18151",18,151,2013,19319,18109,1210,6.3
"18151",18,151,2014,19796,18840,956,4.8
"18151",18,151,2015,19981,19199,782,3.9
"18151",18,151,2016,20072,19338,734,3.7
"18151",18,151,2017,19922,19345,577,2.9
"18153",18,153,1990,8565,7958,607,7.1
"18153",18,153,1991,8727,7972,755,8.7
"18153",18,153,1992,8982,8092,890,9.9
"18153",18,153,1993,9762,8888,874,9
"18153",18,153,1994,10307,9382,925,9
"18153",18,153,1995,10399,9482,917,8.8
"18153",18,153,1996,10349,9520,829,8
"18153",18,153,1997,10133,9469,664,6.6
"18153",18,153,1998,9867,9304,563,5.7
"18153",18,153,1999,9622,9098,524,5.4
"18153",18,153,2000,9225,8728,497,5.4
"18153",18,153,2001,9204,8697,507,5.5
"18153",18,153,2002,9357,8797,560,6
"18153",18,153,2003,9296,8664,632,6.8
"18153",18,153,2004,9351,8653,698,7.5
"18153",18,153,2005,9294,8599,695,7.5
"18153",18,153,2006,9131,8577,554,6.1
"18153",18,153,2007,8918,8426,492,5.5
"18153",18,153,2008,8869,8275,594,6.7
"18153",18,153,2009,8850,7971,879,9.9
"18153",18,153,2010,9085,8170,915,10.1
"18153",18,153,2011,8891,8064,827,9.3
"18153",18,153,2012,8803,7982,821,9.3
"18153",18,153,2013,8705,7917,788,9.1
"18153",18,153,2014,8643,8025,618,7.2
"18153",18,153,2015,8658,8118,540,6.2
"18153",18,153,2016,8695,8185,510,5.9
"18153",18,153,2017,8506,8129,377,4.4
"18155",18,155,1990,3598,3312,286,7.9
"18155",18,155,1991,3944,3621,323,8.2
"18155",18,155,1992,3943,3558,385,9.8
"18155",18,155,1993,3964,3732,232,5.9
"18155",18,155,1994,4206,3975,231,5.5
"18155",18,155,1995,4469,4202,267,6
"18155",18,155,1996,4005,3723,282,7
"18155",18,155,1997,3815,3624,191,5
"18155",18,155,1998,3715,3527,188,5.1
"18155",18,155,1999,3732,3574,158,4.2
"18155",18,155,2000,5009,4759,250,5
"18155",18,155,2001,5973,5777,196,3.3
"18155",18,155,2002,5742,5469,273,4.8
"18155",18,155,2003,5748,5494,254,4.4
"18155",18,155,2004,5707,5443,264,4.6
"18155",18,155,2005,5767,5493,274,4.8
"18155",18,155,2006,5678,5445,233,4.1
"18155",18,155,2007,5687,5466,221,3.9
"18155",18,155,2008,5695,5408,287,5
"18155",18,155,2009,5673,5224,449,7.9
"18155",18,155,2010,5025,4558,467,9.3
"18155",18,155,2011,4987,4580,407,8.2
"18155",18,155,2012,4890,4512,378,7.7
"18155",18,155,2013,4883,4519,364,7.5
"18155",18,155,2014,4800,4517,283,5.9
"18155",18,155,2015,4854,4613,241,5
"18155",18,155,2016,4994,4751,243,4.9
"18155",18,155,2017,4961,4763,198,4
"18157",18,157,1990,65711,63919,1792,2.7
"18157",18,157,1991,64977,63214,1763,2.7
"18157",18,157,1992,65911,63521,2390,3.6
"18157",18,157,1993,68446,66254,2192,3.2
"18157",18,157,1994,70409,68046,2363,3.4
"18157",18,157,1995,73129,71160,1969,2.7
"18157",18,157,1996,73346,71371,1975,2.7
"18157",18,157,1997,73620,71924,1696,2.3
"18157",18,157,1998,74241,72722,1519,2
"18157",18,157,1999,75289,73674,1615,2.1
"18157",18,157,2000,77923,75826,2097,2.7
"18157",18,157,2001,78779,76025,2754,3.5
"18157",18,157,2002,80106,76661,3445,4.3
"18157",18,157,2003,77577,73934,3643,4.7
"18157",18,157,2004,77757,74056,3701,4.8
"18157",18,157,2005,79380,75524,3856,4.9
"18157",18,157,2006,80461,77005,3456,4.3
"18157",18,157,2007,81511,78292,3219,3.9
"18157",18,157,2008,83556,79617,3939,4.7
"18157",18,157,2009,84263,76584,7679,9.1
"18157",18,157,2010,86531,78864,7667,8.9
"18157",18,157,2011,87456,80923,6533,7.5
"18157",18,157,2012,88449,82295,6154,7
"18157",18,157,2013,89630,83675,5955,6.6
"18157",18,157,2014,91257,86672,4585,5
"18157",18,157,2015,93117,89165,3952,4.2
"18157",18,157,2016,94337,90512,3825,4.1
"18157",18,157,2017,94220,91188,3032,3.2
"18159",18,159,1990,8307,7831,476,5.7
"18159",18,159,1991,8144,7599,545,6.7
"18159",18,159,1992,8365,7809,556,6.6
"18159",18,159,1993,8724,8296,428,4.9
"18159",18,159,1994,8785,8394,391,4.5
"18159",18,159,1995,9192,8861,331,3.6
"18159",18,159,1996,9044,8741,303,3.4
"18159",18,159,1997,8776,8506,270,3.1
"18159",18,159,1998,8886,8640,246,2.8
"18159",18,159,1999,8833,8631,202,2.3
"18159",18,159,2000,8674,8436,238,2.7
"18159",18,159,2001,8559,8139,420,4.9
"18159",18,159,2002,8558,8120,438,5.1
"18159",18,159,2003,8313,7863,450,5.4
"18159",18,159,2004,8153,7725,428,5.2
"18159",18,159,2005,8077,7613,464,5.7
"18159",18,159,2006,8025,7587,438,5.5
"18159",18,159,2007,7708,7349,359,4.7
"18159",18,159,2008,7599,7049,550,7.2
"18159",18,159,2009,7216,6277,939,13
"18159",18,159,2010,8046,7221,825,10.3
"18159",18,159,2011,7956,7240,716,9
"18159",18,159,2012,8009,7387,622,7.8
"18159",18,159,2013,7958,7423,535,6.7
"18159",18,159,2014,8160,7737,423,5.2
"18159",18,159,2015,8382,8046,336,4
"18159",18,159,2016,8524,8196,328,3.8
"18159",18,159,2017,8530,8269,261,3.1
"18161",18,161,1990,3490,3210,280,8
"18161",18,161,1991,3402,3085,317,9.3
"18161",18,161,1992,3503,3175,328,9.4
"18161",18,161,1993,3685,3450,235,6.4
"18161",18,161,1994,3954,3722,232,5.9
"18161",18,161,1995,4015,3796,219,5.5
"18161",18,161,1996,4005,3822,183,4.6
"18161",18,161,1997,3974,3839,135,3.4
"18161",18,161,1998,3976,3838,138,3.5
"18161",18,161,1999,3947,3825,122,3.1
"18161",18,161,2000,3791,3670,121,3.2
"18161",18,161,2001,3764,3595,169,4.5
"18161",18,161,2002,3716,3521,195,5.2
"18161",18,161,2003,3775,3582,193,5.1
"18161",18,161,2004,3761,3554,207,5.5
"18161",18,161,2005,3874,3657,217,5.6
"18161",18,161,2006,3903,3687,216,5.5
"18161",18,161,2007,3619,3449,170,4.7
"18161",18,161,2008,3603,3380,223,6.2
"18161",18,161,2009,3527,3166,361,10.2
"18161",18,161,2010,3729,3346,383,10.3
"18161",18,161,2011,3667,3343,324,8.8
"18161",18,161,2012,3557,3270,287,8.1
"18161",18,161,2013,3519,3266,253,7.2
"18161",18,161,2014,3541,3342,199,5.6
"18161",18,161,2015,3561,3402,159,4.5
"18161",18,161,2016,3635,3488,147,4
"18161",18,161,2017,3624,3511,113,3.1
"18163",18,163,1990,84833,80187,4646,5.5
"18163",18,163,1991,83757,78822,4935,5.9
"18163",18,163,1992,84946,79089,5857,6.9
"18163",18,163,1993,88621,83656,4965,5.6
"18163",18,163,1994,91696,87056,4640,5.1
"18163",18,163,1995,92664,87829,4835,5.2
"18163",18,163,1996,91605,87896,3709,4
"18163",18,163,1997,92064,88211,3853,4.2
"18163",18,163,1998,91071,88023,3048,3.3
"18163",18,163,1999,91813,88912,2901,3.2
"18163",18,163,2000,89699,86739,2960,3.3
"18163",18,163,2001,91021,87502,3519,3.9
"18163",18,163,2002,92594,88365,4229,4.6
"18163",18,163,2003,92430,88057,4373,4.7
"18163",18,163,2004,90533,86037,4496,5
"18163",18,163,2005,91447,86649,4798,5.2
"18163",18,163,2006,91457,87051,4406,4.8
"18163",18,163,2007,90815,86554,4261,4.7
"18163",18,163,2008,91482,86733,4749,5.2
"18163",18,163,2009,90591,83152,7439,8.2
"18163",18,163,2010,92128,83895,8233,8.9
"18163",18,163,2011,92760,85342,7418,8
"18163",18,163,2012,91825,84786,7039,7.7
"18163",18,163,2013,90899,84413,6486,7.1
"18163",18,163,2014,92029,87069,4960,5.4
"18163",18,163,2015,92238,88302,3936,4.3
"18163",18,163,2016,93179,89352,3827,4.1
"18163",18,163,2017,93131,90106,3025,3.2
"18165",18,165,1990,7513,7024,489,6.5
"18165",18,165,1991,7532,6997,535,7.1
"18165",18,165,1992,7724,7047,677,8.8
"18165",18,165,1993,8055,7366,689,8.6
"18165",18,165,1994,8302,7597,705,8.5
"18165",18,165,1995,8495,7799,696,8.2
"18165",18,165,1996,8216,7606,610,7.4
"18165",18,165,1997,8010,7462,548,6.8
"18165",18,165,1998,7857,7365,492,6.3
"18165",18,165,1999,7810,7397,413,5.3
"18165",18,165,2000,8134,7746,388,4.8
"18165",18,165,2001,8068,7639,429,5.3
"18165",18,165,2002,8194,7675,519,6.3
"18165",18,165,2003,8058,7531,527,6.5
"18165",18,165,2004,8204,7532,672,8.2
"18165",18,165,2005,8131,7527,604,7.4
"18165",18,165,2006,8157,7623,534,6.5
"18165",18,165,2007,7890,7447,443,5.6
"18165",18,165,2008,7810,7245,565,7.2
"18165",18,165,2009,7975,7010,965,12.1
"18165",18,165,2010,7810,6799,1011,12.9
"18165",18,165,2011,7647,6749,898,11.7
"18165",18,165,2012,7468,6617,851,11.4
"18165",18,165,2013,7324,6537,787,10.7
"18165",18,165,2014,7222,6602,620,8.6
"18165",18,165,2015,7226,6711,515,7.1
"18165",18,165,2016,7267,6789,478,6.6
"18165",18,165,2017,7131,6746,385,5.4
"18167",18,167,1990,49138,46702,2436,5
"18167",18,167,1991,49735,47017,2718,5.5
"18167",18,167,1992,51136,47711,3425,6.7
"18167",18,167,1993,53067,49507,3560,6.7
"18167",18,167,1994,54285,50745,3540,6.5
"18167",18,167,1995,55089,51873,3216,5.8
"18167",18,167,1996,53732,50335,3397,6.3
"18167",18,167,1997,51656,48638,3018,5.8
"18167",18,167,1998,50291,47920,2371,4.7
"18167",18,167,1999,50004,47828,2176,4.4
"18167",18,167,2000,50774,48666,2108,4.2
"18167",18,167,2001,50503,47932,2571,5.1
"18167",18,167,2002,51329,48320,3009,5.9
"18167",18,167,2003,50396,47383,3013,6
"18167",18,167,2004,50430,46771,3659,7.3
"18167",18,167,2005,49898,46501,3397,6.8
"18167",18,167,2006,50269,47050,3219,6.4
"18167",18,167,2007,50120,47466,2654,5.3
"18167",18,167,2008,50403,47164,3239,6.4
"18167",18,167,2009,50961,45807,5154,10.1
"18167",18,167,2010,51129,45402,5727,11.2
"18167",18,167,2011,50515,45311,5204,10.3
"18167",18,167,2012,50132,45160,4972,9.9
"18167",18,167,2013,49522,44879,4643,9.4
"18167",18,167,2014,49446,45689,3757,7.6
"18167",18,167,2015,48986,45981,3005,6.1
"18167",18,167,2016,49352,46695,2657,5.4
"18167",18,167,2017,48600,46534,2066,4.3
"18169",18,169,1990,18210,17054,1156,6.3
"18169",18,169,1991,18114,16503,1611,8.9
"18169",18,169,1992,17887,16388,1499,8.4
"18169",18,169,1993,17914,16926,988,5.5
"18169",18,169,1994,18583,17785,798,4.3
"18169",18,169,1995,18536,17740,796,4.3
"18169",18,169,1996,17913,17178,735,4.1
"18169",18,169,1997,17816,17066,750,4.2
"18169",18,169,1998,17629,17026,603,3.4
"18169",18,169,1999,17640,17086,554,3.1
"18169",18,169,2000,18071,17513,558,3.1
"18169",18,169,2001,18028,17099,929,5.2
"18169",18,169,2002,17832,16878,954,5.3
"18169",18,169,2003,17715,16712,1003,5.7
"18169",18,169,2004,17467,16365,1102,6.3
"18169",18,169,2005,17717,16545,1172,6.6
"18169",18,169,2006,17729,16743,986,5.6
"18169",18,169,2007,16993,16173,820,4.8
"18169",18,169,2008,16541,15299,1242,7.5
"18169",18,169,2009,16331,14199,2132,13.1
"18169",18,169,2010,15955,14133,1822,11.4
"18169",18,169,2011,15707,14205,1502,9.6
"18169",18,169,2012,15693,14361,1332,8.5
"18169",18,169,2013,15454,14276,1178,7.6
"18169",18,169,2014,15461,14601,860,5.6
"18169",18,169,2015,15387,14650,737,4.8
"18169",18,169,2016,15471,14812,659,4.3
"18169",18,169,2017,15115,14585,530,3.5
"18171",18,171,1990,3781,3603,178,4.7
"18171",18,171,1991,3740,3516,224,6
"18171",18,171,1992,3791,3527,264,7
"18171",18,171,1993,3874,3656,218,5.6
"18171",18,171,1994,3992,3802,190,4.8
"18171",18,171,1995,4040,3856,184,4.6
"18171",18,171,1996,3956,3816,140,3.5
"18171",18,171,1997,3913,3786,127,3.2
"18171",18,171,1998,3970,3849,121,3
"18171",18,171,1999,3976,3860,116,2.9
"18171",18,171,2000,4483,4359,124,2.8
"18171",18,171,2001,4554,4404,150,3.3
"18171",18,171,2002,4643,4404,239,5.1
"18171",18,171,2003,4553,4329,224,4.9
"18171",18,171,2004,4613,4401,212,4.6
"18171",18,171,2005,4779,4564,215,4.5
"18171",18,171,2006,4791,4597,194,4
"18171",18,171,2007,4991,4831,160,3.2
"18171",18,171,2008,4795,4598,197,4.1
"18171",18,171,2009,4646,4159,487,10.5
"18171",18,171,2010,4201,3758,443,10.5
"18171",18,171,2011,4271,3924,347,8.1
"18171",18,171,2012,4198,3888,310,7.4
"18171",18,171,2013,4152,3787,365,8.8
"18171",18,171,2014,4093,3844,249,6.1
"18171",18,171,2015,4097,3894,203,5
"18171",18,171,2016,4108,3910,198,4.8
"18171",18,171,2017,4043,3907,136,3.4
"18173",18,173,1990,23575,22492,1083,4.6
"18173",18,173,1991,23545,22436,1109,4.7
"18173",18,173,1992,24139,22740,1399,5.8
"18173",18,173,1993,25821,24499,1322,5.1
"18173",18,173,1994,27268,25908,1360,5
"18173",18,173,1995,27910,26609,1301,4.7
"18173",18,173,1996,28097,27066,1031,3.7
"18173",18,173,1997,28690,27657,1033,3.6
"18173",18,173,1998,28732,27861,871,3
"18173",18,173,1999,29485,28657,828,2.8
"18173",18,173,2000,28416,27452,964,3.4
"18173",18,173,2001,28905,27899,1006,3.5
"18173",18,173,2002,29662,28486,1176,4
"18173",18,173,2003,30145,28866,1279,4.2
"18173",18,173,2004,29807,28491,1316,4.4
"18173",18,173,2005,30602,29170,1432,4.7
"18173",18,173,2006,30960,29655,1305,4.2
"18173",18,173,2007,30489,29304,1185,3.9
"18173",18,173,2008,31044,29605,1439,4.6
"18173",18,173,2009,31087,28692,2395,7.7
"18173",18,173,2010,30817,28345,2472,8
"18173",18,173,2011,31119,28911,2208,7.1
"18173",18,173,2012,30814,28718,2096,6.8
"18173",18,173,2013,30710,28778,1932,6.3
"18173",18,173,2014,31166,29637,1529,4.9
"18173",18,173,2015,31754,30463,1291,4.1
"18173",18,173,2016,32466,31156,1310,4
"18173",18,173,2017,32433,31412,1021,3.1
"18175",18,175,1990,11221,10456,765,6.8
"18175",18,175,1991,10688,9788,900,8.4
"18175",18,175,1992,10756,9731,1025,9.5
"18175",18,175,1993,11194,10370,824,7.4
"18175",18,175,1994,11491,10787,704,6.1
"18175",18,175,1995,12198,11433,765,6.3
"18175",18,175,1996,11982,11172,810,6.8
"18175",18,175,1997,12129,11475,654,5.4
"18175",18,175,1998,12045,11441,604,5
"18175",18,175,1999,11856,11307,549,4.6
"18175",18,175,2000,14032,13489,543,3.9
"18175",18,175,2001,14092,13322,770,5.5
"18175",18,175,2002,14047,13259,788,5.6
"18175",18,175,2003,14067,13260,807,5.7
"18175",18,175,2004,13965,13063,902,6.5
"18175",18,175,2005,14013,13144,869,6.2
"18175",18,175,2006,14296,13407,889,6.2
"18175",18,175,2007,14011,13277,734,5.2
"18175",18,175,2008,14106,13169,937,6.6
"18175",18,175,2009,14037,12360,1677,11.9
"18175",18,175,2010,13806,12118,1688,12.2
"18175",18,175,2011,13515,12081,1434,10.6
"18175",18,175,2012,13174,11930,1244,9.4
"18175",18,175,2013,13142,11994,1148,8.7
"18175",18,175,2014,13310,12425,885,6.6
"18175",18,175,2015,13526,12824,702,5.2
"18175",18,175,2016,13705,13080,625,4.6
"18175",18,175,2017,13650,13145,505,3.7
"18177",18,177,1990,35859,32744,3115,8.7
"18177",18,177,1991,35083,31225,3858,11
"18177",18,177,1992,36220,31726,4494,12.4
"18177",18,177,1993,37366,33872,3494,9.4
"18177",18,177,1994,39460,36886,2574,6.5
"18177",18,177,1995,39160,36919,2241,5.7
"18177",18,177,1996,38901,37126,1775,4.6
"18177",18,177,1997,38700,37229,1471,3.8
"18177",18,177,1998,39054,37518,1536,3.9
"18177",18,177,1999,38261,36915,1346,3.5
"18177",18,177,2000,35502,34175,1327,3.7
"18177",18,177,2001,34617,32820,1797,5.2
"18177",18,177,2002,34971,32860,2111,6
"18177",18,177,2003,34415,32141,2274,6.6
"18177",18,177,2004,33335,30963,2372,7.1
"18177",18,177,2005,33027,30676,2351,7.1
"18177",18,177,2006,34186,32174,2012,5.9
"18177",18,177,2007,33800,31984,1816,5.4
"18177",18,177,2008,33280,30915,2365,7.1
"18177",18,177,2009,32296,28309,3987,12.3
"18177",18,177,2010,31330,27310,4020,12.8
"18177",18,177,2011,30992,27547,3445,11.1
"18177",18,177,2012,30691,27655,3036,9.9
"18177",18,177,2013,30535,27887,2648,8.7
"18177",18,177,2014,30901,28887,2014,6.5
"18177",18,177,2015,30648,29016,1632,5.3
"18177",18,177,2016,30933,29453,1480,4.8
"18177",18,177,2017,30832,29672,1160,3.8
"18179",18,179,1990,13680,13070,610,4.5
"18179",18,179,1991,13475,12766,709,5.3
"18179",18,179,1992,13684,12937,747,5.5
"18179",18,179,1993,13955,13368,587,4.2
"18179",18,179,1994,14463,13909,554,3.8
"18179",18,179,1995,14864,14359,505,3.4
"18179",18,179,1996,14789,14300,489,3.3
"18179",18,179,1997,14893,14537,356,2.4
"18179",18,179,1998,14933,14564,369,2.5
"18179",18,179,1999,14664,14314,350,2.4
"18179",18,179,2000,14871,14499,372,2.5
"18179",18,179,2001,14769,14189,580,3.9
"18179",18,179,2002,14834,14205,629,4.2
"18179",18,179,2003,14970,14259,711,4.7
"18179",18,179,2004,14794,14054,740,5
"18179",18,179,2005,14861,14146,715,4.8
"18179",18,179,2006,15024,14368,656,4.4
"18179",18,179,2007,14671,14062,609,4.2
"18179",18,179,2008,14738,13907,831,5.6
"18179",18,179,2009,14223,12705,1518,10.7
"18179",18,179,2010,14137,12757,1380,9.8
"18179",18,179,2011,14049,12892,1157,8.2
"18179",18,179,2012,13711,12727,984,7.2
"18179",18,179,2013,13650,12784,866,6.3
"18179",18,179,2014,13749,13090,659,4.8
"18179",18,179,2015,14038,13487,551,3.9
"18179",18,179,2016,14161,13657,504,3.6
"18179",18,179,2017,14158,13741,417,2.9
"18181",18,181,1990,12154,11433,721,5.9
"18181",18,181,1991,11991,11264,727,6.1
"18181",18,181,1992,12829,11972,857,6.7
"18181",18,181,1993,14491,13664,827,5.7
"18181",18,181,1994,16160,15310,850,5.3
"18181",18,181,1995,15651,14951,700,4.5
"18181",18,181,1996,14611,13673,938,6.4
"18181",18,181,1997,13080,12151,929,7.1
"18181",18,181,1998,13707,13188,519,3.8
"18181",18,181,1999,13758,13299,459,3.3
"18181",18,181,2000,13584,13169,415,3.1
"18181",18,181,2001,13352,12708,644,4.8
"18181",18,181,2002,12881,11973,908,7
"18181",18,181,2003,12361,11445,916,7.4
"18181",18,181,2004,12256,11443,813,6.6
"18181",18,181,2005,12261,11551,710,5.8
"18181",18,181,2006,12155,11544,611,5
"18181",18,181,2007,12286,11744,542,4.4
"18181",18,181,2008,12411,11694,717,5.8
"18181",18,181,2009,12426,11052,1374,11.1
"18181",18,181,2010,12975,11613,1362,10.5
"18181",18,181,2011,13108,11974,1134,8.7
"18181",18,181,2012,13028,12013,1015,7.8
"18181",18,181,2013,12931,12043,888,6.9
"18181",18,181,2014,13445,12763,682,5.1
"18181",18,181,2015,13610,13057,553,4.1
"18181",18,181,2016,13636,13094,542,4
"18181",18,181,2017,13164,12728,436,3.3
"18183",18,183,1990,14761,13890,871,5.9
"18183",18,183,1991,14674,13696,978,6.7
"18183",18,183,1992,14936,14030,906,6.1
"18183",18,183,1993,15300,14641,659,4.3
"18183",18,183,1994,15899,15303,596,3.7
"18183",18,183,1995,16452,15879,573,3.5
"18183",18,183,1996,16434,15943,491,3
"18183",18,183,1997,16637,16220,417,2.5
"18183",18,183,1998,16768,16369,399,2.4
"18183",18,183,1999,16780,16352,428,2.6
"18183",18,183,2000,17082,16635,447,2.6
"18183",18,183,2001,17203,16422,781,4.5
"18183",18,183,2002,17367,16495,872,5
"18183",18,183,2003,17679,16687,992,5.6
"18183",18,183,2004,17489,16489,1000,5.7
"18183",18,183,2005,17680,16777,903,5.1
"18183",18,183,2006,17956,17094,862,4.8
"18183",18,183,2007,17736,16943,793,4.5
"18183",18,183,2008,17877,16741,1136,6.4
"18183",18,183,2009,17854,15608,2246,12.6
"18183",18,183,2010,17603,15579,2024,11.5
"18183",18,183,2011,17325,15709,1616,9.3
"18183",18,183,2012,16903,15557,1346,8
"18183",18,183,2013,16760,15590,1170,7
"18183",18,183,2014,16831,15963,868,5.2
"18183",18,183,2015,17019,16319,700,4.1
"18183",18,183,2016,17226,16557,669,3.9
"18183",18,183,2017,17198,16695,503,2.9
"19001",19,1,1990,4022,3920,102,2.5
"19001",19,1,1991,4023,3899,124,3.1
"19001",19,1,1992,4186,4050,136,3.2
"19001",19,1,1993,4144,4007,137,3.3
"19001",19,1,1994,4369,4233,136,3.1
"19001",19,1,1995,4533,4380,153,3.4
"19001",19,1,1996,4452,4309,143,3.2
"19001",19,1,1997,4341,4220,121,2.8
"19001",19,1,1998,4269,4165,104,2.4
"19001",19,1,1999,4472,4364,108,2.4
"19001",19,1,2000,4453,4335,118,2.6
"19001",19,1,2001,4558,4433,125,2.7
"19001",19,1,2002,4451,4288,163,3.7
"19001",19,1,2003,4286,4110,176,4.1
"19001",19,1,2004,4291,4113,178,4.1
"19001",19,1,2005,4400,4224,176,4
"19001",19,1,2006,4431,4289,142,3.2
"19001",19,1,2007,4400,4246,154,3.5
"19001",19,1,2008,4377,4199,178,4.1
"19001",19,1,2009,4239,3994,245,5.8
"19001",19,1,2010,4105,3878,227,5.5
"19001",19,1,2011,4096,3897,199,4.9
"19001",19,1,2012,4048,3871,177,4.4
"19001",19,1,2013,4074,3902,172,4.2
"19001",19,1,2014,4158,3991,167,4
"19001",19,1,2015,4226,4089,137,3.2
"19001",19,1,2016,4238,4113,125,2.9
"19001",19,1,2017,4143,4027,116,2.8
"19003",19,3,1990,2436,2343,93,3.8
"19003",19,3,1991,2421,2308,113,4.7
"19003",19,3,1992,2410,2320,90,3.7
"19003",19,3,1993,2367,2287,80,3.4
"19003",19,3,1994,2482,2404,78,3.1
"19003",19,3,1995,2435,2362,73,3
"19003",19,3,1996,2408,2200,208,8.6
"19003",19,3,1997,2338,2207,131,5.6
"19003",19,3,1998,2183,2110,73,3.3
"19003",19,3,1999,2299,2242,57,2.5
"19003",19,3,2000,2330,2242,88,3.8
"19003",19,3,2001,2292,2195,97,4.2
"19003",19,3,2002,2182,2079,103,4.7
"19003",19,3,2003,2127,2019,108,5.1
"19003",19,3,2004,2086,1982,104,5
"19003",19,3,2005,1996,1892,104,5.2
"19003",19,3,2006,2060,1966,94,4.6
"19003",19,3,2007,2099,2012,87,4.1
"19003",19,3,2008,2112,2022,90,4.3
"19003",19,3,2009,2154,2023,131,6.1
"19003",19,3,2010,2240,2132,108,4.8
"19003",19,3,2011,2209,2111,98,4.4
"19003",19,3,2012,2183,2096,87,4
"19003",19,3,2013,2151,2072,79,3.7
"19003",19,3,2014,2215,2141,74,3.3
"19003",19,3,2015,2292,2227,65,2.8
"19003",19,3,2016,2219,2161,58,2.6
"19003",19,3,2017,2132,2081,51,2.4
"19005",19,5,1990,7175,6767,408,5.7
"19005",19,5,1991,7269,6873,396,5.4
"19005",19,5,1992,7403,6988,415,5.6
"19005",19,5,1993,7481,7128,353,4.7
"19005",19,5,1994,7739,7381,358,4.6
"19005",19,5,1995,7736,7344,392,5.1
"19005",19,5,1996,7809,7442,367,4.7
"19005",19,5,1997,7692,7356,336,4.4
"19005",19,5,1998,7432,7076,356,4.8
"19005",19,5,1999,7548,7256,292,3.9
"19005",19,5,2000,7943,7676,267,3.4
"19005",19,5,2001,8459,8121,338,4
"19005",19,5,2002,8401,8018,383,4.6
"19005",19,5,2003,8065,7615,450,5.6
"19005",19,5,2004,7915,7447,468,5.9
"19005",19,5,2005,7996,7578,418,5.2
"19005",19,5,2006,8182,7806,376,4.6
"19005",19,5,2007,8163,7775,388,4.8
"19005",19,5,2008,7886,7376,510,6.5
"19005",19,5,2009,7558,6786,772,10.2
"19005",19,5,2010,7917,7297,620,7.8
"19005",19,5,2011,7745,7189,556,7.2
"19005",19,5,2012,7595,7106,489,6.4
"19005",19,5,2013,7654,7169,485,6.3
"19005",19,5,2014,7715,7280,435,5.6
"19005",19,5,2015,7703,7325,378,4.9
"19005",19,5,2016,7678,7299,379,4.9
"19005",19,5,2017,7520,7217,303,4
"19007",19,7,1990,6358,5920,438,6.9
"19007",19,7,1991,6624,6193,431,6.5
"19007",19,7,1992,6702,6308,394,5.9
"19007",19,7,1993,6793,6436,357,5.3
"19007",19,7,1994,6866,6505,361,5.3
"19007",19,7,1995,6743,6377,366,5.4
"19007",19,7,1996,6759,6404,355,5.3
"19007",19,7,1997,6872,6567,305,4.4
"19007",19,7,1998,6803,6504,299,4.4
"19007",19,7,1999,6815,6538,277,4.1
"19007",19,7,2000,6330,6056,274,4.3
"19007",19,7,2001,6481,6146,335,5.2
"19007",19,7,2002,6541,6199,342,5.2
"19007",19,7,2003,6496,6143,353,5.4
"19007",19,7,2004,6437,6085,352,5.5
"19007",19,7,2005,6472,6136,336,5.2
"19007",19,7,2006,6351,6008,343,5.4
"19007",19,7,2007,5958,5551,407,6.8
"19007",19,7,2008,6028,5695,333,5.5
"19007",19,7,2009,6244,5703,541,8.7
"19007",19,7,2010,6200,5749,451,7.3
"19007",19,7,2011,6053,5634,419,6.9
"19007",19,7,2012,5988,5598,390,6.5
"19007",19,7,2013,5927,5550,377,6.4
"19007",19,7,2014,6159,5807,352,5.7
"19007",19,7,2015,6228,5920,308,4.9
"19007",19,7,2016,6166,5875,291,4.7
"19007",19,7,2017,6058,5827,231,3.8
"19009",19,9,1990,3605,3484,121,3.4
"19009",19,9,1991,3747,3638,109,2.9
"19009",19,9,1992,3822,3717,105,2.7
"19009",19,9,1993,3651,3565,86,2.4
"19009",19,9,1994,3740,3642,98,2.6
"19009",19,9,1995,3735,3615,120,3.2
"19009",19,9,1996,3775,3649,126,3.3
"19009",19,9,1997,3627,3507,120,3.3
"19009",19,9,1998,3459,3357,102,2.9
"19009",19,9,1999,3508,3422,86,2.5
"19009",19,9,2000,3410,3311,99,2.9
"19009",19,9,2001,3539,3425,114,3.2
"19009",19,9,2002,3393,3262,131,3.9
"19009",19,9,2003,3278,3146,132,4
"19009",19,9,2004,3336,3198,138,4.1
"19009",19,9,2005,3354,3201,153,4.6
"19009",19,9,2006,3282,3151,131,4
"19009",19,9,2007,3276,3148,128,3.9
"19009",19,9,2008,3229,3083,146,4.5
"19009",19,9,2009,3291,3099,192,5.8
"19009",19,9,2010,3478,3284,194,5.6
"19009",19,9,2011,3363,3170,193,5.7
"19009",19,9,2012,3216,3062,154,4.8
"19009",19,9,2013,3238,3080,158,4.9
"19009",19,9,2014,3263,3123,140,4.3
"19009",19,9,2015,3239,3110,129,4
"19009",19,9,2016,3280,3172,108,3.3
"19009",19,9,2017,3176,3077,99,3.1
"19011",19,11,1990,11433,10830,603,5.3
"19011",19,11,1991,11109,10533,576,5.2
"19011",19,11,1992,11331,10809,522,4.6
"19011",19,11,1993,11668,11206,462,4
"19011",19,11,1994,11847,11380,467,3.9
"19011",19,11,1995,11983,11482,501,4.2
"19011",19,11,1996,12233,11764,469,3.8
"19011",19,11,1997,12114,11713,401,3.3
"19011",19,11,1998,11827,11479,348,2.9
"19011",19,11,1999,11712,11392,320,2.7
"19011",19,11,2000,13663,13352,311,2.3
"19011",19,11,2001,13954,13522,432,3.1
"19011",19,11,2002,14416,13800,616,4.3
"19011",19,11,2003,14079,13406,673,4.8
"19011",19,11,2004,14085,13443,642,4.6
"19011",19,11,2005,14432,13749,683,4.7
"19011",19,11,2006,14556,13978,578,4
"19011",19,11,2007,14271,13716,555,3.9
"19011",19,11,2008,14425,13818,607,4.2
"19011",19,11,2009,14745,13815,930,6.3
"19011",19,11,2010,14331,13444,887,6.2
"19011",19,11,2011,14118,13299,819,5.8
"19011",19,11,2012,13774,13043,731,5.3
"19011",19,11,2013,13725,13027,698,5.1
"19011",19,11,2014,13882,13242,640,4.6
"19011",19,11,2015,13780,13240,540,3.9
"19011",19,11,2016,13615,13125,490,3.6
"19011",19,11,2017,13463,13023,440,3.3
"19013",19,13,1990,62270,58623,3647,5.9
"19013",19,13,1991,64163,60184,3979,6.2
"19013",19,13,1992,66131,62132,3999,6
"19013",19,13,1993,69190,65398,3792,5.5
"19013",19,13,1994,68613,65373,3240,4.7
"19013",19,13,1995,68972,65927,3045,4.4
"19013",19,13,1996,69335,66384,2951,4.3
"19013",19,13,1997,69839,67266,2573,3.7
"19013",19,13,1998,70453,67963,2490,3.5
"19013",19,13,1999,68466,65759,2707,4
"19013",19,13,2000,68420,66536,1884,2.8
"19013",19,13,2001,69260,66885,2375,3.4
"19013",19,13,2002,71734,68864,2870,4
"19013",19,13,2003,70964,67697,3267,4.6
"19013",19,13,2004,70497,67297,3200,4.5
"19013",19,13,2005,71506,68402,3104,4.3
"19013",19,13,2006,72210,69434,2776,3.8
"19013",19,13,2007,72687,69979,2708,3.7
"19013",19,13,2008,73726,70684,3042,4.1
"19013",19,13,2009,74993,70415,4578,6.1
"19013",19,13,2010,70989,66601,4388,6.2
"19013",19,13,2011,70918,66783,4135,5.8
"19013",19,13,2012,71226,67357,3869,5.4
"19013",19,13,2013,71758,68095,3663,5.1
"19013",19,13,2014,72258,68715,3543,4.9
"19013",19,13,2015,70545,67294,3251,4.6
"19013",19,13,2016,69355,66150,3205,4.6
"19013",19,13,2017,68275,65683,2592,3.8
"19015",19,15,1990,12631,12083,548,4.3
"19015",19,15,1991,12866,12235,631,4.9
"19015",19,15,1992,13032,12498,534,4.1
"19015",19,15,1993,13453,12968,485,3.6
"19015",19,15,1994,13828,13373,455,3.3
"19015",19,15,1995,13874,13463,411,3
"19015",19,15,1996,14170,13810,360,2.5
"19015",19,15,1997,14265,13891,374,2.6
"19015",19,15,1998,14235,13910,325,2.3
"19015",19,15,1999,14320,14026,294,2.1
"19015",19,15,2000,14581,14270,311,2.1
"19015",19,15,2001,14929,14516,413,2.8
"19015",19,15,2002,15173,14687,486,3.2
"19015",19,15,2003,15028,14498,530,3.5
"19015",19,15,2004,14966,14443,523,3.5
"19015",19,15,2005,15374,14843,531,3.5
"19015",19,15,2006,15528,15073,455,2.9
"19015",19,15,2007,15484,14979,505,3.3
"19015",19,15,2008,15658,15092,566,3.6
"19015",19,15,2009,15821,14882,939,5.9
"19015",19,15,2010,14846,13998,848,5.7
"19015",19,15,2011,14658,13931,727,5
"19015",19,15,2012,14571,13940,631,4.3
"19015",19,15,2013,14884,14281,603,4.1
"19015",19,15,2014,15214,14697,517,3.4
"19015",19,15,2015,15322,14856,466,3
"19015",19,15,2016,15132,14711,421,2.8
"19015",19,15,2017,14828,14462,366,2.5
"19017",19,17,1990,11426,10987,439,3.8
"19017",19,17,1991,11901,11337,564,4.7
"19017",19,17,1992,12285,11748,537,4.4
"19017",19,17,1993,12662,12160,502,4
"19017",19,17,1994,12553,12174,379,3
"19017",19,17,1995,12543,12172,371,3
"19017",19,17,1996,12862,12513,349,2.7
"19017",19,17,1997,13028,12722,306,2.3
"19017",19,17,1998,12799,12477,322,2.5
"19017",19,17,1999,12619,12258,361,2.9
"19017",19,17,2000,12772,12460,312,2.4
"19017",19,17,2001,13047,12643,404,3.1
"19017",19,17,2002,13487,13035,452,3.4
"19017",19,17,2003,13468,12942,526,3.9
"19017",19,17,2004,13460,12950,510,3.8
"19017",19,17,2005,13732,13228,504,3.7
"19017",19,17,2006,13942,13496,446,3.2
"19017",19,17,2007,13831,13401,430,3.1
"19017",19,17,2008,13913,13416,497,3.6
"19017",19,17,2009,13892,13140,752,5.4
"19017",19,17,2010,13864,13185,679,4.9
"19017",19,17,2011,13842,13238,604,4.4
"19017",19,17,2012,13867,13335,532,3.8
"19017",19,17,2013,14001,13471,530,3.8
"19017",19,17,2014,14197,13676,521,3.7
"19017",19,17,2015,13978,13483,495,3.5
"19017",19,17,2016,13923,13427,496,3.6
"19017",19,17,2017,13664,13277,387,2.8
"19019",19,19,1990,9582,9044,538,5.6
"19019",19,19,1991,9869,9285,584,5.9
"19019",19,19,1992,10016,9407,609,6.1
"19019",19,19,1993,10380,9801,579,5.6
"19019",19,19,1994,10735,10238,497,4.6
"19019",19,19,1995,10880,10399,481,4.4
"19019",19,19,1996,11016,10516,500,4.5
"19019",19,19,1997,11106,10677,429,3.9
"19019",19,19,1998,11241,10800,441,3.9
"19019",19,19,1999,11093,10676,417,3.8
"19019",19,19,2000,10652,10355,297,2.8
"19019",19,19,2001,10826,10404,422,3.9
"19019",19,19,2002,10888,10397,491,4.5
"19019",19,19,2003,10867,10372,495,4.6
"19019",19,19,2004,10844,10352,492,4.5
"19019",19,19,2005,11166,10656,510,4.6
"19019",19,19,2006,11264,10784,480,4.3
"19019",19,19,2007,11031,10571,460,4.2
"19019",19,19,2008,11177,10718,459,4.1
"19019",19,19,2009,11232,10490,742,6.6
"19019",19,19,2010,11351,10672,679,6
"19019",19,19,2011,11167,10535,632,5.7
"19019",19,19,2012,11025,10495,530,4.8
"19019",19,19,2013,11168,10639,529,4.7
"19019",19,19,2014,11482,10948,534,4.7
"19019",19,19,2015,11322,10837,485,4.3
"19019",19,19,2016,11215,10755,460,4.1
"19019",19,19,2017,11031,10674,357,3.2
"19021",19,21,1990,10016,9749,267,2.7
"19021",19,21,1991,10529,10272,257,2.4
"19021",19,21,1992,10803,10532,271,2.5
"19021",19,21,1993,11087,10788,299,2.7
"19021",19,21,1994,11259,10964,295,2.6
"19021",19,21,1995,11221,10955,266,2.4
"19021",19,21,1996,11221,10955,266,2.4
"19021",19,21,1997,11008,10780,228,2.1
"19021",19,21,1998,10983,10764,219,2
"19021",19,21,1999,11101,10866,235,2.1
"19021",19,21,2000,10249,10010,239,2.3
"19021",19,21,2001,10622,10339,283,2.7
"19021",19,21,2002,10650,10309,341,3.2
"19021",19,21,2003,10382,10005,377,3.6
"19021",19,21,2004,10301,9896,405,3.9
"19021",19,21,2005,10283,9891,392,3.8
"19021",19,21,2006,10509,10165,344,3.3
"19021",19,21,2007,10388,10060,328,3.2
"19021",19,21,2008,10629,10245,384,3.6
"19021",19,21,2009,10777,10212,565,5.2
"19021",19,21,2010,11422,10882,540,4.7
"19021",19,21,2011,11338,10827,511,4.5
"19021",19,21,2012,11227,10760,467,4.2
"19021",19,21,2013,11310,10863,447,4
"19021",19,21,2014,11497,11042,455,4
"19021",19,21,2015,11590,11163,427,3.7
"19021",19,21,2016,11526,11121,405,3.5
"19021",19,21,2017,11432,11126,306,2.7
"19023",19,23,1990,7340,6995,345,4.7
"19023",19,23,1991,7584,7107,477,6.3
"19023",19,23,1992,7879,7378,501,6.4
"19023",19,23,1993,7929,7494,435,5.5
"19023",19,23,1994,8319,7881,438,5.3
"19023",19,23,1995,8205,7794,411,5
"19023",19,23,1996,8199,7793,406,5
"19023",19,23,1997,7964,7645,319,4
"19023",19,23,1998,7826,7507,319,4.1
"19023",19,23,1999,7758,7406,352,4.5
"19023",19,23,2000,7978,7724,254,3.2
"19023",19,23,2001,8255,7895,360,4.4
"19023",19,23,2002,8266,7890,376,4.5
"19023",19,23,2003,8095,7686,409,5.1
"19023",19,23,2004,8060,7689,371,4.6
"19023",19,23,2005,8106,7718,388,4.8
"19023",19,23,2006,8258,7920,338,4.1
"19023",19,23,2007,8260,7929,331,4
"19023",19,23,2008,8502,8104,398,4.7
"19023",19,23,2009,8502,7944,558,6.6
"19023",19,23,2010,8200,7704,496,6
"19023",19,23,2011,8172,7761,411,5
"19023",19,23,2012,8212,7841,371,4.5
"19023",19,23,2013,8263,7889,374,4.5
"19023",19,23,2014,8391,8037,354,4.2
"19023",19,23,2015,8285,7920,365,4.4
"19023",19,23,2016,8039,7690,349,4.3
"19023",19,23,2017,7860,7575,285,3.6
"19025",19,25,1990,4968,4847,121,2.4
"19025",19,25,1991,5056,4897,159,3.1
"19025",19,25,1992,5190,5017,173,3.3
"19025",19,25,1993,5265,5079,186,3.5
"19025",19,25,1994,5226,5049,177,3.4
"19025",19,25,1995,5262,5083,179,3.4
"19025",19,25,1996,5243,5058,185,3.5
"19025",19,25,1997,5067,4914,153,3
"19025",19,25,1998,4877,4743,134,2.7
"19025",19,25,1999,4909,4769,140,2.9
"19025",19,25,2000,5335,5188,147,2.8
"19025",19,25,2001,5328,5153,175,3.3
"19025",19,25,2002,5268,5079,189,3.6
"19025",19,25,2003,5116,4899,217,4.2
"19025",19,25,2004,5103,4888,215,4.2
"19025",19,25,2005,5152,4947,205,4
"19025",19,25,2006,5267,5089,178,3.4
"19025",19,25,2007,5215,5045,170,3.3
"19025",19,25,2008,5284,5098,186,3.5
"19025",19,25,2009,5272,5000,272,5.2
"19025",19,25,2010,4656,4376,280,6
"19025",19,25,2011,4509,4252,257,5.7
"19025",19,25,2012,4428,4184,244,5.5
"19025",19,25,2013,4361,4135,226,5.2
"19025",19,25,2014,4427,4213,214,4.8
"19025",19,25,2015,4459,4265,194,4.4
"19025",19,25,2016,4527,4357,170,3.8
"19025",19,25,2017,4301,4169,132,3.1
"19027",19,27,1990,10715,10261,454,4.2
"19027",19,27,1991,11015,10602,413,3.7
"19027",19,27,1992,11573,11232,341,2.9
"19027",19,27,1993,12122,11746,376,3.1
"19027",19,27,1994,12108,11733,375,3.1
"19027",19,27,1995,12115,11669,446,3.7
"19027",19,27,1996,12261,11872,389,3.2
"19027",19,27,1997,12605,12220,385,3.1
"19027",19,27,1998,12807,12499,308,2.4
"19027",19,27,1999,12698,12414,284,2.2
"19027",19,27,2000,11933,11667,266,2.2
"19027",19,27,2001,12307,11994,313,2.5
"19027",19,27,2002,12287,11930,357,2.9
"19027",19,27,2003,12231,11882,349,2.9
"19027",19,27,2004,12252,11894,358,2.9
"19027",19,27,2005,12269,11902,367,3
"19027",19,27,2006,12422,12098,324,2.6
"19027",19,27,2007,12239,11918,321,2.6
"19027",19,27,2008,12348,11993,355,2.9
"19027",19,27,2009,12386,11864,522,4.2
"19027",19,27,2010,11714,11209,505,4.3
"19027",19,27,2011,11611,11143,468,4
"19027",19,27,2012,11337,10912,425,3.7
"19027",19,27,2013,11272,10893,379,3.4
"19027",19,27,2014,11241,10886,355,3.2
"19027",19,27,2015,11310,11012,298,2.6
"19027",19,27,2016,11291,11003,288,2.6
"19027",19,27,2017,11049,10794,255,2.3
"19029",19,29,1990,7545,7126,419,5.6
"19029",19,29,1991,7532,7123,409,5.4
"19029",19,29,1992,7717,7337,380,4.9
"19029",19,29,1993,7788,7399,389,5
"19029",19,29,1994,7831,7478,353,4.5
"19029",19,29,1995,7810,7458,352,4.5
"19029",19,29,1996,7795,7401,394,5.1
"19029",19,29,1997,7844,7476,368,4.7
"19029",19,29,1998,7611,7320,291,3.8
"19029",19,29,1999,7644,7397,247,3.2
"19029",19,29,2000,7870,7589,281,3.6
"19029",19,29,2001,7896,7584,312,4
"19029",19,29,2002,7731,7381,350,4.5
"19029",19,29,2003,7522,7139,383,5.1
"19029",19,29,2004,7416,7057,359,4.8
"19029",19,29,2005,7628,7277,351,4.6
"19029",19,29,2006,7650,7325,325,4.2
"19029",19,29,2007,7605,7291,314,4.1
"19029",19,29,2008,7607,7255,352,4.6
"19029",19,29,2009,7671,7153,518,6.8
"19029",19,29,2010,7410,6946,464,6.3
"19029",19,29,2011,7288,6854,434,6
"19029",19,29,2012,7194,6820,374,5.2
"19029",19,29,2013,7291,6923,368,5
"19029",19,29,2014,7394,7074,320,4.3
"19029",19,29,2015,7461,7189,272,3.6
"19029",19,29,2016,7273,7036,237,3.3
"19029",19,29,2017,7135,6878,257,3.6
"19031",19,31,1990,9084,8827,257,2.8
"19031",19,31,1991,9242,8965,277,3
"19031",19,31,1992,9304,8973,331,3.6
"19031",19,31,1993,9666,9355,311,3.2
"19031",19,31,1994,9749,9471,278,2.9
"19031",19,31,1995,9632,9362,270,2.8
"19031",19,31,1996,9769,9421,348,3.6
"19031",19,31,1997,9776,9494,282,2.9
"19031",19,31,1998,9434,9188,246,2.6
"19031",19,31,1999,9550,9316,234,2.5
"19031",19,31,2000,10354,10122,232,2.2
"19031",19,31,2001,10676,10374,302,2.8
"19031",19,31,2002,10618,10241,377,3.6
"19031",19,31,2003,10402,10007,395,3.8
"19031",19,31,2004,10340,9926,414,4
"19031",19,31,2005,10582,10185,397,3.8
"19031",19,31,2006,10788,10439,349,3.2
"19031",19,31,2007,10899,10547,352,3.2
"19031",19,31,2008,11324,10908,416,3.7
"19031",19,31,2009,11457,10817,640,5.6
"19031",19,31,2010,10989,10397,592,5.4
"19031",19,31,2011,10873,10312,561,5.2
"19031",19,31,2012,10664,10179,485,4.5
"19031",19,31,2013,10814,10348,466,4.3
"19031",19,31,2014,10940,10518,422,3.9
"19031",19,31,2015,10992,10612,380,3.5
"19031",19,31,2016,10871,10511,360,3.3
"19031",19,31,2017,10797,10483,314,2.9
"19033",19,33,1990,25248,23885,1363,5.4
"19033",19,33,1991,25889,24452,1437,5.6
"19033",19,33,1992,25493,24024,1469,5.8
"19033",19,33,1993,25975,24632,1343,5.2
"19033",19,33,1994,26186,25036,1150,4.4
"19033",19,33,1995,26555,25637,918,3.5
"19033",19,33,1996,27229,26196,1033,3.8
"19033",19,33,1997,27089,26251,838,3.1
"19033",19,33,1998,26740,25958,782,2.9
"19033",19,33,1999,26203,25514,689,2.6
"19033",19,33,2000,25172,24446,726,2.9
"19033",19,33,2001,25034,24174,860,3.4
"19033",19,33,2002,25646,24589,1057,4.1
"19033",19,33,2003,25493,24400,1093,4.3
"19033",19,33,2004,25596,24475,1121,4.4
"19033",19,33,2005,26111,24973,1138,4.4
"19033",19,33,2006,26133,25111,1022,3.9
"19033",19,33,2007,25646,24645,1001,3.9
"19033",19,33,2008,25711,24476,1235,4.8
"19033",19,33,2009,25563,23792,1771,6.9
"19033",19,33,2010,24565,22884,1681,6.8
"19033",19,33,2011,24160,22679,1481,6.1
"19033",19,33,2012,23723,22398,1325,5.6
"19033",19,33,2013,23338,22077,1261,5.4
"19033",19,33,2014,23266,22186,1080,4.6
"19033",19,33,2015,23023,22108,915,4
"19033",19,33,2016,23145,22316,829,3.6
"19033",19,33,2017,23237,22521,716,3.1
"19035",19,35,1990,6721,6534,187,2.8
"19035",19,35,1991,6898,6698,200,2.9
"19035",19,35,1992,6960,6750,210,3
"19035",19,35,1993,7046,6848,198,2.8
"19035",19,35,1994,7139,6919,220,3.1
"19035",19,35,1995,7032,6809,223,3.2
"19035",19,35,1996,7139,6912,227,3.2
"19035",19,35,1997,7099,6894,205,2.9
"19035",19,35,1998,6839,6656,183,2.7
"19035",19,35,1999,6960,6805,155,2.2
"19035",19,35,2000,6948,6787,161,2.3
"19035",19,35,2001,7222,7009,213,2.9
"19035",19,35,2002,6968,6683,285,4.1
"19035",19,35,2003,6712,6429,283,4.2
"19035",19,35,2004,6536,6251,285,4.4
"19035",19,35,2005,6572,6266,306,4.7
"19035",19,35,2006,6561,6288,273,4.2
"19035",19,35,2007,6624,6385,239,3.6
"19035",19,35,2008,6493,6263,230,3.5
"19035",19,35,2009,6614,6312,302,4.6
"19035",19,35,2010,7089,6770,319,4.5
"19035",19,35,2011,6936,6607,329,4.7
"19035",19,35,2012,6857,6560,297,4.3
"19035",19,35,2013,6841,6547,294,4.3
"19035",19,35,2014,6640,6302,338,5.1
"19035",19,35,2015,6346,6015,331,5.2
"19035",19,35,2016,6328,6099,229,3.6
"19035",19,35,2017,6082,5927,155,2.5
"19037",19,37,1990,7083,6645,438,6.2
"19037",19,37,1991,7125,6641,484,6.8
"19037",19,37,1992,7259,6791,468,6.4
"19037",19,37,1993,7475,7027,448,6
"19037",19,37,1994,7657,7237,420,5.5
"19037",19,37,1995,7824,7431,393,5
"19037",19,37,1996,7831,7414,417,5.3
"19037",19,37,1997,7671,7321,350,4.6
"19037",19,37,1998,7618,7329,289,3.8
"19037",19,37,1999,7738,7478,260,3.4
"19037",19,37,2000,6863,6430,433,6.3
"19037",19,37,2001,6715,6297,418,6.2
"19037",19,37,2002,6500,6150,350,5.4
"19037",19,37,2003,6276,5891,385,6.1
"19037",19,37,2004,6093,5731,362,5.9
"19037",19,37,2005,6235,5907,328,5.3
"19037",19,37,2006,6461,6170,291,4.5
"19037",19,37,2007,6535,6263,272,4.2
"19037",19,37,2008,6891,6550,341,4.9
"19037",19,37,2009,6962,6344,618,8.9
"19037",19,37,2010,6555,6070,485,7.4
"19037",19,37,2011,6490,6084,406,6.3
"19037",19,37,2012,6295,5968,327,5.2
"19037",19,37,2013,6367,6050,317,5
"19037",19,37,2014,6488,6181,307,4.7
"19037",19,37,2015,6460,6167,293,4.5
"19037",19,37,2016,6433,6149,284,4.4
"19037",19,37,2017,6399,6195,204,3.2
"19039",19,39,1990,4227,4011,216,5.1
"19039",19,39,1991,4369,4076,293,6.7
"19039",19,39,1992,4213,3933,280,6.6
"19039",19,39,1993,4088,3747,341,8.3
"19039",19,39,1994,4022,3758,264,6.6
"19039",19,39,1995,3937,3701,236,6
"19039",19,39,1996,4059,3852,207,5.1
"19039",19,39,1997,4261,4094,167,3.9
"19039",19,39,1998,4400,4238,162,3.7
"19039",19,39,1999,4589,4429,160,3.5
"19039",19,39,2000,4867,4715,152,3.1
"19039",19,39,2001,4987,4785,202,4.1
"19039",19,39,2002,5020,4755,265,5.3
"19039",19,39,2003,4861,4467,394,8.1
"19039",19,39,2004,4665,4368,297,6.4
"19039",19,39,2005,4643,4403,240,5.2
"19039",19,39,2006,4746,4552,194,4.1
"19039",19,39,2007,4826,4626,200,4.1
"19039",19,39,2008,4908,4679,229,4.7
"19039",19,39,2009,4937,4561,376,7.6
"19039",19,39,2010,4785,4418,367,7.7
"19039",19,39,2011,4686,4357,329,7
"19039",19,39,2012,4610,4333,277,6
"19039",19,39,2013,4586,4333,253,5.5
"19039",19,39,2014,4684,4475,209,4.5
"19039",19,39,2015,4772,4575,197,4.1
"19039",19,39,2016,4837,4674,163,3.4
"19039",19,39,2017,4763,4614,149,3.1
"19041",19,41,1990,8977,8766,211,2.4
"19041",19,41,1991,8876,8576,300,3.4
"19041",19,41,1992,9073,8799,274,3
"19041",19,41,1993,9406,9138,268,2.8
"19041",19,41,1994,9735,9454,281,2.9
"19041",19,41,1995,9835,9555,280,2.8
"19041",19,41,1996,10253,10000,253,2.5
"19041",19,41,1997,10307,10030,277,2.7
"19041",19,41,1998,10100,9814,286,2.8
"19041",19,41,1999,10103,9872,231,2.3
"19041",19,41,2000,9936,9694,242,2.4
"19041",19,41,2001,9777,9471,306,3.1
"19041",19,41,2002,9792,9418,374,3.8
"19041",19,41,2003,9746,9337,409,4.2
"19041",19,41,2004,9516,9139,377,4
"19041",19,41,2005,9490,9115,375,4
"19041",19,41,2006,9760,9436,324,3.3
"19041",19,41,2007,9756,9453,303,3.1
"19041",19,41,2008,9728,9392,336,3.5
"19041",19,41,2009,9584,8931,653,6.8
"19041",19,41,2010,9348,8800,548,5.9
"19041",19,41,2011,9252,8749,503,5.4
"19041",19,41,2012,8884,8436,448,5
"19041",19,41,2013,8815,8418,397,4.5
"19041",19,41,2014,8955,8581,374,4.2
"19041",19,41,2015,8856,8533,323,3.6
"19041",19,41,2016,8730,8394,336,3.8
"19041",19,41,2017,8606,8283,323,3.8
"19043",19,43,1990,9212,8697,515,5.6
"19043",19,43,1991,9222,8673,549,6
"19043",19,43,1992,9614,9055,559,5.8
"19043",19,43,1993,9671,9131,540,5.6
"19043",19,43,1994,9695,9144,551,5.7
"19043",19,43,1995,10626,10068,558,5.3
"19043",19,43,1996,10916,10293,623,5.7
"19043",19,43,1997,10890,10397,493,4.5
"19043",19,43,1998,10397,9893,504,4.8
"19043",19,43,1999,10483,10027,456,4.3
"19043",19,43,2000,10207,9862,345,3.4
"19043",19,43,2001,10407,9926,481,4.6
"19043",19,43,2002,9943,9379,564,5.7
"19043",19,43,2003,9564,8975,589,6.2
"19043",19,43,2004,9472,8825,647,6.8
"19043",19,43,2005,9496,8879,617,6.5
"19043",19,43,2006,9689,9200,489,5
"19043",19,43,2007,9742,9273,469,4.8
"19043",19,43,2008,9972,9423,549,5.5
"19043",19,43,2009,9996,9139,857,8.6
"19043",19,43,2010,10483,9738,745,7.1
"19043",19,43,2011,10341,9702,639,6.2
"19043",19,43,2012,10166,9588,578,5.7
"19043",19,43,2013,10076,9508,568,5.6
"19043",19,43,2014,10204,9695,509,5
"19043",19,43,2015,10299,9869,430,4.2
"19043",19,43,2016,10314,9877,437,4.2
"19043",19,43,2017,10169,9765,404,4
"19045",19,45,1990,25612,24088,1524,6
"19045",19,45,1991,26229,24632,1597,6.1
"19045",19,45,1992,27001,25479,1522,5.6
"19045",19,45,1993,27388,26039,1349,4.9
"19045",19,45,1994,27336,26134,1202,4.4
"19045",19,45,1995,27394,26068,1326,4.8
"19045",19,45,1996,27969,26706,1263,4.5
"19045",19,45,1997,27691,26703,988,3.6
"19045",19,45,1998,27183,26331,852,3.1
"19045",19,45,1999,26770,25809,961,3.6
"19045",19,45,2000,26060,25176,884,3.4
"19045",19,45,2001,26415,25241,1174,4.4
"19045",19,45,2002,26893,25464,1429,5.3
"19045",19,45,2003,26173,24743,1430,5.5
"19045",19,45,2004,26157,24793,1364,5.2
"19045",19,45,2005,26826,25554,1272,4.7
"19045",19,45,2006,27173,26108,1065,3.9
"19045",19,45,2007,27443,26422,1021,3.7
"19045",19,45,2008,28110,26915,1195,4.3
"19045",19,45,2009,28228,26181,2047,7.3
"19045",19,45,2010,26439,24581,1858,7
"19045",19,45,2011,25839,24129,1710,6.6
"19045",19,45,2012,25080,23538,1542,6.1
"19045",19,45,2013,24911,23477,1434,5.8
"19045",19,45,2014,24802,23500,1302,5.2
"19045",19,45,2015,24432,23202,1230,5
"19045",19,45,2016,23827,22654,1173,4.9
"19045",19,45,2017,23167,22218,949,4.1
"19047",19,47,1990,8529,8032,497,5.8
"19047",19,47,1991,8454,8075,379,4.5
"19047",19,47,1992,8664,8317,347,4
"19047",19,47,1993,8879,8491,388,4.4
"19047",19,47,1994,8922,8616,306,3.4
"19047",19,47,1995,8942,8639,303,3.4
"19047",19,47,1996,9058,8768,290,3.2
"19047",19,47,1997,9078,8791,287,3.2
"19047",19,47,1998,8948,8702,246,2.7
"19047",19,47,1999,8929,8724,205,2.3
"19047",19,47,2000,8894,8675,219,2.5
"19047",19,47,2001,8993,8715,278,3.1
"19047",19,47,2002,8944,8602,342,3.8
"19047",19,47,2003,8755,8416,339,3.9
"19047",19,47,2004,8946,8618,328,3.7
"19047",19,47,2005,9173,8822,351,3.8
"19047",19,47,2006,9364,9077,287,3.1
"19047",19,47,2007,9302,8996,306,3.3
"19047",19,47,2008,9391,9078,313,3.3
"19047",19,47,2009,9558,9116,442,4.6
"19047",19,47,2010,8983,8562,421,4.7
"19047",19,47,2011,8818,8401,417,4.7
"19047",19,47,2012,8757,8366,391,4.5
"19047",19,47,2013,8770,8388,382,4.4
"19047",19,47,2014,8745,8389,356,4.1
"19047",19,47,2015,8754,8386,368,4.2
"19047",19,47,2016,8447,7987,460,5.4
"19047",19,47,2017,8220,7880,340,4.1
"19049",19,49,1990,16149,15568,581,3.6
"19049",19,49,1991,16456,15898,558,3.4
"19049",19,49,1992,17075,16484,591,3.5
"19049",19,49,1993,17827,17299,528,3
"19049",19,49,1994,18248,17754,494,2.7
"19049",19,49,1995,18633,18185,448,2.4
"19049",19,49,1996,19559,19129,430,2.2
"19049",19,49,1997,19979,19564,415,2.1
"19049",19,49,1998,20543,20173,370,1.8
"19049",19,49,1999,20943,20601,342,1.6
"19049",19,49,2000,23495,23049,446,1.9
"19049",19,49,2001,24572,23995,577,2.3
"19049",19,49,2002,26053,25293,760,2.9
"19049",19,49,2003,26484,25602,882,3.3
"19049",19,49,2004,27916,26962,954,3.4
"19049",19,49,2005,29439,28444,995,3.4
"19049",19,49,2006,31214,30328,886,2.8
"19049",19,49,2007,32546,31617,929,2.9
"19049",19,49,2008,33950,32834,1116,3.3
"19049",19,49,2009,34990,33263,1727,4.9
"19049",19,49,2010,37296,35596,1700,4.6
"19049",19,49,2011,38216,36585,1631,4.3
"19049",19,49,2012,39165,37635,1530,3.9
"19049",19,49,2013,40906,39431,1475,3.6
"19049",19,49,2014,42774,41369,1405,3.3
"19049",19,49,2015,43706,42445,1261,2.9
"19049",19,49,2016,45876,44671,1205,2.6
"19049",19,49,2017,46065,45077,988,2.1
"19051",19,51,1990,3871,3726,145,3.7
"19051",19,51,1991,4022,3777,245,6.1
"19051",19,51,1992,4099,3889,210,5.1
"19051",19,51,1993,4282,4094,188,4.4
"19051",19,51,1994,4372,4192,180,4.1
"19051",19,51,1995,4407,4228,179,4.1
"19051",19,51,1996,4386,4222,164,3.7
"19051",19,51,1997,4223,4068,155,3.7
"19051",19,51,1998,4235,4093,142,3.4
"19051",19,51,1999,4223,4067,156,3.7
"19051",19,51,2000,4154,4019,135,3.2
"19051",19,51,2001,4333,4157,176,4.1
"19051",19,51,2002,4302,4094,208,4.8
"19051",19,51,2003,4231,4023,208,4.9
"19051",19,51,2004,4164,3960,204,4.9
"19051",19,51,2005,4124,3904,220,5.3
"19051",19,51,2006,4141,3947,194,4.7
"19051",19,51,2007,4080,3896,184,4.5
"19051",19,51,2008,4069,3864,205,5
"19051",19,51,2009,4054,3684,370,9.1
"19051",19,51,2010,4253,3950,303,7.1
"19051",19,51,2011,4187,3932,255,6.1
"19051",19,51,2012,4091,3855,236,5.8
"19051",19,51,2013,4121,3894,227,5.5
"19051",19,51,2014,4116,3905,211,5.1
"19051",19,51,2015,4179,3992,187,4.5
"19051",19,51,2016,4295,4113,182,4.2
"19051",19,51,2017,4254,4112,142,3.3
"19053",19,53,1990,3800,3555,245,6.4
"19053",19,53,1991,3860,3609,251,6.5
"19053",19,53,1992,3886,3611,275,7.1
"19053",19,53,1993,3950,3654,296,7.5
"19053",19,53,1994,4063,3839,224,5.5
"19053",19,53,1995,3993,3727,266,6.7
"19053",19,53,1996,3851,3641,210,5.5
"19053",19,53,1997,3860,3693,167,4.3
"19053",19,53,1998,3796,3604,192,5.1
"19053",19,53,1999,3683,3522,161,4.4
"19053",19,53,2000,4261,4120,141,3.3
"19053",19,53,2001,4454,4303,151,3.4
"19053",19,53,2002,4379,4189,190,4.3
"19053",19,53,2003,4278,4029,249,5.8
"19053",19,53,2004,4152,3936,216,5.2
"19053",19,53,2005,4192,3988,204,4.9
"19053",19,53,2006,4233,4062,171,4
"19053",19,53,2007,4196,4026,170,4.1
"19053",19,53,2008,4273,4109,164,3.8
"19053",19,53,2009,4205,3922,283,6.7
"19053",19,53,2010,4466,4195,271,6.1
"19053",19,53,2011,4343,4126,217,5
"19053",19,53,2012,4243,4055,188,4.4
"19053",19,53,2013,4302,4108,194,4.5
"19053",19,53,2014,4446,4278,168,3.8
"19053",19,53,2015,4431,4285,146,3.3
"19053",19,53,2016,4411,4270,141,3.2
"19053",19,53,2017,4351,4236,115,2.6
"19055",19,55,1990,8817,8405,412,4.7
"19055",19,55,1991,8994,8512,482,5.4
"19055",19,55,1992,9063,8580,483,5.3
"19055",19,55,1993,9081,8575,506,5.6
"19055",19,55,1994,9408,8915,493,5.2
"19055",19,55,1995,9340,8871,469,5
"19055",19,55,1996,9624,9038,586,6.1
"19055",19,55,1997,9701,9239,462,4.8
"19055",19,55,1998,9515,9093,422,4.4
"19055",19,55,1999,9588,9210,378,3.9
"19055",19,55,2000,10148,9864,284,2.8
"19055",19,55,2001,10637,10254,383,3.6
"19055",19,55,2002,10368,9851,517,5
"19055",19,55,2003,9913,9415,498,5
"19055",19,55,2004,9953,9484,469,4.7
"19055",19,55,2005,10443,9984,459,4.4
"19055",19,55,2006,10732,10337,395,3.7
"19055",19,55,2007,10770,10388,382,3.5
"19055",19,55,2008,10841,10410,431,4
"19055",19,55,2009,10883,10152,731,6.7
"19055",19,55,2010,10362,9735,627,6.1
"19055",19,55,2011,10251,9692,559,5.5
"19055",19,55,2012,10256,9797,459,4.5
"19055",19,55,2013,10390,9943,447,4.3
"19055",19,55,2014,10541,10143,398,3.8
"19055",19,55,2015,10692,10328,364,3.4
"19055",19,55,2016,10741,10370,371,3.5
"19055",19,55,2017,10512,10229,283,2.7
"19057",19,57,1990,22095,20907,1188,5.4
"19057",19,57,1991,22512,21179,1333,5.9
"19057",19,57,1992,23040,21674,1366,5.9
"19057",19,57,1993,23711,22427,1284,5.4
"19057",19,57,1994,23781,22708,1073,4.5
"19057",19,57,1995,23819,22770,1049,4.4
"19057",19,57,1996,24114,23007,1107,4.6
"19057",19,57,1997,23787,22882,905,3.8
"19057",19,57,1998,23742,23002,740,3.1
"19057",19,57,1999,23580,22840,740,3.1
"19057",19,57,2000,22248,21477,771,3.5
"19057",19,57,2001,22167,21060,1107,5
"19057",19,57,2002,21992,20681,1311,6
"19057",19,57,2003,21297,19870,1427,6.7
"19057",19,57,2004,20527,19321,1206,5.9
"19057",19,57,2005,20863,19732,1131,5.4
"19057",19,57,2006,21068,20070,998,4.7
"19057",19,57,2007,21064,20134,930,4.4
"19057",19,57,2008,20878,19653,1225,5.9
"19057",19,57,2009,21189,19486,1703,8
"19057",19,57,2010,20214,18710,1504,7.4
"19057",19,57,2011,20304,18935,1369,6.7
"19057",19,57,2012,20092,18857,1235,6.1
"19057",19,57,2013,20499,19262,1237,6
"19057",19,57,2014,20869,19824,1045,5
"19057",19,57,2015,20532,19556,976,4.8
"19057",19,57,2016,20064,19076,988,4.9
"19057",19,57,2017,19655,18819,836,4.3
"19059",19,59,1990,8051,7781,270,3.4
"19059",19,59,1991,8302,8005,297,3.6
"19059",19,59,1992,8860,8565,295,3.3
"19059",19,59,1993,9495,9177,318,3.3
"19059",19,59,1994,9618,9234,384,4
"19059",19,59,1995,9891,9561,330,3.3
"19059",19,59,1996,10267,9955,312,3
"19059",19,59,1997,10048,9703,345,3.4
"19059",19,59,1998,9850,9539,311,3.2
"19059",19,59,1999,9799,9558,241,2.5
"19059",19,59,2000,9431,9175,256,2.7
"19059",19,59,2001,9487,9175,312,3.3
"19059",19,59,2002,9824,9459,365,3.7
"19059",19,59,2003,9838,9378,460,4.7
"19059",19,59,2004,10023,9621,402,4
"19059",19,59,2005,10164,9728,436,4.3
"19059",19,59,2006,9979,9572,407,4.1
"19059",19,59,2007,9744,9364,380,3.9
"19059",19,59,2008,9694,9265,429,4.4
"19059",19,59,2009,9387,8719,668,7.1
"19059",19,59,2010,9297,8666,631,6.8
"19059",19,59,2011,9256,8673,583,6.3
"19059",19,59,2012,9179,8661,518,5.6
"19059",19,59,2013,9337,8840,497,5.3
"19059",19,59,2014,9725,9270,455,4.7
"19059",19,59,2015,10217,9817,400,3.9
"19059",19,59,2016,10314,9872,442,4.3
"19059",19,59,2017,10165,9793,372,3.7
"19061",19,61,1990,46139,43329,2810,6.1
"19061",19,61,1991,47413,44520,2893,6.1
"19061",19,61,1992,48345,45851,2494,5.2
"19061",19,61,1993,49887,47822,2065,4.1
"19061",19,61,1994,50496,48687,1809,3.6
"19061",19,61,1995,50769,48944,1825,3.6
"19061",19,61,1996,50880,48129,2751,5.4
"19061",19,61,1997,50211,48319,1892,3.8
"19061",19,61,1998,49564,47986,1578,3.2
"19061",19,61,1999,49287,47944,1343,2.7
"19061",19,61,2000,48376,46822,1554,3.2
"19061",19,61,2001,47964,45981,1983,4.1
"19061",19,61,2002,48870,46908,1962,4
"19061",19,61,2003,48823,46709,2114,4.3
"19061",19,61,2004,49023,46890,2133,4.4
"19061",19,61,2005,50793,48597,2196,4.3
"19061",19,61,2006,51906,49998,1908,3.7
"19061",19,61,2007,52040,49974,2066,4
"19061",19,61,2008,52196,49895,2301,4.4
"19061",19,61,2009,52911,49417,3494,6.6
"19061",19,61,2010,54224,51088,3136,5.8
"19061",19,61,2011,54378,51630,2748,5.1
"19061",19,61,2012,54623,52150,2473,4.5
"19061",19,61,2013,55063,52562,2501,4.5
"19061",19,61,2014,55648,53351,2297,4.1
"19061",19,61,2015,55757,53701,2056,3.7
"19061",19,61,2016,54754,52810,1944,3.6
"19061",19,61,2017,54459,52821,1638,3
"19063",19,63,1990,5556,5236,320,5.8
"19063",19,63,1991,5705,5370,335,5.9
"19063",19,63,1992,5766,5461,305,5.3
"19063",19,63,1993,5754,5500,254,4.4
"19063",19,63,1994,5694,5413,281,4.9
"19063",19,63,1995,5644,5379,265,4.7
"19063",19,63,1996,5775,5535,240,4.2
"19063",19,63,1997,5867,5620,247,4.2
"19063",19,63,1998,5787,5585,202,3.5
"19063",19,63,1999,5589,5401,188,3.4
"19063",19,63,2000,6003,5833,170,2.8
"19063",19,63,2001,5738,5518,220,3.8
"19063",19,63,2002,6086,5814,272,4.5
"19063",19,63,2003,5989,5668,321,5.4
"19063",19,63,2004,5835,5573,262,4.5
"19063",19,63,2005,5944,5682,262,4.4
"19063",19,63,2006,6043,5798,245,4.1
"19063",19,63,2007,5928,5710,218,3.7
"19063",19,63,2008,5940,5703,237,4
"19063",19,63,2009,5873,5387,486,8.3
"19063",19,63,2010,5869,5457,412,7
"19063",19,63,2011,5787,5463,324,5.6
"19063",19,63,2012,5714,5459,255,4.5
"19063",19,63,2013,5685,5452,233,4.1
"19063",19,63,2014,5742,5515,227,4
"19063",19,63,2015,5667,5455,212,3.7
"19063",19,63,2016,5603,5365,238,4.2
"19063",19,63,2017,5441,5266,175,3.2
"19065",19,65,1990,10282,9836,446,4.3
"19065",19,65,1991,10429,9880,549,5.3
"19065",19,65,1992,10650,10092,558,5.2
"19065",19,65,1993,10787,10274,513,4.8
"19065",19,65,1994,11593,11170,423,3.6
"19065",19,65,1995,11614,11135,479,4.1
"19065",19,65,1996,11592,11152,440,3.8
"19065",19,65,1997,11538,11175,363,3.1
"19065",19,65,1998,11194,10746,448,4
"19065",19,65,1999,11295,10893,402,3.6
"19065",19,65,2000,11183,10765,418,3.7
"19065",19,65,2001,11548,11001,547,4.7
"19065",19,65,2002,11178,10638,540,4.8
"19065",19,65,2003,10946,10385,561,5.1
"19065",19,65,2004,10965,10390,575,5.2
"19065",19,65,2005,11079,10524,555,5
"19065",19,65,2006,11064,10561,503,4.5
"19065",19,65,2007,10903,10425,478,4.4
"19065",19,65,2008,10930,10344,586,5.4
"19065",19,65,2009,10976,10031,945,8.6
"19065",19,65,2010,11015,10228,787,7.1
"19065",19,65,2011,11040,10354,686,6.2
"19065",19,65,2012,10794,10207,587,5.4
"19065",19,65,2013,10669,10106,563,5.3
"19065",19,65,2014,10808,10267,541,5
"19065",19,65,2015,10821,10327,494,4.6
"19065",19,65,2016,10725,10250,475,4.4
"19065",19,65,2017,10429,10042,387,3.7
"19067",19,67,1990,8569,8100,469,5.5
"19067",19,67,1991,8647,8070,577,6.7
"19067",19,67,1992,8745,8175,570,6.5
"19067",19,67,1993,8711,8099,612,7
"19067",19,67,1994,8530,7822,708,8.3
"19067",19,67,1995,8250,7810,440,5.3
"19067",19,67,1996,8455,8033,422,5
"19067",19,67,1997,8128,7748,380,4.7
"19067",19,67,1998,7693,7359,334,4.3
"19067",19,67,1999,7834,7556,278,3.5
"19067",19,67,2000,8483,8172,311,3.7
"19067",19,67,2001,8635,8268,367,4.3
"19067",19,67,2002,8685,8272,413,4.8
"19067",19,67,2003,8579,8147,432,5
"19067",19,67,2004,8744,8317,427,4.9
"19067",19,67,2005,8813,8370,443,5
"19067",19,67,2006,8801,8387,414,4.7
"19067",19,67,2007,8712,8323,389,4.5
"19067",19,67,2008,8613,8106,507,5.9
"19067",19,67,2009,8569,7819,750,8.8
"19067",19,67,2010,8549,7930,619,7.2
"19067",19,67,2011,8291,7754,537,6.5
"19067",19,67,2012,8125,7618,507,6.2
"19067",19,67,2013,8274,7817,457,5.5
"19067",19,67,2014,8421,8041,380,4.5
"19067",19,67,2015,8707,8376,331,3.8
"19067",19,67,2016,8702,8385,317,3.6
"19067",19,67,2017,8777,8492,285,3.2
"19069",19,69,1990,5738,5504,234,4.1
"19069",19,69,1991,5704,5463,241,4.2
"19069",19,69,1992,5838,5597,241,4.1
"19069",19,69,1993,5869,5658,211,3.6
"19069",19,69,1994,6120,5925,195,3.2
"19069",19,69,1995,6142,5963,179,2.9
"19069",19,69,1996,6180,5993,187,3
"19069",19,69,1997,6105,5912,193,3.2
"19069",19,69,1998,6037,5857,180,3
"19069",19,69,1999,5993,5801,192,3.2
"19069",19,69,2000,5684,5530,154,2.7
"19069",19,69,2001,5952,5752,200,3.4
"19069",19,69,2002,5676,5436,240,4.2
"19069",19,69,2003,5397,5151,246,4.6
"19069",19,69,2004,5481,5226,255,4.7
"19069",19,69,2005,5718,5451,267,4.7
"19069",19,69,2006,5842,5617,225,3.9
"19069",19,69,2007,5964,5755,209,3.5
"19069",19,69,2008,5848,5587,261,4.5
"19069",19,69,2009,5881,5446,435,7.4
"19069",19,69,2010,6027,5651,376,6.2
"19069",19,69,2011,5970,5664,306,5.1
"19069",19,69,2012,5812,5552,260,4.5
"19069",19,69,2013,5915,5652,263,4.4
"19069",19,69,2014,5986,5749,237,4
"19069",19,69,2015,5962,5761,201,3.4
"19069",19,69,2016,5952,5746,206,3.5
"19069",19,69,2017,5773,5613,160,2.8
"19071",19,71,1990,3738,3605,133,3.6
"19071",19,71,1991,3725,3542,183,4.9
"19071",19,71,1992,3818,3611,207,5.4
"19071",19,71,1993,3933,3737,196,5
"19071",19,71,1994,4024,3890,134,3.3
"19071",19,71,1995,4008,3884,124,3.1
"19071",19,71,1996,3931,3786,145,3.7
"19071",19,71,1997,3820,3719,101,2.6
"19071",19,71,1998,3688,3589,99,2.7
"19071",19,71,1999,3882,3801,81,2.1
"19071",19,71,2000,4224,4125,99,2.3
"19071",19,71,2001,4660,4536,124,2.7
"19071",19,71,2002,4604,4480,124,2.7
"19071",19,71,2003,4304,4159,145,3.4
"19071",19,71,2004,3913,3757,156,4
"19071",19,71,2005,3947,3790,157,4
"19071",19,71,2006,3963,3814,149,3.8
"19071",19,71,2007,3957,3798,159,4
"19071",19,71,2008,3910,3733,177,4.5
"19071",19,71,2009,3796,3535,261,6.9
"19071",19,71,2010,3978,3743,235,5.9
"19071",19,71,2011,3967,3738,229,5.8
"19071",19,71,2012,4009,3804,205,5.1
"19071",19,71,2013,4128,3954,174,4.2
"19071",19,71,2014,4175,4014,161,3.9
"19071",19,71,2015,4152,4014,138,3.3
"19071",19,71,2016,3993,3862,131,3.3
"19071",19,71,2017,3833,3733,100,2.6
"19073",19,73,1990,4889,4641,248,5.1
"19073",19,73,1991,5002,4760,242,4.8
"19073",19,73,1992,5241,5030,211,4
"19073",19,73,1993,5290,5079,211,4
"19073",19,73,1994,5294,5081,213,4
"19073",19,73,1995,5209,4993,216,4.1
"19073",19,73,1996,5268,5105,163,3.1
"19073",19,73,1997,5020,4894,126,2.5
"19073",19,73,1998,5028,4880,148,2.9
"19073",19,73,1999,5051,4902,149,2.9
"19073",19,73,2000,4978,4816,162,3.3
"19073",19,73,2001,4992,4802,190,3.8
"19073",19,73,2002,5011,4822,189,3.8
"19073",19,73,2003,4991,4796,195,3.9
"19073",19,73,2004,5031,4820,211,4.2
"19073",19,73,2005,5056,4824,232,4.6
"19073",19,73,2006,5060,4863,197,3.9
"19073",19,73,2007,4989,4813,176,3.5
"19073",19,73,2008,5079,4879,200,3.9
"19073",19,73,2009,5122,4821,301,5.9
"19073",19,73,2010,5201,4895,306,5.9
"19073",19,73,2011,5189,4899,290,5.6
"19073",19,73,2012,5117,4863,254,5
"19073",19,73,2013,5125,4885,240,4.7
"19073",19,73,2014,5281,5068,213,4
"19073",19,73,2015,5573,5376,197,3.5
"19073",19,73,2016,5673,5496,177,3.1
"19073",19,73,2017,5409,5258,151,2.8
"19075",19,75,1990,5787,5636,151,2.6
"19075",19,75,1991,5839,5640,199,3.4
"19075",19,75,1992,6034,5819,215,3.6
"19075",19,75,1993,6107,5917,190,3.1
"19075",19,75,1994,6296,6113,183,2.9
"19075",19,75,1995,6086,5854,232,3.8
"19075",19,75,1996,6140,5916,224,3.6
"19075",19,75,1997,6295,6132,163,2.6
"19075",19,75,1998,6157,6012,145,2.4
"19075",19,75,1999,6256,6095,161,2.6
"19075",19,75,2000,6505,6357,148,2.3
"19075",19,75,2001,6558,6381,177,2.7
"19075",19,75,2002,6864,6645,219,3.2
"19075",19,75,2003,6809,6548,261,3.8
"19075",19,75,2004,6779,6538,241,3.6
"19075",19,75,2005,6876,6617,259,3.8
"19075",19,75,2006,6912,6701,211,3.1
"19075",19,75,2007,6805,6589,216,3.2
"19075",19,75,2008,6875,6627,248,3.6
"19075",19,75,2009,6957,6552,405,5.8
"19075",19,75,2010,6755,6371,384,5.7
"19075",19,75,2011,6703,6369,334,5
"19075",19,75,2012,6652,6349,303,4.6
"19075",19,75,2013,6601,6313,288,4.4
"19075",19,75,2014,6733,6453,280,4.2
"19075",19,75,2015,6736,6479,257,3.8
"19075",19,75,2016,6643,6414,229,3.4
"19075",19,75,2017,6501,6309,192,3
"19077",19,77,1990,5451,5239,212,3.9
"19077",19,77,1991,5669,5420,249,4.4
"19077",19,77,1992,5640,5409,231,4.1
"19077",19,77,1993,5883,5646,237,4
"19077",19,77,1994,5869,5649,220,3.7
"19077",19,77,1995,5995,5797,198,3.3
"19077",19,77,1996,6108,5910,198,3.2
"19077",19,77,1997,6132,5952,180,2.9
"19077",19,77,1998,6016,5863,153,2.5
"19077",19,77,1999,6071,5938,133,2.2
"19077",19,77,2000,6043,5885,158,2.6
"19077",19,77,2001,6039,5857,182,3
"19077",19,77,2002,6164,5949,215,3.5
"19077",19,77,2003,6081,5833,248,4.1
"19077",19,77,2004,6071,5815,256,4.2
"19077",19,77,2005,6116,5861,255,4.2
"19077",19,77,2006,6051,5828,223,3.7
"19077",19,77,2007,5857,5634,223,3.8
"19077",19,77,2008,5797,5543,254,4.4
"19077",19,77,2009,5732,5372,360,6.3
"19077",19,77,2010,5852,5474,378,6.5
"19077",19,77,2011,5690,5342,348,6.1
"19077",19,77,2012,5555,5243,312,5.6
"19077",19,77,2013,5533,5248,285,5.2
"19077",19,77,2014,5619,5373,246,4.4
"19077",19,77,2015,5625,5412,213,3.8
"19077",19,77,2016,5631,5429,202,3.6
"19077",19,77,2017,5596,5417,179,3.2
"19079",19,79,1990,8376,7969,407,4.9
"19079",19,79,1991,8505,8149,356,4.2
"19079",19,79,1992,8757,8347,410,4.7
"19079",19,79,1993,8520,8216,304,3.6
"19079",19,79,1994,8771,8508,263,3
"19079",19,79,1995,8696,8344,352,4
"19079",19,79,1996,8719,8459,260,3
"19079",19,79,1997,8645,8383,262,3
"19079",19,79,1998,8395,8167,228,2.7
"19079",19,79,1999,8762,8579,183,2.1
"19079",19,79,2000,8928,8708,220,2.5
"19079",19,79,2001,8774,8500,274,3.1
"19079",19,79,2002,8797,8505,292,3.3
"19079",19,79,2003,8612,8237,375,4.4
"19079",19,79,2004,8618,8258,360,4.2
"19079",19,79,2005,8671,8335,336,3.9
"19079",19,79,2006,8806,8492,314,3.6
"19079",19,79,2007,8645,8369,276,3.2
"19079",19,79,2008,8578,8246,332,3.9
"19079",19,79,2009,8263,7633,630,7.6
"19079",19,79,2010,8083,7495,588,7.3
"19079",19,79,2011,7468,6811,657,8.8
"19079",19,79,2012,7048,6562,486,6.9
"19079",19,79,2013,7040,6657,383,5.4
"19079",19,79,2014,7109,6787,322,4.5
"19079",19,79,2015,7235,6925,310,4.3
"19079",19,79,2016,7150,6881,269,3.8
"19079",19,79,2017,7059,6829,230,3.3
"19081",19,81,1990,6240,5863,377,6
"19081",19,81,1991,6008,5665,343,5.7
"19081",19,81,1992,5920,5603,317,5.4
"19081",19,81,1993,5902,5672,230,3.9
"19081",19,81,1994,6145,5957,188,3.1
"19081",19,81,1995,6206,6010,196,3.2
"19081",19,81,1996,6094,5919,175,2.9
"19081",19,81,1997,6869,6718,151,2.2
"19081",19,81,1998,6764,6636,128,1.9
"19081",19,81,1999,7163,7036,127,1.8
"19081",19,81,2000,6307,6171,136,2.2
"19081",19,81,2001,6354,6190,164,2.6
"19081",19,81,2002,6388,6205,183,2.9
"19081",19,81,2003,6265,6035,230,3.7
"19081",19,81,2004,6365,6145,220,3.5
"19081",19,81,2005,6332,6045,287,4.5
"19081",19,81,2006,6130,5909,221,3.6
"19081",19,81,2007,6038,5811,227,3.8
"19081",19,81,2008,5948,5566,382,6.4
"19081",19,81,2009,5652,5087,565,10
"19081",19,81,2010,6070,5667,403,6.6
"19081",19,81,2011,5938,5606,332,5.6
"19081",19,81,2012,5981,5708,273,4.6
"19081",19,81,2013,6210,5962,248,4
"19081",19,81,2014,6306,6098,208,3.3
"19081",19,81,2015,6370,6196,174,2.7
"19081",19,81,2016,6398,6226,172,2.7
"19081",19,81,2017,6158,5997,161,2.6
"19083",19,83,1990,9411,8958,453,4.8
"19083",19,83,1991,9462,8929,533,5.6
"19083",19,83,1992,9484,9012,472,5
"19083",19,83,1993,9582,9197,385,4
"19083",19,83,1994,9696,9397,299,3.1
"19083",19,83,1995,9734,9358,376,3.9
"19083",19,83,1996,9721,9360,361,3.7
"19083",19,83,1997,9687,9305,382,3.9
"19083",19,83,1998,9626,9283,343,3.6
"19083",19,83,1999,9469,9189,280,3
"19083",19,83,2000,9481,9193,288,3
"19083",19,83,2001,9870,9523,347,3.5
"19083",19,83,2002,9663,9255,408,4.2
"19083",19,83,2003,9133,8660,473,5.2
"19083",19,83,2004,8953,8481,472,5.3
"19083",19,83,2005,8944,8521,423,4.7
"19083",19,83,2006,9149,8807,342,3.7
"19083",19,83,2007,9057,8714,343,3.8
"19083",19,83,2008,9265,8867,398,4.3
"19083",19,83,2009,9372,8757,615,6.6
"19083",19,83,2010,9133,8538,595,6.5
"19083",19,83,2011,8986,8458,528,5.9
"19083",19,83,2012,8757,8289,468,5.3
"19083",19,83,2013,8698,8254,444,5.1
"19083",19,83,2014,8721,8344,377,4.3
"19083",19,83,2015,8821,8470,351,4
"19083",19,83,2016,8584,8250,334,3.9
"19083",19,83,2017,8474,8200,274,3.2
"19085",19,85,1990,7116,6822,294,4.1
"19085",19,85,1991,7244,6862,382,5.3
"19085",19,85,1992,7426,7022,404,5.4
"19085",19,85,1993,7609,7247,362,4.8
"19085",19,85,1994,7684,7340,344,4.5
"19085",19,85,1995,7609,7270,339,4.5
"19085",19,85,1996,7798,7511,287,3.7
"19085",19,85,1997,7831,7569,262,3.3
"19085",19,85,1998,7705,7479,226,2.9
"19085",19,85,1999,7879,7691,188,2.4
"19085",19,85,2000,8066,7852,214,2.7
"19085",19,85,2001,8074,7782,292,3.6
"19085",19,85,2002,8216,7915,301,3.7
"19085",19,85,2003,8169,7787,382,4.7
"19085",19,85,2004,8010,7610,400,5
"19085",19,85,2005,8066,7689,377,4.7
"19085",19,85,2006,8063,7717,346,4.3
"19085",19,85,2007,7780,7455,325,4.2
"19085",19,85,2008,7748,7420,328,4.2
"19085",19,85,2009,7703,7321,382,5
"19085",19,85,2010,8001,7555,446,5.6
"19085",19,85,2011,7818,7385,433,5.5
"19085",19,85,2012,7537,7157,380,5
"19085",19,85,2013,7509,7171,338,4.5
"19085",19,85,2014,7548,7246,302,4
"19085",19,85,2015,7544,7286,258,3.4
"19085",19,85,2016,7459,7208,251,3.4
"19085",19,85,2017,7362,7160,202,2.7
"19087",19,87,1990,10038,9679,359,3.6
"19087",19,87,1991,10196,9749,447,4.4
"19087",19,87,1992,10531,10072,459,4.4
"19087",19,87,1993,10823,10443,380,3.5
"19087",19,87,1994,11160,10799,361,3.2
"19087",19,87,1995,11300,10938,362,3.2
"19087",19,87,1996,11330,10968,362,3.2
"19087",19,87,1997,11306,11009,297,2.6
"19087",19,87,1998,11121,10826,295,2.7
"19087",19,87,1999,11074,10764,310,2.8
"19087",19,87,2000,10540,10231,309,2.9
"19087",19,87,2001,10439,10025,414,4
"19087",19,87,2002,10420,9885,535,5.1
"19087",19,87,2003,10166,9488,678,6.7
"19087",19,87,2004,10291,9678,613,6
"19087",19,87,2005,10490,9971,519,4.9
"19087",19,87,2006,10599,10040,559,5.3
"19087",19,87,2007,10313,9830,483,4.7
"19087",19,87,2008,10161,9613,548,5.4
"19087",19,87,2009,9863,8944,919,9.3
"19087",19,87,2010,9959,9133,826,8.3
"19087",19,87,2011,9829,9161,668,6.8
"19087",19,87,2012,9621,9050,571,5.9
"19087",19,87,2013,9550,9044,506,5.3
"19087",19,87,2014,9558,9139,419,4.4
"19087",19,87,2015,9604,9226,378,3.9
"19087",19,87,2016,9574,9235,339,3.5
"19087",19,87,2017,9681,9392,289,3
"19089",19,89,1990,4607,4423,184,4
"19089",19,89,1991,4702,4515,187,4
"19089",19,89,1992,4893,4692,201,4.1
"19089",19,89,1993,4883,4698,185,3.8
"19089",19,89,1994,5319,5137,182,3.4
"19089",19,89,1995,5436,5237,199,3.7
"19089",19,89,1996,5500,5285,215,3.9
"19089",19,89,1997,5534,5359,175,3.2
"19089",19,89,1998,5566,5397,169,3
"19089",19,89,1999,5640,5490,150,2.7
"19089",19,89,2000,5114,4954,160,3.1
"19089",19,89,2001,5292,5117,175,3.3
"19089",19,89,2002,5253,5038,215,4.1
"19089",19,89,2003,5047,4824,223,4.4
"19089",19,89,2004,5158,4924,234,4.5
"19089",19,89,2005,5196,4968,228,4.4
"19089",19,89,2006,5322,5131,191,3.6
"19089",19,89,2007,5243,5052,191,3.6
"19089",19,89,2008,5215,4968,247,4.7
"19089",19,89,2009,5097,4649,448,8.8
"19089",19,89,2010,5339,5003,336,6.3
"19089",19,89,2011,5320,5036,284,5.3
"19089",19,89,2012,5200,4960,240,4.6
"19089",19,89,2013,5231,4989,242,4.6
"19089",19,89,2014,5323,5108,215,4
"19089",19,89,2015,5379,5185,194,3.6
"19089",19,89,2016,5336,5145,191,3.6
"19089",19,89,2017,5119,4963,156,3
"19091",19,91,1990,4966,4805,161,3.2
"19091",19,91,1991,5012,4813,199,4
"19091",19,91,1992,5145,4979,166,3.2
"19091",19,91,1993,5253,5077,176,3.4
"19091",19,91,1994,5425,5260,165,3
"19091",19,91,1995,5431,5296,135,2.5
"19091",19,91,1996,5637,5508,129,2.3
"19091",19,91,1997,5720,5596,124,2.2
"19091",19,91,1998,5720,5605,115,2
"19091",19,91,1999,5587,5479,108,1.9
"19091",19,91,2000,5262,5128,134,2.5
"19091",19,91,2001,5348,5171,177,3.3
"19091",19,91,2002,5327,5136,191,3.6
"19091",19,91,2003,5196,4976,220,4.2
"19091",19,91,2004,5132,4923,209,4.1
"19091",19,91,2005,5190,4999,191,3.7
"19091",19,91,2006,5185,5014,171,3.3
"19091",19,91,2007,5199,5039,160,3.1
"19091",19,91,2008,5165,4974,191,3.7
"19091",19,91,2009,5154,4848,306,5.9
"19091",19,91,2010,5227,4957,270,5.2
"19091",19,91,2011,5170,4910,260,5
"19091",19,91,2012,5157,4939,218,4.2
"19091",19,91,2013,5217,5004,213,4.1
"19091",19,91,2014,5268,5068,200,3.8
"19091",19,91,2015,5346,5167,179,3.3
"19091",19,91,2016,5394,5238,156,2.9
"19091",19,91,2017,5273,5112,161,3.1
"19093",19,93,1990,3886,3787,99,2.5
"19093",19,93,1991,3776,3639,137,3.6
"19093",19,93,1992,3851,3750,101,2.6
"19093",19,93,1993,4077,3976,101,2.5
"19093",19,93,1994,4185,4086,99,2.4
"19093",19,93,1995,4174,4061,113,2.7
"19093",19,93,1996,4293,4185,108,2.5
"19093",19,93,1997,4273,4156,117,2.7
"19093",19,93,1998,4069,3971,98,2.4
"19093",19,93,1999,4147,4059,88,2.1
"19093",19,93,2000,3981,3895,86,2.2
"19093",19,93,2001,4111,4001,110,2.7
"19093",19,93,2002,4010,3878,132,3.3
"19093",19,93,2003,3864,3714,150,3.9
"19093",19,93,2004,3882,3720,162,4.2
"19093",19,93,2005,3923,3767,156,4
"19093",19,93,2006,3968,3832,136,3.4
"19093",19,93,2007,4035,3901,134,3.3
"19093",19,93,2008,4200,4037,163,3.9
"19093",19,93,2009,3985,3769,216,5.4
"19093",19,93,2010,3846,3650,196,5.1
"19093",19,93,2011,3793,3609,184,4.9
"19093",19,93,2012,3773,3621,152,4
"19093",19,93,2013,3814,3662,152,4
"19093",19,93,2014,3895,3756,139,3.6
"19093",19,93,2015,3963,3839,124,3.1
"19093",19,93,2016,4030,3927,103,2.6
"19093",19,93,2017,4029,3934,95,2.4
"19095",19,95,1990,8006,7799,207,2.6
"19095",19,95,1991,8410,8200,210,2.5
"19095",19,95,1992,9021,8806,215,2.4
"19095",19,95,1993,9392,9172,220,2.3
"19095",19,95,1994,9558,9370,188,2
"19095",19,95,1995,9366,9137,229,2.4
"19095",19,95,1996,9616,9361,255,2.7
"19095",19,95,1997,9464,9233,231,2.4
"19095",19,95,1998,9363,9157,206,2.2
"19095",19,95,1999,9439,9281,158,1.7
"19095",19,95,2000,8824,8641,183,2.1
"19095",19,95,2001,8930,8716,214,2.4
"19095",19,95,2002,8968,8661,307,3.4
"19095",19,95,2003,8625,8301,324,3.8
"19095",19,95,2004,8698,8336,362,4.2
"19095",19,95,2005,8819,8431,388,4.4
"19095",19,95,2006,8837,8514,323,3.7
"19095",19,95,2007,8612,8295,317,3.7
"19095",19,95,2008,8658,8292,366,4.2
"19095",19,95,2009,8596,7984,612,7.1
"19095",19,95,2010,9661,9130,531,5.5
"19095",19,95,2011,9609,9128,481,5
"19095",19,95,2012,9595,9163,432,4.5
"19095",19,95,2013,9928,9517,411,4.1
"19095",19,95,2014,10222,9795,427,4.2
"19095",19,95,2015,10390,10023,367,3.5
"19095",19,95,2016,10572,10244,328,3.1
"19095",19,95,2017,10478,10201,277,2.6
"19097",19,97,1990,10024,9357,667,6.7
"19097",19,97,1991,10304,9622,682,6.6
"19097",19,97,1992,10602,9946,656,6.2
"19097",19,97,1993,10917,10366,551,5
"19097",19,97,1994,11036,10493,543,4.9
"19097",19,97,1995,10572,9974,598,5.7
"19097",19,97,1996,10850,10197,653,6
"19097",19,97,1997,10698,10158,540,5
"19097",19,97,1998,10440,9986,454,4.3
"19097",19,97,1999,10574,10166,408,3.9
"19097",19,97,2000,11120,10723,397,3.6
"19097",19,97,2001,11336,10801,535,4.7
"19097",19,97,2002,11614,11009,605,5.2
"19097",19,97,2003,11199,10514,685,6.1
"19097",19,97,2004,11079,10462,617,5.6
"19097",19,97,2005,11183,10593,590,5.3
"19097",19,97,2006,11256,10717,539,4.8
"19097",19,97,2007,11174,10654,520,4.7
"19097",19,97,2008,11304,10715,589,5.2
"19097",19,97,2009,11240,10300,940,8.4
"19097",19,97,2010,11106,10312,794,7.1
"19097",19,97,2011,10991,10277,714,6.5
"19097",19,97,2012,10818,10227,591,5.5
"19097",19,97,2013,10847,10263,584,5.4
"19097",19,97,2014,11035,10477,558,5.1
"19097",19,97,2015,11173,10700,473,4.2
"19097",19,97,2016,11077,10614,463,4.2
"19097",19,97,2017,10884,10512,372,3.4
"19099",19,99,1990,17898,17247,651,3.6
"19099",19,99,1991,18005,17202,803,4.5
"19099",19,99,1992,17999,17319,680,3.8
"19099",19,99,1993,18154,17474,680,3.7
"19099",19,99,1994,18565,17979,586,3.2
"19099",19,99,1995,18784,18167,617,3.3
"19099",19,99,1996,19075,18463,612,3.2
"19099",19,99,1997,19450,18935,515,2.6
"19099",19,99,1998,19199,18746,453,2.4
"19099",19,99,1999,19430,19046,384,2
"19099",19,99,2000,19769,19284,485,2.5
"19099",19,99,2001,20233,19603,630,3.1
"19099",19,99,2002,20578,19727,851,4.1
"19099",19,99,2003,19678,18666,1012,5.1
"19099",19,99,2004,19186,18099,1087,5.7
"19099",19,99,2005,18644,17551,1093,5.9
"19099",19,99,2006,18315,17376,939,5.1
"19099",19,99,2007,17936,16803,1133,6.3
"19099",19,99,2008,17742,16376,1366,7.7
"19099",19,99,2009,17834,16304,1530,8.6
"19099",19,99,2010,19026,17637,1389,7.3
"19099",19,99,2011,18605,17359,1246,6.7
"19099",19,99,2012,18543,17440,1103,5.9
"19099",19,99,2013,19057,18089,968,5.1
"19099",19,99,2014,19356,18501,855,4.4
"19099",19,99,2015,19119,18371,748,3.9
"19099",19,99,2016,19271,18588,683,3.5
"19099",19,99,2017,19272,18666,606,3.1
"19101",19,101,1990,8513,8146,367,4.3
"19101",19,101,1991,8613,8216,397,4.6
"19101",19,101,1992,9000,8538,462,5.1
"19101",19,101,1993,9564,9150,414,4.3
"19101",19,101,1994,9820,9379,441,4.5
"19101",19,101,1995,9714,9351,363,3.7
"19101",19,101,1996,9959,9663,296,3
"19101",19,101,1997,10502,10176,326,3.1
"19101",19,101,1998,10213,9915,298,2.9
"19101",19,101,1999,9791,9476,315,3.2
"19101",19,101,2000,9018,8762,256,2.8
"19101",19,101,2001,8836,8393,443,5
"19101",19,101,2002,8621,8132,489,5.7
"19101",19,101,2003,8281,7824,457,5.5
"19101",19,101,2004,8164,7745,419,5.1
"19101",19,101,2005,8287,7903,384,4.6
"19101",19,101,2006,8308,7958,350,4.2
"19101",19,101,2007,8370,8027,343,4.1
"19101",19,101,2008,8435,8056,379,4.5
"19101",19,101,2009,8272,7559,713,8.6
"19101",19,101,2010,8956,8321,635,7.1
"19101",19,101,2011,8816,8288,528,6
"19101",19,101,2012,8761,8301,460,5.3
"19101",19,101,2013,8927,8484,443,5
"19101",19,101,2014,9093,8697,396,4.4
"19101",19,101,2015,9157,8803,354,3.9
"19101",19,101,2016,9196,8860,336,3.7
"19101",19,101,2017,8995,8714,281,3.1
"19103",19,103,1990,57658,55809,1849,3.2
"19103",19,103,1991,58595,56839,1756,3
"19103",19,103,1992,60313,58449,1864,3.1
"19103",19,103,1993,63817,62094,1723,2.7
"19103",19,103,1994,65125,63483,1642,2.5
"19103",19,103,1995,65414,63655,1759,2.7
"19103",19,103,1996,65822,64048,1774,2.7
"19103",19,103,1997,65878,64283,1595,2.4
"19103",19,103,1998,67475,65966,1509,2.2
"19103",19,103,1999,68429,67016,1413,2.1
"19103",19,103,2000,67120,65893,1227,1.8
"19103",19,103,2001,68849,67350,1499,2.2
"19103",19,103,2002,72569,70596,1973,2.7
"19103",19,103,2003,72412,70184,2228,3.1
"19103",19,103,2004,72476,70088,2388,3.3
"19103",19,103,2005,73815,71497,2318,3.1
"19103",19,103,2006,75601,73630,1971,2.6
"19103",19,103,2007,77590,75493,2097,2.7
"19103",19,103,2008,79270,76874,2396,3
"19103",19,103,2009,80726,77133,3593,4.5
"19103",19,103,2010,79267,75917,3350,4.2
"19103",19,103,2011,79671,76457,3214,4
"19103",19,103,2012,80297,77342,2955,3.7
"19103",19,103,2013,82752,79931,2821,3.4
"19103",19,103,2014,84150,81559,2591,3.1
"19103",19,103,2015,83940,81687,2253,2.7
"19103",19,103,2016,84422,82240,2182,2.6
"19103",19,103,2017,84887,82775,2112,2.5
"19105",19,105,1990,9322,8862,460,4.9
"19105",19,105,1991,9355,8877,478,5.1
"19105",19,105,1992,9564,9027,537,5.6
"19105",19,105,1993,9440,8985,455,4.8
"19105",19,105,1994,9647,9264,383,4
"19105",19,105,1995,9796,9384,412,4.2
"19105",19,105,1996,9951,9556,395,4
"19105",19,105,1997,9898,9547,351,3.5
"19105",19,105,1998,9675,9403,272,2.8
"19105",19,105,1999,9749,9482,267,2.7
"19105",19,105,2000,10394,10124,270,2.6
"19105",19,105,2001,10483,10090,393,3.7
"19105",19,105,2002,10665,10170,495,4.6
"19105",19,105,2003,10422,9876,546,5.2
"19105",19,105,2004,10339,9821,518,5
"19105",19,105,2005,10423,9927,496,4.8
"19105",19,105,2006,10513,10107,406,3.9
"19105",19,105,2007,10453,10021,432,4.1
"19105",19,105,2008,10548,10073,475,4.5
"19105",19,105,2009,10776,10005,771,7.2
"19105",19,105,2010,11108,10402,706,6.4
"19105",19,105,2011,10915,10281,634,5.8
"19105",19,105,2012,10676,10114,562,5.3
"19105",19,105,2013,10734,10164,570,5.3
"19105",19,105,2014,10810,10278,532,4.9
"19105",19,105,2015,10789,10335,454,4.2
"19105",19,105,2016,10701,10244,457,4.3
"19105",19,105,2017,10527,10141,386,3.7
"19107",19,107,1990,5331,5085,246,4.6
"19107",19,107,1991,5269,4999,270,5.1
"19107",19,107,1992,5225,4922,303,5.8
"19107",19,107,1993,5153,4895,258,5
"19107",19,107,1994,5191,4969,222,4.3
"19107",19,107,1995,5137,4896,241,4.7
"19107",19,107,1996,5335,5092,243,4.6
"19107",19,107,1997,5422,5185,237,4.4
"19107",19,107,1998,5252,5021,231,4.4
"19107",19,107,1999,5159,4927,232,4.5
"19107",19,107,2000,5810,5626,184,3.2
"19107",19,107,2001,6082,5839,243,4
"19107",19,107,2002,6151,5875,276,4.5
"19107",19,107,2003,6082,5803,279,4.6
"19107",19,107,2004,5826,5547,279,4.8
"19107",19,107,2005,5815,5539,276,4.7
"19107",19,107,2006,5820,5585,235,4
"19107",19,107,2007,5629,5394,235,4.2
"19107",19,107,2008,5641,5383,258,4.6
"19107",19,107,2009,5711,5255,456,8
"19107",19,107,2010,5548,5186,362,6.5
"19107",19,107,2011,5472,5137,335,6.1
"19107",19,107,2012,5424,5127,297,5.5
"19107",19,107,2013,5478,5200,278,5.1
"19107",19,107,2014,5524,5280,244,4.4
"19107",19,107,2015,5428,5195,233,4.3
"19107",19,107,2016,5327,5099,228,4.3
"19107",19,107,2017,5192,5005,187,3.6
"19109",19,109,1990,8851,8451,400,4.5
"19109",19,109,1991,8930,8440,490,5.5
"19109",19,109,1992,8961,8544,417,4.7
"19109",19,109,1993,8809,8483,326,3.7
"19109",19,109,1994,9019,8680,339,3.8
"19109",19,109,1995,8886,8543,343,3.9
"19109",19,109,1996,9150,8869,281,3.1
"19109",19,109,1997,9247,9018,229,2.5
"19109",19,109,1998,8915,8670,245,2.7
"19109",19,109,1999,8792,8532,260,3
"19109",19,109,2000,8821,8598,223,2.5
"19109",19,109,2001,9136,8872,264,2.9
"19109",19,109,2002,9051,8727,324,3.6
"19109",19,109,2003,8792,8400,392,4.5
"19109",19,109,2004,8754,8376,378,4.3
"19109",19,109,2005,8883,8529,354,4
"19109",19,109,2006,9047,8752,295,3.3
"19109",19,109,2007,8980,8658,322,3.6
"19109",19,109,2008,9039,8679,360,4
"19109",19,109,2009,8981,8453,528,5.9
"19109",19,109,2010,8381,7955,426,5.1
"19109",19,109,2011,8354,7990,364,4.4
"19109",19,109,2012,8385,8060,325,3.9
"19109",19,109,2013,8475,8174,301,3.6
"19109",19,109,2014,8675,8397,278,3.2
"19109",19,109,2015,8839,8585,254,2.9
"19109",19,109,2016,8906,8673,233,2.6
"19109",19,109,2017,8731,8521,210,2.4
"19111",19,111,1990,18932,17682,1250,6.6
"19111",19,111,1991,19537,18059,1478,7.6
"19111",19,111,1992,19558,18049,1509,7.7
"19111",19,111,1993,19661,18228,1433,7.3
"19111",19,111,1994,19851,18794,1057,5.3
"19111",19,111,1995,19983,18983,1000,5
"19111",19,111,1996,20201,19039,1162,5.8
"19111",19,111,1997,19961,18919,1042,5.2
"19111",19,111,1998,19671,18840,831,4.2
"19111",19,111,1999,19282,18523,759,3.9
"19111",19,111,2000,18601,17776,825,4.4
"19111",19,111,2001,18377,17190,1187,6.5
"19111",19,111,2002,18092,16737,1355,7.5
"19111",19,111,2003,17473,16122,1351,7.7
"19111",19,111,2004,17206,16005,1201,7
"19111",19,111,2005,17402,16262,1140,6.6
"19111",19,111,2006,17491,16406,1085,6.2
"19111",19,111,2007,17332,16341,991,5.7
"19111",19,111,2008,17461,16312,1149,6.6
"19111",19,111,2009,17434,15650,1784,10.2
"19111",19,111,2010,17741,16167,1574,8.9
"19111",19,111,2011,17440,16020,1420,8.1
"19111",19,111,2012,17480,16222,1258,7.2
"19111",19,111,2013,17128,15908,1220,7.1
"19111",19,111,2014,17759,16714,1045,5.9
"19111",19,111,2015,18283,17293,990,5.4
"19111",19,111,2016,17484,16431,1053,6
"19111",19,111,2017,16168,15277,891,5.5
"19113",19,113,1990,96912,91425,5487,5.7
"19113",19,113,1991,97040,92264,4776,4.9
"19113",19,113,1992,99951,95936,4015,4
"19113",19,113,1993,104727,101140,3587,3.4
"19113",19,113,1994,106858,103704,3154,3
"19113",19,113,1995,108892,105909,2983,2.7
"19113",19,113,1996,110160,107138,3022,2.7
"19113",19,113,1997,110513,107815,2698,2.4
"19113",19,113,1998,112522,110403,2119,1.9
"19113",19,113,1999,114551,112439,2112,1.8
"19113",19,113,2000,110907,108407,2500,2.3
"19113",19,113,2001,112586,109057,3529,3.1
"19113",19,113,2002,115368,110206,5162,4.5
"19113",19,113,2003,112195,106753,5442,4.9
"19113",19,113,2004,111170,105980,5190,4.7
"19113",19,113,2005,113248,108404,4844,4.3
"19113",19,113,2006,116249,112017,4232,3.6
"19113",19,113,2007,118163,113836,4327,3.7
"19113",19,113,2008,121196,116264,4932,4.1
"19113",19,113,2009,123192,115728,7464,6.1
"19113",19,113,2010,120123,112941,7182,6
"19113",19,113,2011,119379,112600,6779,5.7
"19113",19,113,2012,118891,112687,6204,5.2
"19113",19,113,2013,119688,113695,5993,5
"19113",19,113,2014,121179,115865,5314,4.4
"19113",19,113,2015,120278,115690,4588,3.8
"19113",19,113,2016,118954,114600,4354,3.7
"19113",19,113,2017,118275,114290,3985,3.4
"19115",19,115,1990,5917,5647,270,4.6
"19115",19,115,1991,6109,5793,316,5.2
"19115",19,115,1992,6360,6010,350,5.5
"19115",19,115,1993,6554,6226,328,5
"19115",19,115,1994,6516,6259,257,3.9
"19115",19,115,1995,6596,6332,264,4
"19115",19,115,1996,6662,6375,287,4.3
"19115",19,115,1997,5851,5588,263,4.5
"19115",19,115,1998,5365,5181,184,3.4
"19115",19,115,1999,5538,5353,185,3.3
"19115",19,115,2000,6236,6054,182,2.9
"19115",19,115,2001,6298,6080,218,3.5
"19115",19,115,2002,6340,6048,292,4.6
"19115",19,115,2003,6270,5978,292,4.7
"19115",19,115,2004,6199,5916,283,4.6
"19115",19,115,2005,6259,5984,275,4.4
"19115",19,115,2006,6432,6188,244,3.8
"19115",19,115,2007,6431,6196,235,3.7
"19115",19,115,2008,6374,6066,308,4.8
"19115",19,115,2009,5983,5488,495,8.3
"19115",19,115,2010,5964,5531,433,7.3
"19115",19,115,2011,5905,5545,360,6.1
"19115",19,115,2012,5788,5471,317,5.5
"19115",19,115,2013,5851,5555,296,5.1
"19115",19,115,2014,5942,5675,267,4.5
"19115",19,115,2015,6029,5799,230,3.8
"19115",19,115,2016,6111,5872,239,3.9
"19115",19,115,2017,6053,5853,200,3.3
"19117",19,117,1990,4269,4006,263,6.2
"19117",19,117,1991,4300,4061,239,5.6
"19117",19,117,1992,4425,4141,284,6.4
"19117",19,117,1993,4404,4126,278,6.3
"19117",19,117,1994,4412,4190,222,5
"19117",19,117,1995,4150,3924,226,5.4
"19117",19,117,1996,4011,3812,199,5
"19117",19,117,1997,4024,3857,167,4.2
"19117",19,117,1998,4102,3954,148,3.6
"19117",19,117,1999,4102,3966,136,3.3
"19117",19,117,2000,4732,4602,130,2.7
"19117",19,117,2001,4888,4720,168,3.4
"19117",19,117,2002,4872,4653,219,4.5
"19117",19,117,2003,4832,4576,256,5.3
"19117",19,117,2004,4885,4620,265,5.4
"19117",19,117,2005,4838,4588,250,5.2
"19117",19,117,2006,4945,4741,204,4.1
"19117",19,117,2007,4774,4590,184,3.9
"19117",19,117,2008,4656,4463,193,4.1
"19117",19,117,2009,4690,4390,300,6.4
"19117",19,117,2010,4233,3974,259,6.1
"19117",19,117,2011,4185,3964,221,5.3
"19117",19,117,2012,4184,3985,199,4.8
"19117",19,117,2013,4246,4047,199,4.7
"19117",19,117,2014,4317,4149,168,3.9
"19117",19,117,2015,4405,4248,157,3.6
"19117",19,117,2016,4388,4249,139,3.2
"19117",19,117,2017,4364,4240,124,2.8
"19119",19,119,1990,5660,5538,122,2.2
"19119",19,119,1991,5667,5535,132,2.3
"19119",19,119,1992,5908,5762,146,2.5
"19119",19,119,1993,5926,5761,165,2.8
"19119",19,119,1994,5923,5779,144,2.4
"19119",19,119,1995,5855,5696,159,2.7
"19119",19,119,1996,5967,5810,157,2.6
"19119",19,119,1997,5923,5794,129,2.2
"19119",19,119,1998,5675,5543,132,2.3
"19119",19,119,1999,5600,5499,101,1.8
"19119",19,119,2000,6351,6225,126,2
"19119",19,119,2001,6592,6436,156,2.4
"19119",19,119,2002,6509,6292,217,3.3
"19119",19,119,2003,6275,6051,224,3.6
"19119",19,119,2004,6202,6001,201,3.2
"19119",19,119,2005,6452,6264,188,2.9
"19119",19,119,2006,6666,6513,153,2.3
"19119",19,119,2007,6681,6521,160,2.4
"19119",19,119,2008,6830,6648,182,2.7
"19119",19,119,2009,6922,6626,296,4.3
"19119",19,119,2010,6405,6158,247,3.9
"19119",19,119,2011,6775,6564,211,3.1
"19119",19,119,2012,6834,6632,202,3
"19119",19,119,2013,6854,6656,198,2.9
"19119",19,119,2014,7026,6847,179,2.5
"19119",19,119,2015,7068,6925,143,2
"19119",19,119,2016,7096,6952,144,2
"19119",19,119,2017,6992,6869,123,1.8
"19121",19,121,1990,6375,6092,283,4.4
"19121",19,121,1991,6394,6036,358,5.6
"19121",19,121,1992,6477,6145,332,5.1
"19121",19,121,1993,7037,6724,313,4.4
"19121",19,121,1994,7452,7144,308,4.1
"19121",19,121,1995,7597,7279,318,4.2
"19121",19,121,1996,7763,7472,291,3.7
"19121",19,121,1997,7605,7321,284,3.7
"19121",19,121,1998,7711,7496,215,2.8
"19121",19,121,1999,7684,7440,244,3.2
"19121",19,121,2000,7599,7366,233,3.1
"19121",19,121,2001,7698,7437,261,3.4
"19121",19,121,2002,7992,7662,330,4.1
"19121",19,121,2003,7848,7494,354,4.5
"19121",19,121,2004,7957,7581,376,4.7
"19121",19,121,2005,8141,7771,370,4.5
"19121",19,121,2006,8400,8068,332,4
"19121",19,121,2007,8278,7937,341,4.1
"19121",19,121,2008,8330,7927,403,4.8
"19121",19,121,2009,8276,7718,558,6.7
"19121",19,121,2010,8460,7917,543,6.4
"19121",19,121,2011,8274,7781,493,6
"19121",19,121,2012,8136,7683,453,5.6
"19121",19,121,2013,8092,7681,411,5.1
"19121",19,121,2014,8243,7870,373,4.5
"19121",19,121,2015,8241,7916,325,3.9
"19121",19,121,2016,8261,7969,292,3.5
"19121",19,121,2017,8315,8015,300,3.6
"19123",19,123,1990,10556,10131,425,4
"19123",19,123,1991,10614,10128,486,4.6
"19123",19,123,1992,10822,10402,420,3.9
"19123",19,123,1993,11122,10688,434,3.9
"19123",19,123,1994,11386,11052,334,2.9
"19123",19,123,1995,11263,10877,386,3.4
"19123",19,123,1996,11191,10821,370,3.3
"19123",19,123,1997,11494,11181,313,2.7
"19123",19,123,1998,11452,11178,274,2.4
"19123",19,123,1999,11746,11478,268,2.3
"19123",19,123,2000,11507,11237,270,2.3
"19123",19,123,2001,11789,11380,409,3.5
"19123",19,123,2002,11635,11117,518,4.5
"19123",19,123,2003,11298,10747,551,4.9
"19123",19,123,2004,11469,10963,506,4.4
"19123",19,123,2005,11647,11149,498,4.3
"19123",19,123,2006,11829,11396,433,3.7
"19123",19,123,2007,11747,11322,425,3.6
"19123",19,123,2008,11816,11276,540,4.6
"19123",19,123,2009,11852,10870,982,8.3
"19123",19,123,2010,11915,11114,801,6.7
"19123",19,123,2011,11834,11144,690,5.8
"19123",19,123,2012,11638,11035,603,5.2
"19123",19,123,2013,11653,11092,561,4.8
"19123",19,123,2014,11877,11356,521,4.4
"19123",19,123,2015,11844,11372,472,4
"19123",19,123,2016,11815,11377,438,3.7
"19123",19,123,2017,11468,11092,376,3.3
"19125",19,125,1990,15768,15170,598,3.8
"19125",19,125,1991,15939,15317,622,3.9
"19125",19,125,1992,16402,15844,558,3.4
"19125",19,125,1993,17123,16521,602,3.5
"19125",19,125,1994,17197,16654,543,3.2
"19125",19,125,1995,17809,17221,588,3.3
"19125",19,125,1996,18300,17709,591,3.2
"19125",19,125,1997,18333,17797,536,2.9
"19125",19,125,1998,18266,17803,463,2.5
"19125",19,125,1999,18341,17943,398,2.2
"19125",19,125,2000,17580,17192,388,2.2
"19125",19,125,2001,17737,17149,588,3.3
"19125",19,125,2002,17588,16826,762,4.3
"19125",19,125,2003,16967,16186,781,4.6
"19125",19,125,2004,17023,16299,724,4.3
"19125",19,125,2005,17599,16904,695,3.9
"19125",19,125,2006,17894,17272,622,3.5
"19125",19,125,2007,17815,17179,636,3.6
"19125",19,125,2008,17807,17088,719,4
"19125",19,125,2009,17487,16320,1167,6.7
"19125",19,125,2010,17600,16557,1043,5.9
"19125",19,125,2011,17163,16229,934,5.4
"19125",19,125,2012,17065,16245,820,4.8
"19125",19,125,2013,17322,16550,772,4.5
"19125",19,125,2014,17462,16797,665,3.8
"19125",19,125,2015,17446,16871,575,3.3
"19125",19,125,2016,17469,16944,525,3
"19125",19,125,2017,17337,16877,460,2.7
"19127",19,127,1990,20029,19342,687,3.4
"19127",19,127,1991,20209,19471,738,3.7
"19127",19,127,1992,20248,19467,781,3.9
"19127",19,127,1993,20770,19925,845,4.1
"19127",19,127,1994,21210,20613,597,2.8
"19127",19,127,1995,21139,20461,678,3.2
"19127",19,127,1996,21249,20530,719,3.4
"19127",19,127,1997,20853,20233,620,3
"19127",19,127,1998,20759,20185,574,2.8
"19127",19,127,1999,20600,20133,467,2.3
"19127",19,127,2000,20554,20001,553,2.7
"19127",19,127,2001,20891,20224,667,3.2
"19127",19,127,2002,20927,20075,852,4.1
"19127",19,127,2003,20620,19517,1103,5.3
"19127",19,127,2004,20391,19344,1047,5.1
"19127",19,127,2005,20482,19505,977,4.8
"19127",19,127,2006,20816,20041,775,3.7
"19127",19,127,2007,20469,19644,825,4
"19127",19,127,2008,20502,19442,1060,5.2
"19127",19,127,2009,20623,19113,1510,7.3
"19127",19,127,2010,20156,18778,1378,6.8
"19127",19,127,2011,20047,18729,1318,6.6
"19127",19,127,2012,19800,18529,1271,6.4
"19127",19,127,2013,19801,18610,1191,6
"19127",19,127,2014,19863,18793,1070,5.4
"19127",19,127,2015,19452,18459,993,5.1
"19127",19,127,2016,19159,18224,935,4.9
"19127",19,127,2017,18248,17406,842,4.6
"19129",19,129,1990,6432,6200,232,3.6
"19129",19,129,1991,6573,6343,230,3.5
"19129",19,129,1992,6606,6341,265,4
"19129",19,129,1993,6544,6321,223,3.4
"19129",19,129,1994,6651,6440,211,3.2
"19129",19,129,1995,6287,6088,199,3.2
"19129",19,129,1996,6357,6163,194,3.1
"19129",19,129,1997,6206,6024,182,2.9
"19129",19,129,1998,6039,5902,137,2.3
"19129",19,129,1999,6381,6259,122,1.9
"19129",19,129,2000,7882,7726,156,2
"19129",19,129,2001,7892,7667,225,2.9
"19129",19,129,2002,8162,7938,224,2.7
"19129",19,129,2003,8119,7808,311,3.8
"19129",19,129,2004,7984,7652,332,4.2
"19129",19,129,2005,8177,7845,332,4.1
"19129",19,129,2006,8421,8104,317,3.8
"19129",19,129,2007,8086,7787,299,3.7
"19129",19,129,2008,8110,7811,299,3.7
"19129",19,129,2009,7963,7598,365,4.6
"19129",19,129,2010,7610,7211,399,5.2
"19129",19,129,2011,7447,7079,368,4.9
"19129",19,129,2012,7264,6930,334,4.6
"19129",19,129,2013,7327,7005,322,4.4
"19129",19,129,2014,7409,7085,324,4.4
"19129",19,129,2015,7430,7125,305,4.1
"19129",19,129,2016,7416,7147,269,3.6
"19129",19,129,2017,7321,7118,203,2.8
"19131",19,131,1990,5158,4953,205,4
"19131",19,131,1991,5184,4958,226,4.4
"19131",19,131,1992,5298,5099,199,3.8
"19131",19,131,1993,5498,5290,208,3.8
"19131",19,131,1994,5756,5534,222,3.9
"19131",19,131,1995,5783,5598,185,3.2
"19131",19,131,1996,5796,5603,193,3.3
"19131",19,131,1997,5706,5574,132,2.3
"19131",19,131,1998,5525,5374,151,2.7
"19131",19,131,1999,5529,5364,165,3
"19131",19,131,2000,5445,5297,148,2.7
"19131",19,131,2001,5676,5510,166,2.9
"19131",19,131,2002,5482,5286,196,3.6
"19131",19,131,2003,5359,5159,200,3.7
"19131",19,131,2004,5313,5109,204,3.8
"19131",19,131,2005,5347,5120,227,4.2
"19131",19,131,2006,5447,5263,184,3.4
"19131",19,131,2007,5571,5386,185,3.3
"19131",19,131,2008,5761,5525,236,4.1
"19131",19,131,2009,5836,5493,343,5.9
"19131",19,131,2010,5734,5437,297,5.2
"19131",19,131,2011,5652,5384,268,4.7
"19131",19,131,2012,5552,5299,253,4.6
"19131",19,131,2013,5509,5272,237,4.3
"19131",19,131,2014,5469,5274,195,3.6
"19131",19,131,2015,5599,5440,159,2.8
"19131",19,131,2016,5887,5733,154,2.6
"19131",19,131,2017,5765,5640,125,2.2
"19133",19,133,1990,4465,4303,162,3.6
"19133",19,133,1991,4457,4265,192,4.3
"19133",19,133,1992,4820,4613,207,4.3
"19133",19,133,1993,5166,4963,203,3.9
"19133",19,133,1994,5246,5072,174,3.3
"19133",19,133,1995,5259,5084,175,3.3
"19133",19,133,1996,5222,5037,185,3.5
"19133",19,133,1997,5398,5232,166,3.1
"19133",19,133,1998,5079,4902,177,3.5
"19133",19,133,1999,5077,4918,159,3.1
"19133",19,133,2000,4974,4821,153,3.1
"19133",19,133,2001,5105,4919,186,3.6
"19133",19,133,2002,5039,4823,216,4.3
"19133",19,133,2003,4869,4616,253,5.2
"19133",19,133,2004,4795,4523,272,5.7
"19133",19,133,2005,4712,4443,269,5.7
"19133",19,133,2006,4665,4411,254,5.4
"19133",19,133,2007,4585,4334,251,5.5
"19133",19,133,2008,4614,4364,250,5.4
"19133",19,133,2009,4568,4226,342,7.5
"19133",19,133,2010,4887,4535,352,7.2
"19133",19,133,2011,4774,4443,331,6.9
"19133",19,133,2012,4535,4245,290,6.4
"19133",19,133,2013,4625,4360,265,5.7
"19133",19,133,2014,4763,4526,237,5
"19133",19,133,2015,4766,4555,211,4.4
"19133",19,133,2016,4732,4539,193,4.1
"19133",19,133,2017,4520,4353,167,3.7
"19135",19,135,1990,3741,3534,207,5.5
"19135",19,135,1991,3919,3688,231,5.9
"19135",19,135,1992,3942,3737,205,5.2
"19135",19,135,1993,4103,3897,206,5
"19135",19,135,1994,4212,4048,164,3.9
"19135",19,135,1995,4314,4121,193,4.5
"19135",19,135,1996,4218,4042,176,4.2
"19135",19,135,1997,4230,4059,171,4
"19135",19,135,1998,4219,4090,129,3.1
"19135",19,135,1999,4192,4067,125,3
"19135",19,135,2000,3895,3776,119,3.1
"19135",19,135,2001,3837,3670,167,4.4
"19135",19,135,2002,3743,3558,185,4.9
"19135",19,135,2003,3485,3286,199,5.7
"19135",19,135,2004,3723,3527,196,5.3
"19135",19,135,2005,3873,3678,195,5
"19135",19,135,2006,4212,4044,168,4
"19135",19,135,2007,4174,4002,172,4.1
"19135",19,135,2008,4215,4026,189,4.5
"19135",19,135,2009,4337,4008,329,7.6
"19135",19,135,2010,4097,3801,296,7.2
"19135",19,135,2011,4034,3763,271,6.7
"19135",19,135,2012,3979,3750,229,5.8
"19135",19,135,2013,4026,3797,229,5.7
"19135",19,135,2014,4080,3875,205,5
"19135",19,135,2015,4040,3860,180,4.5
"19135",19,135,2016,3962,3780,182,4.6
"19135",19,135,2017,3900,3751,149,3.8
"19137",19,137,1990,6127,5843,284,4.6
"19137",19,137,1991,6006,5754,252,4.2
"19137",19,137,1992,5994,5711,283,4.7
"19137",19,137,1993,6147,5895,252,4.1
"19137",19,137,1994,6244,6011,233,3.7
"19137",19,137,1995,6137,5906,231,3.8
"19137",19,137,1996,6443,6072,371,5.8
"19137",19,137,1997,6350,6049,301,4.7
"19137",19,137,1998,6110,5913,197,3.2
"19137",19,137,1999,5936,5745,191,3.2
"19137",19,137,2000,5992,5799,193,3.2
"19137",19,137,2001,6095,5811,284,4.7
"19137",19,137,2002,5807,5495,312,5.4
"19137",19,137,2003,5679,5394,285,5
"19137",19,137,2004,5611,5376,235,4.2
"19137",19,137,2005,5853,5599,254,4.3
"19137",19,137,2006,5838,5514,324,5.5
"19137",19,137,2007,5554,5209,345,6.2
"19137",19,137,2008,5411,5099,312,5.8
"19137",19,137,2009,5271,4800,471,8.9
"19137",19,137,2010,5248,4825,423,8.1
"19137",19,137,2011,5034,4739,295,5.9
"19137",19,137,2012,5032,4776,256,5.1
"19137",19,137,2013,5123,4873,250,4.9
"19137",19,137,2014,5170,4957,213,4.1
"19137",19,137,2015,5174,4989,185,3.6
"19137",19,137,2016,5119,4939,180,3.5
"19137",19,137,2017,4985,4827,158,3.2
"19139",19,139,1990,20887,19839,1048,5
"19139",19,139,1991,20968,19790,1178,5.6
"19139",19,139,1992,21466,20321,1145,5.3
"19139",19,139,1993,21873,20981,892,4.1
"19139",19,139,1994,21646,20867,779,3.6
"19139",19,139,1995,21730,21006,724,3.3
"19139",19,139,1996,22107,21093,1014,4.6
"19139",19,139,1997,21443,20589,854,4
"19139",19,139,1998,21989,21388,601,2.7
"19139",19,139,1999,21780,21173,607,2.8
"19139",19,139,2000,22224,21628,596,2.7
"19139",19,139,2001,22513,21713,800,3.6
"19139",19,139,2002,22578,21660,918,4.1
"19139",19,139,2003,22386,21426,960,4.3
"19139",19,139,2004,22588,21652,936,4.1
"19139",19,139,2005,23383,22478,905,3.9
"19139",19,139,2006,24051,23280,771,3.2
"19139",19,139,2007,23997,23188,809,3.4
"19139",19,139,2008,23935,22878,1057,4.4
"19139",19,139,2009,23877,21801,2076,8.7
"19139",19,139,2010,21815,20074,1741,8
"19139",19,139,2011,21410,20002,1408,6.6
"19139",19,139,2012,21239,20023,1216,5.7
"19139",19,139,2013,21699,20567,1132,5.2
"19139",19,139,2014,22149,21145,1004,4.5
"19139",19,139,2015,22230,21365,865,3.9
"19139",19,139,2016,22461,21608,853,3.8
"19139",19,139,2017,21819,21096,723,3.3
"19141",19,141,1990,7323,7163,160,2.2
"19141",19,141,1991,7444,7264,180,2.4
"19141",19,141,1992,7650,7433,217,2.8
"19141",19,141,1993,7934,7731,203,2.6
"19141",19,141,1994,8083,7881,202,2.5
"19141",19,141,1995,8045,7830,215,2.7
"19141",19,141,1996,8186,7996,190,2.3
"19141",19,141,1997,8097,7910,187,2.3
"19141",19,141,1998,7881,7687,194,2.5
"19141",19,141,1999,7910,7737,173,2.2
"19141",19,141,2000,7751,7576,175,2.3
"19141",19,141,2001,7945,7739,206,2.6
"19141",19,141,2002,7790,7544,246,3.2
"19141",19,141,2003,7473,7183,290,3.9
"19141",19,141,2004,7385,7109,276,3.7
"19141",19,141,2005,7600,7312,288,3.8
"19141",19,141,2006,7730,7496,234,3
"19141",19,141,2007,7741,7508,233,3
"19141",19,141,2008,7798,7537,261,3.3
"19141",19,141,2009,7889,7471,418,5.3
"19141",19,141,2010,8146,7767,379,4.7
"19141",19,141,2011,8104,7765,339,4.2
"19141",19,141,2012,8041,7735,306,3.8
"19141",19,141,2013,8043,7751,292,3.6
"19141",19,141,2014,8249,7980,269,3.3
"19141",19,141,2015,8436,8196,240,2.8
"19141",19,141,2016,8371,8140,231,2.8
"19141",19,141,2017,8038,7842,196,2.4
"19143",19,143,1990,3516,3411,105,3
"19143",19,143,1991,3592,3476,116,3.2
"19143",19,143,1992,3706,3584,122,3.3
"19143",19,143,1993,3642,3531,111,3
"19143",19,143,1994,3710,3595,115,3.1
"19143",19,143,1995,3755,3627,128,3.4
"19143",19,143,1996,3871,3757,114,2.9
"19143",19,143,1997,3793,3688,105,2.8
"19143",19,143,1998,3685,3581,104,2.8
"19143",19,143,1999,3967,3874,93,2.3
"19143",19,143,2000,3603,3515,88,2.4
"19143",19,143,2001,3696,3581,115,3.1
"19143",19,143,2002,3569,3459,110,3.1
"19143",19,143,2003,3478,3346,132,3.8
"19143",19,143,2004,3433,3304,129,3.8
"19143",19,143,2005,3439,3303,136,4
"19143",19,143,2006,3418,3300,118,3.5
"19143",19,143,2007,3349,3238,111,3.3
"19143",19,143,2008,3394,3263,131,3.9
"19143",19,143,2009,3324,3119,205,6.2
"19143",19,143,2010,3670,3489,181,4.9
"19143",19,143,2011,3527,3370,157,4.5
"19143",19,143,2012,3383,3243,140,4.1
"19143",19,143,2013,3410,3279,131,3.8
"19143",19,143,2014,3465,3350,115,3.3
"19143",19,143,2015,3547,3445,102,2.9
"19143",19,143,2016,3647,3551,96,2.6
"19143",19,143,2017,3579,3504,75,2.1
"19145",19,145,1990,8145,7744,401,4.9
"19145",19,145,1991,8188,7704,484,5.9
"19145",19,145,1992,8561,8098,463,5.4
"19145",19,145,1993,8975,8627,348,3.9
"19145",19,145,1994,9307,8976,331,3.6
"19145",19,145,1995,9252,8924,328,3.5
"19145",19,145,1996,9469,9111,358,3.8
"19145",19,145,1997,9398,9115,283,3
"19145",19,145,1998,8994,8740,254,2.8
"19145",19,145,1999,9074,8851,223,2.5
"19145",19,145,2000,8334,8070,264,3.2
"19145",19,145,2001,7712,7324,388,5
"19145",19,145,2002,7596,7232,364,4.8
"19145",19,145,2003,7550,7187,363,4.8
"19145",19,145,2004,7718,7395,323,4.2
"19145",19,145,2005,8118,7807,311,3.8
"19145",19,145,2006,8361,8038,323,3.9
"19145",19,145,2007,8375,7991,384,4.6
"19145",19,145,2008,8154,7761,393,4.8
"19145",19,145,2009,7864,7189,675,8.6
"19145",19,145,2010,7131,6648,483,6.8
"19145",19,145,2011,6856,6465,391,5.7
"19145",19,145,2012,6675,6316,359,5.4
"19145",19,145,2013,6555,6209,346,5.3
"19145",19,145,2014,6608,6315,293,4.4
"19145",19,145,2015,6576,6302,274,4.2
"19145",19,145,2016,6475,6151,324,5
"19145",19,145,2017,6284,6032,252,4
"19147",19,147,1990,4848,4663,185,3.8
"19147",19,147,1991,4926,4738,188,3.8
"19147",19,147,1992,5232,5075,157,3
"19147",19,147,1993,5302,5122,180,3.4
"19147",19,147,1994,5420,5242,178,3.3
"19147",19,147,1995,5356,5187,169,3.2
"19147",19,147,1996,5617,5447,170,3
"19147",19,147,1997,5595,5454,141,2.5
"19147",19,147,1998,5373,5236,137,2.5
"19147",19,147,1999,5462,5327,135,2.5
"19147",19,147,2000,5193,5074,119,2.3
"19147",19,147,2001,5335,5137,198,3.7
"19147",19,147,2002,5151,4964,187,3.6
"19147",19,147,2003,5006,4812,194,3.9
"19147",19,147,2004,5008,4817,191,3.8
"19147",19,147,2005,5100,4898,202,4
"19147",19,147,2006,5361,5188,173,3.2
"19147",19,147,2007,5437,5254,183,3.4
"19147",19,147,2008,5440,5208,232,4.3
"19147",19,147,2009,5320,4943,377,7.1
"19147",19,147,2010,4845,4553,292,6
"19147",19,147,2011,4774,4550,224,4.7
"19147",19,147,2012,4757,4554,203,4.3
"19147",19,147,2013,4777,4598,179,3.7
"19147",19,147,2014,4860,4685,175,3.6
"19147",19,147,2015,4868,4717,151,3.1
"19147",19,147,2016,4973,4819,154,3.1
"19147",19,147,2017,4905,4773,132,2.7
"19149",19,149,1990,11834,11464,370,3.1
"19149",19,149,1991,12382,11977,405,3.3
"19149",19,149,1992,12610,12171,439,3.5
"19149",19,149,1993,12912,12555,357,2.8
"19149",19,149,1994,13096,12734,362,2.8
"19149",19,149,1995,12894,12391,503,3.9
"19149",19,149,1996,13189,12700,489,3.7
"19149",19,149,1997,13177,12765,412,3.1
"19149",19,149,1998,12671,12318,353,2.8
"19149",19,149,1999,13153,12830,323,2.5
"19149",19,149,2000,13476,13137,339,2.5
"19149",19,149,2001,13876,13476,400,2.9
"19149",19,149,2002,13854,13383,471,3.4
"19149",19,149,2003,13774,13251,523,3.8
"19149",19,149,2004,13618,13093,525,3.9
"19149",19,149,2005,14087,13594,493,3.5
"19149",19,149,2006,14410,13958,452,3.1
"19149",19,149,2007,14433,13994,439,3
"19149",19,149,2008,14333,13851,482,3.4
"19149",19,149,2009,14499,13824,675,4.7
"19149",19,149,2010,14568,13916,652,4.5
"19149",19,149,2011,14248,13613,635,4.5
"19149",19,149,2012,14192,13611,581,4.1
"19149",19,149,2013,14492,13912,580,4
"19149",19,149,2014,14686,14183,503,3.4
"19149",19,149,2015,14801,14381,420,2.8
"19149",19,149,2016,15028,14645,383,2.5
"19149",19,149,2017,14570,14217,353,2.4
"19151",19,151,1990,4344,4249,95,2.2
"19151",19,151,1991,4320,4189,131,3
"19151",19,151,1992,4335,4187,148,3.4
"19151",19,151,1993,4252,4134,118,2.8
"19151",19,151,1994,4356,4240,116,2.7
"19151",19,151,1995,4395,4233,162,3.7
"19151",19,151,1996,4436,4305,131,3
"19151",19,151,1997,4378,4276,102,2.3
"19151",19,151,1998,4223,4126,97,2.3
"19151",19,151,1999,4146,4005,141,3.4
"19151",19,151,2000,4190,4077,113,2.7
"19151",19,151,2001,4403,4251,152,3.5
"19151",19,151,2002,4168,3982,186,4.5
"19151",19,151,2003,3845,3625,220,5.7
"19151",19,151,2004,3801,3603,198,5.2
"19151",19,151,2005,3862,3702,160,4.1
"19151",19,151,2006,4101,3976,125,3
"19151",19,151,2007,4132,4001,131,3.2
"19151",19,151,2008,4239,4104,135,3.2
"19151",19,151,2009,4132,3895,237,5.7
"19151",19,151,2010,4057,3850,207,5.1
"19151",19,151,2011,4081,3902,179,4.4
"19151",19,151,2012,4162,3994,168,4
"19151",19,151,2013,4193,4034,159,3.8
"19151",19,151,2014,4334,4183,151,3.5
"19151",19,151,2015,4313,4181,132,3.1
"19151",19,151,2016,4323,4200,123,2.8
"19151",19,151,2017,4118,4016,102,2.5
"19153",19,153,1990,189893,183553,6340,3.3
"19153",19,153,1991,193821,186896,6925,3.6
"19153",19,153,1992,200241,193212,7029,3.5
"19153",19,153,1993,208701,201373,7328,3.5
"19153",19,153,1994,210621,204824,5797,2.8
"19153",19,153,1995,213144,207632,5512,2.6
"19153",19,153,1996,215882,210029,5853,2.7
"19153",19,153,1997,214264,208793,5471,2.6
"19153",19,153,1998,215762,211159,4603,2.1
"19153",19,153,1999,215075,210922,4153,1.9
"19153",19,153,2000,214484,209530,4954,2.3
"19153",19,153,2001,218483,212153,6330,2.9
"19153",19,153,2002,226066,217763,8303,3.7
"19153",19,153,2003,222159,212939,9220,4.2
"19153",19,153,2004,223295,213356,9939,4.5
"19153",19,153,2005,227980,218864,9116,4
"19153",19,153,2006,233878,225888,7990,3.4
"19153",19,153,2007,237576,229306,8270,3.5
"19153",19,153,2008,240951,231148,9803,4.1
"19153",19,153,2009,243967,229011,14956,6.1
"19153",19,153,2010,244947,230346,14601,6
"19153",19,153,2011,242973,229206,13767,5.7
"19153",19,153,2012,244144,231495,12649,5.2
"19153",19,153,2013,250429,238383,12046,4.8
"19153",19,153,2014,256028,245209,10819,4.2
"19153",19,153,2015,255841,246362,9479,3.7
"19153",19,153,2016,257675,248763,8912,3.5
"19153",19,153,2017,259419,251455,7964,3.1
"19155",19,155,1990,43659,41923,1736,4
"19155",19,155,1991,43988,42013,1975,4.5
"19155",19,155,1992,44972,42839,2133,4.7
"19155",19,155,1993,46738,44819,1919,4.1
"19155",19,155,1994,46895,45259,1636,3.5
"19155",19,155,1995,47198,45721,1477,3.1
"19155",19,155,1996,48223,46737,1486,3.1
"19155",19,155,1997,48355,46746,1609,3.3
"19155",19,155,1998,48387,47133,1254,2.6
"19155",19,155,1999,48697,47719,978,2
"19155",19,155,2000,47977,46857,1120,2.3
"19155",19,155,2001,47835,46347,1488,3.1
"19155",19,155,2002,49379,47728,1651,3.3
"19155",19,155,2003,48989,46665,2324,4.7
"19155",19,155,2004,48132,45732,2400,5
"19155",19,155,2005,48658,46274,2384,4.9
"19155",19,155,2006,49273,47098,2175,4.4
"19155",19,155,2007,48121,46077,2044,4.2
"19155",19,155,2008,48610,46542,2068,4.3
"19155",19,155,2009,48372,45904,2468,5.1
"19155",19,155,2010,50344,47437,2907,5.8
"19155",19,155,2011,49538,46770,2768,5.6
"19155",19,155,2012,48462,46011,2451,5.1
"19155",19,155,2013,48637,46415,2222,4.6
"19155",19,155,2014,49263,47151,2112,4.3
"19155",19,155,2015,49037,47229,1808,3.7
"19155",19,155,2016,48330,46694,1636,3.4
"19155",19,155,2017,48034,46694,1340,2.8
"19157",19,157,1990,9994,9532,462,4.6
"19157",19,157,1991,9822,9379,443,4.5
"19157",19,157,1992,10170,9730,440,4.3
"19157",19,157,1993,10364,9862,502,4.8
"19157",19,157,1994,10486,10070,416,4
"19157",19,157,1995,10556,10139,417,4
"19157",19,157,1996,10553,10051,502,4.8
"19157",19,157,1997,10444,10062,382,3.7
"19157",19,157,1998,10368,10040,328,3.2
"19157",19,157,1999,10350,10059,291,2.8
"19157",19,157,2000,10338,10062,276,2.7
"19157",19,157,2001,10695,10351,344,3.2
"19157",19,157,2002,10829,10391,438,4
"19157",19,157,2003,10254,9772,482,4.7
"19157",19,157,2004,10173,9694,479,4.7
"19157",19,157,2005,10271,9800,471,4.6
"19157",19,157,2006,10627,10221,406,3.8
"19157",19,157,2007,10749,10329,420,3.9
"19157",19,157,2008,10485,10004,481,4.6
"19157",19,157,2009,10300,9598,702,6.8
"19157",19,157,2010,10570,9958,612,5.8
"19157",19,157,2011,10396,9817,579,5.6
"19157",19,157,2012,10157,9663,494,4.9
"19157",19,157,2013,10345,9866,479,4.6
"19157",19,157,2014,10420,9977,443,4.3
"19157",19,157,2015,10517,10134,383,3.6
"19157",19,157,2016,10438,10080,358,3.4
"19157",19,157,2017,10440,10110,330,3.2
"19159",19,159,1990,2560,2456,104,4.1
"19159",19,159,1991,2615,2508,107,4.1
"19159",19,159,1992,2701,2598,103,3.8
"19159",19,159,1993,2682,2584,98,3.7
"19159",19,159,1994,2737,2637,100,3.7
"19159",19,159,1995,2669,2563,106,4
"19159",19,159,1996,2741,2641,100,3.6
"19159",19,159,1997,2660,2583,77,2.9
"19159",19,159,1998,2551,2469,82,3.2
"19159",19,159,1999,2643,2570,73,2.8
"19159",19,159,2000,2581,2505,76,2.9
"19159",19,159,2001,2681,2597,84,3.1
"19159",19,159,2002,2614,2516,98,3.7
"19159",19,159,2003,2544,2425,119,4.7
"19159",19,159,2004,2480,2354,126,5.1
"19159",19,159,2005,2428,2317,111,4.6
"19159",19,159,2006,2472,2373,99,4
"19159",19,159,2007,2455,2353,102,4.2
"19159",19,159,2008,2426,2315,111,4.6
"19159",19,159,2009,2453,2317,136,5.5
"19159",19,159,2010,2615,2492,123,4.7
"19159",19,159,2011,2600,2481,119,4.6
"19159",19,159,2012,2538,2426,112,4.4
"19159",19,159,2013,2515,2407,108,4.3
"19159",19,159,2014,2535,2437,98,3.9
"19159",19,159,2015,2569,2482,87,3.4
"19159",19,159,2016,2610,2519,91,3.5
"19159",19,159,2017,2569,2490,79,3.1
"19161",19,161,1990,5872,5634,238,4.1
"19161",19,161,1991,5919,5694,225,3.8
"19161",19,161,1992,6072,5893,179,2.9
"19161",19,161,1993,6040,5843,197,3.3
"19161",19,161,1994,6177,5958,219,3.5
"19161",19,161,1995,6080,5849,231,3.8
"19161",19,161,1996,6096,5870,226,3.7
"19161",19,161,1997,6250,6052,198,3.2
"19161",19,161,1998,6031,5844,187,3.1
"19161",19,161,1999,5973,5818,155,2.6
"19161",19,161,2000,5944,5791,153,2.6
"19161",19,161,2001,6138,5958,180,2.9
"19161",19,161,2002,5985,5778,207,3.5
"19161",19,161,2003,5768,5532,236,4.1
"19161",19,161,2004,5808,5578,230,4
"19161",19,161,2005,5757,5531,226,3.9
"19161",19,161,2006,5883,5687,196,3.3
"19161",19,161,2007,5798,5599,199,3.4
"19161",19,161,2008,5782,5566,216,3.7
"19161",19,161,2009,5800,5505,295,5.1
"19161",19,161,2010,5716,5449,267,4.7
"19161",19,161,2011,5617,5369,248,4.4
"19161",19,161,2012,5503,5270,233,4.2
"19161",19,161,2013,5516,5284,232,4.2
"19161",19,161,2014,5564,5346,218,3.9
"19161",19,161,2015,5646,5457,189,3.3
"19161",19,161,2016,5502,5337,165,3
"19161",19,161,2017,5358,5206,152,2.8
"19163",19,163,1990,78812,75375,3437,4.4
"19163",19,163,1991,80831,76848,3983,4.9
"19163",19,163,1992,83315,78779,4536,5.4
"19163",19,163,1993,85465,81412,4053,4.7
"19163",19,163,1994,84361,81044,3317,3.9
"19163",19,163,1995,83953,80987,2966,3.5
"19163",19,163,1996,85301,82218,3083,3.6
"19163",19,163,1997,85920,83291,2629,3.1
"19163",19,163,1998,86932,84613,2319,2.7
"19163",19,163,1999,86354,83692,2662,3.1
"19163",19,163,2000,85499,82756,2743,3.2
"19163",19,163,2001,85495,82085,3410,4
"19163",19,163,2002,87483,83445,4038,4.6
"19163",19,163,2003,85740,81639,4101,4.8
"19163",19,163,2004,85746,81630,4116,4.8
"19163",19,163,2005,88136,84230,3906,4.4
"19163",19,163,2006,88926,85553,3373,3.8
"19163",19,163,2007,88870,85553,3317,3.7
"19163",19,163,2008,90457,86607,3850,4.3
"19163",19,163,2009,90578,84168,6410,7.1
"19163",19,163,2010,86880,81101,5779,6.7
"19163",19,163,2011,86747,81405,5342,6.2
"19163",19,163,2012,86915,81912,5003,5.8
"19163",19,163,2013,87786,82863,4923,5.6
"19163",19,163,2014,88611,83997,4614,5.2
"19163",19,163,2015,87585,83448,4137,4.7
"19163",19,163,2016,86457,82537,3920,4.5
"19163",19,163,2017,86085,82899,3186,3.7
"19165",19,165,1990,6553,6281,272,4.2
"19165",19,165,1991,6676,6322,354,5.3
"19165",19,165,1992,6718,6365,353,5.3
"19165",19,165,1993,6829,6524,305,4.5
"19165",19,165,1994,6934,6630,304,4.4
"19165",19,165,1995,6857,6599,258,3.8
"19165",19,165,1996,7248,6993,255,3.5
"19165",19,165,1997,7202,6979,223,3.1
"19165",19,165,1998,6861,6691,170,2.5
"19165",19,165,1999,6968,6804,164,2.4
"19165",19,165,2000,7066,6902,164,2.3
"19165",19,165,2001,7346,7150,196,2.7
"19165",19,165,2002,7128,6888,240,3.4
"19165",19,165,2003,6944,6687,257,3.7
"19165",19,165,2004,6869,6608,261,3.8
"19165",19,165,2005,7069,6807,262,3.7
"19165",19,165,2006,7417,7183,234,3.2
"19165",19,165,2007,7539,7295,244,3.2
"19165",19,165,2008,7585,7352,233,3.1
"19165",19,165,2009,7600,7296,304,4
"19165",19,165,2010,6612,6312,300,4.5
"19165",19,165,2011,6717,6427,290,4.3
"19165",19,165,2012,6992,6729,263,3.8
"19165",19,165,2013,6942,6681,261,3.8
"19165",19,165,2014,7063,6842,221,3.1
"19165",19,165,2015,7023,6821,202,2.9
"19165",19,165,2016,6832,6632,200,2.9
"19165",19,165,2017,6678,6516,162,2.4
"19167",19,167,1990,15285,14856,429,2.8
"19167",19,167,1991,15494,15056,438,2.8
"19167",19,167,1992,16137,15694,443,2.7
"19167",19,167,1993,16874,16436,438,2.6
"19167",19,167,1994,17356,16857,499,2.9
"19167",19,167,1995,17295,16778,517,3
"19167",19,167,1996,17625,17091,534,3
"19167",19,167,1997,18005,17540,465,2.6
"19167",19,167,1998,17835,17356,479,2.7
"19167",19,167,1999,17819,17380,439,2.5
"19167",19,167,2000,17576,17239,337,1.9
"19167",19,167,2001,18170,17741,429,2.4
"19167",19,167,2002,18018,17517,501,2.8
"19167",19,167,2003,17951,17406,545,3
"19167",19,167,2004,18202,17663,539,3
"19167",19,167,2005,18840,18293,547,2.9
"19167",19,167,2006,19336,18863,473,2.4
"19167",19,167,2007,19339,18850,489,2.5
"19167",19,167,2008,19727,19168,559,2.8
"19167",19,167,2009,19721,18862,859,4.4
"19167",19,167,2010,19671,18900,771,3.9
"19167",19,167,2011,19529,18810,719,3.7
"19167",19,167,2012,19376,18707,669,3.5
"19167",19,167,2013,19570,18894,676,3.5
"19167",19,167,2014,20162,19570,592,2.9
"19167",19,167,2015,20773,20259,514,2.5
"19167",19,167,2016,20713,20239,474,2.3
"19167",19,167,2017,20350,19938,412,2
"19169",19,169,1990,41850,40276,1574,3.8
"19169",19,169,1991,42040,40390,1650,3.9
"19169",19,169,1992,43054,41500,1554,3.6
"19169",19,169,1993,44901,43520,1381,3.1
"19169",19,169,1994,45961,44661,1300,2.8
"19169",19,169,1995,45494,44229,1265,2.8
"19169",19,169,1996,46217,44981,1236,2.7
"19169",19,169,1997,45958,44778,1180,2.6
"19169",19,169,1998,46253,45094,1159,2.5
"19169",19,169,1999,46439,45448,991,2.1
"19169",19,169,2000,46236,45430,806,1.7
"19169",19,169,2001,46407,45433,974,2.1
"19169",19,169,2002,47937,46712,1225,2.6
"19169",19,169,2003,46960,45620,1340,2.9
"19169",19,169,2004,46473,45102,1371,3
"19169",19,169,2005,46922,45500,1422,3
"19169",19,169,2006,47827,46579,1248,2.6
"19169",19,169,2007,48044,46713,1331,2.8
"19169",19,169,2008,48815,47260,1555,3.2
"19169",19,169,2009,49361,47021,2340,4.7
"19169",19,169,2010,53344,51104,2240,4.2
"19169",19,169,2011,53207,51111,2096,3.9
"19169",19,169,2012,53328,51426,1902,3.6
"19169",19,169,2013,54763,52939,1824,3.3
"19169",19,169,2014,56709,55073,1636,2.9
"19169",19,169,2015,57467,56021,1446,2.5
"19169",19,169,2016,57038,55706,1332,2.3
"19169",19,169,2017,57279,56135,1144,2
"19171",19,171,1990,8240,7870,370,4.5
"19171",19,171,1991,8184,7761,423,5.2
"19171",19,171,1992,8165,7733,432,5.3
"19171",19,171,1993,9106,8697,409,4.5
"19171",19,171,1994,9557,9192,365,3.8
"19171",19,171,1995,9837,9461,376,3.8
"19171",19,171,1996,9656,9241,415,4.3
"19171",19,171,1997,9429,9128,301,3.2
"19171",19,171,1998,9207,8944,263,2.9
"19171",19,171,1999,9182,8911,271,3
"19171",19,171,2000,9217,8909,308,3.3
"19171",19,171,2001,9474,9139,335,3.5
"19171",19,171,2002,9215,8821,394,4.3
"19171",19,171,2003,9007,8281,726,8.1
"19171",19,171,2004,9466,8862,604,6.4
"19171",19,171,2005,8980,8482,498,5.5
"19171",19,171,2006,8966,8590,376,4.2
"19171",19,171,2007,8983,8594,389,4.3
"19171",19,171,2008,8941,8462,479,5.4
"19171",19,171,2009,8974,8326,648,7.2
"19171",19,171,2010,9357,8755,602,6.4
"19171",19,171,2011,9190,8629,561,6.1
"19171",19,171,2012,9089,8544,545,6
"19171",19,171,2013,9108,8602,506,5.6
"19171",19,171,2014,9252,8764,488,5.3
"19171",19,171,2015,9676,9251,425,4.4
"19171",19,171,2016,9780,9372,408,4.2
"19171",19,171,2017,9627,9291,336,3.5
"19173",19,173,1990,3102,2987,115,3.7
"19173",19,173,1991,3288,3144,144,4.4
"19173",19,173,1992,3222,3079,143,4.4
"19173",19,173,1993,3230,3098,132,4.1
"19173",19,173,1994,3322,3132,190,5.7
"19173",19,173,1995,3434,3261,173,5
"19173",19,173,1996,3496,3270,226,6.5
"19173",19,173,1997,3348,3164,184,5.5
"19173",19,173,1998,3289,3176,113,3.4
"19173",19,173,1999,3401,3292,109,3.2
"19173",19,173,2000,3478,3367,111,3.2
"19173",19,173,2001,3440,3299,141,4.1
"19173",19,173,2002,3349,3217,132,3.9
"19173",19,173,2003,3293,3145,148,4.5
"19173",19,173,2004,3240,3101,139,4.3
"19173",19,173,2005,3365,3237,128,3.8
"19173",19,173,2006,3397,3265,132,3.9
"19173",19,173,2007,3357,3221,136,4.1
"19173",19,173,2008,3370,3234,136,4
"19173",19,173,2009,3377,3145,232,6.9
"19173",19,173,2010,3189,3012,177,5.6
"19173",19,173,2011,3151,3002,149,4.7
"19173",19,173,2012,3142,3014,128,4.1
"19173",19,173,2013,3166,3046,120,3.8
"19173",19,173,2014,3247,3128,119,3.7
"19173",19,173,2015,3241,3138,103,3.2
"19173",19,173,2016,3234,3139,95,2.9
"19173",19,173,2017,3237,3164,73,2.3
"19175",19,175,1990,6079,5772,307,5.1
"19175",19,175,1991,6067,5703,364,6
"19175",19,175,1992,6319,6051,268,4.2
"19175",19,175,1993,6468,6171,297,4.6
"19175",19,175,1994,6357,6043,314,4.9
"19175",19,175,1995,6422,6130,292,4.5
"19175",19,175,1996,6513,6205,308,4.7
"19175",19,175,1997,6567,6325,242,3.7
"19175",19,175,1998,6573,6341,232,3.5
"19175",19,175,1999,6596,6351,245,3.7
"19175",19,175,2000,6555,6338,217,3.3
"19175",19,175,2001,6643,6395,248,3.7
"19175",19,175,2002,6519,6194,325,5
"19175",19,175,2003,6266,5910,356,5.7
"19175",19,175,2004,6251,5908,343,5.5
"19175",19,175,2005,6339,6026,313,4.9
"19175",19,175,2006,6477,6214,263,4.1
"19175",19,175,2007,6580,6312,268,4.1
"19175",19,175,2008,6710,6402,308,4.6
"19175",19,175,2009,6932,6475,457,6.6
"19175",19,175,2010,7019,6623,396,5.6
"19175",19,175,2011,6958,6592,366,5.3
"19175",19,175,2012,6853,6506,347,5.1
"19175",19,175,2013,6897,6560,337,4.9
"19175",19,175,2014,6825,6504,321,4.7
"19175",19,175,2015,6581,6304,277,4.2
"19175",19,175,2016,6523,6276,247,3.8
"19175",19,175,2017,6430,6228,202,3.1
"19177",19,177,1990,3618,3491,127,3.5
"19177",19,177,1991,3731,3532,199,5.3
"19177",19,177,1992,3838,3645,193,5
"19177",19,177,1993,4031,3858,173,4.3
"19177",19,177,1994,4085,3922,163,4
"19177",19,177,1995,4114,3949,165,4
"19177",19,177,1996,4204,4048,156,3.7
"19177",19,177,1997,4393,4250,143,3.3
"19177",19,177,1998,4283,4165,118,2.8
"19177",19,177,1999,4176,4052,124,3
"19177",19,177,2000,3987,3861,126,3.2
"19177",19,177,2001,4007,3834,173,4.3
"19177",19,177,2002,3899,3683,216,5.5
"19177",19,177,2003,3789,3572,217,5.7
"19177",19,177,2004,3812,3603,209,5.5
"19177",19,177,2005,3812,3616,196,5.1
"19177",19,177,2006,3925,3757,168,4.3
"19177",19,177,2007,3951,3783,168,4.3
"19177",19,177,2008,3950,3757,193,4.9
"19177",19,177,2009,3850,3511,339,8.8
"19177",19,177,2010,3971,3682,289,7.3
"19177",19,177,2011,3849,3606,243,6.3
"19177",19,177,2012,3799,3579,220,5.8
"19177",19,177,2013,3834,3623,211,5.5
"19177",19,177,2014,3920,3743,177,4.5
"19177",19,177,2015,3844,3687,157,4.1
"19177",19,177,2016,3865,3724,141,3.6
"19177",19,177,2017,3724,3609,115,3.1
"19179",19,179,1990,16935,15909,1026,6.1
"19179",19,179,1991,17450,16151,1299,7.4
"19179",19,179,1992,17879,16703,1176,6.6
"19179",19,179,1993,18542,17481,1061,5.7
"19179",19,179,1994,18654,17753,901,4.8
"19179",19,179,1995,18562,17656,906,4.9
"19179",19,179,1996,18723,17810,913,4.9
"19179",19,179,1997,18133,17027,1106,6.1
"19179",19,179,1998,17718,17025,693,3.9
"19179",19,179,1999,17526,16842,684,3.9
"19179",19,179,2000,17831,17203,628,3.5
"19179",19,179,2001,18220,17383,837,4.6
"19179",19,179,2002,19097,18051,1046,5.5
"19179",19,179,2003,19282,18201,1081,5.6
"19179",19,179,2004,19028,17974,1054,5.5
"19179",19,179,2005,19153,18109,1044,5.5
"19179",19,179,2006,18807,17961,846,4.5
"19179",19,179,2007,18850,18034,816,4.3
"19179",19,179,2008,18877,17925,952,5
"19179",19,179,2009,18907,17254,1653,8.7
"19179",19,179,2010,18508,17054,1454,7.9
"19179",19,179,2011,18118,16822,1296,7.2
"19179",19,179,2012,17892,16649,1243,6.9
"19179",19,179,2013,18136,16989,1147,6.3
"19179",19,179,2014,18166,17170,996,5.5
"19179",19,179,2015,18026,17091,935,5.2
"19179",19,179,2016,17918,16880,1038,5.8
"19179",19,179,2017,17641,16837,804,4.6
"19181",19,181,1990,20376,19809,567,2.8
"19181",19,181,1991,20807,20158,649,3.1
"19181",19,181,1992,21529,20861,668,3.1
"19181",19,181,1993,22539,21841,698,3.1
"19181",19,181,1994,22818,22321,497,2.2
"19181",19,181,1995,23084,22549,535,2.3
"19181",19,181,1996,23459,22952,507,2.2
"19181",19,181,1997,23307,22837,470,2
"19181",19,181,1998,23576,23120,456,1.9
"19181",19,181,1999,23425,23009,416,1.8
"19181",19,181,2000,23477,22981,496,2.1
"19181",19,181,2001,23776,23161,615,2.6
"19181",19,181,2002,24452,23673,779,3.2
"19181",19,181,2003,24157,23272,885,3.7
"19181",19,181,2004,24137,23193,944,3.9
"19181",19,181,2005,24600,23699,901,3.7
"19181",19,181,2006,25327,24514,813,3.2
"19181",19,181,2007,25475,24644,831,3.3
"19181",19,181,2008,25753,24771,982,3.8
"19181",19,181,2009,25913,24391,1522,5.9
"19181",19,181,2010,26357,24871,1486,5.6
"19181",19,181,2011,25952,24607,1345,5.2
"19181",19,181,2012,25885,24650,1235,4.8
"19181",19,181,2013,26344,25160,1184,4.5
"19181",19,181,2014,26810,25749,1061,4
"19181",19,181,2015,26728,25806,922,3.4
"19181",19,181,2016,27145,26280,865,3.2
"19181",19,181,2017,27296,26545,751,2.8
"19183",19,183,1990,10408,10117,291,2.8
"19183",19,183,1991,10713,10352,361,3.4
"19183",19,183,1992,10963,10584,379,3.5
"19183",19,183,1993,11156,10788,368,3.3
"19183",19,183,1994,11302,10973,329,2.9
"19183",19,183,1995,11375,11020,355,3.1
"19183",19,183,1996,11641,11242,399,3.4
"19183",19,183,1997,11586,11259,327,2.8
"19183",19,183,1998,11424,11146,278,2.4
"19183",19,183,1999,11306,11031,275,2.4
"19183",19,183,2000,11286,11041,245,2.2
"19183",19,183,2001,11630,11306,324,2.8
"19183",19,183,2002,12198,11798,400,3.3
"19183",19,183,2003,12114,11659,455,3.8
"19183",19,183,2004,12113,11575,538,4.4
"19183",19,183,2005,12251,11792,459,3.7
"19183",19,183,2006,12455,12084,371,3
"19183",19,183,2007,11943,11536,407,3.4
"19183",19,183,2008,12018,11526,492,4.1
"19183",19,183,2009,11924,11262,662,5.6
"19183",19,183,2010,12422,11789,633,5.1
"19183",19,183,2011,12313,11736,577,4.7
"19183",19,183,2012,12150,11639,511,4.2
"19183",19,183,2013,12275,11813,462,3.8
"19183",19,183,2014,12341,11897,444,3.6
"19183",19,183,2015,12400,12010,390,3.1
"19183",19,183,2016,12371,12010,361,2.9
"19183",19,183,2017,12358,11998,360,2.9
"19185",19,185,1990,3208,3115,93,2.9
"19185",19,185,1991,3146,3030,116,3.7
"19185",19,185,1992,3311,3139,172,5.2
"19185",19,185,1993,3294,3117,177,5.4
"19185",19,185,1994,3416,3295,121,3.5
"19185",19,185,1995,3410,3276,134,3.9
"19185",19,185,1996,3416,3252,164,4.8
"19185",19,185,1997,3259,3122,137,4.2
"19185",19,185,1998,3040,2922,118,3.9
"19185",19,185,1999,3004,2916,88,2.9
"19185",19,185,2000,3233,3136,97,3
"19185",19,185,2001,3349,3232,117,3.5
"19185",19,185,2002,3322,3183,139,4.2
"19185",19,185,2003,3162,3017,145,4.6
"19185",19,185,2004,3117,2977,140,4.5
"19185",19,185,2005,3166,3020,146,4.6
"19185",19,185,2006,3211,3083,128,4
"19185",19,185,2007,3208,3063,145,4.5
"19185",19,185,2008,3246,3109,137,4.2
"19185",19,185,2009,3236,3031,205,6.3
"19185",19,185,2010,2876,2699,177,6.2
"19185",19,185,2011,2823,2667,156,5.5
"19185",19,185,2012,2792,2640,152,5.4
"19185",19,185,2013,2850,2702,148,5.2
"19185",19,185,2014,2877,2732,145,5
"19185",19,185,2015,2852,2739,113,4
"19185",19,185,2016,2844,2737,107,3.8
"19185",19,185,2017,2783,2697,86,3.1
"19187",19,187,1990,19515,18493,1022,5.2
"19187",19,187,1991,19584,18577,1007,5.1
"19187",19,187,1992,19864,18756,1108,5.6
"19187",19,187,1993,20271,19282,989,4.9
"19187",19,187,1994,20417,19573,844,4.1
"19187",19,187,1995,20589,19733,856,4.2
"19187",19,187,1996,20429,19701,728,3.6
"19187",19,187,1997,20315,19634,681,3.4
"19187",19,187,1998,20480,19883,597,2.9
"19187",19,187,1999,20342,19773,569,2.8
"19187",19,187,2000,19865,19269,596,3
"19187",19,187,2001,20071,19340,731,3.6
"19187",19,187,2002,20047,19214,833,4.2
"19187",19,187,2003,19575,18646,929,4.7
"19187",19,187,2004,19305,18387,918,4.8
"19187",19,187,2005,19705,18862,843,4.3
"19187",19,187,2006,19822,19048,774,3.9
"19187",19,187,2007,19830,19045,785,4
"19187",19,187,2008,20058,19181,877,4.4
"19187",19,187,2009,19819,18350,1469,7.4
"19187",19,187,2010,20145,18748,1397,6.9
"19187",19,187,2011,19774,18396,1378,7
"19187",19,187,2012,19277,18060,1217,6.3
"19187",19,187,2013,19757,18708,1049,5.3
"19187",19,187,2014,19856,18896,960,4.8
"19187",19,187,2015,20370,19485,885,4.3
"19187",19,187,2016,20459,19644,815,4
"19187",19,187,2017,19369,18639,730,3.8
"19189",19,189,1990,6432,5920,512,8
"19189",19,189,1991,5990,5630,360,6
"19189",19,189,1992,6375,6145,230,3.6
"19189",19,189,1993,6698,6481,217,3.2
"19189",19,189,1994,6846,6675,171,2.5
"19189",19,189,1995,6807,6630,177,2.6
"19189",19,189,1996,7075,6908,167,2.4
"19189",19,189,1997,6751,6601,150,2.2
"19189",19,189,1998,6597,6447,150,2.3
"19189",19,189,1999,6622,6494,128,1.9
"19189",19,189,2000,6436,6307,129,2
"19189",19,189,2001,6530,6355,175,2.7
"19189",19,189,2002,6335,6138,197,3.1
"19189",19,189,2003,6020,5793,227,3.8
"19189",19,189,2004,5863,5658,205,3.5
"19189",19,189,2005,5953,5682,271,4.6
"19189",19,189,2006,5814,5608,206,3.5
"19189",19,189,2007,5767,5568,199,3.5
"19189",19,189,2008,5922,5540,382,6.5
"19189",19,189,2009,5771,5227,544,9.4
"19189",19,189,2010,5820,5431,389,6.7
"19189",19,189,2011,5445,5117,328,6
"19189",19,189,2012,5116,4843,273,5.3
"19189",19,189,2013,5167,4919,248,4.8
"19189",19,189,2014,5232,5012,220,4.2
"19189",19,189,2015,5174,4967,207,4
"19189",19,189,2016,5205,5025,180,3.5
"19189",19,189,2017,5190,5025,165,3.2
"19191",19,191,1990,11310,10664,646,5.7
"19191",19,191,1991,11462,10851,611,5.3
"19191",19,191,1992,11760,11103,657,5.6
"19191",19,191,1993,11913,11263,650,5.5
"19191",19,191,1994,12154,11557,597,4.9
"19191",19,191,1995,12237,11665,572,4.7
"19191",19,191,1996,12456,11909,547,4.4
"19191",19,191,1997,12384,11924,460,3.7
"19191",19,191,1998,12124,11673,451,3.7
"19191",19,191,1999,12902,12496,406,3.1
"19191",19,191,2000,12139,11835,304,2.5
"19191",19,191,2001,12569,12204,365,2.9
"19191",19,191,2002,12505,12046,459,3.7
"19191",19,191,2003,12258,11733,525,4.3
"19191",19,191,2004,12376,11851,525,4.2
"19191",19,191,2005,12433,11913,520,4.2
"19191",19,191,2006,12556,12106,450,3.6
"19191",19,191,2007,12425,11973,452,3.6
"19191",19,191,2008,12390,11851,539,4.4
"19191",19,191,2009,12268,11501,767,6.3
"19191",19,191,2010,12295,11616,679,5.5
"19191",19,191,2011,12112,11509,603,5
"19191",19,191,2012,11886,11338,548,4.6
"19191",19,191,2013,11893,11342,551,4.6
"19191",19,191,2014,12078,11565,513,4.2
"19191",19,191,2015,12237,11786,451,3.7
"19191",19,191,2016,12077,11653,424,3.5
"19191",19,191,2017,11839,11470,369,3.1
"19193",19,193,1990,50262,48006,2256,4.5
"19193",19,193,1991,51504,49025,2479,4.8
"19193",19,193,1992,52830,50682,2148,4.1
"19193",19,193,1993,55055,53339,1716,3.1
"19193",19,193,1994,55358,53668,1690,3.1
"19193",19,193,1995,55996,54272,1724,3.1
"19193",19,193,1996,56652,54688,1964,3.5
"19193",19,193,1997,56047,54209,1838,3.3
"19193",19,193,1998,55391,53796,1595,2.9
"19193",19,193,1999,54262,52903,1359,2.5
"19193",19,193,2000,55308,53888,1420,2.6
"19193",19,193,2001,55289,53531,1758,3.2
"19193",19,193,2002,56018,53873,2145,3.8
"19193",19,193,2003,54526,51986,2540,4.7
"19193",19,193,2004,53025,50386,2639,5
"19193",19,193,2005,53329,50751,2578,4.8
"19193",19,193,2006,54183,51888,2295,4.2
"19193",19,193,2007,54875,52748,2127,3.9
"19193",19,193,2008,55927,53765,2162,3.9
"19193",19,193,2009,55996,52811,3185,5.7
"19193",19,193,2010,55997,52313,3684,6.6
"19193",19,193,2011,54559,51431,3128,5.7
"19193",19,193,2012,54283,51447,2836,5.2
"19193",19,193,2013,55223,52580,2643,4.8
"19193",19,193,2014,56036,53581,2455,4.4
"19193",19,193,2015,56239,54102,2137,3.8
"19193",19,193,2016,55823,53841,1982,3.6
"19193",19,193,2017,54218,52480,1738,3.2
"19195",19,195,1990,4046,3777,269,6.6
"19195",19,195,1991,4023,3796,227,5.6
"19195",19,195,1992,3940,3749,191,4.8
"19195",19,195,1993,4089,3904,185,4.5
"19195",19,195,1994,4105,3930,175,4.3
"19195",19,195,1995,4136,3996,140,3.4
"19195",19,195,1996,4269,4114,155,3.6
"19195",19,195,1997,4207,4083,124,2.9
"19195",19,195,1998,4172,4044,128,3.1
"19195",19,195,1999,4081,3966,115,2.8
"19195",19,195,2000,4352,4225,127,2.9
"19195",19,195,2001,4336,4191,145,3.3
"19195",19,195,2002,4465,4280,185,4.1
"19195",19,195,2003,4401,4219,182,4.1
"19195",19,195,2004,4464,4280,184,4.1
"19195",19,195,2005,4611,4399,212,4.6
"19195",19,195,2006,4582,4409,173,3.8
"19195",19,195,2007,4525,4356,169,3.7
"19195",19,195,2008,4576,4336,240,5.2
"19195",19,195,2009,4486,4165,321,7.2
"19195",19,195,2010,4342,4027,315,7.3
"19195",19,195,2011,4288,4014,274,6.4
"19195",19,195,2012,4221,3991,230,5.4
"19195",19,195,2013,4185,3969,216,5.2
"19195",19,195,2014,4211,4020,191,4.5
"19195",19,195,2015,4231,4061,170,4
"19195",19,195,2016,4275,4129,146,3.4
"19195",19,195,2017,4219,4089,130,3.1
"19197",19,197,1990,7120,6865,255,3.6
"19197",19,197,1991,7199,6908,291,4
"19197",19,197,1992,7209,6889,320,4.4
"19197",19,197,1993,7021,6739,282,4
"19197",19,197,1994,7095,6851,244,3.4
"19197",19,197,1995,7435,7156,279,3.8
"19197",19,197,1996,7333,7109,224,3.1
"19197",19,197,1997,7118,6935,183,2.6
"19197",19,197,1998,6979,6813,166,2.4
"19197",19,197,1999,6779,6619,160,2.4
"19197",19,197,2000,7574,7378,196,2.6
"19197",19,197,2001,7580,7327,253,3.3
"19197",19,197,2002,7259,6970,289,4
"19197",19,197,2003,6950,6630,320,4.6
"19197",19,197,2004,7064,6741,323,4.6
"19197",19,197,2005,7153,6849,304,4.2
"19197",19,197,2006,7175,6917,258,3.6
"19197",19,197,2007,7003,6729,274,3.9
"19197",19,197,2008,7113,6795,318,4.5
"19197",19,197,2009,7047,6528,519,7.4
"19197",19,197,2010,6857,6366,491,7.2
"19197",19,197,2011,6787,6322,465,6.9
"19197",19,197,2012,6792,6428,364,5.4
"19197",19,197,2013,6846,6539,307,4.5
"19197",19,197,2014,6960,6676,284,4.1
"19197",19,197,2015,6913,6641,272,3.9
"19197",19,197,2016,6700,6425,275,4.1
"19197",19,197,2017,6552,6325,227,3.5
"20001",20,1,1990,6845,6447,398,5.8
"20001",20,1,1991,6628,6239,389,5.9
"20001",20,1,1992,6638,6296,342,5.2
"20001",20,1,1993,6805,6420,385,5.7
"20001",20,1,1994,7169,6733,436,6.1
"20001",20,1,1995,7035,6553,482,6.9
"20001",20,1,1996,6867,6446,421,6.1
"20001",20,1,1997,6951,6573,378,5.4
"20001",20,1,1998,7423,7077,346,4.7
"20001",20,1,1999,7311,6945,366,5
"20001",20,1,2000,7167,6846,321,4.5
"20001",20,1,2001,7228,6794,434,6
"20001",20,1,2002,6939,6569,370,5.3
"20001",20,1,2003,7185,6837,348,4.8
"20001",20,1,2004,7383,6959,424,5.7
"20001",20,1,2005,7195,6810,385,5.4
"20001",20,1,2006,7535,7221,314,4.2
"20001",20,1,2007,7497,7194,303,4
"20001",20,1,2008,7408,7069,339,4.6
"20001",20,1,2009,7536,6947,589,7.8
"20001",20,1,2010,7010,6429,581,8.3
"20001",20,1,2011,7032,6468,564,8
"20001",20,1,2012,6863,6372,491,7.2
"20001",20,1,2013,6890,6471,419,6.1
"20001",20,1,2014,6806,6460,346,5.1
"20001",20,1,2015,6606,6268,338,5.1
"20001",20,1,2016,6439,6080,359,5.6
"20001",20,1,2017,6298,5991,307,4.9
"20003",20,3,1990,3766,3548,218,5.8
"20003",20,3,1991,3889,3623,266,6.8
"20003",20,3,1992,3874,3616,258,6.7
"20003",20,3,1993,3930,3628,302,7.7
"20003",20,3,1994,4060,3793,267,6.6
"20003",20,3,1995,4061,3828,233,5.7
"20003",20,3,1996,3884,3673,211,5.4
"20003",20,3,1997,4058,3843,215,5.3
"20003",20,3,1998,3862,3653,209,5.4
"20003",20,3,1999,4006,3816,190,4.7
"20003",20,3,2000,4073,3906,167,4.1
"20003",20,3,2001,4051,3841,210,5.2
"20003",20,3,2002,4130,3911,219,5.3
"20003",20,3,2003,4130,3904,226,5.5
"20003",20,3,2004,4146,3885,261,6.3
"20003",20,3,2005,4039,3800,239,5.9
"20003",20,3,2006,4165,3963,202,4.8
"20003",20,3,2007,4144,3949,195,4.7
"20003",20,3,2008,4339,4130,209,4.8
"20003",20,3,2009,4482,4140,342,7.6
"20003",20,3,2010,4572,4220,352,7.7
"20003",20,3,2011,4490,4148,342,7.6
"20003",20,3,2012,4300,4020,280,6.5
"20003",20,3,2013,4238,3992,246,5.8
"20003",20,3,2014,4187,3971,216,5.2
"20003",20,3,2015,4135,3935,200,4.8
"20003",20,3,2016,4176,3996,180,4.3
"20003",20,3,2017,4144,3980,164,4
"20005",20,5,1990,8151,7645,506,6.2
"20005",20,5,1991,8255,7728,527,6.4
"20005",20,5,1992,8325,7778,547,6.6
"20005",20,5,1993,8340,7698,642,7.7
"20005",20,5,1994,8623,7950,673,7.8
"20005",20,5,1995,8429,7851,578,6.9
"20005",20,5,1996,8185,7559,626,7.6
"20005",20,5,1997,8223,7680,543,6.6
"20005",20,5,1998,8693,8261,432,5
"20005",20,5,1999,8901,8519,382,4.3
"20005",20,5,2000,8405,8043,362,4.3
"20005",20,5,2001,8045,7638,407,5.1
"20005",20,5,2002,8136,7698,438,5.4
"20005",20,5,2003,8315,7858,457,5.5
"20005",20,5,2004,8652,8147,505,5.8
"20005",20,5,2005,8677,8202,475,5.5
"20005",20,5,2006,8723,8309,414,4.7
"20005",20,5,2007,8781,8376,405,4.6
"20005",20,5,2008,8854,8446,408,4.6
"20005",20,5,2009,8861,8046,815,9.2
"20005",20,5,2010,7938,7154,784,9.9
"20005",20,5,2011,7926,7209,717,9
"20005",20,5,2012,7836,7229,607,7.7
"20005",20,5,2013,7777,7110,667,8.6
"20005",20,5,2014,7631,7135,496,6.5
"20005",20,5,2015,7470,7012,458,6.1
"20005",20,5,2016,7045,6608,437,6.2
"20005",20,5,2017,7055,6690,365,5.2
"20007",20,7,1990,2828,2767,61,2.2
"20007",20,7,1991,2788,2709,79,2.8
"20007",20,7,1992,2771,2694,77,2.8
"20007",20,7,1993,2825,2736,89,3.2
"20007",20,7,1994,2847,2746,101,3.5
"20007",20,7,1995,2533,2428,105,4.1
"20007",20,7,1996,2552,2456,96,3.8
"20007",20,7,1997,2441,2352,89,3.6
"20007",20,7,1998,2493,2397,96,3.9
"20007",20,7,1999,2457,2397,60,2.4
"20007",20,7,2000,2657,2586,71,2.7
"20007",20,7,2001,2519,2435,84,3.3
"20007",20,7,2002,2520,2432,88,3.5
"20007",20,7,2003,2662,2565,97,3.6
"20007",20,7,2004,2640,2536,104,3.9
"20007",20,7,2005,2601,2506,95,3.7
"20007",20,7,2006,2598,2514,84,3.2
"20007",20,7,2007,2618,2534,84,3.2
"20007",20,7,2008,2754,2664,90,3.3
"20007",20,7,2009,2921,2791,130,4.5
"20007",20,7,2010,2769,2644,125,4.5
"20007",20,7,2011,2778,2667,111,4
"20007",20,7,2012,2730,2624,106,3.9
"20007",20,7,2013,2761,2651,110,4
"20007",20,7,2014,2715,2632,83,3.1
"20007",20,7,2015,2662,2549,113,4.2
"20007",20,7,2016,2527,2434,93,3.7
"20007",20,7,2017,2475,2404,71,2.9
"20009",20,9,1990,15044,14542,502,3.3
"20009",20,9,1991,15245,14694,551,3.6
"20009",20,9,1992,15415,14781,634,4.1
"20009",20,9,1993,15351,14628,723,4.7
"20009",20,9,1994,15508,14760,748,4.8
"20009",20,9,1995,15453,14755,698,4.5
"20009",20,9,1996,15315,14713,602,3.9
"20009",20,9,1997,15038,14557,481,3.2
"20009",20,9,1998,15048,14540,508,3.4
"20009",20,9,1999,14764,14274,490,3.3
"20009",20,9,2000,14319,13848,471,3.3
"20009",20,9,2001,14090,13640,450,3.2
"20009",20,9,2002,14614,14032,582,4
"20009",20,9,2003,14522,13882,640,4.4
"20009",20,9,2004,14727,14073,654,4.4
"20009",20,9,2005,14792,14199,593,4
"20009",20,9,2006,15405,14871,534,3.5
"20009",20,9,2007,14869,14351,518,3.5
"20009",20,9,2008,15624,15106,518,3.3
"20009",20,9,2009,16047,15143,904,5.6
"20009",20,9,2010,15001,14100,901,6
"20009",20,9,2011,15036,14252,784,5.2
"20009",20,9,2012,14963,14289,674,4.5
"20009",20,9,2013,15097,14485,612,4.1
"20009",20,9,2014,15455,14906,549,3.6
"20009",20,9,2015,14591,13976,615,4.2
"20009",20,9,2016,14023,13395,628,4.5
"20009",20,9,2017,14100,13589,511,3.6
"20011",20,11,1990,6745,6375,370,5.5
"20011",20,11,1991,6623,6236,387,5.8
"20011",20,11,1992,6805,6419,386,5.7
"20011",20,11,1993,6836,6331,505,7.4
"20011",20,11,1994,6675,6240,435,6.5
"20011",20,11,1995,6635,6252,383,5.8
"20011",20,11,1996,6774,6391,383,5.7
"20011",20,11,1997,6658,6302,356,5.3
"20011",20,11,1998,7034,6699,335,4.8
"20011",20,11,1999,6905,6595,310,4.5
"20011",20,11,2000,8214,7908,306,3.7
"20011",20,11,2001,8764,8430,334,3.8
"20011",20,11,2002,8247,7850,397,4.8
"20011",20,11,2003,8593,8185,408,4.7
"20011",20,11,2004,8797,8296,501,5.7
"20011",20,11,2005,8679,8243,436,5
"20011",20,11,2006,9149,8793,356,3.9
"20011",20,11,2007,8857,8465,392,4.4
"20011",20,11,2008,8517,8103,414,4.9
"20011",20,11,2009,8794,8181,613,7
"20011",20,11,2010,7223,6572,651,9
"20011",20,11,2011,6876,6259,617,9
"20011",20,11,2012,6715,6199,516,7.7
"20011",20,11,2013,6868,6423,445,6.5
"20011",20,11,2014,7093,6720,373,5.3
"20011",20,11,2015,7119,6778,341,4.8
"20011",20,11,2016,7129,6783,346,4.9
"20011",20,11,2017,6860,6551,309,4.5
"20013",20,13,1990,5059,4872,187,3.7
"20013",20,13,1991,4911,4660,251,5.1
"20013",20,13,1992,4867,4603,264,5.4
"20013",20,13,1993,4876,4590,286,5.9
"20013",20,13,1994,5014,4702,312,6.2
"20013",20,13,1995,5060,4764,296,5.8
"20013",20,13,1996,4940,4613,327,6.6
"20013",20,13,1997,4849,4565,284,5.9
"20013",20,13,1998,5723,5460,263,4.6
"20013",20,13,1999,5912,5461,451,7.6
"20013",20,13,2000,5432,5170,262,4.8
"20013",20,13,2001,5172,4893,279,5.4
"20013",20,13,2002,5215,4935,280,5.4
"20013",20,13,2003,5485,5236,249,4.5
"20013",20,13,2004,5605,5325,280,5
"20013",20,13,2005,5601,5332,269,4.8
"20013",20,13,2006,5678,5458,220,3.9
"20013",20,13,2007,5509,5282,227,4.1
"20013",20,13,2008,5558,5316,242,4.4
"20013",20,13,2009,5914,5581,333,5.6
"20013",20,13,2010,5266,4917,349,6.6
"20013",20,13,2011,5186,4877,309,6
"20013",20,13,2012,5236,4955,281,5.4
"20013",20,13,2013,5455,5182,273,5
"20013",20,13,2014,5407,5186,221,4.1
"20013",20,13,2015,5355,5142,213,4
"20013",20,13,2016,5165,4978,187,3.6
"20013",20,13,2017,5327,5156,171,3.2
"20015",20,15,1990,26010,25137,873,3.4
"20015",20,15,1991,26519,25592,927,3.5
"20015",20,15,1992,27683,26538,1145,4.1
"20015",20,15,1993,28773,27125,1648,5.7
"20015",20,15,1994,29061,27444,1617,5.6
"20015",20,15,1995,29238,28079,1159,4
"20015",20,15,1996,29579,28493,1086,3.7
"20015",20,15,1997,30823,29816,1007,3.3
"20015",20,15,1998,31861,30918,943,3
"20015",20,15,1999,32004,31003,1001,3.1
"20015",20,15,2000,30625,29427,1198,3.9
"20015",20,15,2001,30460,29264,1196,3.9
"20015",20,15,2002,30926,29189,1737,5.6
"20015",20,15,2003,30833,28935,1898,6.2
"20015",20,15,2004,31654,29738,1916,6.1
"20015",20,15,2005,32038,30277,1761,5.5
"20015",20,15,2006,32135,30658,1477,4.6
"20015",20,15,2007,32414,31075,1339,4.1
"20015",20,15,2008,32739,31296,1443,4.4
"20015",20,15,2009,32715,30311,2404,7.3
"20015",20,15,2010,33009,30447,2562,7.8
"20015",20,15,2011,32445,30171,2274,7
"20015",20,15,2012,31996,30002,1994,6.2
"20015",20,15,2013,31823,30062,1761,5.5
"20015",20,15,2014,31944,30387,1557,4.9
"20015",20,15,2015,32035,30671,1364,4.3
"20015",20,15,2016,32196,30853,1343,4.2
"20015",20,15,2017,31813,30616,1197,3.8
"20017",20,17,1990,1398,1315,83,5.9
"20017",20,17,1991,1423,1333,90,6.3
"20017",20,17,1992,1427,1360,67,4.7
"20017",20,17,1993,1427,1354,73,5.1
"20017",20,17,1994,1413,1329,84,5.9
"20017",20,17,1995,1496,1414,82,5.5
"20017",20,17,1996,1466,1389,77,5.3
"20017",20,17,1997,1467,1404,63,4.3
"20017",20,17,1998,1539,1474,65,4.2
"20017",20,17,1999,1482,1427,55,3.7
"20017",20,17,2000,1571,1526,45,2.9
"20017",20,17,2001,1550,1493,57,3.7
"20017",20,17,2002,1626,1555,71,4.4
"20017",20,17,2003,1629,1560,69,4.2
"20017",20,17,2004,1718,1643,75,4.4
"20017",20,17,2005,1688,1619,69,4.1
"20017",20,17,2006,1691,1624,67,4
"20017",20,17,2007,1584,1520,64,4
"20017",20,17,2008,1469,1408,61,4.2
"20017",20,17,2009,1546,1464,82,5.3
"20017",20,17,2010,1442,1361,81,5.6
"20017",20,17,2011,1338,1265,73,5.5
"20017",20,17,2012,1325,1255,70,5.3
"20017",20,17,2013,1250,1180,70,5.6
"20017",20,17,2014,1232,1182,50,4.1
"20017",20,17,2015,1252,1207,45,3.6
"20017",20,17,2016,1407,1358,49,3.5
"20017",20,17,2017,1404,1367,37,2.6
"20019",20,19,1990,1757,1685,72,4.1
"20019",20,19,1991,1783,1697,86,4.8
"20019",20,19,1992,1769,1648,121,6.8
"20019",20,19,1993,1766,1672,94,5.3
"20019",20,19,1994,1807,1698,109,6
"20019",20,19,1995,1707,1614,93,5.4
"20019",20,19,1996,1727,1621,106,6.1
"20019",20,19,1997,1595,1484,111,7
"20019",20,19,1998,1729,1628,101,5.8
"20019",20,19,1999,1711,1622,89,5.2
"20019",20,19,2000,1892,1811,81,4.3
"20019",20,19,2001,1883,1790,93,4.9
"20019",20,19,2002,1932,1828,104,5.4
"20019",20,19,2003,1955,1854,101,5.2
"20019",20,19,2004,2030,1921,109,5.4
"20019",20,19,2005,1965,1861,104,5.3
"20019",20,19,2006,1889,1793,96,5.1
"20019",20,19,2007,1781,1697,84,4.7
"20019",20,19,2008,1860,1775,85,4.6
"20019",20,19,2009,1868,1704,164,8.8
"20019",20,19,2010,1740,1583,157,9
"20019",20,19,2011,1699,1559,140,8.2
"20019",20,19,2012,1695,1584,111,6.5
"20019",20,19,2013,1620,1520,100,6.2
"20019",20,19,2014,1577,1491,86,5.5
"20019",20,19,2015,1551,1463,88,5.7
"20019",20,19,2016,1540,1460,80,5.2
"20019",20,19,2017,1447,1379,68,4.7
"20021",20,21,1990,9694,8939,755,7.8
"20021",20,21,1991,9631,8930,701,7.3
"20021",20,21,1992,9906,9113,793,8
"20021",20,21,1993,9771,9014,757,7.7
"20021",20,21,1994,10127,9331,796,7.9
"20021",20,21,1995,10407,9703,704,6.8
"20021",20,21,1996,10347,9602,745,7.2
"20021",20,21,1997,10910,10254,656,6
"20021",20,21,1998,10307,9718,589,5.7
"20021",20,21,1999,10279,9819,460,4.5
"20021",20,21,2000,10822,10314,508,4.7
"20021",20,21,2001,10532,9936,596,5.7
"20021",20,21,2002,10468,9749,719,6.9
"20021",20,21,2003,10702,9953,749,7
"20021",20,21,2004,10909,10142,767,7
"20021",20,21,2005,10896,10194,702,6.4
"20021",20,21,2006,10691,10142,549,5.1
"20021",20,21,2007,11108,10565,543,4.9
"20021",20,21,2008,11210,10628,582,5.2
"20021",20,21,2009,11606,10630,976,8.4
"20021",20,21,2010,10798,9817,981,9.1
"20021",20,21,2011,10801,9924,877,8.1
"20021",20,21,2012,10571,9745,826,7.8
"20021",20,21,2013,10498,9828,670,6.4
"20021",20,21,2014,10349,9828,521,5
"20021",20,21,2015,10414,9952,462,4.4
"20021",20,21,2016,10290,9834,456,4.4
"20021",20,21,2017,10164,9770,394,3.9
"20023",20,23,1990,1517,1503,14,.9
"20023",20,23,1991,1517,1499,18,1.2
"20023",20,23,1992,1511,1485,26,1.7
"20023",20,23,1993,1519,1486,33,2.2
"20023",20,23,1994,1592,1553,39,2.4
"20023",20,23,1995,1557,1525,32,2.1
"20023",20,23,1996,1552,1519,33,2.1
"20023",20,23,1997,1481,1453,28,1.9
"20023",20,23,1998,1587,1560,27,1.7
"20023",20,23,1999,1575,1548,27,1.7
"20023",20,23,2000,1613,1572,41,2.5
"20023",20,23,2001,1496,1451,45,3
"20023",20,23,2002,1534,1485,49,3.2
"20023",20,23,2003,1623,1575,48,3
"20023",20,23,2004,1612,1551,61,3.8
"20023",20,23,2005,1539,1470,69,4.5
"20023",20,23,2006,1476,1425,51,3.5
"20023",20,23,2007,1416,1366,50,3.5
"20023",20,23,2008,1476,1429,47,3.2
"20023",20,23,2009,1530,1476,54,3.5
"20023",20,23,2010,1405,1348,57,4.1
"20023",20,23,2011,1346,1288,58,4.3
"20023",20,23,2012,1330,1282,48,3.6
"20023",20,23,2013,1310,1265,45,3.4
"20023",20,23,2014,1314,1273,41,3.1
"20023",20,23,2015,1358,1321,37,2.7
"20023",20,23,2016,1345,1307,38,2.8
"20023",20,23,2017,1315,1281,34,2.6
"20025",20,25,1990,1252,1238,14,1.1
"20025",20,25,1991,1265,1241,24,1.9
"20025",20,25,1992,1271,1252,19,1.5
"20025",20,25,1993,1289,1261,28,2.2
"20025",20,25,1994,1304,1276,28,2.1
"20025",20,25,1995,1313,1281,32,2.4
"20025",20,25,1996,1332,1301,31,2.3
"20025",20,25,1997,1314,1283,31,2.4
"20025",20,25,1998,1356,1332,24,1.8
"20025",20,25,1999,1333,1312,21,1.6
"20025",20,25,2000,1194,1161,33,2.8
"20025",20,25,2001,1166,1136,30,2.6
"20025",20,25,2002,1214,1175,39,3.2
"20025",20,25,2003,1253,1212,41,3.3
"20025",20,25,2004,1232,1187,45,3.7
"20025",20,25,2005,1181,1140,41,3.5
"20025",20,25,2006,1197,1159,38,3.2
"20025",20,25,2007,1206,1169,37,3.1
"20025",20,25,2008,1251,1211,40,3.2
"20025",20,25,2009,1279,1232,47,3.7
"20025",20,25,2010,1223,1169,54,4.4
"20025",20,25,2011,1211,1165,46,3.8
"20025",20,25,2012,1201,1159,42,3.5
"20025",20,25,2013,1188,1151,37,3.1
"20025",20,25,2014,1143,1113,30,2.6
"20025",20,25,2015,1159,1131,28,2.4
"20025",20,25,2016,1116,1085,31,2.8
"20025",20,25,2017,1104,1076,28,2.5
"20027",20,27,1990,4332,4181,151,3.5
"20027",20,27,1991,4391,4228,163,3.7
"20027",20,27,1992,4672,4503,169,3.6
"20027",20,27,1993,4650,4490,160,3.4
"20027",20,27,1994,4619,4472,147,3.2
"20027",20,27,1995,4719,4566,153,3.2
"20027",20,27,1996,4722,4577,145,3.1
"20027",20,27,1997,4630,4494,136,2.9
"20027",20,27,1998,4753,4618,135,2.8
"20027",20,27,1999,4873,4728,145,3
"20027",20,27,2000,4557,4410,147,3.2
"20027",20,27,2001,4452,4270,182,4.1
"20027",20,27,2002,4504,4315,189,4.2
"20027",20,27,2003,4612,4411,201,4.4
"20027",20,27,2004,4730,4523,207,4.4
"20027",20,27,2005,4873,4674,199,4.1
"20027",20,27,2006,4958,4789,169,3.4
"20027",20,27,2007,5067,4897,170,3.4
"20027",20,27,2008,5170,4993,177,3.4
"20027",20,27,2009,5290,5054,236,4.5
"20027",20,27,2010,4631,4374,257,5.5
"20027",20,27,2011,4389,4141,248,5.7
"20027",20,27,2012,4246,4027,219,5.2
"20027",20,27,2013,4194,3983,211,5
"20027",20,27,2014,4169,3985,184,4.4
"20027",20,27,2015,4117,3941,176,4.3
"20027",20,27,2016,4034,3870,164,4.1
"20027",20,27,2017,3825,3681,144,3.8
"20029",20,29,1990,5416,5207,209,3.9
"20029",20,29,1991,5258,5107,151,2.9
"20029",20,29,1992,5329,5179,150,2.8
"20029",20,29,1993,5420,5260,160,3
"20029",20,29,1994,5341,5179,162,3
"20029",20,29,1995,5284,5114,170,3.2
"20029",20,29,1996,5170,4989,181,3.5
"20029",20,29,1997,5160,4980,180,3.5
"20029",20,29,1998,4989,4836,153,3.1
"20029",20,29,1999,4989,4837,152,3
"20029",20,29,2000,5291,5101,190,3.6
"20029",20,29,2001,5181,4993,188,3.6
"20029",20,29,2002,5253,5055,198,3.8
"20029",20,29,2003,5764,5556,208,3.6
"20029",20,29,2004,5822,5605,217,3.7
"20029",20,29,2005,5687,5472,215,3.8
"20029",20,29,2006,5885,5686,199,3.4
"20029",20,29,2007,5590,5391,199,3.6
"20029",20,29,2008,5581,5376,205,3.7
"20029",20,29,2009,5816,5559,257,4.4
"20029",20,29,2010,4654,4392,262,5.6
"20029",20,29,2011,4527,4279,248,5.5
"20029",20,29,2012,4573,4345,228,5
"20029",20,29,2013,4452,4258,194,4.4
"20029",20,29,2014,4389,4204,185,4.2
"20029",20,29,2015,4312,4148,164,3.8
"20029",20,29,2016,4256,4081,175,4.1
"20029",20,29,2017,3895,3725,170,4.4
"20031",20,31,1990,3982,3774,208,5.2
"20031",20,31,1991,4098,3883,215,5.2
"20031",20,31,1992,4213,3942,271,6.4
"20031",20,31,1993,4430,4192,238,5.4
"20031",20,31,1994,4252,3976,276,6.5
"20031",20,31,1995,4246,3978,268,6.3
"20031",20,31,1996,4299,4032,267,6.2
"20031",20,31,1997,4695,4426,269,5.7
"20031",20,31,1998,4221,3988,233,5.5
"20031",20,31,1999,4172,3976,196,4.7
"20031",20,31,2000,4674,4501,173,3.7
"20031",20,31,2001,4597,4363,234,5.1
"20031",20,31,2002,4766,4481,285,6
"20031",20,31,2003,4920,4629,291,5.9
"20031",20,31,2004,4909,4637,272,5.5
"20031",20,31,2005,5154,4867,287,5.6
"20031",20,31,2006,5314,5055,259,4.9
"20031",20,31,2007,5101,4871,230,4.5
"20031",20,31,2008,5373,5118,255,4.7
"20031",20,31,2009,5576,5253,323,5.8
"20031",20,31,2010,4847,4479,368,7.6
"20031",20,31,2011,4649,4285,364,7.8
"20031",20,31,2012,4519,4203,316,7
"20031",20,31,2013,4943,4651,292,5.9
"20031",20,31,2014,4893,4614,279,5.7
"20031",20,31,2015,4741,4470,271,5.7
"20031",20,31,2016,4283,4018,265,6.2
"20031",20,31,2017,4124,3907,217,5.3
"20033",20,33,1990,1075,1060,15,1.4
"20033",20,33,1991,1083,1071,12,1.1
"20033",20,33,1992,1061,1050,11,1
"20033",20,33,1993,1077,1057,20,1.9
"20033",20,33,1994,1129,1105,24,2.1
"20033",20,33,1995,1074,1058,16,1.5
"20033",20,33,1996,1055,1031,24,2.3
"20033",20,33,1997,1035,1014,21,2
"20033",20,33,1998,1007,988,19,1.9
"20033",20,33,1999,1025,1011,14,1.4
"20033",20,33,2000,1034,1011,23,2.2
"20033",20,33,2001,1003,977,26,2.6
"20033",20,33,2002,1035,1007,28,2.7
"20033",20,33,2003,1033,1003,30,2.9
"20033",20,33,2004,1033,1001,32,3.1
"20033",20,33,2005,1074,1043,31,2.9
"20033",20,33,2006,1088,1057,31,2.8
"20033",20,33,2007,1079,1046,33,3.1
"20033",20,33,2008,1112,1076,36,3.2
"20033",20,33,2009,1105,1066,39,3.5
"20033",20,33,2010,994,949,45,4.5
"20033",20,33,2011,980,937,43,4.4
"20033",20,33,2012,999,960,39,3.9
"20033",20,33,2013,1033,997,36,3.5
"20033",20,33,2014,978,948,30,3.1
"20033",20,33,2015,992,959,33,3.3
"20033",20,33,2016,971,941,30,3.1
"20033",20,33,2017,922,895,27,2.9
"20035",20,35,1990,17937,16811,1126,6.3
"20035",20,35,1991,17894,17012,882,4.9
"20035",20,35,1992,18122,17148,974,5.4
"20035",20,35,1993,18620,17601,1019,5.5
"20035",20,35,1994,18208,17156,1052,5.8
"20035",20,35,1995,18396,17402,994,5.4
"20035",20,35,1996,18411,17576,835,4.5
"20035",20,35,1997,18791,17896,895,4.8
"20035",20,35,1998,17938,16967,971,5.4
"20035",20,35,1999,17697,16974,723,4.1
"20035",20,35,2000,17577,16796,781,4.4
"20035",20,35,2001,17776,17031,745,4.2
"20035",20,35,2002,18578,17353,1225,6.6
"20035",20,35,2003,18368,17143,1225,6.7
"20035",20,35,2004,18223,17123,1100,6
"20035",20,35,2005,17755,16779,976,5.5
"20035",20,35,2006,18154,17367,787,4.3
"20035",20,35,2007,18211,17486,725,4
"20035",20,35,2008,18142,17333,809,4.5
"20035",20,35,2009,18586,17295,1291,6.9
"20035",20,35,2010,17259,15906,1353,7.8
"20035",20,35,2011,17096,15896,1200,7
"20035",20,35,2012,17215,16152,1063,6.2
"20035",20,35,2013,17163,16166,997,5.8
"20035",20,35,2014,17260,16460,800,4.6
"20035",20,35,2015,17042,16263,779,4.6
"20035",20,35,2016,16909,16162,747,4.4
"20035",20,35,2017,16961,16316,645,3.8
"20037",20,37,1990,16446,15397,1049,6.4
"20037",20,37,1991,15930,15049,881,5.5
"20037",20,37,1992,16640,15742,898,5.4
"20037",20,37,1993,17164,16090,1074,6.3
"20037",20,37,1994,17566,16607,959,5.5
"20037",20,37,1995,18052,17168,884,4.9
"20037",20,37,1996,18418,17504,914,5
"20037",20,37,1997,17922,17019,903,5
"20037",20,37,1998,18197,17410,787,4.3
"20037",20,37,1999,18544,17882,662,3.6
"20037",20,37,2000,18904,18087,817,4.3
"20037",20,37,2001,18762,17819,943,5
"20037",20,37,2002,19097,18119,978,5.1
"20037",20,37,2003,19334,18258,1076,5.6
"20037",20,37,2004,19306,18119,1187,6.1
"20037",20,37,2005,19439,18327,1112,5.7
"20037",20,37,2006,19331,18343,988,5.1
"20037",20,37,2007,20216,19230,986,4.9
"20037",20,37,2008,19905,18845,1060,5.3
"20037",20,37,2009,20225,18497,1728,8.5
"20037",20,37,2010,19356,17672,1684,8.7
"20037",20,37,2011,19169,17652,1517,7.9
"20037",20,37,2012,19284,18004,1280,6.6
"20037",20,37,2013,19282,18144,1138,5.9
"20037",20,37,2014,19132,18108,1024,5.4
"20037",20,37,2015,18928,17964,964,5.1
"20037",20,37,2016,18919,18005,914,4.8
"20037",20,37,2017,19123,18323,800,4.2
"20039",20,39,1990,1991,1946,45,2.3
"20039",20,39,1991,1949,1917,32,1.6
"20039",20,39,1992,1969,1925,44,2.2
"20039",20,39,1993,1927,1874,53,2.8
"20039",20,39,1994,1985,1937,48,2.4
"20039",20,39,1995,1880,1829,51,2.7
"20039",20,39,1996,1836,1779,57,3.1
"20039",20,39,1997,1722,1673,49,2.8
"20039",20,39,1998,1684,1638,46,2.7
"20039",20,39,1999,1658,1624,34,2.1
"20039",20,39,2000,1730,1686,44,2.5
"20039",20,39,2001,1798,1748,50,2.8
"20039",20,39,2002,1830,1777,53,2.9
"20039",20,39,2003,1866,1807,59,3.2
"20039",20,39,2004,1809,1744,65,3.6
"20039",20,39,2005,1699,1642,57,3.4
"20039",20,39,2006,1679,1623,56,3.3
"20039",20,39,2007,1664,1612,52,3.1
"20039",20,39,2008,1784,1729,55,3.1
"20039",20,39,2009,1815,1748,67,3.7
"20039",20,39,2010,1457,1384,73,5
"20039",20,39,2011,1415,1347,68,4.8
"20039",20,39,2012,1401,1339,62,4.4
"20039",20,39,2013,1361,1307,54,4
"20039",20,39,2014,1352,1305,47,3.5
"20039",20,39,2015,1351,1301,50,3.7
"20039",20,39,2016,1293,1242,51,3.9
"20039",20,39,2017,1266,1227,39,3.1
"20041",20,41,1990,9385,9041,344,3.7
"20041",20,41,1991,9570,9196,374,3.9
"20041",20,41,1992,9929,9571,358,3.6
"20041",20,41,1993,9856,9419,437,4.4
"20041",20,41,1994,10064,9596,468,4.7
"20041",20,41,1995,10184,9619,565,5.5
"20041",20,41,1996,10366,9850,516,5
"20041",20,41,1997,10500,10060,440,4.2
"20041",20,41,1998,10487,10171,316,3
"20041",20,41,1999,10434,10116,318,3
"20041",20,41,2000,10264,9941,323,3.1
"20041",20,41,2001,9864,9477,387,3.9
"20041",20,41,2002,10036,9615,421,4.2
"20041",20,41,2003,10408,9930,478,4.6
"20041",20,41,2004,10600,10101,499,4.7
"20041",20,41,2005,10544,10071,473,4.5
"20041",20,41,2006,10566,10145,421,4
"20041",20,41,2007,10611,10199,412,3.9
"20041",20,41,2008,10715,10289,426,4
"20041",20,41,2009,10918,10350,568,5.2
"20041",20,41,2010,10234,9557,677,6.6
"20041",20,41,2011,10109,9442,667,6.6
"20041",20,41,2012,10060,9452,608,6
"20041",20,41,2013,9859,9278,581,5.9
"20041",20,41,2014,9719,9227,492,5.1
"20041",20,41,2015,9520,9028,492,5.2
"20041",20,41,2016,9168,8762,406,4.4
"20041",20,41,2017,9279,8924,355,3.8
"20043",20,43,1990,3784,3521,263,7
"20043",20,43,1991,3689,3395,294,8
"20043",20,43,1992,3762,3525,237,6.3
"20043",20,43,1993,3990,3682,308,7.7
"20043",20,43,1994,4158,3842,316,7.6
"20043",20,43,1995,4130,3849,281,6.8
"20043",20,43,1996,4226,3954,272,6.4
"20043",20,43,1997,4243,3973,270,6.4
"20043",20,43,1998,4385,4142,243,5.5
"20043",20,43,1999,4270,4033,237,5.6
"20043",20,43,2000,4116,3920,196,4.8
"20043",20,43,2001,4235,3912,323,7.6
"20043",20,43,2002,4328,3915,413,9.5
"20043",20,43,2003,4409,4092,317,7.2
"20043",20,43,2004,4528,4182,346,7.6
"20043",20,43,2005,4436,4158,278,6.3
"20043",20,43,2006,4496,4273,223,5
"20043",20,43,2007,4551,4333,218,4.8
"20043",20,43,2008,4487,4237,250,5.6
"20043",20,43,2009,4634,4152,482,10.4
"20043",20,43,2010,4540,4139,401,8.8
"20043",20,43,2011,4453,4105,348,7.8
"20043",20,43,2012,4392,4117,275,6.3
"20043",20,43,2013,4337,4102,235,5.4
"20043",20,43,2014,4294,4101,193,4.5
"20043",20,43,2015,4319,4132,187,4.3
"20043",20,43,2016,4274,4109,165,3.9
"20043",20,43,2017,4253,4106,147,3.5
"20045",20,45,1990,44657,42537,2120,4.7
"20045",20,45,1991,45734,43679,2055,4.5
"20045",20,45,1992,47768,45723,2045,4.3
"20045",20,45,1993,48869,46490,2379,4.9
"20045",20,45,1994,49925,47508,2417,4.8
"20045",20,45,1995,51231,48792,2439,4.8
"20045",20,45,1996,51116,48725,2391,4.7
"20045",20,45,1997,52798,50598,2200,4.2
"20045",20,45,1998,54754,52542,2212,4
"20045",20,45,1999,55660,53693,1967,3.5
"20045",20,45,2000,58565,56989,1576,2.7
"20045",20,45,2001,58558,56673,1885,3.2
"20045",20,45,2002,59207,56951,2256,3.8
"20045",20,45,2003,61314,58936,2378,3.9
"20045",20,45,2004,63173,60550,2623,4.2
"20045",20,45,2005,63186,60679,2507,4
"20045",20,45,2006,62560,60180,2380,3.8
"20045",20,45,2007,62110,59692,2418,3.9
"20045",20,45,2008,61712,59114,2598,4.2
"20045",20,45,2009,63191,59579,3612,5.7
"20045",20,45,2010,64379,60574,3805,5.9
"20045",20,45,2011,63747,60141,3606,5.7
"20045",20,45,2012,63496,60235,3261,5.1
"20045",20,45,2013,63535,60479,3056,4.8
"20045",20,45,2014,64633,61994,2639,4.1
"20045",20,45,2015,64763,62375,2388,3.7
"20045",20,45,2016,65274,62967,2307,3.5
"20045",20,45,2017,65199,63138,2061,3.2
"20047",20,47,1990,1844,1805,39,2.1
"20047",20,47,1991,1832,1781,51,2.8
"20047",20,47,1992,1803,1746,57,3.2
"20047",20,47,1993,1837,1776,61,3.3
"20047",20,47,1994,1881,1813,68,3.6
"20047",20,47,1995,1876,1824,52,2.8
"20047",20,47,1996,1761,1703,58,3.3
"20047",20,47,1997,1722,1664,58,3.4
"20047",20,47,1998,1753,1704,49,2.8
"20047",20,47,1999,1692,1650,42,2.5
"20047",20,47,2000,1697,1653,44,2.6
"20047",20,47,2001,1666,1619,47,2.8
"20047",20,47,2002,1687,1629,58,3.4
"20047",20,47,2003,1694,1632,62,3.7
"20047",20,47,2004,1696,1634,62,3.7
"20047",20,47,2005,1787,1727,60,3.4
"20047",20,47,2006,1715,1663,52,3
"20047",20,47,2007,1636,1580,56,3.4
"20047",20,47,2008,1756,1707,49,2.8
"20047",20,47,2009,1804,1728,76,4.2
"20047",20,47,2010,1683,1593,90,5.3
"20047",20,47,2011,1664,1589,75,4.5
"20047",20,47,2012,1642,1576,66,4
"20047",20,47,2013,1607,1547,60,3.7
"20047",20,47,2014,1605,1552,53,3.3
"20047",20,47,2015,1749,1696,53,3
"20047",20,47,2016,1654,1604,50,3
"20047",20,47,2017,1548,1501,47,3
"20049",20,49,1990,1449,1395,54,3.7
"20049",20,49,1991,1423,1356,67,4.7
"20049",20,49,1992,1498,1427,71,4.7
"20049",20,49,1993,1451,1362,89,6.1
"20049",20,49,1994,1452,1354,98,6.7
"20049",20,49,1995,1506,1431,75,5
"20049",20,49,1996,1410,1355,55,3.9
"20049",20,49,1997,1381,1322,59,4.3
"20049",20,49,1998,1314,1251,63,4.8
"20049",20,49,1999,1341,1284,57,4.3
"20049",20,49,2000,1432,1363,69,4.8
"20049",20,49,2001,1464,1387,77,5.3
"20049",20,49,2002,1421,1339,82,5.8
"20049",20,49,2003,1442,1355,87,6
"20049",20,49,2004,1477,1392,85,5.8
"20049",20,49,2005,1452,1372,80,5.5
"20049",20,49,2006,1465,1394,71,4.8
"20049",20,49,2007,1423,1341,82,5.8
"20049",20,49,2008,1462,1379,83,5.7
"20049",20,49,2009,1527,1402,125,8.2
"20049",20,49,2010,1414,1296,118,8.3
"20049",20,49,2011,1382,1277,105,7.6
"20049",20,49,2012,1348,1256,92,6.8
"20049",20,49,2013,1323,1248,75,5.7
"20049",20,49,2014,1308,1241,67,5.1
"20049",20,49,2015,1280,1219,61,4.8
"20049",20,49,2016,1189,1130,59,5
"20049",20,49,2017,1193,1142,51,4.3
"20051",20,51,1990,14138,13659,479,3.4
"20051",20,51,1991,14644,14162,482,3.3
"20051",20,51,1992,15189,14633,556,3.7
"20051",20,51,1993,15406,14821,585,3.8
"20051",20,51,1994,16134,15571,563,3.5
"20051",20,51,1995,16319,15811,508,3.1
"20051",20,51,1996,16303,15811,492,3
"20051",20,51,1997,17066,16648,418,2.4
"20051",20,51,1998,17573,17089,484,2.8
"20051",20,51,1999,16963,16551,412,2.4
"20051",20,51,2000,15342,14947,395,2.6
"20051",20,51,2001,15397,14955,442,2.9
"20051",20,51,2002,16031,15544,487,3
"20051",20,51,2003,16859,16333,526,3.1
"20051",20,51,2004,16888,16265,623,3.7
"20051",20,51,2005,16637,16076,561,3.4
"20051",20,51,2006,17198,16724,474,2.8
"20051",20,51,2007,17143,16666,477,2.8
"20051",20,51,2008,17372,16843,529,3
"20051",20,51,2009,18090,17388,702,3.9
"20051",20,51,2010,17642,16946,696,3.9
"20051",20,51,2011,17841,17209,632,3.5
"20051",20,51,2012,18020,17403,617,3.4
"20051",20,51,2013,18044,17477,567,3.1
"20051",20,51,2014,17905,17412,493,2.8
"20051",20,51,2015,17522,16999,523,3
"20051",20,51,2016,17013,16488,525,3.1
"20051",20,51,2017,16972,16545,427,2.5
"20053",20,53,1990,2899,2824,75,2.6
"20053",20,53,1991,2888,2810,78,2.7
"20053",20,53,1992,2925,2815,110,3.8
"20053",20,53,1993,2909,2800,109,3.7
"20053",20,53,1994,2901,2794,107,3.7
"20053",20,53,1995,2910,2782,128,4.4
"20053",20,53,1996,2881,2781,100,3.5
"20053",20,53,1997,2814,2743,71,2.5
"20053",20,53,1998,2855,2786,69,2.4
"20053",20,53,1999,2911,2843,68,2.3
"20053",20,53,2000,3162,3057,105,3.3
"20053",20,53,2001,3102,2996,106,3.4
"20053",20,53,2002,3119,2994,125,4
"20053",20,53,2003,3152,3020,132,4.2
"20053",20,53,2004,3227,3084,143,4.4
"20053",20,53,2005,3398,3265,133,3.9
"20053",20,53,2006,3660,3539,121,3.3
"20053",20,53,2007,3690,3566,124,3.4
"20053",20,53,2008,3872,3744,128,3.3
"20053",20,53,2009,3874,3712,162,4.2
"20053",20,53,2010,3395,3235,160,4.7
"20053",20,53,2011,3491,3349,142,4.1
"20053",20,53,2012,3487,3365,122,3.5
"20053",20,53,2013,3447,3332,115,3.3
"20053",20,53,2014,3445,3343,102,3
"20053",20,53,2015,2939,2831,108,3.7
"20053",20,53,2016,2834,2725,109,3.8
"20053",20,53,2017,2708,2624,84,3.1
"20055",20,55,1990,17635,17098,537,3
"20055",20,55,1991,18031,17520,511,2.8
"20055",20,55,1992,18781,18118,663,3.5
"20055",20,55,1993,18802,18066,736,3.9
"20055",20,55,1994,18479,17823,656,3.5
"20055",20,55,1995,19349,18691,658,3.4
"20055",20,55,1996,19312,18602,710,3.7
"20055",20,55,1997,19202,18651,551,2.9
"20055",20,55,1998,20039,19499,540,2.7
"20055",20,55,1999,19851,19302,549,2.8
"20055",20,55,2000,20222,19709,513,2.5
"20055",20,55,2001,18522,17217,1305,7
"20055",20,55,2002,17897,17216,681,3.8
"20055",20,55,2003,18149,17475,674,3.7
"20055",20,55,2004,18233,17473,760,4.2
"20055",20,55,2005,18059,17314,745,4.1
"20055",20,55,2006,18113,17485,628,3.5
"20055",20,55,2007,17903,17291,612,3.4
"20055",20,55,2008,19131,18452,679,3.5
"20055",20,55,2009,19742,18875,867,4.4
"20055",20,55,2010,20174,19255,919,4.6
"20055",20,55,2011,20743,19857,886,4.3
"20055",20,55,2012,20154,19254,900,4.5
"20055",20,55,2013,19980,19124,856,4.3
"20055",20,55,2014,20196,19503,693,3.4
"20055",20,55,2015,20130,19421,709,3.5
"20055",20,55,2016,20151,19530,621,3.1
"20055",20,55,2017,20373,19829,544,2.7
"20057",20,57,1990,14146,13731,415,2.9
"20057",20,57,1991,14297,13904,393,2.7
"20057",20,57,1992,14263,13804,459,3.2
"20057",20,57,1993,14552,14070,482,3.3
"20057",20,57,1994,15768,15132,636,4
"20057",20,57,1995,15822,15270,552,3.5
"20057",20,57,1996,15458,14869,589,3.8
"20057",20,57,1997,15656,15202,454,2.9
"20057",20,57,1998,15905,15532,373,2.3
"20057",20,57,1999,15747,15419,328,2.1
"20057",20,57,2000,15838,15428,410,2.6
"20057",20,57,2001,15484,15003,481,3.1
"20057",20,57,2002,16091,15600,491,3.1
"20057",20,57,2003,16612,16042,570,3.4
"20057",20,57,2004,16932,16280,652,3.9
"20057",20,57,2005,16676,16078,598,3.6
"20057",20,57,2006,17080,16536,544,3.2
"20057",20,57,2007,16647,16121,526,3.2
"20057",20,57,2008,18094,17544,550,3
"20057",20,57,2009,18924,18263,661,3.5
"20057",20,57,2010,18114,17361,753,4.2
"20057",20,57,2011,18271,17483,788,4.3
"20057",20,57,2012,18822,18095,727,3.9
"20057",20,57,2013,18629,17883,746,4
"20057",20,57,2014,18174,17483,691,3.8
"20057",20,57,2015,18062,17449,613,3.4
"20057",20,57,2016,17885,17320,565,3.2
"20057",20,57,2017,17791,17295,496,2.8
"20059",20,59,1990,11167,10510,657,5.9
"20059",20,59,1991,11315,10670,645,5.7
"20059",20,59,1992,11667,11005,662,5.7
"20059",20,59,1993,12097,11357,740,6.1
"20059",20,59,1994,12364,11569,795,6.4
"20059",20,59,1995,12474,11734,740,5.9
"20059",20,59,1996,13384,12773,611,4.6
"20059",20,59,1997,14037,13456,581,4.1
"20059",20,59,1998,13442,12797,645,4.8
"20059",20,59,1999,13198,12730,468,3.5
"20059",20,59,2000,13198,12719,479,3.6
"20059",20,59,2001,13115,12486,629,4.8
"20059",20,59,2002,13184,12474,710,5.4
"20059",20,59,2003,13509,12756,753,5.6
"20059",20,59,2004,13855,13005,850,6.1
"20059",20,59,2005,13868,13081,787,5.7
"20059",20,59,2006,13771,13060,711,5.2
"20059",20,59,2007,13817,13115,702,5.1
"20059",20,59,2008,13782,13008,774,5.6
"20059",20,59,2009,13658,12407,1251,9.2
"20059",20,59,2010,14363,13070,1293,9
"20059",20,59,2011,13989,12817,1172,8.4
"20059",20,59,2012,13977,12960,1017,7.3
"20059",20,59,2013,13966,13108,858,6.1
"20059",20,59,2014,14049,13331,718,5.1
"20059",20,59,2015,14102,13457,645,4.6
"20059",20,59,2016,14227,13631,596,4.2
"20059",20,59,2017,14142,13616,526,3.7
"20061",20,61,1990,10781,9959,822,7.6
"20061",20,61,1991,10775,9832,943,8.8
"20061",20,61,1992,11755,10965,790,6.7
"20061",20,61,1993,11382,10507,875,7.7
"20061",20,61,1994,10949,10060,889,8.1
"20061",20,61,1995,10934,10209,725,6.6
"20061",20,61,1996,10176,9504,672,6.6
"20061",20,61,1997,10094,9398,696,6.9
"20061",20,61,1998,10303,9636,667,6.5
"20061",20,61,1999,10068,9405,663,6.6
"20061",20,61,2000,11335,10805,530,4.7
"20061",20,61,2001,10994,10391,603,5.5
"20061",20,61,2002,10963,10301,662,6
"20061",20,61,2003,11131,10452,679,6.1
"20061",20,61,2004,11230,10513,717,6.4
"20061",20,61,2005,11144,10484,660,5.9
"20061",20,61,2006,11288,10695,593,5.3
"20061",20,61,2007,11921,11397,524,4.4
"20061",20,61,2008,13568,12933,635,4.7
"20061",20,61,2009,14117,13077,1040,7.4
"20061",20,61,2010,13359,12136,1223,9.2
"20061",20,61,2011,13174,11964,1210,9.2
"20061",20,61,2012,12807,11697,1110,8.7
"20061",20,61,2013,12663,11566,1097,8.7
"20061",20,61,2014,12332,11431,901,7.3
"20061",20,61,2015,12111,11361,750,6.2
"20061",20,61,2016,12058,11379,679,5.6
"20061",20,61,2017,11573,10989,584,5
"20063",20,63,1990,1481,1460,21,1.4
"20063",20,63,1991,1468,1448,20,1.4
"20063",20,63,1992,1474,1445,29,2
"20063",20,63,1993,1516,1485,31,2
"20063",20,63,1994,1544,1514,30,1.9
"20063",20,63,1995,1565,1538,27,1.7
"20063",20,63,1996,1494,1467,27,1.8
"20063",20,63,1997,1490,1459,31,2.1
"20063",20,63,1998,1479,1439,40,2.7
"20063",20,63,1999,1512,1485,27,1.8
"20063",20,63,2000,1576,1541,35,2.2
"20063",20,63,2001,1507,1468,39,2.6
"20063",20,63,2002,1588,1541,47,3
"20063",20,63,2003,1573,1528,45,2.9
"20063",20,63,2004,1532,1483,49,3.2
"20063",20,63,2005,1517,1471,46,3
"20063",20,63,2006,1522,1480,42,2.8
"20063",20,63,2007,1502,1457,45,3
"20063",20,63,2008,1516,1474,42,2.8
"20063",20,63,2009,1623,1575,48,3
"20063",20,63,2010,1505,1454,51,3.4
"20063",20,63,2011,1498,1448,50,3.3
"20063",20,63,2012,1513,1468,45,3
"20063",20,63,2013,1488,1439,49,3.3
"20063",20,63,2014,1483,1444,39,2.6
"20063",20,63,2015,1487,1450,37,2.5
"20063",20,63,2016,1451,1416,35,2.4
"20063",20,63,2017,1417,1384,33,2.3
"20065",20,65,1990,1723,1685,38,2.2
"20065",20,65,1991,1725,1689,36,2.1
"20065",20,65,1992,1703,1660,43,2.5
"20065",20,65,1993,1704,1658,46,2.7
"20065",20,65,1994,1731,1659,72,4.2
"20065",20,65,1995,1648,1575,73,4.4
"20065",20,65,1996,1604,1541,63,3.9
"20065",20,65,1997,1532,1486,46,3
"20065",20,65,1998,1556,1511,45,2.9
"20065",20,65,1999,1561,1524,37,2.4
"20065",20,65,2000,1438,1398,40,2.8
"20065",20,65,2001,1366,1322,44,3.2
"20065",20,65,2002,1418,1371,47,3.3
"20065",20,65,2003,1442,1395,47,3.3
"20065",20,65,2004,1439,1383,56,3.9
"20065",20,65,2005,1411,1361,50,3.5
"20065",20,65,2006,1449,1402,47,3.2
"20065",20,65,2007,1481,1435,46,3.1
"20065",20,65,2008,1520,1469,51,3.4
"20065",20,65,2009,1485,1419,66,4.4
"20065",20,65,2010,1389,1323,66,4.8
"20065",20,65,2011,1416,1357,59,4.2
"20065",20,65,2012,1386,1339,47,3.4
"20065",20,65,2013,1351,1295,56,4.1
"20065",20,65,2014,1312,1269,43,3.3
"20065",20,65,2015,1272,1222,50,3.9
"20065",20,65,2016,1225,1171,54,4.4
"20065",20,65,2017,1125,1085,40,3.6
"20067",20,67,1990,3658,3579,79,2.2
"20067",20,67,1991,3698,3595,103,2.8
"20067",20,67,1992,3755,3649,106,2.8
"20067",20,67,1993,3873,3756,117,3
"20067",20,67,1994,3973,3835,138,3.5
"20067",20,67,1995,4064,3944,120,3
"20067",20,67,1996,3975,3842,133,3.3
"20067",20,67,1997,4091,3947,144,3.5
"20067",20,67,1998,4076,3921,155,3.8
"20067",20,67,1999,3852,3703,149,3.9
"20067",20,67,2000,3722,3617,105,2.8
"20067",20,67,2001,3687,3583,104,2.8
"20067",20,67,2002,3723,3600,123,3.3
"20067",20,67,2003,3793,3656,137,3.6
"20067",20,67,2004,3888,3743,145,3.7
"20067",20,67,2005,3787,3652,135,3.6
"20067",20,67,2006,3914,3800,114,2.9
"20067",20,67,2007,3957,3845,112,2.8
"20067",20,67,2008,4002,3887,115,2.9
"20067",20,67,2009,4156,3994,162,3.9
"20067",20,67,2010,4202,4021,181,4.3
"20067",20,67,2011,4104,3932,172,4.2
"20067",20,67,2012,3987,3832,155,3.9
"20067",20,67,2013,3991,3847,144,3.6
"20067",20,67,2014,3936,3802,134,3.4
"20067",20,67,2015,3902,3762,140,3.6
"20067",20,67,2016,3774,3639,135,3.6
"20067",20,67,2017,3478,3367,111,3.2
"20069",20,69,1990,2649,2594,55,2.1
"20069",20,69,1991,2647,2588,59,2.2
"20069",20,69,1992,2648,2580,68,2.6
"20069",20,69,1993,2627,2563,64,2.4
"20069",20,69,1994,2707,2624,83,3.1
"20069",20,69,1995,2794,2722,72,2.6
"20069",20,69,1996,2749,2673,76,2.8
"20069",20,69,1997,2594,2530,64,2.5
"20069",20,69,1998,3202,3130,72,2.2
"20069",20,69,1999,3271,3207,64,2
"20069",20,69,2000,2996,2919,77,2.6
"20069",20,69,2001,3005,2928,77,2.6
"20069",20,69,2002,3117,3021,96,3.1
"20069",20,69,2003,3149,3056,93,3
"20069",20,69,2004,3211,3115,96,3
"20069",20,69,2005,3155,3060,95,3
"20069",20,69,2006,3186,3095,91,2.9
"20069",20,69,2007,3155,3071,84,2.7
"20069",20,69,2008,3323,3236,87,2.6
"20069",20,69,2009,3476,3371,105,3
"20069",20,69,2010,3489,3376,113,3.2
"20069",20,69,2011,3585,3466,119,3.3
"20069",20,69,2012,3562,3451,111,3.1
"20069",20,69,2013,3487,3383,104,3
"20069",20,69,2014,3494,3400,94,2.7
"20069",20,69,2015,3601,3518,83,2.3
"20069",20,69,2016,3410,3333,77,2.3
"20069",20,69,2017,3422,3354,68,2
"20071",20,71,1990,903,888,15,1.7
"20071",20,71,1991,880,866,14,1.6
"20071",20,71,1992,863,837,26,3
"20071",20,71,1993,849,818,31,3.7
"20071",20,71,1994,822,796,26,3.2
"20071",20,71,1995,912,883,29,3.2
"20071",20,71,1996,870,846,24,2.8
"20071",20,71,1997,872,846,26,3
"20071",20,71,1998,819,790,29,3.5
"20071",20,71,1999,824,800,24,2.9
"20071",20,71,2000,762,737,25,3.3
"20071",20,71,2001,787,760,27,3.4
"20071",20,71,2002,773,749,24,3.1
"20071",20,71,2003,787,758,29,3.7
"20071",20,71,2004,772,740,32,4.1
"20071",20,71,2005,742,712,30,4
"20071",20,71,2006,734,711,23,3.1
"20071",20,71,2007,698,675,23,3.3
"20071",20,71,2008,731,703,28,3.8
"20071",20,71,2009,733,705,28,3.8
"20071",20,71,2010,827,799,28,3.4
"20071",20,71,2011,842,816,26,3.1
"20071",20,71,2012,884,857,27,3.1
"20071",20,71,2013,908,886,22,2.4
"20071",20,71,2014,897,878,19,2.1
"20071",20,71,2015,935,915,20,2.1
"20071",20,71,2016,912,893,19,2.1
"20071",20,71,2017,880,864,16,1.8
"20073",20,73,1990,3588,3418,170,4.7
"20073",20,73,1991,3482,3325,157,4.5
"20073",20,73,1992,3561,3374,187,5.3
"20073",20,73,1993,3530,3310,220,6.2
"20073",20,73,1994,3604,3376,228,6.3
"20073",20,73,1995,3350,3166,184,5.5
"20073",20,73,1996,3354,3196,158,4.7
"20073",20,73,1997,3176,3023,153,4.8
"20073",20,73,1998,3244,3085,159,4.9
"20073",20,73,1999,3195,3034,161,5
"20073",20,73,2000,3721,3547,174,4.7
"20073",20,73,2001,3536,3356,180,5.1
"20073",20,73,2002,3600,3388,212,5.9
"20073",20,73,2003,3625,3414,211,5.8
"20073",20,73,2004,3540,3309,231,6.5
"20073",20,73,2005,3613,3422,191,5.3
"20073",20,73,2006,3529,3366,163,4.6
"20073",20,73,2007,3570,3404,166,4.6
"20073",20,73,2008,3628,3436,192,5.3
"20073",20,73,2009,3579,3341,238,6.6
"20073",20,73,2010,3441,3181,260,7.6
"20073",20,73,2011,3466,3236,230,6.6
"20073",20,73,2012,3426,3234,192,5.6
"20073",20,73,2013,3358,3179,179,5.3
"20073",20,73,2014,3327,3177,150,4.5
"20073",20,73,2015,3289,3139,150,4.6
"20073",20,73,2016,3323,3161,162,4.9
"20073",20,73,2017,3211,3074,137,4.3
"20075",20,75,1990,1259,1246,13,1
"20075",20,75,1991,1234,1217,17,1.4
"20075",20,75,1992,1235,1212,23,1.9
"20075",20,75,1993,1233,1200,33,2.7
"20075",20,75,1994,1292,1265,27,2.1
"20075",20,75,1995,1259,1231,28,2.2
"20075",20,75,1996,1213,1185,28,2.3
"20075",20,75,1997,1182,1160,22,1.9
"20075",20,75,1998,1256,1232,24,1.9
"20075",20,75,1999,1249,1232,17,1.4
"20075",20,75,2000,1274,1240,34,2.7
"20075",20,75,2001,1255,1218,37,2.9
"20075",20,75,2002,1261,1220,41,3.3
"20075",20,75,2003,1285,1246,39,3
"20075",20,75,2004,1277,1232,45,3.5
"20075",20,75,2005,1246,1205,41,3.3
"20075",20,75,2006,1261,1220,41,3.3
"20075",20,75,2007,1250,1207,43,3.4
"20075",20,75,2008,1288,1244,44,3.4
"20075",20,75,2009,1344,1291,53,3.9
"20075",20,75,2010,1825,1768,57,3.1
"20075",20,75,2011,1746,1697,49,2.8
"20075",20,75,2012,1825,1776,49,2.7
"20075",20,75,2013,1715,1666,49,2.9
"20075",20,75,2014,1662,1623,39,2.3
"20075",20,75,2015,1652,1620,32,1.9
"20075",20,75,2016,1643,1599,44,2.7
"20075",20,75,2017,1608,1570,38,2.4
"20077",20,77,1990,3298,3221,77,2.3
"20077",20,77,1991,3202,3120,82,2.6
"20077",20,77,1992,3147,3033,114,3.6
"20077",20,77,1993,3096,2972,124,4
"20077",20,77,1994,3168,3035,133,4.2
"20077",20,77,1995,3051,2949,102,3.3
"20077",20,77,1996,3099,2992,107,3.5
"20077",20,77,1997,3054,2970,84,2.8
"20077",20,77,1998,2997,2931,66,2.2
"20077",20,77,1999,3011,2919,92,3.1
"20077",20,77,2000,3178,3063,115,3.6
"20077",20,77,2001,3076,2965,111,3.6
"20077",20,77,2002,3189,3067,122,3.8
"20077",20,77,2003,3258,3119,139,4.3
"20077",20,77,2004,3397,3252,145,4.3
"20077",20,77,2005,3420,3295,125,3.7
"20077",20,77,2006,3435,3324,111,3.2
"20077",20,77,2007,3395,3292,103,3
"20077",20,77,2008,3438,3328,110,3.2
"20077",20,77,2009,3469,3293,176,5.1
"20077",20,77,2010,2937,2753,184,6.3
"20077",20,77,2011,2895,2731,164,5.7
"20077",20,77,2012,3107,2972,135,4.3
"20077",20,77,2013,3104,2979,125,4
"20077",20,77,2014,2979,2869,110,3.7
"20077",20,77,2015,2855,2744,111,3.9
"20077",20,77,2016,2881,2778,103,3.6
"20077",20,77,2017,2654,2555,99,3.7
"20079",20,79,1990,16142,15639,503,3.1
"20079",20,79,1991,16137,15598,539,3.3
"20079",20,79,1992,16429,15753,676,4.1
"20079",20,79,1993,16584,15957,627,3.8
"20079",20,79,1994,16232,15512,720,4.4
"20079",20,79,1995,15994,15352,642,4
"20079",20,79,1996,15931,15337,594,3.7
"20079",20,79,1997,17162,16684,478,2.8
"20079",20,79,1998,17791,17342,449,2.5
"20079",20,79,1999,17715,17201,514,2.9
"20079",20,79,2000,17596,16988,608,3.5
"20079",20,79,2001,17473,16876,597,3.4
"20079",20,79,2002,17627,16884,743,4.2
"20079",20,79,2003,17572,16672,900,5.1
"20079",20,79,2004,17894,17022,872,4.9
"20079",20,79,2005,18030,17222,808,4.5
"20079",20,79,2006,17907,17117,790,4.4
"20079",20,79,2007,17969,17301,668,3.7
"20079",20,79,2008,18086,17376,710,3.9
"20079",20,79,2009,18262,16976,1286,7
"20079",20,79,2010,17774,16497,1277,7.2
"20079",20,79,2011,17387,16330,1057,6.1
"20079",20,79,2012,17249,16312,937,5.4
"20079",20,79,2013,17110,16278,832,4.9
"20079",20,79,2014,17110,16382,728,4.3
"20079",20,79,2015,17208,16538,670,3.9
"20079",20,79,2016,17206,16479,727,4.2
"20079",20,79,2017,17031,16343,688,4
"20081",20,81,1990,2008,1959,49,2.4
"20081",20,81,1991,1995,1956,39,2
"20081",20,81,1992,1953,1910,43,2.2
"20081",20,81,1993,2002,1947,55,2.7
"20081",20,81,1994,2121,2068,53,2.5
"20081",20,81,1995,2143,2073,70,3.3
"20081",20,81,1996,2078,2017,61,2.9
"20081",20,81,1997,2013,1962,51,2.5
"20081",20,81,1998,2086,2033,53,2.5
"20081",20,81,1999,2151,2105,46,2.1
"20081",20,81,2000,2081,2034,47,2.3
"20081",20,81,2001,2036,1979,57,2.8
"20081",20,81,2002,2120,2059,61,2.9
"20081",20,81,2003,2115,2054,61,2.9
"20081",20,81,2004,2174,2097,77,3.5
"20081",20,81,2005,2145,2079,66,3.1
"20081",20,81,2006,2099,2039,60,2.9
"20081",20,81,2007,2152,2090,62,2.9
"20081",20,81,2008,2193,2133,60,2.7
"20081",20,81,2009,2299,2222,77,3.3
"20081",20,81,2010,2445,2357,88,3.6
"20081",20,81,2011,2414,2329,85,3.5
"20081",20,81,2012,2462,2379,83,3.4
"20081",20,81,2013,2389,2319,70,2.9
"20081",20,81,2014,2356,2295,61,2.6
"20081",20,81,2015,2358,2299,59,2.5
"20081",20,81,2016,2305,2245,60,2.6
"20081",20,81,2017,2218,2168,50,2.3
"20083",20,83,1990,973,959,14,1.4
"20083",20,83,1991,951,939,12,1.3
"20083",20,83,1992,945,928,17,1.8
"20083",20,83,1993,997,977,20,2
"20083",20,83,1994,1027,1002,25,2.4
"20083",20,83,1995,1021,997,24,2.4
"20083",20,83,1996,985,962,23,2.3
"20083",20,83,1997,942,924,18,1.9
"20083",20,83,1998,1053,1032,21,2
"20083",20,83,1999,1088,1066,22,2
"20083",20,83,2000,1006,973,33,3.3
"20083",20,83,2001,934,904,30,3.2
"20083",20,83,2002,956,922,34,3.6
"20083",20,83,2003,987,948,39,4
"20083",20,83,2004,965,921,44,4.6
"20083",20,83,2005,965,927,38,3.9
"20083",20,83,2006,963,929,34,3.5
"20083",20,83,2007,903,867,36,4
"20083",20,83,2008,944,912,32,3.4
"20083",20,83,2009,953,915,38,4
"20083",20,83,2010,1085,1045,40,3.7
"20083",20,83,2011,1109,1067,42,3.8
"20083",20,83,2012,1111,1073,38,3.4
"20083",20,83,2013,1116,1073,43,3.9
"20083",20,83,2014,1034,999,35,3.4
"20083",20,83,2015,1027,995,32,3.1
"20083",20,83,2016,1030,1003,27,2.6
"20083",20,83,2017,993,968,25,2.5
"20085",20,85,1990,5660,5326,334,5.9
"20085",20,85,1991,5623,5273,350,6.2
"20085",20,85,1992,5928,5594,334,5.6
"20085",20,85,1993,6206,5810,396,6.4
"20085",20,85,1994,6485,6112,373,5.8
"20085",20,85,1995,6332,5973,359,5.7
"20085",20,85,1996,6613,6235,378,5.7
"20085",20,85,1997,6762,6382,380,5.6
"20085",20,85,1998,8431,8100,331,3.9
"20085",20,85,1999,8927,8659,268,3
"20085",20,85,2000,6657,6385,272,4.1
"20085",20,85,2001,6638,6348,290,4.4
"20085",20,85,2002,6875,6534,341,5
"20085",20,85,2003,7023,6593,430,6.1
"20085",20,85,2004,7099,6668,431,6.1
"20085",20,85,2005,7157,6744,413,5.8
"20085",20,85,2006,6916,6546,370,5.3
"20085",20,85,2007,6945,6561,384,5.5
"20085",20,85,2008,6872,6476,396,5.8
"20085",20,85,2009,7038,6548,490,7
"20085",20,85,2010,7509,7046,463,6.2
"20085",20,85,2011,7419,6973,446,6
"20085",20,85,2012,7345,6932,413,5.6
"20085",20,85,2013,7286,6916,370,5.1
"20085",20,85,2014,7386,7081,305,4.1
"20085",20,85,2015,7240,6972,268,3.7
"20085",20,85,2016,7260,7009,251,3.5
"20085",20,85,2017,7181,6956,225,3.1
"20087",20,87,1990,8148,7740,408,5
"20087",20,87,1991,8532,8083,449,5.3
"20087",20,87,1992,8850,8426,424,4.8
"20087",20,87,1993,9137,8659,478,5.2
"20087",20,87,1994,9505,9070,435,4.6
"20087",20,87,1995,9778,9355,423,4.3
"20087",20,87,1996,10024,9556,468,4.7
"20087",20,87,1997,10583,10079,504,4.8
"20087",20,87,1998,10340,9894,446,4.3
"20087",20,87,1999,9714,9389,325,3.3
"20087",20,87,2000,9768,9398,370,3.8
"20087",20,87,2001,9774,9377,397,4.1
"20087",20,87,2002,10065,9592,473,4.7
"20087",20,87,2003,10106,9590,516,5.1
"20087",20,87,2004,10271,9681,590,5.7
"20087",20,87,2005,10146,9622,524,5.2
"20087",20,87,2006,9700,9238,462,4.8
"20087",20,87,2007,9606,9127,479,5
"20087",20,87,2008,9615,9109,506,5.3
"20087",20,87,2009,9723,8986,737,7.6
"20087",20,87,2010,10671,9871,800,7.5
"20087",20,87,2011,10450,9707,743,7.1
"20087",20,87,2012,10240,9620,620,6.1
"20087",20,87,2013,10187,9604,583,5.7
"20087",20,87,2014,10215,9722,493,4.8
"20087",20,87,2015,10187,9761,426,4.2
"20087",20,87,2016,10217,9820,397,3.9
"20087",20,87,2017,10104,9744,360,3.6
"20089",20,89,1990,2086,2042,44,2.1
"20089",20,89,1991,2036,1997,39,1.9
"20089",20,89,1992,2112,2074,38,1.8
"20089",20,89,1993,2128,2088,40,1.9
"20089",20,89,1994,2126,2086,40,1.9
"20089",20,89,1995,2180,2125,55,2.5
"20089",20,89,1996,2131,2055,76,3.6
"20089",20,89,1997,2085,2034,51,2.4
"20089",20,89,1998,2094,2042,52,2.5
"20089",20,89,1999,2059,2023,36,1.7
"20089",20,89,2000,1892,1843,49,2.6
"20089",20,89,2001,1816,1764,52,2.9
"20089",20,89,2002,1984,1926,58,2.9
"20089",20,89,2003,2093,2032,61,2.9
"20089",20,89,2004,2058,1988,70,3.4
"20089",20,89,2005,1974,1911,63,3.2
"20089",20,89,2006,1900,1841,59,3.1
"20089",20,89,2007,1918,1863,55,2.9
"20089",20,89,2008,1950,1888,62,3.2
"20089",20,89,2009,1995,1911,84,4.2
"20089",20,89,2010,1558,1473,85,5.5
"20089",20,89,2011,1528,1456,72,4.7
"20089",20,89,2012,1449,1387,62,4.3
"20089",20,89,2013,1422,1370,52,3.7
"20089",20,89,2014,1380,1326,54,3.9
"20089",20,89,2015,1374,1314,60,4.4
"20089",20,89,2016,1331,1274,57,4.3
"20089",20,89,2017,1312,1267,45,3.4
"20091",20,91,1990,210902,204707,6195,2.9
"20091",20,91,1991,213378,206355,7023,3.3
"20091",20,91,1992,220417,213471,6946,3.2
"20091",20,91,1993,228876,221437,7439,3.3
"20091",20,91,1994,237355,229719,7636,3.2
"20091",20,91,1995,237045,230126,6919,2.9
"20091",20,91,1996,241665,234894,6771,2.8
"20091",20,91,1997,251907,246154,5753,2.3
"20091",20,91,1998,262724,256387,6337,2.4
"20091",20,91,1999,270649,265121,5528,2
"20091",20,91,2000,263190,255705,7485,2.8
"20091",20,91,2001,262563,252706,9857,3.8
"20091",20,91,2002,267927,255226,12701,4.7
"20091",20,91,2003,277509,263333,14176,5.1
"20091",20,91,2004,286194,272005,14189,5
"20091",20,91,2005,290970,277684,13286,4.6
"20091",20,91,2006,292027,279977,12050,4.1
"20091",20,91,2007,298890,286748,12142,4.1
"20091",20,91,2008,301599,287691,13908,4.6
"20091",20,91,2009,299697,280131,19566,6.5
"20091",20,91,2010,307190,288469,18721,6.1
"20091",20,91,2011,308303,291774,16529,5.4
"20091",20,91,2012,310263,296014,14249,4.6
"20091",20,91,2013,314173,300633,13540,4.3
"20091",20,91,2014,320747,308630,12117,3.8
"20091",20,91,2015,324703,313723,10980,3.4
"20091",20,91,2016,328355,317665,10690,3.3
"20091",20,91,2017,332197,322197,10000,3
"20093",20,93,1990,2032,1980,52,2.6
"20093",20,93,1991,2027,1988,39,1.9
"20093",20,93,1992,2094,2035,59,2.8
"20093",20,93,1993,2098,2026,72,3.4
"20093",20,93,1994,2104,2043,61,2.9
"20093",20,93,1995,2191,2125,66,3
"20093",20,93,1996,2167,2105,62,2.9
"20093",20,93,1997,2140,2089,51,2.4
"20093",20,93,1998,2164,2110,54,2.5
"20093",20,93,1999,2097,2043,54,2.6
"20093",20,93,2000,2031,1976,55,2.7
"20093",20,93,2001,1913,1851,62,3.2
"20093",20,93,2002,1929,1865,64,3.3
"20093",20,93,2003,2022,1944,78,3.9
"20093",20,93,2004,1956,1868,88,4.5
"20093",20,93,2005,2018,1933,85,4.2
"20093",20,93,2006,2023,1947,76,3.8
"20093",20,93,2007,2128,2059,69,3.2
"20093",20,93,2008,2179,2105,74,3.4
"20093",20,93,2009,2174,2078,96,4.4
"20093",20,93,2010,2155,2058,97,4.5
"20093",20,93,2011,2179,2083,96,4.4
"20093",20,93,2012,2170,2084,86,4
"20093",20,93,2013,2099,2023,76,3.6
"20093",20,93,2014,2117,2052,65,3.1
"20093",20,93,2015,2148,2081,67,3.1
"20093",20,93,2016,2058,1993,65,3.2
"20093",20,93,2017,2055,2004,51,2.5
"20095",20,95,1990,3922,3790,132,3.4
"20095",20,95,1991,3970,3805,165,4.2
"20095",20,95,1992,3983,3809,174,4.4
"20095",20,95,1993,4049,3810,239,5.9
"20095",20,95,1994,4267,4008,259,6.1
"20095",20,95,1995,4252,4079,173,4.1
"20095",20,95,1996,4210,4029,181,4.3
"20095",20,95,1997,4270,4116,154,3.6
"20095",20,95,1998,4258,4136,122,2.9
"20095",20,95,1999,4264,4127,137,3.2
"20095",20,95,2000,4248,4098,150,3.5
"20095",20,95,2001,4147,3998,149,3.6
"20095",20,95,2002,4195,3995,200,4.8
"20095",20,95,2003,4253,4027,226,5.3
"20095",20,95,2004,4287,4084,203,4.7
"20095",20,95,2005,4332,4150,182,4.2
"20095",20,95,2006,4377,4217,160,3.7
"20095",20,95,2007,4285,4140,145,3.4
"20095",20,95,2008,4490,4340,150,3.3
"20095",20,95,2009,4633,4373,260,5.6
"20095",20,95,2010,3862,3594,268,6.9
"20095",20,95,2011,3823,3579,244,6.4
"20095",20,95,2012,3768,3537,231,6.1
"20095",20,95,2013,3716,3514,202,5.4
"20095",20,95,2014,3603,3459,144,4
"20095",20,95,2015,3649,3491,158,4.3
"20095",20,95,2016,3528,3373,155,4.4
"20095",20,95,2017,3440,3314,126,3.7
"20097",20,97,1990,1734,1707,27,1.6
"20097",20,97,1991,1738,1702,36,2.1
"20097",20,97,1992,1725,1682,43,2.5
"20097",20,97,1993,1705,1661,44,2.6
"20097",20,97,1994,1895,1836,59,3.1
"20097",20,97,1995,1826,1780,46,2.5
"20097",20,97,1996,1679,1632,47,2.8
"20097",20,97,1997,1633,1599,34,2.1
"20097",20,97,1998,1614,1579,35,2.2
"20097",20,97,1999,1690,1661,29,1.7
"20097",20,97,2000,1610,1566,44,2.7
"20097",20,97,2001,1490,1442,48,3.2
"20097",20,97,2002,1464,1409,55,3.8
"20097",20,97,2003,1627,1575,52,3.2
"20097",20,97,2004,1692,1632,60,3.5
"20097",20,97,2005,1616,1560,56,3.5
"20097",20,97,2006,1636,1588,48,2.9
"20097",20,97,2007,1492,1422,70,4.7
"20097",20,97,2008,1433,1384,49,3.4
"20097",20,97,2009,1580,1525,55,3.5
"20097",20,97,2010,1398,1325,73,5.2
"20097",20,97,2011,1344,1287,57,4.2
"20097",20,97,2012,1407,1354,53,3.8
"20097",20,97,2013,1422,1374,48,3.4
"20097",20,97,2014,1349,1305,44,3.3
"20097",20,97,2015,1448,1405,43,3
"20097",20,97,2016,1420,1381,39,2.7
"20097",20,97,2017,1342,1308,34,2.5
"20099",20,99,1990,11574,10765,809,7
"20099",20,99,1991,11712,11009,703,6
"20099",20,99,1992,11317,10324,993,8.8
"20099",20,99,1993,11036,10165,871,7.9
"20099",20,99,1994,10866,9976,890,8.2
"20099",20,99,1995,10676,10036,640,6
"20099",20,99,1996,10736,10070,666,6.2
"20099",20,99,1997,10542,9966,576,5.5
"20099",20,99,1998,11541,10978,563,4.9
"20099",20,99,1999,11688,11184,504,4.3
"20099",20,99,2000,11342,10799,543,4.8
"20099",20,99,2001,10720,10137,583,5.4
"20099",20,99,2002,10796,10150,646,6
"20099",20,99,2003,10194,9522,672,6.6
"20099",20,99,2004,10523,9805,718,6.8
"20099",20,99,2005,10444,9770,674,6.5
"20099",20,99,2006,10775,10203,572,5.3
"20099",20,99,2007,11351,10790,561,4.9
"20099",20,99,2008,11469,10861,608,5.3
"20099",20,99,2009,11659,10659,1000,8.6
"20099",20,99,2010,11277,10203,1074,9.5
"20099",20,99,2011,11038,10039,999,9.1
"20099",20,99,2012,10711,9858,853,8
"20099",20,99,2013,10728,9959,769,7.2
"20099",20,99,2014,10772,10144,628,5.8
"20099",20,99,2015,10753,10137,616,5.7
"20099",20,99,2016,10733,10155,578,5.4
"20099",20,99,2017,10350,9881,469,4.5
"20101",20,101,1990,1127,1109,18,1.6
"20101",20,101,1991,1106,1091,15,1.4
"20101",20,101,1992,1098,1083,15,1.4
"20101",20,101,1993,1109,1091,18,1.6
"20101",20,101,1994,1270,1235,35,2.8
"20101",20,101,1995,1186,1144,42,3.5
"20101",20,101,1996,1122,1094,28,2.5
"20101",20,101,1997,1074,1022,52,4.8
"20101",20,101,1998,1096,1066,30,2.7
"20101",20,101,1999,1131,1097,34,3
"20101",20,101,2000,1117,1086,31,2.8
"20101",20,101,2001,1110,1071,39,3.5
"20101",20,101,2002,1125,1080,45,4
"20101",20,101,2003,1117,1073,44,3.9
"20101",20,101,2004,1085,1038,47,4.3
"20101",20,101,2005,1064,1026,38,3.6
"20101",20,101,2006,1064,1027,37,3.5
"20101",20,101,2007,1066,1028,38,3.6
"20101",20,101,2008,1098,1057,41,3.7
"20101",20,101,2009,1142,1104,38,3.3
"20101",20,101,2010,985,944,41,4.2
"20101",20,101,2011,959,915,44,4.6
"20101",20,101,2012,900,859,41,4.6
"20101",20,101,2013,883,852,31,3.5
"20101",20,101,2014,863,835,28,3.2
"20101",20,101,2015,878,849,29,3.3
"20101",20,101,2016,810,785,25,3.1
"20101",20,101,2017,797,770,27,3.4
"20103",20,103,1990,25512,24240,1272,5
"20103",20,103,1991,25816,24494,1322,5.1
"20103",20,103,1992,26326,24947,1379,5.2
"20103",20,103,1993,27109,25575,1534,5.7
"20103",20,103,1994,27678,26194,1484,5.4
"20103",20,103,1995,27432,26021,1411,5.1
"20103",20,103,1996,27761,26335,1426,5.1
"20103",20,103,1997,28187,26927,1260,4.5
"20103",20,103,1998,28976,27776,1200,4.1
"20103",20,103,1999,29291,28266,1025,3.5
"20103",20,103,2000,31310,30074,1236,3.9
"20103",20,103,2001,31117,29539,1578,5.1
"20103",20,103,2002,31427,29589,1838,5.8
"20103",20,103,2003,32140,30168,1972,6.1
"20103",20,103,2004,32836,30743,2093,6.4
"20103",20,103,2005,33105,31070,2035,6.1
"20103",20,103,2006,32764,30926,1838,5.6
"20103",20,103,2007,32857,31086,1771,5.4
"20103",20,103,2008,32928,31016,1912,5.8
"20103",20,103,2009,32725,30100,2625,8
"20103",20,103,2010,34342,31735,2607,7.6
"20103",20,103,2011,34425,31917,2508,7.3
"20103",20,103,2012,34446,32240,2206,6.4
"20103",20,103,2013,34597,32529,2068,6
"20103",20,103,2014,34990,33245,1745,5
"20103",20,103,2015,35272,33686,1586,4.5
"20103",20,103,2016,35786,34246,1540,4.3
"20103",20,103,2017,36117,34708,1409,3.9
"20105",20,105,1990,1806,1735,71,3.9
"20105",20,105,1991,1803,1742,61,3.4
"20105",20,105,1992,1847,1785,62,3.4
"20105",20,105,1993,1860,1788,72,3.9
"20105",20,105,1994,1798,1726,72,4
"20105",20,105,1995,1831,1734,97,5.3
"20105",20,105,1996,1796,1723,73,4.1
"20105",20,105,1997,1718,1663,55,3.2
"20105",20,105,1998,1817,1764,53,2.9
"20105",20,105,1999,1827,1791,36,2
"20105",20,105,2000,1900,1848,52,2.7
"20105",20,105,2001,1786,1722,64,3.6
"20105",20,105,2002,1875,1795,80,4.3
"20105",20,105,2003,1917,1820,97,5.1
"20105",20,105,2004,1820,1731,89,4.9
"20105",20,105,2005,1805,1728,77,4.3
"20105",20,105,2006,1848,1783,65,3.5
"20105",20,105,2007,1828,1757,71,3.9
"20105",20,105,2008,1933,1861,72,3.7
"20105",20,105,2009,2021,1910,111,5.5
"20105",20,105,2010,1882,1770,112,6
"20105",20,105,2011,1877,1780,97,5.2
"20105",20,105,2012,1847,1757,90,4.9
"20105",20,105,2013,1778,1696,82,4.6
"20105",20,105,2014,1771,1698,73,4.1
"20105",20,105,2015,1798,1736,62,3.4
"20105",20,105,2016,1738,1678,60,3.5
"20105",20,105,2017,1689,1641,48,2.8
"20107",20,107,1990,3359,3078,281,8.4
"20107",20,107,1991,3305,2989,316,9.6
"20107",20,107,1992,3355,3021,334,10
"20107",20,107,1993,3357,3008,349,10.4
"20107",20,107,1994,3420,3063,357,10.4
"20107",20,107,1995,3529,3222,307,8.7
"20107",20,107,1996,3324,3056,268,8.1
"20107",20,107,1997,3402,3109,293,8.6
"20107",20,107,1998,3331,3051,280,8.4
"20107",20,107,1999,3299,3072,227,6.9
"20107",20,107,2000,4740,4515,225,4.7
"20107",20,107,2001,4700,4419,281,6
"20107",20,107,2002,4640,4353,287,6.2
"20107",20,107,2003,4718,4401,317,6.7
"20107",20,107,2004,4826,4460,366,7.6
"20107",20,107,2005,4897,4542,355,7.2
"20107",20,107,2006,4809,4510,299,6.2
"20107",20,107,2007,4752,4446,306,6.4
"20107",20,107,2008,4639,4328,311,6.7
"20107",20,107,2009,4533,4026,507,11.2
"20107",20,107,2010,4534,4028,506,11.2
"20107",20,107,2011,4501,3999,502,11.2
"20107",20,107,2012,4382,3949,433,9.9
"20107",20,107,2013,4334,3959,375,8.7
"20107",20,107,2014,4319,3997,322,7.5
"20107",20,107,2015,4328,4051,277,6.4
"20107",20,107,2016,4343,4064,279,6.4
"20107",20,107,2017,4355,4100,255,5.9
"20109",20,109,1990,1567,1540,27,1.7
"20109",20,109,1991,1567,1521,46,2.9
"20109",20,109,1992,1599,1538,61,3.8
"20109",20,109,1993,1590,1539,51,3.2
"20109",20,109,1994,1596,1552,44,2.8
"20109",20,109,1995,1660,1624,36,2.2
"20109",20,109,1996,1592,1551,41,2.6
"20109",20,109,1997,1678,1636,42,2.5
"20109",20,109,1998,1588,1551,37,2.3
"20109",20,109,1999,1629,1598,31,1.9
"20109",20,109,2000,1601,1546,55,3.4
"20109",20,109,2001,1537,1490,47,3.1
"20109",20,109,2002,1556,1500,56,3.6
"20109",20,109,2003,1593,1542,51,3.2
"20109",20,109,2004,1577,1520,57,3.6
"20109",20,109,2005,1553,1498,55,3.5
"20109",20,109,2006,1493,1446,47,3.1
"20109",20,109,2007,1775,1725,50,2.8
"20109",20,109,2008,1659,1613,46,2.8
"20109",20,109,2009,1730,1673,57,3.3
"20109",20,109,2010,1737,1676,61,3.5
"20109",20,109,2011,1774,1716,58,3.3
"20109",20,109,2012,1754,1701,53,3
"20109",20,109,2013,1742,1694,48,2.8
"20109",20,109,2014,1733,1694,39,2.3
"20109",20,109,2015,1756,1713,43,2.4
"20109",20,109,2016,1723,1679,44,2.6
"20109",20,109,2017,1682,1646,36,2.1
"20111",20,111,1990,18310,17409,901,4.9
"20111",20,111,1991,18769,17954,815,4.3
"20111",20,111,1992,19193,18353,840,4.4
"20111",20,111,1993,19207,18319,888,4.6
"20111",20,111,1994,18969,18074,895,4.7
"20111",20,111,1995,19956,19071,885,4.4
"20111",20,111,1996,19565,18739,826,4.2
"20111",20,111,1997,19591,18811,780,4
"20111",20,111,1998,20037,19334,703,3.5
"20111",20,111,1999,19959,19275,684,3.4
"20111",20,111,2000,18572,18002,570,3.1
"20111",20,111,2001,18551,17799,752,4.1
"20111",20,111,2002,18966,18146,820,4.3
"20111",20,111,2003,19476,18611,865,4.4
"20111",20,111,2004,19949,19025,924,4.6
"20111",20,111,2005,19509,18621,888,4.6
"20111",20,111,2006,19435,18623,812,4.2
"20111",20,111,2007,19695,18888,807,4.1
"20111",20,111,2008,18873,17767,1106,5.9
"20111",20,111,2009,18645,17502,1143,6.1
"20111",20,111,2010,17481,16316,1165,6.7
"20111",20,111,2011,17333,16222,1111,6.4
"20111",20,111,2012,17227,16227,1000,5.8
"20111",20,111,2013,16426,15247,1179,7.2
"20111",20,111,2014,16511,15666,845,5.1
"20111",20,111,2015,16637,15924,713,4.3
"20111",20,111,2016,16822,16132,690,4.1
"20111",20,111,2017,16809,16171,638,3.8
"20113",20,113,1990,14399,13982,417,2.9
"20113",20,113,1991,14378,13902,476,3.3
"20113",20,113,1992,14735,14298,437,3
"20113",20,113,1993,15263,14813,450,2.9
"20113",20,113,1994,15540,15139,401,2.6
"20113",20,113,1995,15725,15300,425,2.7
"20113",20,113,1996,15889,15438,451,2.8
"20113",20,113,1997,16141,15707,434,2.7
"20113",20,113,1998,16058,15642,416,2.6
"20113",20,113,1999,16205,15844,361,2.2
"20113",20,113,2000,15377,14934,443,2.9
"20113",20,113,2001,15026,14490,536,3.6
"20113",20,113,2002,15589,15065,524,3.4
"20113",20,113,2003,16104,15501,603,3.7
"20113",20,113,2004,17044,16380,664,3.9
"20113",20,113,2005,17084,16441,643,3.8
"20113",20,113,2006,17229,16648,581,3.4
"20113",20,113,2007,16742,16161,581,3.5
"20113",20,113,2008,16521,15927,594,3.6
"20113",20,113,2009,16937,16100,837,4.9
"20113",20,113,2010,16477,15627,850,5.2
"20113",20,113,2011,16652,15892,760,4.6
"20113",20,113,2012,16654,15969,685,4.1
"20113",20,113,2013,16579,15937,642,3.9
"20113",20,113,2014,16823,16277,546,3.2
"20113",20,113,2015,17183,16670,513,3
"20113",20,113,2016,16340,15825,515,3.2
"20113",20,113,2017,16290,15841,449,2.8
"20115",20,115,1990,6348,6171,177,2.8
"20115",20,115,1991,6570,6394,176,2.7
"20115",20,115,1992,6626,6426,200,3
"20115",20,115,1993,6603,6401,202,3.1
"20115",20,115,1994,6898,6713,185,2.7
"20115",20,115,1995,6918,6739,179,2.6
"20115",20,115,1996,6961,6770,191,2.7
"20115",20,115,1997,7123,6964,159,2.2
"20115",20,115,1998,6847,6690,157,2.3
"20115",20,115,1999,7139,6972,167,2.3
"20115",20,115,2000,6711,6512,199,3
"20115",20,115,2001,6555,6328,227,3.5
"20115",20,115,2002,6554,6301,253,3.9
"20115",20,115,2003,6663,6359,304,4.6
"20115",20,115,2004,6731,6427,304,4.5
"20115",20,115,2005,6779,6496,283,4.2
"20115",20,115,2006,6781,6514,267,3.9
"20115",20,115,2007,6697,6452,245,3.7
"20115",20,115,2008,6755,6505,250,3.7
"20115",20,115,2009,7023,6635,388,5.5
"20115",20,115,2010,6742,6342,400,5.9
"20115",20,115,2011,6471,6104,367,5.7
"20115",20,115,2012,6344,6019,325,5.1
"20115",20,115,2013,6210,5920,290,4.7
"20115",20,115,2014,6139,5889,250,4.1
"20115",20,115,2015,6163,5930,233,3.8
"20115",20,115,2016,6121,5880,241,3.9
"20115",20,115,2017,6267,6040,227,3.6
"20117",20,117,1990,5343,5240,103,1.9
"20117",20,117,1991,5287,5116,171,3.2
"20117",20,117,1992,5502,5369,133,2.4
"20117",20,117,1993,5652,5507,145,2.6
"20117",20,117,1994,5725,5578,147,2.6
"20117",20,117,1995,5932,5752,180,3
"20117",20,117,1996,5947,5752,195,3.3
"20117",20,117,1997,5958,5781,177,3
"20117",20,117,1998,5946,5787,159,2.7
"20117",20,117,1999,6009,5849,160,2.7
"20117",20,117,2000,5560,5365,195,3.5
"20117",20,117,2001,5483,5276,207,3.8
"20117",20,117,2002,5674,5450,224,3.9
"20117",20,117,2003,5730,5520,210,3.7
"20117",20,117,2004,5820,5596,224,3.8
"20117",20,117,2005,5919,5699,220,3.7
"20117",20,117,2006,5786,5583,203,3.5
"20117",20,117,2007,6058,5867,191,3.2
"20117",20,117,2008,5977,5753,224,3.7
"20117",20,117,2009,6160,5816,344,5.6
"20117",20,117,2010,5908,5608,300,5.1
"20117",20,117,2011,5992,5713,279,4.7
"20117",20,117,2012,6084,5830,254,4.2
"20117",20,117,2013,6042,5809,233,3.9
"20117",20,117,2014,5876,5686,190,3.2
"20117",20,117,2015,5735,5568,167,2.9
"20117",20,117,2016,5563,5395,168,3
"20117",20,117,2017,5490,5337,153,2.8
"20119",20,119,1990,2196,2159,37,1.7
"20119",20,119,1991,2117,2070,47,2.2
"20119",20,119,1992,2128,2079,49,2.3
"20119",20,119,1993,2093,2047,46,2.2
"20119",20,119,1994,2154,2096,58,2.7
"20119",20,119,1995,2322,2265,57,2.5
"20119",20,119,1996,2228,2177,51,2.3
"20119",20,119,1997,2309,2262,47,2
"20119",20,119,1998,2167,2126,41,1.9
"20119",20,119,1999,2249,2202,47,2.1
"20119",20,119,2000,2168,2111,57,2.6
"20119",20,119,2001,2105,2044,61,2.9
"20119",20,119,2002,2160,2094,66,3.1
"20119",20,119,2003,2238,2168,70,3.1
"20119",20,119,2004,2214,2132,82,3.7
"20119",20,119,2005,2151,2073,78,3.6
"20119",20,119,2006,2192,2124,68,3.1
"20119",20,119,2007,2304,2237,67,2.9
"20119",20,119,2008,2404,2333,71,3
"20119",20,119,2009,2559,2461,98,3.8
"20119",20,119,2010,2567,2458,109,4.2
"20119",20,119,2011,2534,2440,94,3.7
"20119",20,119,2012,2470,2387,83,3.4
"20119",20,119,2013,2351,2277,74,3.1
"20119",20,119,2014,2379,2316,63,2.6
"20119",20,119,2015,2419,2347,72,3
"20119",20,119,2016,2377,2313,64,2.7
"20119",20,119,2017,2260,2205,55,2.4
"20121",20,121,1990,12149,11555,594,4.9
"20121",20,121,1991,12217,11517,700,5.7
"20121",20,121,1992,12404,11742,662,5.3
"20121",20,121,1993,12623,11946,677,5.4
"20121",20,121,1994,13019,12378,641,4.9
"20121",20,121,1995,13023,12457,566,4.3
"20121",20,121,1996,13255,12732,523,3.9
"20121",20,121,1997,13762,13235,527,3.8
"20121",20,121,1998,13995,13513,482,3.4
"20121",20,121,1999,14392,13963,429,3
"20121",20,121,2000,15359,14864,495,3.2
"20121",20,121,2001,15128,14498,630,4.2
"20121",20,121,2002,15081,14386,695,4.6
"20121",20,121,2003,15449,14659,790,5.1
"20121",20,121,2004,15972,15131,841,5.3
"20121",20,121,2005,16335,15500,835,5.1
"20121",20,121,2006,16270,15523,747,4.6
"20121",20,121,2007,16470,15698,772,4.7
"20121",20,121,2008,16316,15476,840,5.1
"20121",20,121,2009,16144,14820,1324,8.2
"20121",20,121,2010,17111,15815,1296,7.6
"20121",20,121,2011,16914,15696,1218,7.2
"20121",20,121,2012,16755,15694,1061,6.3
"20121",20,121,2013,16783,15847,936,5.6
"20121",20,121,2014,16853,16058,795,4.7
"20121",20,121,2015,16757,16032,725,4.3
"20121",20,121,2016,17022,16315,707,4.2
"20121",20,121,2017,17175,16534,641,3.7
"20123",20,123,1990,3487,3381,106,3
"20123",20,123,1991,3511,3394,117,3.3
"20123",20,123,1992,3596,3481,115,3.2
"20123",20,123,1993,3604,3494,110,3.1
"20123",20,123,1994,3648,3569,79,2.2
"20123",20,123,1995,3615,3508,107,3
"20123",20,123,1996,3633,3530,103,2.8
"20123",20,123,1997,3491,3416,75,2.1
"20123",20,123,1998,3785,3718,67,1.8
"20123",20,123,1999,3805,3737,68,1.8
"20123",20,123,2000,3511,3417,94,2.7
"20123",20,123,2001,3263,3146,117,3.6
"20123",20,123,2002,3322,3202,120,3.6
"20123",20,123,2003,3424,3290,134,3.9
"20123",20,123,2004,3509,3373,136,3.9
"20123",20,123,2005,3440,3311,129,3.8
"20123",20,123,2006,3419,3301,118,3.5
"20123",20,123,2007,3336,3218,118,3.5
"20123",20,123,2008,3570,3452,118,3.3
"20123",20,123,2009,3814,3637,177,4.6
"20123",20,123,2010,3874,3689,185,4.8
"20123",20,123,2011,3893,3753,140,3.6
"20123",20,123,2012,3868,3752,116,3
"20123",20,123,2013,3877,3764,113,2.9
"20123",20,123,2014,3834,3709,125,3.3
"20123",20,123,2015,3775,3650,125,3.3
"20123",20,123,2016,3696,3574,122,3.3
"20123",20,123,2017,3452,3358,94,2.7
"20125",20,125,1990,18082,16997,1085,6
"20125",20,125,1991,17763,16626,1137,6.4
"20125",20,125,1992,17860,16693,1167,6.5
"20125",20,125,1993,17945,16844,1101,6.1
"20125",20,125,1994,18076,16986,1090,6
"20125",20,125,1995,18027,17021,1006,5.6
"20125",20,125,1996,18191,16903,1288,7.1
"20125",20,125,1997,17365,16421,944,5.4
"20125",20,125,1998,18679,17790,889,4.8
"20125",20,125,1999,18830,17927,903,4.8
"20125",20,125,2000,16998,16131,867,5.1
"20125",20,125,2001,16196,15152,1044,6.4
"20125",20,125,2002,16239,15164,1075,6.6
"20125",20,125,2003,16557,15455,1102,6.7
"20125",20,125,2004,17212,16033,1179,6.8
"20125",20,125,2005,16896,15910,986,5.8
"20125",20,125,2006,17711,16900,811,4.6
"20125",20,125,2007,17582,16725,857,4.9
"20125",20,125,2008,17971,16966,1005,5.6
"20125",20,125,2009,18732,16890,1842,9.8
"20125",20,125,2010,18083,16158,1925,10.6
"20125",20,125,2011,18272,16458,1814,9.9
"20125",20,125,2012,18407,16984,1423,7.7
"20125",20,125,2013,17835,16631,1204,6.8
"20125",20,125,2014,17335,16338,997,5.8
"20125",20,125,2015,16577,15507,1070,6.5
"20125",20,125,2016,15999,15020,979,6.1
"20125",20,125,2017,14987,14203,784,5.2
"20127",20,127,1990,2933,2832,101,3.4
"20127",20,127,1991,2923,2800,123,4.2
"20127",20,127,1992,2984,2846,138,4.6
"20127",20,127,1993,3113,2974,139,4.5
"20127",20,127,1994,3225,3088,137,4.2
"20127",20,127,1995,3093,2999,94,3
"20127",20,127,1996,3092,2992,100,3.2
"20127",20,127,1997,3118,2991,127,4.1
"20127",20,127,1998,3123,3015,108,3.5
"20127",20,127,1999,3148,3055,93,3
"20127",20,127,2000,3061,2953,108,3.5
"20127",20,127,2001,2912,2792,120,4.1
"20127",20,127,2002,3074,2955,119,3.9
"20127",20,127,2003,3117,2986,131,4.2
"20127",20,127,2004,2982,2831,151,5.1
"20127",20,127,2005,2914,2768,146,5
"20127",20,127,2006,2907,2781,126,4.3
"20127",20,127,2007,2968,2824,144,4.9
"20127",20,127,2008,2904,2764,140,4.8
"20127",20,127,2009,3085,2870,215,7
"20127",20,127,2010,3311,3085,226,6.8
"20127",20,127,2011,3289,3069,220,6.7
"20127",20,127,2012,3203,3008,195,6.1
"20127",20,127,2013,3100,2931,169,5.5
"20127",20,127,2014,3096,2959,137,4.4
"20127",20,127,2015,3105,2972,133,4.3
"20127",20,127,2016,3051,2934,117,3.8
"20127",20,127,2017,3013,2919,94,3.1
"20129",20,129,1990,1625,1595,30,1.8
"20129",20,129,1991,1657,1622,35,2.1
"20129",20,129,1992,1653,1597,56,3.4
"20129",20,129,1993,1675,1621,54,3.2
"20129",20,129,1994,1647,1602,45,2.7
"20129",20,129,1995,1742,1704,38,2.2
"20129",20,129,1996,1759,1715,44,2.5
"20129",20,129,1997,1783,1745,38,2.1
"20129",20,129,1998,1884,1844,40,2.1
"20129",20,129,1999,1741,1701,40,2.3
"20129",20,129,2000,1746,1698,48,2.7
"20129",20,129,2001,1664,1618,46,2.8
"20129",20,129,2002,1597,1547,50,3.1
"20129",20,129,2003,1676,1625,51,3
"20129",20,129,2004,1689,1635,54,3.2
"20129",20,129,2005,1708,1649,59,3.5
"20129",20,129,2006,1725,1677,48,2.8
"20129",20,129,2007,1683,1637,46,2.7
"20129",20,129,2008,1778,1728,50,2.8
"20129",20,129,2009,1783,1709,74,4.2
"20129",20,129,2010,1756,1680,76,4.3
"20129",20,129,2011,1674,1612,62,3.7
"20129",20,129,2012,1655,1594,61,3.7
"20129",20,129,2013,1593,1531,62,3.9
"20129",20,129,2014,1488,1429,59,4
"20129",20,129,2015,1436,1376,60,4.2
"20129",20,129,2016,1344,1292,52,3.9
"20129",20,129,2017,1212,1167,45,3.7
"20131",20,131,1990,5096,5018,78,1.5
"20131",20,131,1991,5229,5128,101,1.9
"20131",20,131,1992,5394,5271,123,2.3
"20131",20,131,1993,5442,5300,142,2.6
"20131",20,131,1994,5467,5314,153,2.8
"20131",20,131,1995,5656,5528,128,2.3
"20131",20,131,1996,5668,5495,173,3.1
"20131",20,131,1997,5885,5693,192,3.3
"20131",20,131,1998,5520,5377,143,2.6
"20131",20,131,1999,5649,5503,146,2.6
"20131",20,131,2000,5232,5084,148,2.8
"20131",20,131,2001,4926,4751,175,3.6
"20131",20,131,2002,5086,4908,178,3.5
"20131",20,131,2003,5258,5084,174,3.3
"20131",20,131,2004,5413,5207,206,3.8
"20131",20,131,2005,5423,5225,198,3.7
"20131",20,131,2006,5449,5268,181,3.3
"20131",20,131,2007,5619,5447,172,3.1
"20131",20,131,2008,5768,5587,181,3.1
"20131",20,131,2009,5921,5679,242,4.1
"20131",20,131,2010,5820,5570,250,4.3
"20131",20,131,2011,5900,5672,228,3.9
"20131",20,131,2012,5997,5780,217,3.6
"20131",20,131,2013,5823,5622,201,3.5
"20131",20,131,2014,5847,5680,167,2.9
"20131",20,131,2015,5939,5787,152,2.6
"20131",20,131,2016,5897,5739,158,2.7
"20131",20,131,2017,5580,5445,135,2.4
"20133",20,133,1990,8354,7979,375,4.5
"20133",20,133,1991,8638,8215,423,4.9
"20133",20,133,1992,8731,8299,432,4.9
"20133",20,133,1993,8712,8255,457,5.2
"20133",20,133,1994,9029,8580,449,5
"20133",20,133,1995,9023,8617,406,4.5
"20133",20,133,1996,8859,8457,402,4.5
"20133",20,133,1997,9019,8627,392,4.3
"20133",20,133,1998,8563,8195,368,4.3
"20133",20,133,1999,8882,8489,393,4.4
"20133",20,133,2000,8398,8033,365,4.3
"20133",20,133,2001,8275,7834,441,5.3
"20133",20,133,2002,8420,8011,409,4.9
"20133",20,133,2003,8908,8480,428,4.8
"20133",20,133,2004,8974,8535,439,4.9
"20133",20,133,2005,8789,8347,442,5
"20133",20,133,2006,9231,8869,362,3.9
"20133",20,133,2007,9291,8909,382,4.1
"20133",20,133,2008,9216,8762,454,4.9
"20133",20,133,2009,8733,7997,736,8.4
"20133",20,133,2010,7410,6651,759,10.2
"20133",20,133,2011,7400,6713,687,9.3
"20133",20,133,2012,6895,6288,607,8.8
"20133",20,133,2013,6733,6160,573,8.5
"20133",20,133,2014,6393,5911,482,7.5
"20133",20,133,2015,6269,5803,466,7.4
"20133",20,133,2016,6056,5622,434,7.2
"20133",20,133,2017,6053,5736,317,5.2
"20135",20,135,1990,1969,1933,36,1.8
"20135",20,135,1991,1951,1926,25,1.3
"20135",20,135,1992,1979,1928,51,2.6
"20135",20,135,1993,1961,1915,46,2.3
"20135",20,135,1994,1755,1710,45,2.6
"20135",20,135,1995,1970,1921,49,2.5
"20135",20,135,1996,1903,1856,47,2.5
"20135",20,135,1997,1810,1765,45,2.5
"20135",20,135,1998,1899,1837,62,3.3
"20135",20,135,1999,1856,1811,45,2.4
"20135",20,135,2000,1783,1740,43,2.4
"20135",20,135,2001,1717,1669,48,2.8
"20135",20,135,2002,1720,1669,51,3
"20135",20,135,2003,1714,1662,52,3
"20135",20,135,2004,1737,1680,57,3.3
"20135",20,135,2005,1701,1646,55,3.2
"20135",20,135,2006,1695,1647,48,2.8
"20135",20,135,2007,1734,1683,51,2.9
"20135",20,135,2008,1822,1766,56,3.1
"20135",20,135,2009,1863,1790,73,3.9
"20135",20,135,2010,1618,1554,64,4
"20135",20,135,2011,1623,1568,55,3.4
"20135",20,135,2012,1626,1573,53,3.3
"20135",20,135,2013,1602,1553,49,3.1
"20135",20,135,2014,1613,1569,44,2.7
"20135",20,135,2015,1538,1487,51,3.3
"20135",20,135,2016,1423,1374,49,3.4
"20135",20,135,2017,1368,1328,40,2.9
"20137",20,137,1990,2897,2849,48,1.7
"20137",20,137,1991,2854,2798,56,2
"20137",20,137,1992,2860,2809,51,1.8
"20137",20,137,1993,2878,2831,47,1.6
"20137",20,137,1994,2881,2834,47,1.6
"20137",20,137,1995,3058,2995,63,2.1
"20137",20,137,1996,3065,3009,56,1.8
"20137",20,137,1997,3165,3098,67,2.1
"20137",20,137,1998,3137,3076,61,1.9
"20137",20,137,1999,3183,3138,45,1.4
"20137",20,137,2000,2661,2581,80,3
"20137",20,137,2001,2532,2442,90,3.6
"20137",20,137,2002,2618,2523,95,3.6
"20137",20,137,2003,2646,2541,105,4
"20137",20,137,2004,2701,2589,112,4.1
"20137",20,137,2005,2725,2626,99,3.6
"20137",20,137,2006,2701,2612,89,3.3
"20137",20,137,2007,2696,2609,87,3.2
"20137",20,137,2008,2819,2728,91,3.2
"20137",20,137,2009,2898,2771,127,4.4
"20137",20,137,2010,3098,2980,118,3.8
"20137",20,137,2011,3138,3028,110,3.5
"20137",20,137,2012,3144,3046,98,3.1
"20137",20,137,2013,3085,2999,86,2.8
"20137",20,137,2014,3038,2966,72,2.4
"20137",20,137,2015,2950,2877,73,2.5
"20137",20,137,2016,2873,2803,70,2.4
"20137",20,137,2017,2820,2757,63,2.2
"20139",20,139,1990,7491,6988,503,6.7
"20139",20,139,1991,7487,6970,517,6.9
"20139",20,139,1992,7748,7228,520,6.7
"20139",20,139,1993,7812,7281,531,6.8
"20139",20,139,1994,7831,7263,568,7.3
"20139",20,139,1995,8285,7732,553,6.7
"20139",20,139,1996,8601,8086,515,6
"20139",20,139,1997,9264,8642,622,6.7
"20139",20,139,1998,9855,9314,541,5.5
"20139",20,139,1999,9952,9516,436,4.4
"20139",20,139,2000,8842,8455,387,4.4
"20139",20,139,2001,8770,8359,411,4.7
"20139",20,139,2002,9007,8548,459,5.1
"20139",20,139,2003,9060,8533,527,5.8
"20139",20,139,2004,9238,8630,608,6.6
"20139",20,139,2005,9123,8559,564,6.2
"20139",20,139,2006,8712,8235,477,5.5
"20139",20,139,2007,8526,8060,466,5.5
"20139",20,139,2008,8510,7999,511,6
"20139",20,139,2009,8537,7875,662,7.8
"20139",20,139,2010,8618,7906,712,8.3
"20139",20,139,2011,8568,7857,711,8.3
"20139",20,139,2012,8343,7738,605,7.3
"20139",20,139,2013,8278,7727,551,6.7
"20139",20,139,2014,8138,7695,443,5.4
"20139",20,139,2015,8057,7656,401,5
"20139",20,139,2016,8058,7703,355,4.4
"20139",20,139,2017,7961,7646,315,4
"20141",20,141,1990,2416,2377,39,1.6
"20141",20,141,1991,2510,2455,55,2.2
"20141",20,141,1992,2530,2474,56,2.2
"20141",20,141,1993,2557,2482,75,2.9
"20141",20,141,1994,2618,2551,67,2.6
"20141",20,141,1995,2539,2476,63,2.5
"20141",20,141,1996,2366,2297,69,2.9
"20141",20,141,1997,2304,2247,57,2.5
"20141",20,141,1998,2307,2254,53,2.3
"20141",20,141,1999,2298,2253,45,2
"20141",20,141,2000,2310,2250,60,2.6
"20141",20,141,2001,2264,2185,79,3.5
"20141",20,141,2002,2264,2191,73,3.2
"20141",20,141,2003,2375,2283,92,3.9
"20141",20,141,2004,2316,2216,100,4.3
"20141",20,141,2005,2298,2210,88,3.8
"20141",20,141,2006,2251,2172,79,3.5
"20141",20,141,2007,2208,2124,84,3.8
"20141",20,141,2008,2251,2174,77,3.4
"20141",20,141,2009,2298,2196,102,4.4
"20141",20,141,2010,2224,2116,108,4.9
"20141",20,141,2011,2261,2160,101,4.5
"20141",20,141,2012,2172,2079,93,4.3
"20141",20,141,2013,2121,2031,90,4.2
"20141",20,141,2014,2057,1980,77,3.7
"20141",20,141,2015,2091,2018,73,3.5
"20141",20,141,2016,2059,1989,70,3.4
"20141",20,141,2017,2008,1952,56,2.8
"20143",20,143,1990,2784,2648,136,4.9
"20143",20,143,1991,2771,2684,87,3.1
"20143",20,143,1992,2820,2728,92,3.3
"20143",20,143,1993,2803,2710,93,3.3
"20143",20,143,1994,2761,2679,82,3
"20143",20,143,1995,2988,2881,107,3.6
"20143",20,143,1996,3049,2940,109,3.6
"20143",20,143,1997,3121,2988,133,4.3
"20143",20,143,1998,3129,3034,95,3
"20143",20,143,1999,3171,3088,83,2.6
"20143",20,143,2000,3372,3272,100,3
"20143",20,143,2001,3287,3166,121,3.7
"20143",20,143,2002,3332,3200,132,4
"20143",20,143,2003,3352,3204,148,4.4
"20143",20,143,2004,3416,3248,168,4.9
"20143",20,143,2005,3368,3215,153,4.5
"20143",20,143,2006,3374,3256,118,3.5
"20143",20,143,2007,3258,3134,124,3.8
"20143",20,143,2008,3385,3261,124,3.7
"20143",20,143,2009,3418,3228,190,5.6
"20143",20,143,2010,3286,3090,196,6
"20143",20,143,2011,3270,3082,188,5.7
"20143",20,143,2012,3220,3046,174,5.4
"20143",20,143,2013,3238,3092,146,4.5
"20143",20,143,2014,3241,3108,133,4.1
"20143",20,143,2015,3230,3108,122,3.8
"20143",20,143,2016,3163,3043,120,3.8
"20143",20,143,2017,3060,2966,94,3.1
"20145",20,145,1990,3660,3583,77,2.1
"20145",20,145,1991,3675,3583,92,2.5
"20145",20,145,1992,3906,3790,116,3
"20145",20,145,1993,3910,3780,130,3.3
"20145",20,145,1994,3855,3763,92,2.4
"20145",20,145,1995,3931,3828,103,2.6
"20145",20,145,1996,3619,3521,98,2.7
"20145",20,145,1997,3580,3495,85,2.4
"20145",20,145,1998,3784,3703,81,2.1
"20145",20,145,1999,3818,3741,77,2
"20145",20,145,2000,3524,3427,97,2.8
"20145",20,145,2001,3441,3337,104,3
"20145",20,145,2002,3425,3313,112,3.3
"20145",20,145,2003,3548,3412,136,3.8
"20145",20,145,2004,3718,3579,139,3.7
"20145",20,145,2005,3866,3720,146,3.8
"20145",20,145,2006,3983,3851,132,3.3
"20145",20,145,2007,3991,3867,124,3.1
"20145",20,145,2008,3819,3697,122,3.2
"20145",20,145,2009,3959,3807,152,3.8
"20145",20,145,2010,3608,3439,169,4.7
"20145",20,145,2011,3481,3322,159,4.6
"20145",20,145,2012,3421,3281,140,4.1
"20145",20,145,2013,3414,3265,149,4.4
"20145",20,145,2014,3389,3261,128,3.8
"20145",20,145,2015,3307,3184,123,3.7
"20145",20,145,2016,3209,3103,106,3.3
"20145",20,145,2017,3035,2934,101,3.3
"20147",20,147,1990,3135,3079,56,1.8
"20147",20,147,1991,3073,3000,73,2.4
"20147",20,147,1992,3173,3100,73,2.3
"20147",20,147,1993,3218,3136,82,2.5
"20147",20,147,1994,3261,3188,73,2.2
"20147",20,147,1995,3292,3183,109,3.3
"20147",20,147,1996,3265,3148,117,3.6
"20147",20,147,1997,3152,3066,86,2.7
"20147",20,147,1998,3180,3089,91,2.9
"20147",20,147,1999,3215,3153,62,1.9
"20147",20,147,2000,3122,3037,85,2.7
"20147",20,147,2001,3014,2925,89,3
"20147",20,147,2002,3147,3052,95,3
"20147",20,147,2003,3145,3039,106,3.4
"20147",20,147,2004,3240,3115,125,3.9
"20147",20,147,2005,3079,2966,113,3.7
"20147",20,147,2006,3092,2996,96,3.1
"20147",20,147,2007,3229,3132,97,3
"20147",20,147,2008,3066,2934,132,4.3
"20147",20,147,2009,3197,3000,197,6.2
"20147",20,147,2010,3037,2881,156,5.1
"20147",20,147,2011,3019,2866,153,5.1
"20147",20,147,2012,3012,2877,135,4.5
"20147",20,147,2013,2965,2839,126,4.2
"20147",20,147,2014,2907,2805,102,3.5
"20147",20,147,2015,2954,2860,94,3.2
"20147",20,147,2016,2857,2767,90,3.2
"20147",20,147,2017,2811,2728,83,3
"20149",20,149,1990,8358,7936,422,5
"20149",20,149,1991,8699,8244,455,5.2
"20149",20,149,1992,8846,8475,371,4.2
"20149",20,149,1993,9097,8731,366,4
"20149",20,149,1994,8830,8483,347,3.9
"20149",20,149,1995,9456,9071,385,4.1
"20149",20,149,1996,10130,9767,363,3.6
"20149",20,149,1997,10652,10268,384,3.6
"20149",20,149,1998,11039,10698,341,3.1
"20149",20,149,1999,11002,10747,255,2.3
"20149",20,149,2000,9357,9060,297,3.2
"20149",20,149,2001,9286,8927,359,3.9
"20149",20,149,2002,9526,9123,403,4.2
"20149",20,149,2003,9932,9525,407,4.1
"20149",20,149,2004,10512,10044,468,4.5
"20149",20,149,2005,10813,10373,440,4.1
"20149",20,149,2006,11186,10814,372,3.3
"20149",20,149,2007,11553,11177,376,3.3
"20149",20,149,2008,10778,10391,387,3.6
"20149",20,149,2009,11102,10471,631,5.7
"20149",20,149,2010,11890,11268,622,5.2
"20149",20,149,2011,11564,10986,578,5
"20149",20,149,2012,11582,11038,544,4.7
"20149",20,149,2013,11923,11375,548,4.6
"20149",20,149,2014,12027,11558,469,3.9
"20149",20,149,2015,11955,11519,436,3.6
"20149",20,149,2016,12151,11728,423,3.5
"20149",20,149,2017,12168,11795,373,3.1
"20151",20,151,1990,4844,4702,142,2.9
"20151",20,151,1991,4848,4715,133,2.7
"20151",20,151,1992,4933,4786,147,3
"20151",20,151,1993,5051,4865,186,3.7
"20151",20,151,1994,5192,5010,182,3.5
"20151",20,151,1995,5135,4983,152,3
"20151",20,151,1996,5075,4904,171,3.4
"20151",20,151,1997,5033,4905,128,2.5
"20151",20,151,1998,5012,4895,117,2.3
"20151",20,151,1999,4896,4781,115,2.3
"20151",20,151,2000,5063,4929,134,2.6
"20151",20,151,2001,4987,4846,141,2.8
"20151",20,151,2002,5387,5218,169,3.1
"20151",20,151,2003,5464,5282,182,3.3
"20151",20,151,2004,5483,5289,194,3.5
"20151",20,151,2005,5493,5298,195,3.5
"20151",20,151,2006,5607,5440,167,3
"20151",20,151,2007,5706,5529,177,3.1
"20151",20,151,2008,5707,5510,197,3.5
"20151",20,151,2009,5985,5688,297,5
"20151",20,151,2010,5289,4993,296,5.6
"20151",20,151,2011,5362,5091,271,5.1
"20151",20,151,2012,5436,5192,244,4.5
"20151",20,151,2013,5439,5223,216,4
"20151",20,151,2014,5499,5321,178,3.2
"20151",20,151,2015,5290,5077,213,4
"20151",20,151,2016,5104,4897,207,4.1
"20151",20,151,2017,4931,4769,162,3.3
"20153",20,153,1990,1634,1606,28,1.7
"20153",20,153,1991,1592,1547,45,2.8
"20153",20,153,1992,1621,1591,30,1.9
"20153",20,153,1993,1651,1625,26,1.6
"20153",20,153,1994,1690,1649,41,2.4
"20153",20,153,1995,1686,1636,50,3
"20153",20,153,1996,1627,1581,46,2.8
"20153",20,153,1997,1570,1523,47,3
"20153",20,153,1998,1508,1471,37,2.5
"20153",20,153,1999,1551,1510,41,2.6
"20153",20,153,2000,1468,1427,41,2.8
"20153",20,153,2001,1350,1305,45,3.3
"20153",20,153,2002,1352,1303,49,3.6
"20153",20,153,2003,1407,1356,51,3.6
"20153",20,153,2004,1376,1313,63,4.6
"20153",20,153,2005,1339,1286,53,4
"20153",20,153,2006,1313,1270,43,3.3
"20153",20,153,2007,1234,1190,44,3.6
"20153",20,153,2008,1234,1191,43,3.5
"20153",20,153,2009,1319,1267,52,3.9
"20153",20,153,2010,1511,1458,53,3.5
"20153",20,153,2011,1518,1465,53,3.5
"20153",20,153,2012,1569,1526,43,2.7
"20153",20,153,2013,1549,1507,42,2.7
"20153",20,153,2014,1515,1478,37,2.4
"20153",20,153,2015,1535,1500,35,2.3
"20153",20,153,2016,1545,1508,37,2.4
"20153",20,153,2017,1463,1430,33,2.3
"20155",20,155,1990,31333,29955,1378,4.4
"20155",20,155,1991,31385,29805,1580,5
"20155",20,155,1992,31399,29870,1529,4.9
"20155",20,155,1993,31918,30422,1496,4.7
"20155",20,155,1994,32437,31044,1393,4.3
"20155",20,155,1995,32806,31491,1315,4
"20155",20,155,1996,32834,31584,1250,3.8
"20155",20,155,1997,32732,31541,1191,3.6
"20155",20,155,1998,33076,31883,1193,3.6
"20155",20,155,1999,33115,32037,1078,3.3
"20155",20,155,2000,32322,31134,1188,3.7
"20155",20,155,2001,31821,30402,1419,4.5
"20155",20,155,2002,32592,31077,1515,4.6
"20155",20,155,2003,32493,30814,1679,5.2
"20155",20,155,2004,32865,31140,1725,5.2
"20155",20,155,2005,32566,30952,1614,5
"20155",20,155,2006,32984,31505,1479,4.5
"20155",20,155,2007,32485,31113,1372,4.2
"20155",20,155,2008,34408,32990,1418,4.1
"20155",20,155,2009,35110,33064,2046,5.8
"20155",20,155,2010,32894,30800,2094,6.4
"20155",20,155,2011,32636,30664,1972,6
"20155",20,155,2012,32067,30318,1749,5.5
"20155",20,155,2013,31588,29930,1658,5.2
"20155",20,155,2014,31182,29809,1373,4.4
"20155",20,155,2015,30842,29515,1327,4.3
"20155",20,155,2016,30137,28812,1325,4.4
"20155",20,155,2017,30028,28867,1161,3.9
"20157",20,157,1990,3204,3160,44,1.4
"20157",20,157,1991,3239,3191,48,1.5
"20157",20,157,1992,3330,3281,49,1.5
"20157",20,157,1993,3352,3286,66,2
"20157",20,157,1994,3263,3166,97,3
"20157",20,157,1995,3260,3185,75,2.3
"20157",20,157,1996,3206,3133,73,2.3
"20157",20,157,1997,3101,3022,79,2.5
"20157",20,157,1998,3022,2949,73,2.4
"20157",20,157,1999,3075,3019,56,1.8
"20157",20,157,2000,2975,2890,85,2.9
"20157",20,157,2001,2873,2776,97,3.4
"20157",20,157,2002,2918,2808,110,3.8
"20157",20,157,2003,2911,2773,138,4.7
"20157",20,157,2004,2866,2729,137,4.8
"20157",20,157,2005,2756,2644,112,4.1
"20157",20,157,2006,2728,2630,98,3.6
"20157",20,157,2007,2756,2668,88,3.2
"20157",20,157,2008,2968,2875,93,3.1
"20157",20,157,2009,2901,2779,122,4.2
"20157",20,157,2010,2732,2614,118,4.3
"20157",20,157,2011,2683,2580,103,3.8
"20157",20,157,2012,2611,2511,100,3.8
"20157",20,157,2013,2649,2560,89,3.4
"20157",20,157,2014,2567,2489,78,3
"20157",20,157,2015,2590,2519,71,2.7
"20157",20,157,2016,2544,2474,70,2.8
"20157",20,157,2017,2460,2391,69,2.8
"20159",20,159,1990,4843,4692,151,3.1
"20159",20,159,1991,4993,4819,174,3.5
"20159",20,159,1992,5018,4789,229,4.6
"20159",20,159,1993,5012,4767,245,4.9
"20159",20,159,1994,5040,4794,246,4.9
"20159",20,159,1995,4927,4699,228,4.6
"20159",20,159,1996,4794,4581,213,4.4
"20159",20,159,1997,4631,4454,177,3.8
"20159",20,159,1998,4868,4668,200,4.1
"20159",20,159,1999,4734,4561,173,3.7
"20159",20,159,2000,5202,5014,188,3.6
"20159",20,159,2001,5133,4943,190,3.7
"20159",20,159,2002,5390,5177,213,4
"20159",20,159,2003,5254,5031,223,4.2
"20159",20,159,2004,5483,5226,257,4.7
"20159",20,159,2005,5476,5226,250,4.6
"20159",20,159,2006,5616,5387,229,4.1
"20159",20,159,2007,5605,5389,216,3.9
"20159",20,159,2008,5843,5621,222,3.8
"20159",20,159,2009,6049,5746,303,5
"20159",20,159,2010,5306,5018,288,5.4
"20159",20,159,2011,5388,5109,279,5.2
"20159",20,159,2012,5403,5162,241,4.5
"20159",20,159,2013,5442,5209,233,4.3
"20159",20,159,2014,5446,5254,192,3.5
"20159",20,159,2015,5478,5271,207,3.8
"20159",20,159,2016,5305,5094,211,4
"20159",20,159,2017,5406,5232,174,3.2
"20161",20,161,1990,28237,27081,1156,4.1
"20161",20,161,1991,28154,26726,1428,5.1
"20161",20,161,1992,28863,27631,1232,4.3
"20161",20,161,1993,29001,27763,1238,4.3
"20161",20,161,1994,29009,27741,1268,4.4
"20161",20,161,1995,29975,28669,1306,4.4
"20161",20,161,1996,30043,28782,1261,4.2
"20161",20,161,1997,30644,29391,1253,4.1
"20161",20,161,1998,31248,30080,1168,3.7
"20161",20,161,1999,30593,29623,970,3.2
"20161",20,161,2000,30748,29874,874,2.8
"20161",20,161,2001,30142,29169,973,3.2
"20161",20,161,2002,30623,29566,1057,3.5
"20161",20,161,2003,32007,30879,1128,3.5
"20161",20,161,2004,33545,32210,1335,4
"20161",20,161,2005,33993,32724,1269,3.7
"20161",20,161,2006,34957,33789,1168,3.3
"20161",20,161,2007,39474,38239,1235,3.1
"20161",20,161,2008,37328,36016,1312,3.5
"20161",20,161,2009,37558,35888,1670,4.4
"20161",20,161,2010,36091,34289,1802,5
"20161",20,161,2011,35427,33724,1703,4.8
"20161",20,161,2012,36247,34667,1580,4.4
"20161",20,161,2013,36571,35030,1541,4.2
"20161",20,161,2014,36570,35219,1351,3.7
"20161",20,161,2015,35632,34416,1216,3.4
"20161",20,161,2016,34889,33707,1182,3.4
"20161",20,161,2017,35023,33974,1049,3
"20163",20,163,1990,2748,2674,74,2.7
"20163",20,163,1991,2794,2737,57,2
"20163",20,163,1992,2864,2773,91,3.2
"20163",20,163,1993,2868,2760,108,3.8
"20163",20,163,1994,2777,2674,103,3.7
"20163",20,163,1995,2940,2848,92,3.1
"20163",20,163,1996,3001,2903,98,3.3
"20163",20,163,1997,3079,3002,77,2.5
"20163",20,163,1998,2899,2794,105,3.6
"20163",20,163,1999,3009,2928,81,2.7
"20163",20,163,2000,2733,2645,88,3.2
"20163",20,163,2001,2671,2579,92,3.4
"20163",20,163,2002,2735,2637,98,3.6
"20163",20,163,2003,2732,2582,150,5.5
"20163",20,163,2004,2730,2576,154,5.6
"20163",20,163,2005,2673,2560,113,4.2
"20163",20,163,2006,2710,2610,100,3.7
"20163",20,163,2007,2655,2557,98,3.7
"20163",20,163,2008,2692,2568,124,4.6
"20163",20,163,2009,2805,2617,188,6.7
"20163",20,163,2010,2767,2593,174,6.3
"20163",20,163,2011,2726,2581,145,5.3
"20163",20,163,2012,2767,2639,128,4.6
"20163",20,163,2013,2779,2663,116,4.2
"20163",20,163,2014,2849,2746,103,3.6
"20163",20,163,2015,2810,2681,129,4.6
"20163",20,163,2016,2669,2543,126,4.7
"20163",20,163,2017,2505,2409,96,3.8
"20165",20,165,1990,1815,1780,35,1.9
"20165",20,165,1991,1841,1789,52,2.8
"20165",20,165,1992,1893,1837,56,3
"20165",20,165,1993,1856,1805,51,2.7
"20165",20,165,1994,1907,1840,67,3.5
"20165",20,165,1995,1866,1809,57,3.1
"20165",20,165,1996,1864,1810,54,2.9
"20165",20,165,1997,1822,1760,62,3.4
"20165",20,165,1998,1895,1838,57,3
"20165",20,165,1999,1877,1822,55,2.9
"20165",20,165,2000,1731,1673,58,3.4
"20165",20,165,2001,1665,1607,58,3.5
"20165",20,165,2002,1690,1627,63,3.7
"20165",20,165,2003,1686,1614,72,4.3
"20165",20,165,2004,1708,1630,78,4.6
"20165",20,165,2005,1660,1593,67,4
"20165",20,165,2006,1698,1637,61,3.6
"20165",20,165,2007,1645,1584,61,3.7
"20165",20,165,2008,1709,1643,66,3.9
"20165",20,165,2009,1705,1608,97,5.7
"20165",20,165,2010,1793,1697,96,5.4
"20165",20,165,2011,1841,1760,81,4.4
"20165",20,165,2012,1891,1803,88,4.7
"20165",20,165,2013,1810,1732,78,4.3
"20165",20,165,2014,1807,1743,64,3.5
"20165",20,165,2015,1795,1732,63,3.5
"20165",20,165,2016,1732,1663,69,4
"20165",20,165,2017,1634,1582,52,3.2
"20167",20,167,1990,3744,3648,96,2.6
"20167",20,167,1991,3753,3639,114,3
"20167",20,167,1992,3863,3738,125,3.2
"20167",20,167,1993,3849,3690,159,4.1
"20167",20,167,1994,3844,3684,160,4.2
"20167",20,167,1995,3745,3594,151,4
"20167",20,167,1996,3706,3560,146,3.9
"20167",20,167,1997,3643,3515,128,3.5
"20167",20,167,1998,3626,3508,118,3.3
"20167",20,167,1999,3531,3416,115,3.3
"20167",20,167,2000,3544,3404,140,4
"20167",20,167,2001,3243,3081,162,5
"20167",20,167,2002,3268,3122,146,4.5
"20167",20,167,2003,3418,3273,145,4.2
"20167",20,167,2004,3455,3286,169,4.9
"20167",20,167,2005,3466,3305,161,4.6
"20167",20,167,2006,3471,3339,132,3.8
"20167",20,167,2007,3488,3361,127,3.6
"20167",20,167,2008,3611,3476,135,3.7
"20167",20,167,2009,3606,3428,178,4.9
"20167",20,167,2010,3741,3550,191,5.1
"20167",20,167,2011,3784,3607,177,4.7
"20167",20,167,2012,3808,3652,156,4.1
"20167",20,167,2013,3849,3697,152,3.9
"20167",20,167,2014,3836,3701,135,3.5
"20167",20,167,2015,3733,3594,139,3.7
"20167",20,167,2016,3574,3424,150,4.2
"20167",20,167,2017,3501,3384,117,3.3
"20169",20,169,1990,26964,25908,1056,3.9
"20169",20,169,1991,27837,26787,1050,3.8
"20169",20,169,1992,28697,27659,1038,3.6
"20169",20,169,1993,28809,27631,1178,4.1
"20169",20,169,1994,28176,27173,1003,3.6
"20169",20,169,1995,29849,28634,1215,4.1
"20169",20,169,1996,30187,29081,1106,3.7
"20169",20,169,1997,30252,29158,1094,3.6
"20169",20,169,1998,30362,29397,965,3.2
"20169",20,169,1999,30707,29869,838,2.7
"20169",20,169,2000,29912,29031,881,2.9
"20169",20,169,2001,29487,28401,1086,3.7
"20169",20,169,2002,29762,28557,1205,4
"20169",20,169,2003,29927,28561,1366,4.6
"20169",20,169,2004,30663,29191,1472,4.8
"20169",20,169,2005,30355,29026,1329,4.4
"20169",20,169,2006,30460,29310,1150,3.8
"20169",20,169,2007,30271,29196,1075,3.6
"20169",20,169,2008,31537,30325,1212,3.8
"20169",20,169,2009,31865,30113,1752,5.5
"20169",20,169,2010,30934,29027,1907,6.2
"20169",20,169,2011,30761,28891,1870,6.1
"20169",20,169,2012,30708,28940,1768,5.8
"20169",20,169,2013,31098,29550,1548,5
"20169",20,169,2014,30680,29387,1293,4.2
"20169",20,169,2015,30872,29712,1160,3.8
"20169",20,169,2016,30112,28990,1122,3.7
"20169",20,169,2017,30674,29693,981,3.2
"20171",20,171,1990,2695,2644,51,1.9
"20171",20,171,1991,2717,2661,56,2.1
"20171",20,171,1992,2714,2645,69,2.5
"20171",20,171,1993,2705,2626,79,2.9
"20171",20,171,1994,2797,2736,61,2.2
"20171",20,171,1995,2759,2702,57,2.1
"20171",20,171,1996,2692,2617,75,2.8
"20171",20,171,1997,2685,2628,57,2.1
"20171",20,171,1998,2710,2649,61,2.3
"20171",20,171,1999,2704,2659,45,1.7
"20171",20,171,2000,2988,2924,64,2.1
"20171",20,171,2001,2914,2844,70,2.4
"20171",20,171,2002,2937,2862,75,2.6
"20171",20,171,2003,2903,2819,84,2.9
"20171",20,171,2004,2915,2823,92,3.2
"20171",20,171,2005,2824,2729,95,3.4
"20171",20,171,2006,2777,2698,79,2.8
"20171",20,171,2007,2588,2516,72,2.8
"20171",20,171,2008,2736,2663,73,2.7
"20171",20,171,2009,2888,2801,87,3
"20171",20,171,2010,2767,2661,106,3.8
"20171",20,171,2011,2725,2623,102,3.7
"20171",20,171,2012,2775,2690,85,3.1
"20171",20,171,2013,2838,2756,82,2.9
"20171",20,171,2014,2851,2773,78,2.7
"20171",20,171,2015,2885,2806,79,2.7
"20171",20,171,2016,2887,2816,71,2.5
"20171",20,171,2017,2851,2789,62,2.2
"20173",20,173,1990,215912,206827,9085,4.2
"20173",20,173,1991,217966,208904,9062,4.2
"20173",20,173,1992,223556,213566,9990,4.5
"20173",20,173,1993,227821,214417,13404,5.9
"20173",20,173,1994,226407,212754,13653,6
"20173",20,173,1995,220934,210261,10673,4.8
"20173",20,173,1996,224446,215103,9343,4.2
"20173",20,173,1997,230236,222365,7871,3.4
"20173",20,173,1998,238228,230928,7300,3.1
"20173",20,173,1999,239138,230262,8876,3.7
"20173",20,173,2000,238296,228780,9516,4
"20173",20,173,2001,237443,227793,9650,4.1
"20173",20,173,2002,241458,227267,14191,5.9
"20173",20,173,2003,240350,224059,16291,6.8
"20173",20,173,2004,243548,228577,14971,6.1
"20173",20,173,2005,244942,231582,13360,5.5
"20173",20,173,2006,245201,233957,11244,4.6
"20173",20,173,2007,250715,240113,10602,4.2
"20173",20,173,2008,254830,243295,11535,4.5
"20173",20,173,2009,259399,237590,21809,8.4
"20173",20,173,2010,252713,230497,22216,8.8
"20173",20,173,2011,249217,229352,19865,8
"20173",20,173,2012,246743,229760,16983,6.9
"20173",20,173,2013,246243,231111,15132,6.1
"20173",20,173,2014,246940,233675,13265,5.4
"20173",20,173,2015,246783,235028,11755,4.8
"20173",20,173,2016,247299,235806,11493,4.6
"20173",20,173,2017,244662,234327,10335,4.2
"20175",20,175,1990,9845,9446,399,4.1
"20175",20,175,1991,9905,9555,350,3.5
"20175",20,175,1992,9918,9492,426,4.3
"20175",20,175,1993,9924,9478,446,4.5
"20175",20,175,1994,10438,10001,437,4.2
"20175",20,175,1995,10647,10194,453,4.3
"20175",20,175,1996,10664,10182,482,4.5
"20175",20,175,1997,10772,10439,333,3.1
"20175",20,175,1998,10921,10600,321,2.9
"20175",20,175,1999,11005,10673,332,3
"20175",20,175,2000,10385,10085,300,2.9
"20175",20,175,2001,10145,9773,372,3.7
"20175",20,175,2002,10284,9874,410,4
"20175",20,175,2003,10304,9915,389,3.8
"20175",20,175,2004,10496,10065,431,4.1
"20175",20,175,2005,10454,10043,411,3.9
"20175",20,175,2006,10567,10214,353,3.3
"20175",20,175,2007,10447,10094,353,3.4
"20175",20,175,2008,11123,10774,349,3.1
"20175",20,175,2009,11157,10613,544,4.9
"20175",20,175,2010,10794,10261,533,4.9
"20175",20,175,2011,10820,10321,499,4.6
"20175",20,175,2012,10828,10383,445,4.1
"20175",20,175,2013,11082,10628,454,4.1
"20175",20,175,2014,11153,10763,390,3.5
"20175",20,175,2015,10623,10166,457,4.3
"20175",20,175,2016,10232,9787,445,4.3
"20175",20,175,2017,9873,9526,347,3.5
"20177",20,177,1990,86874,82713,4161,4.8
"20177",20,177,1991,86650,82441,4209,4.9
"20177",20,177,1992,87840,83789,4051,4.6
"20177",20,177,1993,89793,85416,4377,4.9
"20177",20,177,1994,90236,86067,4169,4.6
"20177",20,177,1995,89856,85812,4044,4.5
"20177",20,177,1996,90682,86273,4409,4.9
"20177",20,177,1997,90005,85602,4403,4.9
"20177",20,177,1998,90764,87020,3744,4.1
"20177",20,177,1999,89938,86890,3048,3.4
"20177",20,177,2000,91500,87979,3521,3.8
"20177",20,177,2001,91149,87382,3767,4.1
"20177",20,177,2002,93158,88896,4262,4.6
"20177",20,177,2003,93520,88640,4880,5.2
"20177",20,177,2004,94817,89089,5728,6
"20177",20,177,2005,93338,88245,5093,5.5
"20177",20,177,2006,90352,86036,4316,4.8
"20177",20,177,2007,91388,87152,4236,4.6
"20177",20,177,2008,92467,87810,4657,5
"20177",20,177,2009,94610,88421,6189,6.5
"20177",20,177,2010,93584,87047,6537,7
"20177",20,177,2011,92932,86630,6302,6.8
"20177",20,177,2012,91978,86288,5690,6.2
"20177",20,177,2013,92035,86721,5314,5.8
"20177",20,177,2014,91849,87465,4384,4.8
"20177",20,177,2015,91236,87371,3865,4.2
"20177",20,177,2016,91691,88014,3677,4
"20177",20,177,2017,90915,87585,3330,3.7
"20179",20,179,1990,1500,1481,19,1.3
"20179",20,179,1991,1501,1477,24,1.6
"20179",20,179,1992,1475,1448,27,1.8
"20179",20,179,1993,1470,1433,37,2.5
"20179",20,179,1994,1547,1512,35,2.3
"20179",20,179,1995,1510,1482,28,1.9
"20179",20,179,1996,1534,1493,41,2.7
"20179",20,179,1997,1495,1465,30,2
"20179",20,179,1998,1480,1443,37,2.5
"20179",20,179,1999,1489,1463,26,1.7
"20179",20,179,2000,1488,1457,31,2.1
"20179",20,179,2001,1442,1406,36,2.5
"20179",20,179,2002,1466,1422,44,3
"20179",20,179,2003,1536,1494,42,2.7
"20179",20,179,2004,1557,1507,50,3.2
"20179",20,179,2005,1520,1477,43,2.8
"20179",20,179,2006,1507,1464,43,2.9
"20179",20,179,2007,1553,1510,43,2.8
"20179",20,179,2008,1570,1529,41,2.6
"20179",20,179,2009,1603,1558,45,2.8
"20179",20,179,2010,1514,1463,51,3.4
"20179",20,179,2011,1526,1477,49,3.2
"20179",20,179,2012,1546,1503,43,2.8
"20179",20,179,2013,1498,1457,41,2.7
"20179",20,179,2014,1458,1420,38,2.6
"20179",20,179,2015,1482,1449,33,2.2
"20179",20,179,2016,1449,1414,35,2.4
"20179",20,179,2017,1363,1332,31,2.3
"20181",20,181,1990,3552,3455,97,2.7
"20181",20,181,1991,3566,3478,88,2.5
"20181",20,181,1992,3693,3593,100,2.7
"20181",20,181,1993,3880,3741,139,3.6
"20181",20,181,1994,3923,3805,118,3
"20181",20,181,1995,4004,3898,106,2.6
"20181",20,181,1996,4002,3906,96,2.4
"20181",20,181,1997,4207,4121,86,2
"20181",20,181,1998,4071,3986,85,2.1
"20181",20,181,1999,4225,4155,70,1.7
"20181",20,181,2000,3620,3522,98,2.7
"20181",20,181,2001,3727,3613,114,3.1
"20181",20,181,2002,3744,3632,112,3
"20181",20,181,2003,3791,3673,118,3.1
"20181",20,181,2004,3687,3558,129,3.5
"20181",20,181,2005,3606,3483,123,3.4
"20181",20,181,2006,3671,3564,107,2.9
"20181",20,181,2007,3632,3528,104,2.9
"20181",20,181,2008,3747,3630,117,3.1
"20181",20,181,2009,3798,3647,151,4
"20181",20,181,2010,3154,3004,150,4.8
"20181",20,181,2011,3205,3076,129,4
"20181",20,181,2012,3217,3094,123,3.8
"20181",20,181,2013,3128,3003,125,4
"20181",20,181,2014,3090,2991,99,3.2
"20181",20,181,2015,3090,3001,89,2.9
"20181",20,181,2016,2942,2845,97,3.3
"20181",20,181,2017,2882,2797,85,2.9
"20183",20,183,1990,2437,2397,40,1.6
"20183",20,183,1991,2393,2347,46,1.9
"20183",20,183,1992,2450,2403,47,1.9
"20183",20,183,1993,2459,2401,58,2.4
"20183",20,183,1994,2532,2478,54,2.1
"20183",20,183,1995,2521,2443,78,3.1
"20183",20,183,1996,2459,2380,79,3.2
"20183",20,183,1997,2355,2291,64,2.7
"20183",20,183,1998,2333,2287,46,2
"20183",20,183,1999,2434,2398,36,1.5
"20183",20,183,2000,2175,2116,59,2.7
"20183",20,183,2001,2130,2059,71,3.3
"20183",20,183,2002,2258,2191,67,3
"20183",20,183,2003,2254,2175,79,3.5
"20183",20,183,2004,2339,2246,93,4
"20183",20,183,2005,2256,2174,82,3.6
"20183",20,183,2006,2236,2162,74,3.3
"20183",20,183,2007,2178,2109,69,3.2
"20183",20,183,2008,2171,2084,87,4
"20183",20,183,2009,2253,2146,107,4.7
"20183",20,183,2010,2333,2232,101,4.3
"20183",20,183,2011,2265,2174,91,4
"20183",20,183,2012,2215,2128,87,3.9
"20183",20,183,2013,2157,2080,77,3.6
"20183",20,183,2014,2116,2050,66,3.1
"20183",20,183,2015,2094,2013,81,3.9
"20183",20,183,2016,2034,1969,65,3.2
"20183",20,183,2017,1971,1916,55,2.8
"20185",20,185,1990,2412,2356,56,2.3
"20185",20,185,1991,2435,2372,63,2.6
"20185",20,185,1992,2421,2355,66,2.7
"20185",20,185,1993,2455,2361,94,3.8
"20185",20,185,1994,2376,2296,80,3.4
"20185",20,185,1995,2472,2396,76,3.1
"20185",20,185,1996,2481,2403,78,3.1
"20185",20,185,1997,2365,2304,61,2.6
"20185",20,185,1998,2456,2395,61,2.5
"20185",20,185,1999,2424,2365,59,2.4
"20185",20,185,2000,2286,2215,71,3.1
"20185",20,185,2001,2210,2138,72,3.3
"20185",20,185,2002,2191,2097,94,4.3
"20185",20,185,2003,2248,2159,89,4
"20185",20,185,2004,2233,2135,98,4.4
"20185",20,185,2005,2223,2136,87,3.9
"20185",20,185,2006,2237,2158,79,3.5
"20185",20,185,2007,2132,2054,78,3.7
"20185",20,185,2008,2157,2077,80,3.7
"20185",20,185,2009,2275,2157,118,5.2
"20185",20,185,2010,2366,2246,120,5.1
"20185",20,185,2011,2317,2198,119,5.1
"20185",20,185,2012,2218,2115,103,4.6
"20185",20,185,2013,2216,2119,97,4.4
"20185",20,185,2014,2162,2081,81,3.7
"20185",20,185,2015,2182,2095,87,4
"20185",20,185,2016,2095,2018,77,3.7
"20185",20,185,2017,2003,1937,66,3.3
"20187",20,187,1990,1117,1098,19,1.7
"20187",20,187,1991,1130,1101,29,2.6
"20187",20,187,1992,1067,1043,24,2.2
"20187",20,187,1993,1054,1026,28,2.7
"20187",20,187,1994,1114,1082,32,2.9
"20187",20,187,1995,1135,1110,25,2.2
"20187",20,187,1996,1111,1084,27,2.4
"20187",20,187,1997,1078,1049,29,2.7
"20187",20,187,1998,1096,1075,21,1.9
"20187",20,187,1999,1110,1086,24,2.2
"20187",20,187,2000,1266,1236,30,2.4
"20187",20,187,2001,1217,1187,30,2.5
"20187",20,187,2002,1148,1115,33,2.9
"20187",20,187,2003,1179,1145,34,2.9
"20187",20,187,2004,1163,1125,38,3.3
"20187",20,187,2005,1136,1102,34,3
"20187",20,187,2006,1158,1127,31,2.7
"20187",20,187,2007,1120,1087,33,2.9
"20187",20,187,2008,1117,1080,37,3.3
"20187",20,187,2009,1185,1146,39,3.3
"20187",20,187,2010,1093,1048,45,4.1
"20187",20,187,2011,1064,1021,43,4
"20187",20,187,2012,1048,1011,37,3.5
"20187",20,187,2013,1045,1007,38,3.6
"20187",20,187,2014,1026,992,34,3.3
"20187",20,187,2015,1061,1029,32,3
"20187",20,187,2016,1071,1041,30,2.8
"20187",20,187,2017,992,965,27,2.7
"20189",20,189,1990,2459,2414,45,1.8
"20189",20,189,1991,2495,2443,52,2.1
"20189",20,189,1992,2490,2414,76,3.1
"20189",20,189,1993,2455,2385,70,2.9
"20189",20,189,1994,2425,2355,70,2.9
"20189",20,189,1995,2646,2587,59,2.2
"20189",20,189,1996,2741,2638,103,3.8
"20189",20,189,1997,2807,2739,68,2.4
"20189",20,189,1998,2815,2755,60,2.1
"20189",20,189,1999,2798,2735,63,2.3
"20189",20,189,2000,2463,2394,69,2.8
"20189",20,189,2001,2283,2203,80,3.5
"20189",20,189,2002,2379,2296,83,3.5
"20189",20,189,2003,2320,2240,80,3.4
"20189",20,189,2004,2418,2316,102,4.2
"20189",20,189,2005,2403,2306,97,4
"20189",20,189,2006,2330,2250,80,3.4
"20189",20,189,2007,2254,2180,74,3.3
"20189",20,189,2008,2292,2214,78,3.4
"20189",20,189,2009,2378,2265,113,4.8
"20189",20,189,2010,2870,2749,121,4.2
"20189",20,189,2011,2765,2653,112,4.1
"20189",20,189,2012,2886,2784,102,3.5
"20189",20,189,2013,3314,3215,99,3
"20189",20,189,2014,3364,3263,101,3
"20189",20,189,2015,3178,3060,118,3.7
"20189",20,189,2016,2908,2793,115,4
"20189",20,189,2017,2657,2572,85,3.2
"20191",20,191,1990,12313,11782,531,4.3
"20191",20,191,1991,12391,11792,599,4.8
"20191",20,191,1992,12540,11849,691,5.5
"20191",20,191,1993,12888,11980,908,7
"20191",20,191,1994,12922,12033,889,6.9
"20191",20,191,1995,12732,12061,671,5.3
"20191",20,191,1996,12818,12281,537,4.2
"20191",20,191,1997,12778,12379,399,3.1
"20191",20,191,1998,13753,13386,367,2.7
"20191",20,191,1999,14036,13531,505,3.6
"20191",20,191,2000,12868,12290,578,4.5
"20191",20,191,2001,12574,12055,519,4.1
"20191",20,191,2002,12718,11816,902,7.1
"20191",20,191,2003,12434,11478,956,7.7
"20191",20,191,2004,12373,11600,773,6.2
"20191",20,191,2005,12272,11551,721,5.9
"20191",20,191,2006,11947,11383,564,4.7
"20191",20,191,2007,11816,11295,521,4.4
"20191",20,191,2008,11695,11154,541,4.6
"20191",20,191,2009,11670,10657,1013,8.7
"20191",20,191,2010,11958,10896,1062,8.9
"20191",20,191,2011,11573,10687,886,7.7
"20191",20,191,2012,11298,10578,720,6.4
"20191",20,191,2013,11144,10516,628,5.6
"20191",20,191,2014,11065,10537,528,4.8
"20191",20,191,2015,11079,10587,492,4.4
"20191",20,191,2016,10932,10469,463,4.2
"20191",20,191,2017,10761,10352,409,3.8
"20193",20,193,1990,4274,4137,137,3.2
"20193",20,193,1991,4238,4144,94,2.2
"20193",20,193,1992,4382,4275,107,2.4
"20193",20,193,1993,4419,4278,141,3.2
"20193",20,193,1994,4729,4607,122,2.6
"20193",20,193,1995,4732,4599,133,2.8
"20193",20,193,1996,4694,4564,130,2.8
"20193",20,193,1997,4795,4668,127,2.6
"20193",20,193,1998,4637,4530,107,2.3
"20193",20,193,1999,4720,4636,84,1.8
"20193",20,193,2000,4257,4156,101,2.4
"20193",20,193,2001,4235,4116,119,2.8
"20193",20,193,2002,4173,4039,134,3.2
"20193",20,193,2003,4315,4185,130,3
"20193",20,193,2004,4326,4179,147,3.4
"20193",20,193,2005,4331,4195,136,3.1
"20193",20,193,2006,4525,4394,131,2.9
"20193",20,193,2007,4140,4015,125,3
"20193",20,193,2008,4233,4102,131,3.1
"20193",20,193,2009,4310,4150,160,3.7
"20193",20,193,2010,4543,4363,180,4
"20193",20,193,2011,4600,4431,169,3.7
"20193",20,193,2012,4542,4385,157,3.5
"20193",20,193,2013,4465,4309,156,3.5
"20193",20,193,2014,4378,4251,127,2.9
"20193",20,193,2015,4415,4299,116,2.6
"20193",20,193,2016,4353,4233,120,2.8
"20193",20,193,2017,4266,4156,110,2.6
"20195",20,195,1990,1810,1779,31,1.7
"20195",20,195,1991,1804,1772,32,1.8
"20195",20,195,1992,1838,1799,39,2.1
"20195",20,195,1993,1858,1816,42,2.3
"20195",20,195,1994,2006,1972,34,1.7
"20195",20,195,1995,2039,1988,51,2.5
"20195",20,195,1996,1982,1928,54,2.7
"20195",20,195,1997,1986,1932,54,2.7
"20195",20,195,1998,1908,1863,45,2.4
"20195",20,195,1999,1883,1823,60,3.2
"20195",20,195,2000,1666,1625,41,2.5
"20195",20,195,2001,1625,1577,48,3
"20195",20,195,2002,1667,1612,55,3.3
"20195",20,195,2003,1717,1659,58,3.4
"20195",20,195,2004,1712,1653,59,3.4
"20195",20,195,2005,1722,1665,57,3.3
"20195",20,195,2006,1744,1691,53,3
"20195",20,195,2007,1691,1635,56,3.3
"20195",20,195,2008,1872,1815,57,3
"20195",20,195,2009,1895,1824,71,3.7
"20195",20,195,2010,1509,1438,71,4.7
"20195",20,195,2011,1494,1424,70,4.7
"20195",20,195,2012,1509,1444,65,4.3
"20195",20,195,2013,1491,1436,55,3.7
"20195",20,195,2014,1488,1442,46,3.1
"20195",20,195,2015,1509,1456,53,3.5
"20195",20,195,2016,1476,1417,59,4
"20195",20,195,2017,1435,1387,48,3.3
"20197",20,197,1990,3277,3154,123,3.8
"20197",20,197,1991,3302,3148,154,4.7
"20197",20,197,1992,3358,3196,162,4.8
"20197",20,197,1993,3417,3247,170,5
"20197",20,197,1994,3395,3236,159,4.7
"20197",20,197,1995,3459,3300,159,4.6
"20197",20,197,1996,3466,3310,156,4.5
"20197",20,197,1997,3412,3253,159,4.7
"20197",20,197,1998,3511,3360,151,4.3
"20197",20,197,1999,3647,3529,118,3.2
"20197",20,197,2000,3739,3619,120,3.2
"20197",20,197,2001,3688,3558,130,3.5
"20197",20,197,2002,3733,3592,141,3.8
"20197",20,197,2003,3757,3601,156,4.2
"20197",20,197,2004,3810,3625,185,4.9
"20197",20,197,2005,3775,3604,171,4.5
"20197",20,197,2006,3631,3495,136,3.7
"20197",20,197,2007,3657,3511,146,4
"20197",20,197,2008,3708,3540,168,4.5
"20197",20,197,2009,3768,3495,273,7.2
"20197",20,197,2010,3887,3633,254,6.5
"20197",20,197,2011,3837,3597,240,6.3
"20197",20,197,2012,3786,3581,205,5.4
"20197",20,197,2013,3769,3579,190,5
"20197",20,197,2014,3759,3604,155,4.1
"20197",20,197,2015,3732,3589,143,3.8
"20197",20,197,2016,3706,3574,132,3.6
"20197",20,197,2017,3637,3521,116,3.2
"20199",20,199,1990,880,864,16,1.8
"20199",20,199,1991,846,822,24,2.8
"20199",20,199,1992,817,800,17,2.1
"20199",20,199,1993,830,812,18,2.2
"20199",20,199,1994,835,807,28,3.4
"20199",20,199,1995,885,866,19,2.1
"20199",20,199,1996,857,838,19,2.2
"20199",20,199,1997,836,814,22,2.6
"20199",20,199,1998,856,840,16,1.9
"20199",20,199,1999,873,858,15,1.7
"20199",20,199,2000,931,911,20,2.1
"20199",20,199,2001,908,882,26,2.9
"20199",20,199,2002,939,914,25,2.7
"20199",20,199,2003,964,938,26,2.7
"20199",20,199,2004,942,913,29,3.1
"20199",20,199,2005,928,900,28,3
"20199",20,199,2006,896,868,28,3.1
"20199",20,199,2007,904,878,26,2.9
"20199",20,199,2008,850,809,41,4.8
"20199",20,199,2009,920,865,55,6
"20199",20,199,2010,893,840,53,5.9
"20199",20,199,2011,882,834,48,5.4
"20199",20,199,2012,872,835,37,4.2
"20199",20,199,2013,852,825,27,3.2
"20199",20,199,2014,876,853,23,2.6
"20199",20,199,2015,877,853,24,2.7
"20199",20,199,2016,860,837,23,2.7
"20199",20,199,2017,847,826,21,2.5
"20201",20,201,1990,3470,3395,75,2.2
"20201",20,201,1991,3532,3419,113,3.2
"20201",20,201,1992,3608,3490,118,3.3
"20201",20,201,1993,3613,3486,127,3.5
"20201",20,201,1994,3704,3555,149,4
"20201",20,201,1995,3604,3468,136,3.8
"20201",20,201,1996,3539,3401,138,3.9
"20201",20,201,1997,3427,3312,115,3.4
"20201",20,201,1998,3426,3324,102,3
"20201",20,201,1999,3433,3341,92,2.7
"20201",20,201,2000,3348,3234,114,3.4
"20201",20,201,2001,3302,3182,120,3.6
"20201",20,201,2002,3316,3195,121,3.6
"20201",20,201,2003,3428,3299,129,3.8
"20201",20,201,2004,3460,3316,144,4.2
"20201",20,201,2005,3410,3280,130,3.8
"20201",20,201,2006,3359,3243,116,3.5
"20201",20,201,2007,3334,3221,113,3.4
"20201",20,201,2008,3340,3219,121,3.6
"20201",20,201,2009,3474,3306,168,4.8
"20201",20,201,2010,3346,3184,162,4.8
"20201",20,201,2011,3309,3158,151,4.6
"20201",20,201,2012,3248,3113,135,4.2
"20201",20,201,2013,3127,3011,116,3.7
"20201",20,201,2014,3104,3004,100,3.2
"20201",20,201,2015,3129,3031,98,3.1
"20201",20,201,2016,3084,2983,101,3.3
"20201",20,201,2017,2962,2873,89,3
"20203",20,203,1990,1288,1266,22,1.7
"20203",20,203,1991,1270,1247,23,1.8
"20203",20,203,1992,1260,1234,26,2.1
"20203",20,203,1993,1296,1260,36,2.8
"20203",20,203,1994,1307,1274,33,2.5
"20203",20,203,1995,1300,1263,37,2.8
"20203",20,203,1996,1248,1213,35,2.8
"20203",20,203,1997,1209,1161,48,4
"20203",20,203,1998,1235,1196,39,3.2
"20203",20,203,1999,1320,1284,36,2.7
"20203",20,203,2000,1254,1219,35,2.8
"20203",20,203,2001,1196,1158,38,3.2
"20203",20,203,2002,1228,1189,39,3.2
"20203",20,203,2003,1304,1259,45,3.5
"20203",20,203,2004,1348,1300,48,3.6
"20203",20,203,2005,1305,1259,46,3.5
"20203",20,203,2006,1251,1213,38,3
"20203",20,203,2007,1237,1200,37,3
"20203",20,203,2008,1266,1226,40,3.2
"20203",20,203,2009,1281,1238,43,3.4
"20203",20,203,2010,1336,1290,46,3.4
"20203",20,203,2011,1329,1278,51,3.8
"20203",20,203,2012,1332,1262,70,5.3
"20203",20,203,2013,1288,1243,45,3.5
"20203",20,203,2014,1234,1199,35,2.8
"20203",20,203,2015,1255,1218,37,2.9
"20203",20,203,2016,1206,1178,28,2.3
"20203",20,203,2017,1168,1140,28,2.4
"20205",20,205,1990,4597,4395,202,4.4
"20205",20,205,1991,4554,4247,307,6.7
"20205",20,205,1992,4724,4448,276,5.8
"20205",20,205,1993,4801,4532,269,5.6
"20205",20,205,1994,4926,4662,264,5.4
"20205",20,205,1995,5308,5054,254,4.8
"20205",20,205,1996,5422,5130,292,5.4
"20205",20,205,1997,5434,5211,223,4.1
"20205",20,205,1998,5253,5025,228,4.3
"20205",20,205,1999,5545,5368,177,3.2
"20205",20,205,2000,4996,4804,192,3.8
"20205",20,205,2001,4755,4480,275,5.8
"20205",20,205,2002,4817,4590,227,4.7
"20205",20,205,2003,5015,4750,265,5.3
"20205",20,205,2004,5192,4915,277,5.3
"20205",20,205,2005,5397,5157,240,4.4
"20205",20,205,2006,5609,5403,206,3.7
"20205",20,205,2007,5516,5311,205,3.7
"20205",20,205,2008,5525,5215,310,5.6
"20205",20,205,2009,5305,4733,572,10.8
"20205",20,205,2010,4500,3962,538,12
"20205",20,205,2011,4270,3782,488,11.4
"20205",20,205,2012,4188,3772,416,9.9
"20205",20,205,2013,4110,3746,364,8.9
"20205",20,205,2014,4169,3881,288,6.9
"20205",20,205,2015,4008,3745,263,6.6
"20205",20,205,2016,4116,3869,247,6
"20205",20,205,2017,3998,3810,188,4.7
"20207",20,207,1990,1687,1634,53,3.1
"20207",20,207,1991,1739,1669,70,4
"20207",20,207,1992,1837,1747,90,4.9
"20207",20,207,1993,1933,1824,109,5.6
"20207",20,207,1994,1751,1635,116,6.6
"20207",20,207,1995,1659,1512,147,8.9
"20207",20,207,1996,1585,1482,103,6.5
"20207",20,207,1997,1427,1346,81,5.7
"20207",20,207,1998,1585,1489,96,6.1
"20207",20,207,1999,1595,1513,82,5.1
"20207",20,207,2000,1702,1621,81,4.8
"20207",20,207,2001,1686,1581,105,6.2
"20207",20,207,2002,1710,1604,106,6.2
"20207",20,207,2003,1722,1611,111,6.4
"20207",20,207,2004,1709,1579,130,7.6
"20207",20,207,2005,1683,1576,107,6.4
"20207",20,207,2006,1667,1584,83,5
"20207",20,207,2007,1668,1582,86,5.2
"20207",20,207,2008,1674,1579,95,5.7
"20207",20,207,2009,1792,1639,153,8.5
"20207",20,207,2010,1736,1599,137,7.9
"20207",20,207,2011,1718,1602,116,6.8
"20207",20,207,2012,1644,1542,102,6.2
"20207",20,207,2013,1627,1526,101,6.2
"20207",20,207,2014,1627,1541,86,5.3
"20207",20,207,2015,1611,1530,81,5
"20207",20,207,2016,1617,1524,93,5.8
"20207",20,207,2017,1589,1518,71,4.5
"20209",20,209,1990,79489,72861,6628,8.3
"20209",20,209,1991,77702,71101,6601,8.5
"20209",20,209,1992,77728,71092,6636,8.5
"20209",20,209,1993,78278,71198,7080,9
"20209",20,209,1994,78000,71209,6791,8.7
"20209",20,209,1995,75782,69627,6155,8.1
"20209",20,209,1996,75331,69340,5991,8
"20209",20,209,1997,75939,70634,5305,7
"20209",20,209,1998,77124,71548,5576,7.2
"20209",20,209,1999,76269,71673,4596,6
"20209",20,209,2000,74318,69878,4440,6
"20209",20,209,2001,73333,67926,5407,7.4
"20209",20,209,2002,73426,66539,6887,9.4
"20209",20,209,2003,74937,66813,8124,10.8
"20209",20,209,2004,74025,67200,6825,9.2
"20209",20,209,2005,73559,67194,6365,8.7
"20209",20,209,2006,71776,66313,5463,7.6
"20209",20,209,2007,71446,66013,5433,7.6
"20209",20,209,2008,71160,65407,5753,8.1
"20209",20,209,2009,70526,62998,7528,10.7
"20209",20,209,2010,74994,67433,7561,10.1
"20209",20,209,2011,74544,67430,7114,9.5
"20209",20,209,2012,74381,68103,6278,8.4
"20209",20,209,2013,74775,68839,5936,7.9
"20209",20,209,2014,75548,70372,5176,6.9
"20209",20,209,2015,76154,71583,4571,6
"20209",20,209,2016,76448,72195,4253,5.6
"20209",20,209,2017,77204,73194,4010,5.2
"21001",21,1,1990,7269,6838,431,5.9
"21001",21,1,1991,7610,6924,686,9
"21001",21,1,1992,7586,7046,540,7.1
"21001",21,1,1993,7865,7366,499,6.3
"21001",21,1,1994,7831,7402,429,5.5
"21001",21,1,1995,7947,7395,552,6.9
"21001",21,1,1996,8227,7522,705,8.6
"21001",21,1,1997,8421,6924,1497,17.8
"21001",21,1,1998,7883,6643,1240,15.7
"21001",21,1,1999,7568,6869,699,9.2
"21001",21,1,2000,8239,7825,414,5
"21001",21,1,2001,8731,8316,415,4.8
"21001",21,1,2002,8666,8198,468,5.4
"21001",21,1,2003,8772,8258,514,5.9
"21001",21,1,2004,8387,7943,444,5.3
"21001",21,1,2005,8675,8190,485,5.6
"21001",21,1,2006,8891,8388,503,5.7
"21001",21,1,2007,8912,8393,519,5.8
"21001",21,1,2008,8853,8248,605,6.8
"21001",21,1,2009,9218,8227,991,10.8
"21001",21,1,2010,7810,6839,971,12.4
"21001",21,1,2011,7747,6834,913,11.8
"21001",21,1,2012,7826,7083,743,9.5
"21001",21,1,2013,7559,6792,767,10.1
"21001",21,1,2014,7216,6592,624,8.6
"21001",21,1,2015,6946,6429,517,7.4
"21001",21,1,2016,6834,6363,471,6.9
"21001",21,1,2017,6854,6420,434,6.3
"21003",21,3,1990,7279,6239,1040,14.3
"21003",21,3,1991,7116,6483,633,8.9
"21003",21,3,1992,7164,6664,500,7
"21003",21,3,1993,8002,7627,375,4.7
"21003",21,3,1994,9251,8937,314,3.4
"21003",21,3,1995,8845,8543,302,3.4
"21003",21,3,1996,8826,8258,568,6.4
"21003",21,3,1997,8989,8333,656,7.3
"21003",21,3,1998,8664,8300,364,4.2
"21003",21,3,1999,8748,8283,465,5.3
"21003",21,3,2000,8517,8144,373,4.4
"21003",21,3,2001,8728,8203,525,6
"21003",21,3,2002,8646,8105,541,6.3
"21003",21,3,2003,8525,7945,580,6.8
"21003",21,3,2004,8507,7956,551,6.5
"21003",21,3,2005,8586,8029,557,6.5
"21003",21,3,2006,8463,7916,547,6.5
"21003",21,3,2007,8235,7754,481,5.8
"21003",21,3,2008,8367,7778,589,7
"21003",21,3,2009,8740,7482,1258,14.4
"21003",21,3,2010,9126,8056,1070,11.7
"21003",21,3,2011,9111,8215,896,9.8
"21003",21,3,2012,9024,8302,722,8
"21003",21,3,2013,8950,8284,666,7.4
"21003",21,3,2014,8658,8147,511,5.9
"21003",21,3,2015,8589,8168,421,4.9
"21003",21,3,2016,8756,8372,384,4.4
"21003",21,3,2017,8954,8589,365,4.1
"21005",21,5,1990,8151,7862,289,3.5
"21005",21,5,1991,8365,7934,431,5.2
"21005",21,5,1992,8399,8054,345,4.1
"21005",21,5,1993,8618,8254,364,4.2
"21005",21,5,1994,8877,8562,315,3.5
"21005",21,5,1995,8994,8713,281,3.1
"21005",21,5,1996,9286,8859,427,4.6
"21005",21,5,1997,9571,9169,402,4.2
"21005",21,5,1998,9816,9478,338,3.4
"21005",21,5,1999,10035,9737,298,3
"21005",21,5,2000,10242,9892,350,3.4
"21005",21,5,2001,10332,9817,515,5
"21005",21,5,2002,10207,9703,504,4.9
"21005",21,5,2003,10278,9803,475,4.6
"21005",21,5,2004,10393,9949,444,4.3
"21005",21,5,2005,10616,10108,508,4.8
"21005",21,5,2006,11028,10457,571,5.2
"21005",21,5,2007,11038,10489,549,5
"21005",21,5,2008,10877,10182,695,6.4
"21005",21,5,2009,11092,9939,1153,10.4
"21005",21,5,2010,11579,10466,1113,9.6
"21005",21,5,2011,11567,10603,964,8.3
"21005",21,5,2012,11540,10744,796,6.9
"21005",21,5,2013,11531,10788,743,6.4
"21005",21,5,2014,11416,10822,594,5.2
"21005",21,5,2015,11200,10733,467,4.2
"21005",21,5,2016,11364,10900,464,4.1
"21005",21,5,2017,11573,11092,481,4.2
"21007",21,7,1990,3748,3417,331,8.8
"21007",21,7,1991,3775,3442,333,8.8
"21007",21,7,1992,3853,3471,382,9.9
"21007",21,7,1993,3848,3511,337,8.8
"21007",21,7,1994,3875,3572,303,7.8
"21007",21,7,1995,3974,3704,270,6.8
"21007",21,7,1996,4062,3795,267,6.6
"21007",21,7,1997,4296,3871,425,9.9
"21007",21,7,1998,4168,3931,237,5.7
"21007",21,7,1999,4256,3995,261,6.1
"21007",21,7,2000,4240,3988,252,5.9
"21007",21,7,2001,4178,3902,276,6.6
"21007",21,7,2002,4099,3807,292,7.1
"21007",21,7,2003,4131,3809,322,7.8
"21007",21,7,2004,4115,3833,282,6.9
"21007",21,7,2005,4180,3895,285,6.8
"21007",21,7,2006,4169,3914,255,6.1
"21007",21,7,2007,4229,3996,233,5.5
"21007",21,7,2008,4134,3877,257,6.2
"21007",21,7,2009,4098,3690,408,10
"21007",21,7,2010,3839,3445,394,10.3
"21007",21,7,2011,3884,3497,387,10
"21007",21,7,2012,3881,3527,354,9.1
"21007",21,7,2013,3825,3474,351,9.2
"21007",21,7,2014,3672,3378,294,8
"21007",21,7,2015,3604,3357,247,6.9
"21007",21,7,2016,3659,3332,327,8.9
"21007",21,7,2017,3650,3371,279,7.6
"21009",21,9,1990,16380,15503,877,5.4
"21009",21,9,1991,17011,15523,1488,8.7
"21009",21,9,1992,16956,15849,1107,6.5
"21009",21,9,1993,17153,16228,925,5.4
"21009",21,9,1994,17659,16940,719,4.1
"21009",21,9,1995,18081,17164,917,5.1
"21009",21,9,1996,18723,17513,1210,6.5
"21009",21,9,1997,18406,17436,970,5.3
"21009",21,9,1998,18668,17871,797,4.3
"21009",21,9,1999,18847,17862,985,5.2
"21009",21,9,2000,19423,18529,894,4.6
"21009",21,9,2001,19375,18411,964,5
"21009",21,9,2002,19201,18298,903,4.7
"21009",21,9,2003,19404,18397,1007,5.2
"21009",21,9,2004,19208,18344,864,4.5
"21009",21,9,2005,19363,18320,1043,5.4
"21009",21,9,2006,19583,18481,1102,5.6
"21009",21,9,2007,19497,18489,1008,5.2
"21009",21,9,2008,19414,18223,1191,6.1
"21009",21,9,2009,19339,16957,2382,12.3
"21009",21,9,2010,19749,17540,2209,11.2
"21009",21,9,2011,19890,17940,1950,9.8
"21009",21,9,2012,19833,18273,1560,7.9
"21009",21,9,2013,19575,18070,1505,7.7
"21009",21,9,2014,18700,17526,1174,6.3
"21009",21,9,2015,18393,17439,954,5.2
"21009",21,9,2016,19082,18189,893,4.7
"21009",21,9,2017,19257,18377,880,4.6
"21011",21,11,1990,4729,4174,555,11.7
"21011",21,11,1991,4616,3929,687,14.9
"21011",21,11,1992,4567,4047,520,11.4
"21011",21,11,1993,4514,3974,540,12
"21011",21,11,1994,4768,4217,551,11.6
"21011",21,11,1995,4931,4455,476,9.7
"21011",21,11,1996,5133,4774,359,7
"21011",21,11,1997,5521,5149,372,6.7
"21011",21,11,1998,5806,5496,310,5.3
"21011",21,11,1999,5870,5504,366,6.2
"21011",21,11,2000,4970,4665,305,6.1
"21011",21,11,2001,5046,4675,371,7.4
"21011",21,11,2002,4989,4620,369,7.4
"21011",21,11,2003,5076,4678,398,7.8
"21011",21,11,2004,4962,4623,339,6.8
"21011",21,11,2005,5015,4605,410,8.2
"21011",21,11,2006,5126,4730,396,7.7
"21011",21,11,2007,5049,4670,379,7.5
"21011",21,11,2008,5028,4579,449,8.9
"21011",21,11,2009,5116,4327,789,15.4
"21011",21,11,2010,4887,4172,715,14.6
"21011",21,11,2011,4835,4224,611,12.6
"21011",21,11,2012,4890,4382,508,10.4
"21011",21,11,2013,4828,4330,498,10.3
"21011",21,11,2014,4716,4297,419,8.9
"21011",21,11,2015,4713,4352,361,7.7
"21011",21,11,2016,4785,4432,353,7.4
"21011",21,11,2017,4755,4384,371,7.8
"21013",21,13,1990,10512,9469,1043,9.9
"21013",21,13,1991,10670,9290,1380,12.9
"21013",21,13,1992,10321,9087,1234,12
"21013",21,13,1993,10378,9274,1104,10.6
"21013",21,13,1994,10178,9251,927,9.1
"21013",21,13,1995,10203,9405,798,7.8
"21013",21,13,1996,10033,9242,791,7.9
"21013",21,13,1997,10219,9390,829,8.1
"21013",21,13,1998,9952,9325,627,6.3
"21013",21,13,1999,10141,9576,565,5.6
"21013",21,13,2000,9945,9295,650,6.5
"21013",21,13,2001,9824,9013,811,8.3
"21013",21,13,2002,9521,8701,820,8.6
"21013",21,13,2003,9459,8642,817,8.6
"21013",21,13,2004,9463,8802,661,7
"21013",21,13,2005,9425,8726,699,7.4
"21013",21,13,2006,9610,8864,746,7.8
"21013",21,13,2007,9494,8734,760,8
"21013",21,13,2008,9603,8751,852,8.9
"21013",21,13,2009,9777,8605,1172,12
"21013",21,13,2010,10197,8959,1238,12.1
"21013",21,13,2011,10190,8976,1214,11.9
"21013",21,13,2012,10269,9043,1226,11.9
"21013",21,13,2013,9866,8552,1314,13.3
"21013",21,13,2014,9300,8362,938,10.1
"21013",21,13,2015,8815,8068,747,8.5
"21013",21,13,2016,8760,7960,800,9.1
"21013",21,13,2017,8790,8100,690,7.8
"21015",21,15,1990,31797,30773,1024,3.2
"21015",21,15,1991,32859,31202,1657,5
"21015",21,15,1992,33952,32001,1951,5.7
"21015",21,15,1993,35032,33189,1843,5.3
"21015",21,15,1994,36353,34668,1685,4.6
"21015",21,15,1995,37803,36251,1552,4.1
"21015",21,15,1996,39541,38021,1520,3.8
"21015",21,15,1997,42048,40599,1449,3.4
"21015",21,15,1998,44059,42809,1250,2.8
"21015",21,15,1999,46155,44901,1254,2.7
"21015",21,15,2000,49328,47873,1455,2.9
"21015",21,15,2001,50296,48350,1946,3.9
"21015",21,15,2002,51447,49341,2106,4.1
"21015",21,15,2003,53738,51136,2602,4.8
"21015",21,15,2004,56764,54293,2471,4.4
"21015",21,15,2005,59889,57025,2864,4.8
"21015",21,15,2006,61369,58483,2886,4.7
"21015",21,15,2007,61711,58999,2712,4.4
"21015",21,15,2008,62871,59447,3424,5.4
"21015",21,15,2009,64357,58589,5768,9
"21015",21,15,2010,63271,57662,5609,8.9
"21015",21,15,2011,64221,59178,5043,7.9
"21015",21,15,2012,65398,60924,4474,6.8
"21015",21,15,2013,66021,61650,4371,6.6
"21015",21,15,2014,65181,61810,3371,5.2
"21015",21,15,2015,64971,62311,2660,4.1
"21015",21,15,2016,66528,63955,2573,3.9
"21015",21,15,2017,68431,65761,2670,3.9
"21017",21,17,1990,9711,9155,556,5.7
"21017",21,17,1991,9431,8988,443,4.7
"21017",21,17,1992,9405,8971,434,4.6
"21017",21,17,1993,9586,9120,466,4.9
"21017",21,17,1994,9466,9071,395,4.2
"21017",21,17,1995,9512,9224,288,3
"21017",21,17,1996,9622,9299,323,3.4
"21017",21,17,1997,9902,9599,303,3.1
"21017",21,17,1998,9959,9707,252,2.5
"21017",21,17,1999,10068,9822,246,2.4
"21017",21,17,2000,10038,9707,331,3.3
"21017",21,17,2001,9950,9495,455,4.6
"21017",21,17,2002,9776,9245,531,5.4
"21017",21,17,2003,9719,9161,558,5.7
"21017",21,17,2004,9599,9141,458,4.8
"21017",21,17,2005,9810,9276,534,5.4
"21017",21,17,2006,9831,9344,487,5
"21017",21,17,2007,9689,9217,472,4.9
"21017",21,17,2008,9550,8995,555,5.8
"21017",21,17,2009,9263,8370,893,9.6
"21017",21,17,2010,10064,9151,913,9.1
"21017",21,17,2011,10046,9198,848,8.4
"21017",21,17,2012,9847,9132,715,7.3
"21017",21,17,2013,9824,9136,688,7
"21017",21,17,2014,9637,9095,542,5.6
"21017",21,17,2015,9659,9200,459,4.8
"21017",21,17,2016,9784,9310,474,4.8
"21017",21,17,2017,9921,9463,458,4.6
"21019",21,19,1990,22528,21134,1394,6.2
"21019",21,19,1991,22888,20739,2149,9.4
"21019",21,19,1992,23052,20803,2249,9.8
"21019",21,19,1993,23152,20533,2619,11.3
"21019",21,19,1994,22431,20674,1757,7.8
"21019",21,19,1995,22674,20849,1825,8
"21019",21,19,1996,22340,20797,1543,6.9
"21019",21,19,1997,22773,21133,1640,7.2
"21019",21,19,1998,22613,21193,1420,6.3
"21019",21,19,1999,22534,20990,1544,6.9
"21019",21,19,2000,21564,20320,1244,5.8
"21019",21,19,2001,21523,20140,1383,6.4
"21019",21,19,2002,21859,20486,1373,6.3
"21019",21,19,2003,22710,21133,1577,6.9
"21019",21,19,2004,22894,21495,1399,6.1
"21019",21,19,2005,22989,21631,1358,5.9
"21019",21,19,2006,23096,21830,1266,5.5
"21019",21,19,2007,22838,21660,1178,5.2
"21019",21,19,2008,22798,21456,1342,5.9
"21019",21,19,2009,22747,20838,1909,8.4
"21019",21,19,2010,20421,18342,2079,10.2
"21019",21,19,2011,20244,18162,2082,10.3
"21019",21,19,2012,20080,18210,1870,9.3
"21019",21,19,2013,19704,17845,1859,9.4
"21019",21,19,2014,19056,17619,1437,7.5
"21019",21,19,2015,18130,16877,1253,6.9
"21019",21,19,2016,18358,16847,1511,8.2
"21019",21,19,2017,18497,17177,1320,7.1
"21021",21,21,1990,12609,11822,787,6.2
"21021",21,21,1991,12507,11588,919,7.3
"21021",21,21,1992,12892,12098,794,6.2
"21021",21,21,1993,13124,12457,667,5.1
"21021",21,21,1994,13209,12525,684,5.2
"21021",21,21,1995,13164,12556,608,4.6
"21021",21,21,1996,13460,12889,571,4.2
"21021",21,21,1997,13699,13147,552,4
"21021",21,21,1998,14364,13906,458,3.2
"21021",21,21,1999,14532,14062,470,3.2
"21021",21,21,2000,13583,13045,538,4
"21021",21,21,2001,13568,12834,734,5.4
"21021",21,21,2002,13285,12447,838,6.3
"21021",21,21,2003,13357,12225,1132,8.5
"21021",21,21,2004,12623,11798,825,6.5
"21021",21,21,2005,12713,11872,841,6.6
"21021",21,21,2006,12835,11975,860,6.7
"21021",21,21,2007,12705,11938,767,6
"21021",21,21,2008,12745,11885,860,6.7
"21021",21,21,2009,12948,11481,1467,11.3
"21021",21,21,2010,13342,11853,1489,11.2
"21021",21,21,2011,13157,11743,1414,10.7
"21021",21,21,2012,13074,11900,1174,9
"21021",21,21,2013,12813,11683,1130,8.8
"21021",21,21,2014,12279,11428,851,6.9
"21021",21,21,2015,11992,11325,667,5.6
"21021",21,21,2016,12303,11689,614,5
"21021",21,21,2017,12701,12064,637,5
"21023",21,23,1990,3517,3274,243,6.9
"21023",21,23,1991,3557,3224,333,9.4
"21023",21,23,1992,3590,3288,302,8.4
"21023",21,23,1993,3684,3357,327,8.9
"21023",21,23,1994,3717,3478,239,6.4
"21023",21,23,1995,3749,3528,221,5.9
"21023",21,23,1996,3849,3621,228,5.9
"21023",21,23,1997,3804,3573,231,6.1
"21023",21,23,1998,3874,3711,163,4.2
"21023",21,23,1999,3964,3804,160,4
"21023",21,23,2000,4208,4061,147,3.5
"21023",21,23,2001,4188,3990,198,4.7
"21023",21,23,2002,4180,3968,212,5.1
"21023",21,23,2003,4246,3987,259,6.1
"21023",21,23,2004,4397,4144,253,5.8
"21023",21,23,2005,4422,4142,280,6.3
"21023",21,23,2006,4341,4094,247,5.7
"21023",21,23,2007,4259,4005,254,6
"21023",21,23,2008,4243,3936,307,7.2
"21023",21,23,2009,4289,3807,482,11.2
"21023",21,23,2010,3982,3529,453,11.4
"21023",21,23,2011,3981,3553,428,10.8
"21023",21,23,2012,3950,3577,373,9.4
"21023",21,23,2013,3932,3547,385,9.8
"21023",21,23,2014,3795,3495,300,7.9
"21023",21,23,2015,3689,3455,234,6.3
"21023",21,23,2016,3791,3559,232,6.1
"21023",21,23,2017,3878,3652,226,5.8
"21025",21,25,1990,5132,4575,557,10.9
"21025",21,25,1991,5191,4188,1003,19.3
"21025",21,25,1992,5026,4314,712,14.2
"21025",21,25,1993,5083,4580,503,9.9
"21025",21,25,1994,4973,4574,399,8
"21025",21,25,1995,4658,4143,515,11.1
"21025",21,25,1996,4426,3931,495,11.2
"21025",21,25,1997,4203,3775,428,10.2
"21025",21,25,1998,4184,3851,333,8
"21025",21,25,1999,4248,3886,362,8.5
"21025",21,25,2000,5423,5060,363,6.7
"21025",21,25,2001,5399,4989,410,7.6
"21025",21,25,2002,5386,4960,426,7.9
"21025",21,25,2003,5474,5003,471,8.6
"21025",21,25,2004,5480,5082,398,7.3
"21025",21,25,2005,5563,5150,413,7.4
"21025",21,25,2006,5667,5251,416,7.3
"21025",21,25,2007,5641,5247,394,7
"21025",21,25,2008,5619,5210,409,7.3
"21025",21,25,2009,5675,5097,578,10.2
"21025",21,25,2010,4528,3916,612,13.5
"21025",21,25,2011,4410,3847,563,12.8
"21025",21,25,2012,4538,3882,656,14.5
"21025",21,25,2013,4484,3816,668,14.9
"21025",21,25,2014,4176,3699,477,11.4
"21025",21,25,2015,3990,3615,375,9.4
"21025",21,25,2016,3925,3554,371,9.5
"21025",21,25,2017,3942,3606,336,8.5
"21027",21,27,1990,6961,6499,462,6.6
"21027",21,27,1991,7075,6465,610,8.6
"21027",21,27,1992,7312,6718,594,8.1
"21027",21,27,1993,7435,6935,500,6.7
"21027",21,27,1994,7452,6990,462,6.2
"21027",21,27,1995,7687,7191,496,6.5
"21027",21,27,1996,7861,7328,533,6.8
"21027",21,27,1997,7959,7437,522,6.6
"21027",21,27,1998,7836,7400,436,5.6
"21027",21,27,1999,7816,7322,494,6.3
"21027",21,27,2000,8705,8290,415,4.8
"21027",21,27,2001,8775,8226,549,6.3
"21027",21,27,2002,8865,8273,592,6.7
"21027",21,27,2003,8980,8359,621,6.9
"21027",21,27,2004,8766,8209,557,6.4
"21027",21,27,2005,8919,8296,623,7
"21027",21,27,2006,9082,8480,602,6.6
"21027",21,27,2007,9098,8551,547,6
"21027",21,27,2008,9153,8471,682,7.5
"21027",21,27,2009,9377,8274,1103,11.8
"21027",21,27,2010,8273,7202,1071,12.9
"21027",21,27,2011,8280,7323,957,11.6
"21027",21,27,2012,8282,7482,800,9.7
"21027",21,27,2013,8243,7487,756,9.2
"21027",21,27,2014,8076,7494,582,7.2
"21027",21,27,2015,7912,7440,472,6
"21027",21,27,2016,7944,7455,489,6.2
"21027",21,27,2017,8206,7725,481,5.9
"21029",21,29,1990,25407,24251,1156,4.5
"21029",21,29,1991,25735,24405,1330,5.2
"21029",21,29,1992,26565,25434,1131,4.3
"21029",21,29,1993,27601,26642,959,3.5
"21029",21,29,1994,28780,28015,765,2.7
"21029",21,29,1995,29752,28839,913,3.1
"21029",21,29,1996,30671,29535,1136,3.7
"21029",21,29,1997,31695,30648,1047,3.3
"21029",21,29,1998,32856,31920,936,2.8
"21029",21,29,1999,34236,33152,1084,3.2
"21029",21,29,2000,33653,32564,1089,3.2
"21029",21,29,2001,33257,31861,1396,4.2
"21029",21,29,2002,33232,31514,1718,5.2
"21029",21,29,2003,33695,31806,1889,5.6
"21029",21,29,2004,34571,32852,1719,5
"21029",21,29,2005,35870,33830,2040,5.7
"21029",21,29,2006,38622,36352,2270,5.9
"21029",21,29,2007,38936,36739,2197,5.6
"21029",21,29,2008,39338,36604,2734,7
"21029",21,29,2009,39761,35479,4282,10.8
"21029",21,29,2010,38803,34671,4132,10.6
"21029",21,29,2011,38954,35079,3875,9.9
"21029",21,29,2012,39265,36099,3166,8.1
"21029",21,29,2013,39671,36740,2931,7.4
"21029",21,29,2014,39174,36903,2271,5.8
"21029",21,29,2015,39107,37323,1784,4.6
"21029",21,29,2016,40178,38485,1693,4.2
"21029",21,29,2017,41337,39581,1756,4.2
"21031",21,31,1990,5437,4856,581,10.7
"21031",21,31,1991,5424,4873,551,10.2
"21031",21,31,1992,5492,5038,454,8.3
"21031",21,31,1993,5362,5005,357,6.7
"21031",21,31,1994,5402,5095,307,5.7
"21031",21,31,1995,5623,5182,441,7.8
"21031",21,31,1996,5640,5223,417,7.4
"21031",21,31,1997,5709,5377,332,5.8
"21031",21,31,1998,5805,5442,363,6.3
"21031",21,31,1999,5931,5596,335,5.6
"21031",21,31,2000,6638,6369,269,4.1
"21031",21,31,2001,6732,6365,367,5.5
"21031",21,31,2002,6492,5968,524,8.1
"21031",21,31,2003,6190,5593,597,9.6
"21031",21,31,2004,5767,5360,407,7.1
"21031",21,31,2005,5719,5312,407,7.1
"21031",21,31,2006,5780,5326,454,7.9
"21031",21,31,2007,5602,5247,355,6.3
"21031",21,31,2008,5458,5028,430,7.9
"21031",21,31,2009,5499,4713,786,14.3
"21031",21,31,2010,5457,4802,655,12
"21031",21,31,2011,5452,4867,585,10.7
"21031",21,31,2012,5411,4925,486,9
"21031",21,31,2013,5375,4883,492,9.2
"21031",21,31,2014,5184,4796,388,7.5
"21031",21,31,2015,5046,4747,299,5.9
"21031",21,31,2016,5106,4823,283,5.5
"21031",21,31,2017,5257,4970,287,5.5
"21033",21,33,1990,6150,5700,450,7.3
"21033",21,33,1991,6115,5575,540,8.8
"21033",21,33,1992,6255,5503,752,12
"21033",21,33,1993,6708,6174,534,8
"21033",21,33,1994,7174,6828,346,4.8
"21033",21,33,1995,6999,6586,413,5.9
"21033",21,33,1996,6378,5764,614,9.6
"21033",21,33,1997,6345,5932,413,6.5
"21033",21,33,1998,6404,6064,340,5.3
"21033",21,33,1999,6524,6217,307,4.7
"21033",21,33,2000,6234,5958,276,4.4
"21033",21,33,2001,6277,5957,320,5.1
"21033",21,33,2002,6313,5991,322,5.1
"21033",21,33,2003,6372,5994,378,5.9
"21033",21,33,2004,6249,5931,318,5.1
"21033",21,33,2005,6394,6019,375,5.9
"21033",21,33,2006,6653,6305,348,5.2
"21033",21,33,2007,6630,6279,351,5.3
"21033",21,33,2008,6661,6225,436,6.5
"21033",21,33,2009,6909,6220,689,10
"21033",21,33,2010,5916,5293,623,10.5
"21033",21,33,2011,5695,5149,546,9.6
"21033",21,33,2012,5677,5205,472,8.3
"21033",21,33,2013,5632,5171,461,8.2
"21033",21,33,2014,5445,5090,355,6.5
"21033",21,33,2015,5395,5099,296,5.5
"21033",21,33,2016,5473,5178,295,5.4
"21033",21,33,2017,5467,5182,285,5.2
"21035",21,35,1990,15466,14576,890,5.8
"21035",21,35,1991,15499,14654,845,5.5
"21035",21,35,1992,15929,15053,876,5.5
"21035",21,35,1993,16194,15294,900,5.6
"21035",21,35,1994,16398,15589,809,4.9
"21035",21,35,1995,16622,15949,673,4
"21035",21,35,1996,17176,16380,796,4.6
"21035",21,35,1997,17704,16790,914,5.2
"21035",21,35,1998,17837,16926,911,5.1
"21035",21,35,1999,17851,17083,768,4.3
"21035",21,35,2000,17382,16701,681,3.9
"21035",21,35,2001,17320,16423,897,5.2
"21035",21,35,2002,16697,15511,1186,7.1
"21035",21,35,2003,16631,15369,1262,7.6
"21035",21,35,2004,17346,16427,919,5.3
"21035",21,35,2005,17597,16615,982,5.6
"21035",21,35,2006,18003,16983,1020,5.7
"21035",21,35,2007,17749,16794,955,5.4
"21035",21,35,2008,17810,16774,1036,5.8
"21035",21,35,2009,17940,16448,1492,8.3
"21035",21,35,2010,18915,17391,1524,8.1
"21035",21,35,2011,19019,17593,1426,7.5
"21035",21,35,2012,18306,17014,1292,7.1
"21035",21,35,2013,18141,16825,1316,7.3
"21035",21,35,2014,18693,17616,1077,5.8
"21035",21,35,2015,18358,17498,860,4.7
"21035",21,35,2016,18561,17710,851,4.6
"21035",21,35,2017,18597,17771,826,4.4
"21037",21,37,1990,43319,41831,1488,3.4
"21037",21,37,1991,43048,40802,2246,5.2
"21037",21,37,1992,43360,40595,2765,6.4
"21037",21,37,1993,43303,40948,2355,5.4
"21037",21,37,1994,43540,41526,2014,4.6
"21037",21,37,1995,44334,42347,1987,4.5
"21037",21,37,1996,44633,42696,1937,4.3
"21037",21,37,1997,45686,43870,1816,4
"21037",21,37,1998,45638,44052,1586,3.5
"21037",21,37,1999,45664,44162,1502,3.3
"21037",21,37,2000,46821,45291,1530,3.3
"21037",21,37,2001,46072,44064,2008,4.4
"21037",21,37,2002,45203,43242,1961,4.3
"21037",21,37,2003,45125,42883,2242,5
"21037",21,37,2004,45541,43385,2156,4.7
"21037",21,37,2005,45946,43475,2471,5.4
"21037",21,37,2006,45162,42854,2308,5.1
"21037",21,37,2007,44530,42314,2216,5
"21037",21,37,2008,44380,41696,2684,6
"21037",21,37,2009,45055,40571,4484,10
"21037",21,37,2010,48713,44284,4429,9.1
"21037",21,37,2011,48811,44758,4053,8.3
"21037",21,37,2012,48813,45437,3376,6.9
"21037",21,37,2013,48752,45550,3202,6.6
"21037",21,37,2014,47830,45354,2476,5.2
"21037",21,37,2015,47322,45352,1970,4.2
"21037",21,37,2016,48187,46314,1873,3.9
"21037",21,37,2017,49517,47635,1882,3.8
"21039",21,39,1990,2545,2339,206,8.1
"21039",21,39,1991,2615,2355,260,9.9
"21039",21,39,1992,2597,2380,217,8.4
"21039",21,39,1993,2589,2411,178,6.9
"21039",21,39,1994,2588,2424,164,6.3
"21039",21,39,1995,2649,2492,157,5.9
"21039",21,39,1996,2720,2550,170,6.3
"21039",21,39,1997,2765,2572,193,7
"21039",21,39,1998,2697,2559,138,5.1
"21039",21,39,1999,2792,2615,177,6.3
"21039",21,39,2000,2420,2273,147,6.1
"21039",21,39,2001,2428,2272,156,6.4
"21039",21,39,2002,2367,2209,158,6.7
"21039",21,39,2003,2429,2236,193,7.9
"21039",21,39,2004,2318,2147,171,7.4
"21039",21,39,2005,2321,2152,169,7.3
"21039",21,39,2006,2318,2178,140,6
"21039",21,39,2007,2260,2123,137,6.1
"21039",21,39,2008,2270,2122,148,6.5
"21039",21,39,2009,2339,2133,206,8.8
"21039",21,39,2010,2251,2047,204,9.1
"21039",21,39,2011,2305,2101,204,8.9
"21039",21,39,2012,2341,2154,187,8
"21039",21,39,2013,2375,2205,170,7.2
"21039",21,39,2014,2380,2237,143,6
"21039",21,39,2015,2315,2184,131,5.7
"21039",21,39,2016,2679,2512,167,6.2
"21039",21,39,2017,2432,2266,166,6.8
"21041",21,41,1990,4217,4031,186,4.4
"21041",21,41,1991,4087,3831,256,6.3
"21041",21,41,1992,4497,4283,214,4.8
"21041",21,41,1993,4668,4399,269,5.8
"21041",21,41,1994,4961,4746,215,4.3
"21041",21,41,1995,4759,4471,288,6.1
"21041",21,41,1996,4574,4363,211,4.6
"21041",21,41,1997,4769,4557,212,4.4
"21041",21,41,1998,5049,4781,268,5.3
"21041",21,41,1999,5069,4854,215,4.2
"21041",21,41,2000,4995,4780,215,4.3
"21041",21,41,2001,5247,4947,300,5.7
"21041",21,41,2002,5157,4784,373,7.2
"21041",21,41,2003,5294,4936,358,6.8
"21041",21,41,2004,5493,5203,290,5.3
"21041",21,41,2005,5619,5307,312,5.6
"21041",21,41,2006,5768,5452,316,5.5
"21041",21,41,2007,5726,5417,309,5.4
"21041",21,41,2008,5538,5125,413,7.5
"21041",21,41,2009,5446,4736,710,13
"21041",21,41,2010,4999,4274,725,14.5
"21041",21,41,2011,5110,4487,623,12.2
"21041",21,41,2012,5065,4547,518,10.2
"21041",21,41,2013,5167,4695,472,9.1
"21041",21,41,2014,4863,4517,346,7.1
"21041",21,41,2015,4957,4681,276,5.6
"21041",21,41,2016,5137,4879,258,5
"21041",21,41,2017,4919,4687,232,4.7
"21043",21,43,1990,10530,9136,1394,13.2
"21043",21,43,1991,10779,9063,1716,15.9
"21043",21,43,1992,10909,9216,1693,15.5
"21043",21,43,1993,11068,9283,1785,16.1
"21043",21,43,1994,11168,9511,1657,14.8
"21043",21,43,1995,11337,9737,1600,14.1
"21043",21,43,1996,11196,9869,1327,11.9
"21043",21,43,1997,11539,10197,1342,11.6
"21043",21,43,1998,11766,10426,1340,11.4
"21043",21,43,1999,12103,10548,1555,12.8
"21043",21,43,2000,11797,10950,847,7.2
"21043",21,43,2001,12505,11228,1277,10.2
"21043",21,43,2002,12690,11527,1163,9.2
"21043",21,43,2003,13058,11901,1157,8.9
"21043",21,43,2004,13373,12254,1119,8.4
"21043",21,43,2005,13629,12504,1125,8.3
"21043",21,43,2006,13713,12675,1038,7.6
"21043",21,43,2007,13501,12543,958,7.1
"21043",21,43,2008,13304,12219,1085,8.2
"21043",21,43,2009,13518,11833,1685,12.5
"21043",21,43,2010,11925,10244,1681,14.1
"21043",21,43,2011,11696,10079,1617,13.8
"21043",21,43,2012,11492,10056,1436,12.5
"21043",21,43,2013,11034,9637,1397,12.7
"21043",21,43,2014,10473,9349,1124,10.7
"21043",21,43,2015,10195,9193,1002,9.8
"21043",21,43,2016,10180,9125,1055,10.4
"21043",21,43,2017,10232,9253,979,9.6
"21045",21,45,1990,6051,5742,309,5.1
"21045",21,45,1991,6670,6094,576,8.6
"21045",21,45,1992,6987,6519,468,6.7
"21045",21,45,1993,6845,6315,530,7.7
"21045",21,45,1994,6795,6417,378,5.6
"21045",21,45,1995,7016,6647,369,5.3
"21045",21,45,1996,6896,6434,462,6.7
"21045",21,45,1997,7072,6559,513,7.3
"21045",21,45,1998,6996,6378,618,8.8
"21045",21,45,1999,6724,6217,507,7.5
"21045",21,45,2000,6899,6583,316,4.6
"21045",21,45,2001,7215,6729,486,6.7
"21045",21,45,2002,7254,6773,481,6.6
"21045",21,45,2003,7308,6817,491,6.7
"21045",21,45,2004,6964,6530,434,6.2
"21045",21,45,2005,7075,6646,429,6.1
"21045",21,45,2006,7486,6979,507,6.8
"21045",21,45,2007,7320,6916,404,5.5
"21045",21,45,2008,7125,6674,451,6.3
"21045",21,45,2009,7145,6388,757,10.6
"21045",21,45,2010,6914,6155,759,11
"21045",21,45,2011,6980,6283,697,10
"21045",21,45,2012,6861,6287,574,8.4
"21045",21,45,2013,6813,6225,588,8.6
"21045",21,45,2014,6612,6162,450,6.8
"21045",21,45,2015,6690,6315,375,5.6
"21045",21,45,2016,6888,6564,324,4.7
"21045",21,45,2017,6943,6618,325,4.7
"21047",21,47,1990,24301,22621,1680,6.9
"21047",21,47,1991,23391,21496,1895,8.1
"21047",21,47,1992,22559,21243,1316,5.8
"21047",21,47,1993,22852,21594,1258,5.5
"21047",21,47,1994,24251,23124,1127,4.6
"21047",21,47,1995,25764,24362,1402,5.4
"21047",21,47,1996,26879,25749,1130,4.2
"21047",21,47,1997,27375,26049,1326,4.8
"21047",21,47,1998,27345,26218,1127,4.1
"21047",21,47,1999,27950,26872,1078,3.9
"21047",21,47,2000,26573,25307,1266,4.8
"21047",21,47,2001,26486,24723,1763,6.7
"21047",21,47,2002,26065,24523,1542,5.9
"21047",21,47,2003,26182,24445,1737,6.6
"21047",21,47,2004,26556,24992,1564,5.9
"21047",21,47,2005,26460,24620,1840,7
"21047",21,47,2006,26223,24499,1724,6.6
"21047",21,47,2007,29455,27592,1863,6.3
"21047",21,47,2008,28973,26578,2395,8.3
"21047",21,47,2009,29392,25772,3620,12.3
"21047",21,47,2010,27294,24107,3187,11.7
"21047",21,47,2011,26810,23916,2894,10.8
"21047",21,47,2012,26742,24249,2493,9.3
"21047",21,47,2013,26605,24098,2507,9.4
"21047",21,47,2014,25398,23467,1931,7.6
"21047",21,47,2015,24695,23118,1577,6.4
"21047",21,47,2016,24630,23093,1537,6.2
"21047",21,47,2017,25091,23563,1528,6.1
"21049",21,49,1990,14814,13803,1011,6.8
"21049",21,49,1991,14619,13587,1032,7.1
"21049",21,49,1992,14564,13694,870,6
"21049",21,49,1993,14858,14072,786,5.3
"21049",21,49,1994,14934,14149,785,5.3
"21049",21,49,1995,15180,14523,657,4.3
"21049",21,49,1996,15600,14962,638,4.1
"21049",21,49,1997,16103,15431,672,4.2
"21049",21,49,1998,16289,15742,547,3.4
"21049",21,49,1999,16703,16163,540,3.2
"21049",21,49,2000,17100,16469,631,3.7
"21049",21,49,2001,16986,16090,896,5.3
"21049",21,49,2002,16670,15743,927,5.6
"21049",21,49,2003,16657,15714,943,5.7
"21049",21,49,2004,16636,15790,846,5.1
"21049",21,49,2005,17061,16130,931,5.5
"21049",21,49,2006,17370,16426,944,5.4
"21049",21,49,2007,17233,16396,837,4.9
"21049",21,49,2008,17091,16008,1083,6.3
"21049",21,49,2009,17039,15167,1872,11
"21049",21,49,2010,17775,15862,1913,10.8
"21049",21,49,2011,17537,15804,1733,9.9
"21049",21,49,2012,17416,15998,1418,8.1
"21049",21,49,2013,17266,15968,1298,7.5
"21049",21,49,2014,16959,15922,1037,6.1
"21049",21,49,2015,16732,15856,876,5.2
"21049",21,49,2016,16859,16036,823,4.9
"21049",21,49,2017,17258,16455,803,4.7
"21051",21,51,1990,6593,6093,500,7.6
"21051",21,51,1991,6667,6026,641,9.6
"21051",21,51,1992,6858,6160,698,10.2
"21051",21,51,1993,7078,6405,673,9.5
"21051",21,51,1994,6982,6425,557,8
"21051",21,51,1995,7111,6557,554,7.8
"21051",21,51,1996,7166,6530,636,8.9
"21051",21,51,1997,7252,6594,658,9.1
"21051",21,51,1998,7187,6691,496,6.9
"21051",21,51,1999,7356,6844,512,7
"21051",21,51,2000,7261,6783,478,6.6
"21051",21,51,2001,7321,6778,543,7.4
"21051",21,51,2002,7174,6422,752,10.5
"21051",21,51,2003,7133,6418,715,10
"21051",21,51,2004,7063,6528,535,7.6
"21051",21,51,2005,7153,6547,606,8.5
"21051",21,51,2006,7067,6363,704,10
"21051",21,51,2007,6997,6256,741,10.6
"21051",21,51,2008,6798,6094,704,10.4
"21051",21,51,2009,6964,6012,952,13.7
"21051",21,51,2010,6030,5153,877,14.5
"21051",21,51,2011,6052,5142,910,15
"21051",21,51,2012,5956,5123,833,14
"21051",21,51,2013,5752,4930,822,14.3
"21051",21,51,2014,5549,4928,621,11.2
"21051",21,51,2015,5421,4909,512,9.4
"21051",21,51,2016,5688,5132,556,9.8
"21051",21,51,2017,5640,5161,479,8.5
"21053",21,53,1990,4151,3748,403,9.7
"21053",21,53,1991,4448,4111,337,7.6
"21053",21,53,1992,4473,3990,483,10.8
"21053",21,53,1993,4487,4131,356,7.9
"21053",21,53,1994,4404,4059,345,7.8
"21053",21,53,1995,4382,4024,358,8.2
"21053",21,53,1996,4519,4053,466,10.3
"21053",21,53,1997,4483,4147,336,7.5
"21053",21,53,1998,4590,4303,287,6.3
"21053",21,53,1999,5541,5321,220,4
"21053",21,53,2000,4549,4321,228,5
"21053",21,53,2001,4689,4401,288,6.1
"21053",21,53,2002,4686,4282,404,8.6
"21053",21,53,2003,4756,4318,438,9.2
"21053",21,53,2004,4645,4330,315,6.8
"21053",21,53,2005,4542,4251,291,6.4
"21053",21,53,2006,4506,4238,268,5.9
"21053",21,53,2007,4639,4396,243,5.2
"21053",21,53,2008,4710,4405,305,6.5
"21053",21,53,2009,4852,4395,457,9.4
"21053",21,53,2010,4273,3803,470,11
"21053",21,53,2011,4281,3794,487,11.4
"21053",21,53,2012,4250,3788,462,10.9
"21053",21,53,2013,4113,3683,430,10.5
"21053",21,53,2014,4000,3639,361,9
"21053",21,53,2015,3842,3526,316,8.2
"21053",21,53,2016,3795,3512,283,7.5
"21053",21,53,2017,3877,3622,255,6.6
"21055",21,55,1990,3904,3563,341,8.7
"21055",21,55,1991,3795,3358,437,11.5
"21055",21,55,1992,3850,3492,358,9.3
"21055",21,55,1993,4110,3815,295,7.2
"21055",21,55,1994,4162,3916,246,5.9
"21055",21,55,1995,4334,4003,331,7.6
"21055",21,55,1996,4278,3966,312,7.3
"21055",21,55,1997,4221,3891,330,7.8
"21055",21,55,1998,4068,3802,266,6.5
"21055",21,55,1999,4019,3791,228,5.7
"21055",21,55,2000,4372,4092,280,6.4
"21055",21,55,2001,4406,4074,332,7.5
"21055",21,55,2002,4216,3977,239,5.7
"21055",21,55,2003,4277,3984,293,6.9
"21055",21,55,2004,3976,3741,235,5.9
"21055",21,55,2005,4001,3762,239,6
"21055",21,55,2006,4035,3789,246,6.1
"21055",21,55,2007,3797,3566,231,6.1
"21055",21,55,2008,4026,3763,263,6.5
"21055",21,55,2009,4110,3676,434,10.6
"21055",21,55,2010,4064,3660,404,9.9
"21055",21,55,2011,4174,3819,355,8.5
"21055",21,55,2012,4159,3839,320,7.7
"21055",21,55,2013,4099,3795,304,7.4
"21055",21,55,2014,3867,3628,239,6.2
"21055",21,55,2015,3823,3617,206,5.4
"21055",21,55,2016,4154,3942,212,5.1
"21055",21,55,2017,4139,3919,220,5.3
"21057",21,57,1990,2985,2767,218,7.3
"21057",21,57,1991,3020,2808,212,7
"21057",21,57,1992,2971,2621,350,11.8
"21057",21,57,1993,2944,2703,241,8.2
"21057",21,57,1994,2927,2750,177,6
"21057",21,57,1995,2872,2559,313,10.9
"21057",21,57,1996,2852,2402,450,15.8
"21057",21,57,1997,2799,2470,329,11.8
"21057",21,57,1998,2772,2603,169,6.1
"21057",21,57,1999,2893,2699,194,6.7
"21057",21,57,2000,3200,3019,181,5.7
"21057",21,57,2001,3258,3073,185,5.7
"21057",21,57,2002,3216,3035,181,5.6
"21057",21,57,2003,3205,2971,234,7.3
"21057",21,57,2004,2985,2777,208,7
"21057",21,57,2005,2963,2728,235,7.9
"21057",21,57,2006,3019,2798,221,7.3
"21057",21,57,2007,2964,2759,205,6.9
"21057",21,57,2008,2945,2715,230,7.8
"21057",21,57,2009,3063,2670,393,12.8
"21057",21,57,2010,3174,2800,374,11.8
"21057",21,57,2011,3118,2775,343,11
"21057",21,57,2012,3119,2783,336,10.8
"21057",21,57,2013,3038,2714,324,10.7
"21057",21,57,2014,2947,2723,224,7.6
"21057",21,57,2015,2906,2733,173,6
"21057",21,57,2016,2931,2767,164,5.6
"21057",21,57,2017,2958,2802,156,5.3
"21059",21,59,1990,43795,41281,2514,5.7
"21059",21,59,1991,44628,41464,3164,7.1
"21059",21,59,1992,45012,41721,3291,7.3
"21059",21,59,1993,46056,43164,2892,6.3
"21059",21,59,1994,47666,45276,2390,5
"21059",21,59,1995,48785,46019,2766,5.7
"21059",21,59,1996,47976,45255,2721,5.7
"21059",21,59,1997,49364,46481,2883,5.8
"21059",21,59,1998,49261,47021,2240,4.5
"21059",21,59,1999,50185,47603,2582,5.1
"21059",21,59,2000,47038,45066,1972,4.2
"21059",21,59,2001,46359,44034,2325,5
"21059",21,59,2002,45642,43133,2509,5.5
"21059",21,59,2003,46123,43355,2768,6
"21059",21,59,2004,45864,43444,2420,5.3
"21059",21,59,2005,46341,43643,2698,5.8
"21059",21,59,2006,47260,44748,2512,5.3
"21059",21,59,2007,47117,44838,2279,4.8
"21059",21,59,2008,47303,44604,2699,5.7
"21059",21,59,2009,48300,43819,4481,9.3
"21059",21,59,2010,46881,42523,4358,9.3
"21059",21,59,2011,47742,43754,3988,8.4
"21059",21,59,2012,48254,44882,3372,7
"21059",21,59,2013,47636,44363,3273,6.9
"21059",21,59,2014,45889,43289,2600,5.7
"21059",21,59,2015,45150,43062,2088,4.6
"21059",21,59,2016,46182,44083,2099,4.5
"21059",21,59,2017,47366,45269,2097,4.4
"21061",21,61,1990,4363,3963,400,9.2
"21061",21,61,1991,4443,3964,479,10.8
"21061",21,61,1992,4581,4019,562,12.3
"21061",21,61,1993,4519,4024,495,11
"21061",21,61,1994,4411,4103,308,7
"21061",21,61,1995,4580,4259,321,7
"21061",21,61,1996,4847,4373,474,9.8
"21061",21,61,1997,4957,4527,430,8.7
"21061",21,61,1998,4925,4586,339,6.9
"21061",21,61,1999,5073,4784,289,5.7
"21061",21,61,2000,5056,4806,250,4.9
"21061",21,61,2001,5026,4723,303,6
"21061",21,61,2002,5085,4726,359,7.1
"21061",21,61,2003,5129,4768,361,7
"21061",21,61,2004,5127,4823,304,5.9
"21061",21,61,2005,5408,5024,384,7.1
"21061",21,61,2006,5417,5046,371,6.8
"21061",21,61,2007,5322,4985,337,6.3
"21061",21,61,2008,5316,4915,401,7.5
"21061",21,61,2009,5274,4555,719,13.6
"21061",21,61,2010,5122,4440,682,13.3
"21061",21,61,2011,5122,4523,599,11.7
"21061",21,61,2012,5033,4532,501,10
"21061",21,61,2013,4996,4496,500,10
"21061",21,61,2014,4776,4377,399,8.4
"21061",21,61,2015,4640,4312,328,7.1
"21061",21,61,2016,4755,4455,300,6.3
"21061",21,61,2017,4884,4592,292,6
"21063",21,63,1990,2243,1936,307,13.7
"21063",21,63,1991,2450,2037,413,16.9
"21063",21,63,1992,2411,1999,412,17.1
"21063",21,63,1993,2407,2044,363,15.1
"21063",21,63,1994,2454,2121,333,13.6
"21063",21,63,1995,2620,2153,467,17.8
"21063",21,63,1996,2782,2369,413,14.8
"21063",21,63,1997,2915,2497,418,14.3
"21063",21,63,1998,2896,2494,402,13.9
"21063",21,63,1999,2795,2402,393,14.1
"21063",21,63,2000,2469,2250,219,8.9
"21063",21,63,2001,2556,2333,223,8.7
"21063",21,63,2002,2635,2411,224,8.5
"21063",21,63,2003,2729,2504,225,8.2
"21063",21,63,2004,2815,2529,286,10.2
"21063",21,63,2005,3006,2716,290,9.6
"21063",21,63,2006,3096,2837,259,8.4
"21063",21,63,2007,3040,2812,228,7.5
"21063",21,63,2008,3143,2881,262,8.3
"21063",21,63,2009,3274,2835,439,13.4
"21063",21,63,2010,2399,2019,380,15.8
"21063",21,63,2011,2331,1963,368,15.8
"21063",21,63,2012,2304,1973,331,14.4
"21063",21,63,2013,2255,1928,327,14.5
"21063",21,63,2014,2152,1908,244,11.3
"21063",21,63,2015,2121,1912,209,9.9
"21063",21,63,2016,2187,1944,243,11.1
"21063",21,63,2017,2227,2000,227,10.2
"21065",21,65,1990,5838,5119,719,12.3
"21065",21,65,1991,5668,4992,676,11.9
"21065",21,65,1992,5753,5202,551,9.6
"21065",21,65,1993,5814,5319,495,8.5
"21065",21,65,1994,5801,5343,458,7.9
"21065",21,65,1995,5911,5502,409,6.9
"21065",21,65,1996,5924,5593,331,5.6
"21065",21,65,1997,6164,5838,326,5.3
"21065",21,65,1998,5891,5555,336,5.7
"21065",21,65,1999,5790,5512,278,4.8
"21065",21,65,2000,6050,5761,289,4.8
"21065",21,65,2001,6084,5707,377,6.2
"21065",21,65,2002,6024,5636,388,6.4
"21065",21,65,2003,6035,5589,446,7.4
"21065",21,65,2004,5964,5523,441,7.4
"21065",21,65,2005,6039,5609,430,7.1
"21065",21,65,2006,6123,5725,398,6.5
"21065",21,65,2007,6119,5725,394,6.4
"21065",21,65,2008,6164,5686,478,7.8
"21065",21,65,2009,6412,5613,799,12.5
"21065",21,65,2010,5694,4923,771,13.5
"21065",21,65,2011,5607,4910,697,12.4
"21065",21,65,2012,5619,5058,561,10
"21065",21,65,2013,5536,4997,539,9.7
"21065",21,65,2014,5401,4995,406,7.5
"21065",21,65,2015,5284,4963,321,6.1
"21065",21,65,2016,5354,5043,311,5.8
"21065",21,65,2017,5383,5061,322,6
"21067",21,67,1990,127948,123313,4635,3.6
"21067",21,67,1991,126559,121876,4683,3.7
"21067",21,67,1992,128105,123382,4723,3.7
"21067",21,67,1993,131886,127374,4512,3.4
"21067",21,67,1994,132967,128620,4347,3.3
"21067",21,67,1995,134194,130662,3532,2.6
"21067",21,67,1996,135788,132510,3278,2.4
"21067",21,67,1997,139916,136479,3437,2.5
"21067",21,67,1998,141904,139029,2875,2
"21067",21,67,1999,144550,141689,2861,2
"21067",21,67,2000,150199,145815,4384,2.9
"21067",21,67,2001,147819,142345,5474,3.7
"21067",21,67,2002,145076,138928,6148,4.2
"21067",21,67,2003,145310,138669,6641,4.6
"21067",21,67,2004,143803,137942,5861,4.1
"21067",21,67,2005,146365,139834,6531,4.5
"21067",21,67,2006,148691,142257,6434,4.3
"21067",21,67,2007,151234,145196,6038,4
"21067",21,67,2008,150018,142748,7270,4.8
"21067",21,67,2009,152180,140328,11852,7.8
"21067",21,67,2010,163286,151190,12096,7.4
"21067",21,67,2011,164926,153602,11324,6.9
"21067",21,67,2012,166267,156579,9688,5.8
"21067",21,67,2013,168417,158648,9769,5.8
"21067",21,67,2014,166831,158848,7983,4.8
"21067",21,67,2015,166522,160099,6423,3.9
"21067",21,67,2016,169790,163637,6153,3.6
"21067",21,67,2017,174304,167944,6360,3.6
"21069",21,69,1990,5858,5553,305,5.2
"21069",21,69,1991,6194,5759,435,7
"21069",21,69,1992,6103,5682,421,6.9
"21069",21,69,1993,6499,6001,498,7.7
"21069",21,69,1994,6414,6034,380,5.9
"21069",21,69,1995,6210,5856,354,5.7
"21069",21,69,1996,6143,5820,323,5.3
"21069",21,69,1997,6071,5533,538,8.9
"21069",21,69,1998,5986,5649,337,5.6
"21069",21,69,1999,6254,5977,277,4.4
"21069",21,69,2000,6516,6212,304,4.7
"21069",21,69,2001,6690,6358,332,5
"21069",21,69,2002,6700,6333,367,5.5
"21069",21,69,2003,6812,6412,400,5.9
"21069",21,69,2004,6555,6161,394,6
"21069",21,69,2005,6629,6229,400,6
"21069",21,69,2006,6637,6207,430,6.5
"21069",21,69,2007,6484,6067,417,6.4
"21069",21,69,2008,6456,5992,464,7.2
"21069",21,69,2009,6543,5737,806,12.3
"21069",21,69,2010,6713,5940,773,11.5
"21069",21,69,2011,6466,5779,687,10.6
"21069",21,69,2012,6478,5892,586,9
"21069",21,69,2013,6521,5903,618,9.5
"21069",21,69,2014,6364,5872,492,7.7
"21069",21,69,2015,6236,5853,383,6.1
"21069",21,69,2016,6079,5708,371,6.1
"21069",21,69,2017,6159,5790,369,6
"21071",21,71,1990,14654,13448,1206,8.2
"21071",21,71,1991,14943,13254,1689,11.3
"21071",21,71,1992,15051,13404,1647,10.9
"21071",21,71,1993,14728,13288,1440,9.8
"21071",21,71,1994,14390,13175,1215,8.4
"21071",21,71,1995,14400,12879,1521,10.6
"21071",21,71,1996,14042,12562,1480,10.5
"21071",21,71,1997,13944,12701,1243,8.9
"21071",21,71,1998,13970,13029,941,6.7
"21071",21,71,1999,13770,12695,1075,7.8
"21071",21,71,2000,13875,12919,956,6.9
"21071",21,71,2001,13935,13012,923,6.6
"21071",21,71,2002,14197,13191,1006,7.1
"21071",21,71,2003,14470,13297,1173,8.1
"21071",21,71,2004,14771,13732,1039,7
"21071",21,71,2005,14982,13928,1054,7
"21071",21,71,2006,15212,14236,976,6.4
"21071",21,71,2007,15081,14103,978,6.5
"21071",21,71,2008,15268,14246,1022,6.7
"21071",21,71,2009,15613,13910,1703,10.9
"21071",21,71,2010,13940,12064,1876,13.5
"21071",21,71,2011,13716,12183,1533,11.2
"21071",21,71,2012,13738,12144,1594,11.6
"21071",21,71,2013,13134,11392,1742,13.3
"21071",21,71,2014,12389,11117,1272,10.3
"21071",21,71,2015,11913,10819,1094,9.2
"21071",21,71,2016,11843,10541,1302,11
"21071",21,71,2017,11777,10818,959,8.1
"21073",21,73,1990,24569,23846,723,2.9
"21073",21,73,1991,24406,23373,1033,4.2
"21073",21,73,1992,24232,23293,939,3.9
"21073",21,73,1993,24016,23223,793,3.3
"21073",21,73,1994,24224,23480,744,3.1
"21073",21,73,1995,24164,23452,712,2.9
"21073",21,73,1996,24092,23203,889,3.7
"21073",21,73,1997,24353,23587,766,3.1
"21073",21,73,1998,24688,23969,719,2.9
"21073",21,73,1999,24890,24270,620,2.5
"21073",21,73,2000,25571,24714,857,3.4
"21073",21,73,2001,25158,24228,930,3.7
"21073",21,73,2002,24991,23926,1065,4.3
"21073",21,73,2003,24919,23783,1136,4.6
"21073",21,73,2004,24953,23923,1030,4.1
"21073",21,73,2005,25110,23945,1165,4.6
"21073",21,73,2006,25354,24176,1178,4.6
"21073",21,73,2007,25090,23959,1131,4.5
"21073",21,73,2008,24787,23348,1439,5.8
"21073",21,73,2009,24568,22383,2185,8.9
"21073",21,73,2010,24625,22481,2144,8.7
"21073",21,73,2011,24611,22664,1947,7.9
"21073",21,73,2012,24555,22914,1641,6.7
"21073",21,73,2013,24573,22958,1615,6.6
"21073",21,73,2014,24336,23047,1289,5.3
"21073",21,73,2015,24018,22986,1032,4.3
"21073",21,73,2016,24239,23240,999,4.1
"21073",21,73,2017,24673,23652,1021,4.1
"21075",21,75,1990,3428,3125,303,8.8
"21075",21,75,1991,3615,3243,372,10.3
"21075",21,75,1992,3668,3347,321,8.8
"21075",21,75,1993,3721,3476,245,6.6
"21075",21,75,1994,3671,3485,186,5.1
"21075",21,75,1995,3989,3792,197,4.9
"21075",21,75,1996,4109,3506,603,14.7
"21075",21,75,1997,3990,3623,367,9.2
"21075",21,75,1998,3693,3332,361,9.8
"21075",21,75,1999,3392,3035,357,10.5
"21075",21,75,2000,3160,2994,166,5.3
"21075",21,75,2001,3208,3004,204,6.4
"21075",21,75,2002,3160,2942,218,6.9
"21075",21,75,2003,3105,2760,345,11.1
"21075",21,75,2004,2971,2703,268,9
"21075",21,75,2005,2858,2647,211,7.4
"21075",21,75,2006,2800,2588,212,7.6
"21075",21,75,2007,2706,2504,202,7.5
"21075",21,75,2008,2711,2504,207,7.6
"21075",21,75,2009,2684,2343,341,12.7
"21075",21,75,2010,2729,2415,314,11.5
"21075",21,75,2011,2659,2327,332,12.5
"21075",21,75,2012,2483,2202,281,11.3
"21075",21,75,2013,2387,2130,257,10.8
"21075",21,75,2014,2226,2041,185,8.3
"21075",21,75,2015,2082,1923,159,7.6
"21075",21,75,2016,2085,1941,144,6.9
"21075",21,75,2017,2085,1935,150,7.2
"21077",21,77,1990,2703,2579,124,4.6
"21077",21,77,1991,2754,2544,210,7.6
"21077",21,77,1992,2770,2583,187,6.8
"21077",21,77,1993,2814,2646,168,6
"21077",21,77,1994,2954,2784,170,5.8
"21077",21,77,1995,3041,2864,177,5.8
"21077",21,77,1996,3191,3015,176,5.5
"21077",21,77,1997,3435,3245,190,5.5
"21077",21,77,1998,3599,3460,139,3.9
"21077",21,77,1999,3727,3596,131,3.5
"21077",21,77,2000,3934,3779,155,3.9
"21077",21,77,2001,3890,3710,180,4.6
"21077",21,77,2002,3818,3602,216,5.7
"21077",21,77,2003,3908,3686,222,5.7
"21077",21,77,2004,3958,3734,224,5.7
"21077",21,77,2005,4053,3815,238,5.9
"21077",21,77,2006,3975,3785,190,4.8
"21077",21,77,2007,3893,3684,209,5.4
"21077",21,77,2008,3916,3639,277,7.1
"21077",21,77,2009,4030,3542,488,12.1
"21077",21,77,2010,4076,3573,503,12.3
"21077",21,77,2011,4004,3574,430,10.7
"21077",21,77,2012,3944,3576,368,9.3
"21077",21,77,2013,3953,3584,369,9.3
"21077",21,77,2014,3859,3589,270,7
"21077",21,77,2015,3804,3607,197,5.2
"21077",21,77,2016,3861,3671,190,4.9
"21077",21,77,2017,3947,3765,182,4.6
"21079",21,79,1990,5671,5318,353,6.2
"21079",21,79,1991,5713,5307,406,7.1
"21079",21,79,1992,6052,5645,407,6.7
"21079",21,79,1993,6198,5828,370,6
"21079",21,79,1994,6281,5924,357,5.7
"21079",21,79,1995,6358,6074,284,4.5
"21079",21,79,1996,6564,6313,251,3.8
"21079",21,79,1997,6822,6576,246,3.6
"21079",21,79,1998,7296,7099,197,2.7
"21079",21,79,1999,7524,7322,202,2.7
"21079",21,79,2000,7599,7334,265,3.5
"21079",21,79,2001,7567,7208,359,4.7
"21079",21,79,2002,7383,6980,403,5.5
"21079",21,79,2003,7936,7482,454,5.7
"21079",21,79,2004,7423,7010,413,5.6
"21079",21,79,2005,7522,7057,465,6.2
"21079",21,79,2006,7624,7176,448,5.9
"21079",21,79,2007,7685,7253,432,5.6
"21079",21,79,2008,7575,7080,495,6.5
"21079",21,79,2009,7738,6827,911,11.8
"21079",21,79,2010,7935,7051,884,11.1
"21079",21,79,2011,7810,7026,784,10
"21079",21,79,2012,7752,7098,654,8.4
"21079",21,79,2013,7745,7111,634,8.2
"21079",21,79,2014,7582,7087,495,6.5
"21079",21,79,2015,7609,7222,387,5.1
"21079",21,79,2016,7642,7275,367,4.8
"21079",21,79,2017,7744,7373,371,4.8
"21081",21,81,1990,7717,7372,345,4.5
"21081",21,81,1991,7889,7347,542,6.9
"21081",21,81,1992,8196,7516,680,8.3
"21081",21,81,1993,8296,7738,558,6.7
"21081",21,81,1994,8567,8071,496,5.8
"21081",21,81,1995,8939,8467,472,5.3
"21081",21,81,1996,9364,8831,533,5.7
"21081",21,81,1997,9755,9245,510,5.2
"21081",21,81,1998,9990,9539,451,4.5
"21081",21,81,1999,10206,9805,401,3.9
"21081",21,81,2000,11633,11188,445,3.8
"21081",21,81,2001,11759,11169,590,5
"21081",21,81,2002,11847,11205,642,5.4
"21081",21,81,2003,12122,11402,720,5.9
"21081",21,81,2004,12405,11743,662,5.3
"21081",21,81,2005,12592,11903,689,5.5
"21081",21,81,2006,12532,11861,671,5.4
"21081",21,81,2007,12590,11898,692,5.5
"21081",21,81,2008,12771,11881,890,7
"21081",21,81,2009,12856,11375,1481,11.5
"21081",21,81,2010,11684,10308,1376,11.8
"21081",21,81,2011,11623,10385,1238,10.7
"21081",21,81,2012,11501,10462,1039,9
"21081",21,81,2013,11504,10549,955,8.3
"21081",21,81,2014,11193,10460,733,6.5
"21081",21,81,2015,10979,10391,588,5.4
"21081",21,81,2016,11228,10672,556,5
"21081",21,81,2017,11531,10965,566,4.9
"21083",21,83,1990,15950,14242,1708,10.7
"21083",21,83,1991,15969,14306,1663,10.4
"21083",21,83,1992,15703,14577,1126,7.2
"21083",21,83,1993,15968,14783,1185,7.4
"21083",21,83,1994,16351,15078,1273,7.8
"21083",21,83,1995,16522,15464,1058,6.4
"21083",21,83,1996,17333,15967,1366,7.9
"21083",21,83,1997,17397,16102,1295,7.4
"21083",21,83,1998,17260,16274,986,5.7
"21083",21,83,1999,17618,16619,999,5.7
"21083",21,83,2000,17221,16368,853,5
"21083",21,83,2001,17118,15999,1119,6.5
"21083",21,83,2002,16934,15754,1180,7
"21083",21,83,2003,16730,15496,1234,7.4
"21083",21,83,2004,16590,15384,1206,7.3
"21083",21,83,2005,16336,14709,1627,10
"21083",21,83,2006,15829,14700,1129,7.1
"21083",21,83,2007,15948,14950,998,6.3
"21083",21,83,2008,15807,14718,1089,6.9
"21083",21,83,2009,16349,14723,1626,9.9
"21083",21,83,2010,16827,15231,1596,9.5
"21083",21,83,2011,16903,15367,1536,9.1
"21083",21,83,2012,16667,15293,1374,8.2
"21083",21,83,2013,16479,15085,1394,8.5
"21083",21,83,2014,15845,14661,1184,7.5
"21083",21,83,2015,15388,14451,937,6.1
"21083",21,83,2016,15624,14668,956,6.1
"21083",21,83,2017,16041,15094,947,5.9
"21085",21,85,1990,9435,8616,819,8.7
"21085",21,85,1991,9870,9018,852,8.6
"21085",21,85,1992,10025,9199,826,8.2
"21085",21,85,1993,10176,9325,851,8.4
"21085",21,85,1994,10283,9595,688,6.7
"21085",21,85,1995,10755,10013,742,6.9
"21085",21,85,1996,11187,10394,793,7.1
"21085",21,85,1997,11455,10552,903,7.9
"21085",21,85,1998,12101,11380,721,6
"21085",21,85,1999,12402,11627,775,6.2
"21085",21,85,2000,11304,10724,580,5.1
"21085",21,85,2001,11541,10681,860,7.5
"21085",21,85,2002,11588,10651,937,8.1
"21085",21,85,2003,11755,10677,1078,9.2
"21085",21,85,2004,11562,10746,816,7.1
"21085",21,85,2005,11498,10509,989,8.6
"21085",21,85,2006,11617,10653,964,8.3
"21085",21,85,2007,11251,10340,911,8.1
"21085",21,85,2008,11115,10010,1105,9.9
"21085",21,85,2009,11481,9795,1686,14.7
"21085",21,85,2010,11549,9904,1645,14.2
"21085",21,85,2011,11397,9999,1398,12.3
"21085",21,85,2012,11312,10150,1162,10.3
"21085",21,85,2013,11242,10085,1157,10.3
"21085",21,85,2014,10853,9942,911,8.4
"21085",21,85,2015,10677,9972,705,6.6
"21085",21,85,2016,10919,10195,724,6.6
"21085",21,85,2017,10990,10327,663,6
"21087",21,87,1990,5209,4963,246,4.7
"21087",21,87,1991,5221,4829,392,7.5
"21087",21,87,1992,5243,4957,286,5.5
"21087",21,87,1993,5284,5041,243,4.6
"21087",21,87,1994,5220,4991,229,4.4
"21087",21,87,1995,5275,4890,385,7.3
"21087",21,87,1996,5220,4824,396,7.6
"21087",21,87,1997,4944,4517,427,8.6
"21087",21,87,1998,4731,3904,827,17.5
"21087",21,87,1999,4285,3691,594,13.9
"21087",21,87,2000,5368,5122,246,4.6
"21087",21,87,2001,5565,5267,298,5.4
"21087",21,87,2002,5562,5267,295,5.3
"21087",21,87,2003,5639,5282,357,6.3
"21087",21,87,2004,5451,5157,294,5.4
"21087",21,87,2005,5585,5241,344,6.2
"21087",21,87,2006,5615,5303,312,5.6
"21087",21,87,2007,5631,5285,346,6.1
"21087",21,87,2008,5530,5105,425,7.7
"21087",21,87,2009,5681,5011,670,11.8
"21087",21,87,2010,5596,4938,658,11.8
"21087",21,87,2011,5452,4925,527,9.7
"21087",21,87,2012,5454,5000,454,8.3
"21087",21,87,2013,5320,4880,440,8.3
"21087",21,87,2014,5077,4745,332,6.5
"21087",21,87,2015,5016,4752,264,5.3
"21087",21,87,2016,5066,4840,226,4.5
"21087",21,87,2017,5137,4900,237,4.6
"21089",21,89,1990,15971,14961,1010,6.3
"21089",21,89,1991,16074,14600,1474,9.2
"21089",21,89,1992,16494,14845,1649,10
"21089",21,89,1993,16537,14728,1809,10.9
"21089",21,89,1994,16117,14902,1215,7.5
"21089",21,89,1995,16299,15090,1209,7.4
"21089",21,89,1996,16200,15164,1036,6.4
"21089",21,89,1997,16658,15483,1175,7.1
"21089",21,89,1998,16577,15579,998,6
"21089",21,89,1999,16615,15540,1075,6.5
"21089",21,89,2000,15892,14969,923,5.8
"21089",21,89,2001,15898,14908,990,6.2
"21089",21,89,2002,16054,15074,980,6.1
"21089",21,89,2003,16775,15624,1151,6.9
"21089",21,89,2004,17042,15977,1065,6.2
"21089",21,89,2005,17203,16106,1097,6.4
"21089",21,89,2006,17418,16410,1008,5.8
"21089",21,89,2007,17487,16537,950,5.4
"21089",21,89,2008,17499,16406,1093,6.2
"21089",21,89,2009,17874,16214,1660,9.3
"21089",21,89,2010,15351,13579,1772,11.5
"21089",21,89,2011,15208,13502,1706,11.2
"21089",21,89,2012,15042,13553,1489,9.9
"21089",21,89,2013,14793,13283,1510,10.2
"21089",21,89,2014,14277,13059,1218,8.5
"21089",21,89,2015,13613,12568,1045,7.7
"21089",21,89,2016,13750,12541,1209,8.8
"21089",21,89,2017,13833,12779,1054,7.6
"21091",21,91,1990,3573,3260,313,8.8
"21091",21,91,1991,3630,3223,407,11.2
"21091",21,91,1992,3407,3043,364,10.7
"21091",21,91,1993,3474,3146,328,9.4
"21091",21,91,1994,3445,3192,253,7.3
"21091",21,91,1995,3462,3219,243,7
"21091",21,91,1996,3605,3359,246,6.8
"21091",21,91,1997,3938,3671,267,6.8
"21091",21,91,1998,4054,3826,228,5.6
"21091",21,91,1999,4175,3747,428,10.3
"21091",21,91,2000,4203,3996,207,4.9
"21091",21,91,2001,4145,3902,243,5.9
"21091",21,91,2002,4075,3825,250,6.1
"21091",21,91,2003,4102,3816,286,7
"21091",21,91,2004,4055,3819,236,5.8
"21091",21,91,2005,4154,3895,259,6.2
"21091",21,91,2006,4231,3981,250,5.9
"21091",21,91,2007,4189,3974,215,5.1
"21091",21,91,2008,4191,3947,244,5.8
"21091",21,91,2009,4333,3825,508,11.7
"21091",21,91,2010,4060,3643,417,10.3
"21091",21,91,2011,4080,3738,342,8.4
"21091",21,91,2012,4150,3853,297,7.2
"21091",21,91,2013,4099,3803,296,7.2
"21091",21,91,2014,3977,3737,240,6
"21091",21,91,2015,3850,3657,193,5
"21091",21,91,2016,3997,3779,218,5.5
"21091",21,91,2017,4087,3880,207,5.1
"21093",21,93,1990,34823,32665,2158,6.2
"21093",21,93,1991,34479,32095,2384,6.9
"21093",21,93,1992,34459,32014,2445,7.1
"21093",21,93,1993,34983,32611,2372,6.8
"21093",21,93,1994,34863,32756,2107,6
"21093",21,93,1995,35056,33007,2049,5.8
"21093",21,93,1996,35833,33901,1932,5.4
"21093",21,93,1997,36434,34409,2025,5.6
"21093",21,93,1998,36538,34707,1831,5
"21093",21,93,1999,36999,34897,2102,5.7
"21093",21,93,2000,43226,41368,1858,4.3
"21093",21,93,2001,43178,40986,2192,5.1
"21093",21,93,2002,43572,41066,2506,5.8
"21093",21,93,2003,44952,42458,2494,5.5
"21093",21,93,2004,45276,42833,2443,5.4
"21093",21,93,2005,46216,43522,2694,5.8
"21093",21,93,2006,47757,45197,2560,5.4
"21093",21,93,2007,47394,44983,2411,5.1
"21093",21,93,2008,47522,44570,2952,6.2
"21093",21,93,2009,47868,42943,4925,10.3
"21093",21,93,2010,46901,42359,4542,9.7
"21093",21,93,2011,47443,43077,4366,9.2
"21093",21,93,2012,47576,43682,3894,8.2
"21093",21,93,2013,47819,44154,3665,7.7
"21093",21,93,2014,46565,43673,2892,6.2
"21093",21,93,2015,46634,44331,2303,4.9
"21093",21,93,2016,47290,45138,2152,4.6
"21093",21,93,2017,48370,46134,2236,4.6
"21095",21,95,1990,11300,10248,1052,9.3
"21095",21,95,1991,11266,9497,1769,15.7
"21095",21,95,1992,11026,9292,1734,15.7
"21095",21,95,1993,10276,9025,1251,12.2
"21095",21,95,1994,10238,9034,1204,11.8
"21095",21,95,1995,10162,8502,1660,16.3
"21095",21,95,1996,9363,8108,1255,13.4
"21095",21,95,1997,9440,8234,1206,12.8
"21095",21,95,1998,9446,8290,1156,12.2
"21095",21,95,1999,9197,8170,1027,11.2
"21095",21,95,2000,10083,9252,831,8.2
"21095",21,95,2001,9985,9218,767,7.7
"21095",21,95,2002,10171,9271,900,8.8
"21095",21,95,2003,10435,9421,1014,9.7
"21095",21,95,2004,10182,9420,762,7.5
"21095",21,95,2005,10052,9264,788,7.8
"21095",21,95,2006,10179,9366,813,8
"21095",21,95,2007,10160,9250,910,9
"21095",21,95,2008,10052,9162,890,8.9
"21095",21,95,2009,10593,9441,1152,10.9
"21095",21,95,2010,10193,8979,1214,11.9
"21095",21,95,2011,10025,8904,1121,11.2
"21095",21,95,2012,9926,8527,1399,14.1
"21095",21,95,2013,9510,7793,1717,18.1
"21095",21,95,2014,8392,7221,1171,14
"21095",21,95,2015,7475,6589,886,11.9
"21095",21,95,2016,7269,6376,893,12.3
"21095",21,95,2017,6948,6294,654,9.4
"21097",21,97,1990,7681,7313,368,4.8
"21097",21,97,1991,7626,7134,492,6.5
"21097",21,97,1992,7583,7096,487,6.4
"21097",21,97,1993,7578,7097,481,6.3
"21097",21,97,1994,7643,7229,414,5.4
"21097",21,97,1995,7569,7167,402,5.3
"21097",21,97,1996,7372,7002,370,5
"21097",21,97,1997,7484,7051,433,5.8
"21097",21,97,1998,7572,7258,314,4.1
"21097",21,97,1999,7437,7117,320,4.3
"21097",21,97,2000,9183,8858,325,3.5
"21097",21,97,2001,9269,8794,475,5.1
"21097",21,97,2002,9119,8614,505,5.5
"21097",21,97,2003,9167,8641,526,5.7
"21097",21,97,2004,8796,8298,498,5.7
"21097",21,97,2005,8880,8358,522,5.9
"21097",21,97,2006,9022,8533,489,5.4
"21097",21,97,2007,9232,8782,450,4.9
"21097",21,97,2008,9261,8679,582,6.3
"21097",21,97,2009,9391,8323,1068,11.4
"21097",21,97,2010,9016,8013,1003,11.1
"21097",21,97,2011,8950,8050,900,10.1
"21097",21,97,2012,8901,8199,702,7.9
"21097",21,97,2013,8745,8084,661,7.6
"21097",21,97,2014,8415,7911,504,6
"21097",21,97,2015,8398,8011,387,4.6
"21097",21,97,2016,8574,8171,403,4.7
"21097",21,97,2017,8803,8402,401,4.6
"21099",21,99,1990,6798,6368,430,6.3
"21099",21,99,1991,7124,6463,661,9.3
"21099",21,99,1992,7198,6700,498,6.9
"21099",21,99,1993,7301,6857,444,6.1
"21099",21,99,1994,7573,7238,335,4.4
"21099",21,99,1995,7798,7294,504,6.5
"21099",21,99,1996,7910,7409,501,6.3
"21099",21,99,1997,7883,7375,508,6.4
"21099",21,99,1998,8008,7589,419,5.2
"21099",21,99,1999,7984,7570,414,5.2
"21099",21,99,2000,7670,7309,361,4.7
"21099",21,99,2001,7761,7343,418,5.4
"21099",21,99,2002,7800,7383,417,5.3
"21099",21,99,2003,7883,7394,489,6.2
"21099",21,99,2004,7682,7278,404,5.3
"21099",21,99,2005,7814,7309,505,6.5
"21099",21,99,2006,7964,7462,502,6.3
"21099",21,99,2007,8137,7704,433,5.3
"21099",21,99,2008,8237,7696,541,6.6
"21099",21,99,2009,8333,7472,861,10.3
"21099",21,99,2010,8110,7264,846,10.4
"21099",21,99,2011,8196,7387,809,9.9
"21099",21,99,2012,8138,7464,674,8.3
"21099",21,99,2013,8057,7420,637,7.9
"21099",21,99,2014,7811,7317,494,6.3
"21099",21,99,2015,7769,7375,394,5.1
"21099",21,99,2016,8018,7642,376,4.7
"21099",21,99,2017,8257,7896,361,4.4
"21101",21,101,1990,22347,21117,1230,5.5
"21101",21,101,1991,22388,20803,1585,7.1
"21101",21,101,1992,22316,20758,1558,7
"21101",21,101,1993,22869,21611,1258,5.5
"21101",21,101,1994,23230,22034,1196,5.1
"21101",21,101,1995,23530,22145,1385,5.9
"21101",21,101,1996,23914,22257,1657,6.9
"21101",21,101,1997,24045,22620,1425,5.9
"21101",21,101,1998,24120,22607,1513,6.3
"21101",21,101,1999,24035,22993,1042,4.3
"21101",21,101,2000,22956,22152,804,3.5
"21101",21,101,2001,23101,22021,1080,4.7
"21101",21,101,2002,23124,21894,1230,5.3
"21101",21,101,2003,22818,21569,1249,5.5
"21101",21,101,2004,22737,21685,1052,4.6
"21101",21,101,2005,23169,21920,1249,5.4
"21101",21,101,2006,23148,21972,1176,5.1
"21101",21,101,2007,22689,21551,1138,5
"21101",21,101,2008,22832,21439,1393,6.1
"21101",21,101,2009,23299,20819,2480,10.6
"21101",21,101,2010,22850,20503,2347,10.3
"21101",21,101,2011,22865,20810,2055,9
"21101",21,101,2012,22636,20932,1704,7.5
"21101",21,101,2013,22130,20474,1656,7.5
"21101",21,101,2014,21627,20313,1314,6.1
"21101",21,101,2015,21208,20177,1031,4.9
"21101",21,101,2016,21374,20340,1034,4.8
"21101",21,101,2017,21863,20853,1010,4.6
"21103",21,103,1990,6569,6335,234,3.6
"21103",21,103,1991,7091,6766,325,4.6
"21103",21,103,1992,7077,6767,310,4.4
"21103",21,103,1993,7488,7186,302,4
"21103",21,103,1994,7615,7391,224,2.9
"21103",21,103,1995,7500,7174,326,4.3
"21103",21,103,1996,7218,6918,300,4.2
"21103",21,103,1997,7103,6847,256,3.6
"21103",21,103,1998,6845,6545,300,4.4
"21103",21,103,1999,7529,7260,269,3.6
"21103",21,103,2000,7813,7565,248,3.2
"21103",21,103,2001,7685,7353,332,4.3
"21103",21,103,2002,7514,7186,328,4.4
"21103",21,103,2003,7615,7214,401,5.3
"21103",21,103,2004,7739,7369,370,4.8
"21103",21,103,2005,7904,7452,452,5.7
"21103",21,103,2006,8041,7584,457,5.7
"21103",21,103,2007,7819,7405,414,5.3
"21103",21,103,2008,7767,7284,483,6.2
"21103",21,103,2009,7981,7144,837,10.5
"21103",21,103,2010,7834,7060,774,9.9
"21103",21,103,2011,7752,7070,682,8.8
"21103",21,103,2012,7700,7138,562,7.3
"21103",21,103,2013,7761,7201,560,7.2
"21103",21,103,2014,7633,7194,439,5.8
"21103",21,103,2015,7599,7243,356,4.7
"21103",21,103,2016,7857,7529,328,4.2
"21103",21,103,2017,8048,7716,332,4.1
"21105",21,105,1990,2536,2352,184,7.3
"21105",21,105,1991,2592,2364,228,8.8
"21105",21,105,1992,2529,2373,156,6.2
"21105",21,105,1993,2515,2366,149,5.9
"21105",21,105,1994,2492,2326,166,6.7
"21105",21,105,1995,2491,2334,157,6.3
"21105",21,105,1996,2545,2364,181,7.1
"21105",21,105,1997,2503,2362,141,5.6
"21105",21,105,1998,2472,2346,126,5.1
"21105",21,105,1999,2509,2354,155,6.2
"21105",21,105,2000,2377,2266,111,4.7
"21105",21,105,2001,2418,2277,141,5.8
"21105",21,105,2002,2339,2183,156,6.7
"21105",21,105,2003,2239,2042,197,8.8
"21105",21,105,2004,2040,1856,184,9
"21105",21,105,2005,2049,1890,159,7.8
"21105",21,105,2006,2065,1929,136,6.6
"21105",21,105,2007,2033,1895,138,6.8
"21105",21,105,2008,2094,1947,147,7
"21105",21,105,2009,2126,1938,188,8.8
"21105",21,105,2010,2300,2112,188,8.2
"21105",21,105,2011,2282,2078,204,8.9
"21105",21,105,2012,2165,1990,175,8.1
"21105",21,105,2013,2160,2006,154,7.1
"21105",21,105,2014,2126,1994,132,6.2
"21105",21,105,2015,2039,1921,118,5.8
"21105",21,105,2016,2028,1912,116,5.7
"21105",21,105,2017,1931,1793,138,7.1
"21107",21,107,1990,21114,19680,1434,6.8
"21107",21,107,1991,20917,19189,1728,8.3
"21107",21,107,1992,20876,18826,2050,9.8
"21107",21,107,1993,20741,19057,1684,8.1
"21107",21,107,1994,20589,19285,1304,6.3
"21107",21,107,1995,20413,18914,1499,7.3
"21107",21,107,1996,20490,19035,1455,7.1
"21107",21,107,1997,20445,19197,1248,6.1
"21107",21,107,1998,20009,19022,987,4.9
"21107",21,107,1999,19632,18491,1141,5.8
"21107",21,107,2000,21349,20205,1144,5.4
"21107",21,107,2001,21096,19884,1212,5.7
"21107",21,107,2002,21368,20171,1197,5.6
"21107",21,107,2003,21659,20234,1425,6.6
"21107",21,107,2004,22365,21160,1205,5.4
"21107",21,107,2005,22736,21403,1333,5.9
"21107",21,107,2006,23260,21922,1338,5.8
"21107",21,107,2007,23298,21919,1379,5.9
"21107",21,107,2008,23112,21422,1690,7.3
"21107",21,107,2009,23022,20898,2124,9.2
"21107",21,107,2010,21211,19157,2054,9.7
"21107",21,107,2011,21545,19720,1825,8.5
"21107",21,107,2012,21582,19918,1664,7.7
"21107",21,107,2013,21504,19807,1697,7.9
"21107",21,107,2014,20396,19082,1314,6.4
"21107",21,107,2015,19635,18538,1097,5.6
"21107",21,107,2016,20261,19132,1129,5.6
"21107",21,107,2017,20168,19193,975,4.8
"21109",21,109,1990,4334,3849,485,11.2
"21109",21,109,1991,4484,4022,462,10.3
"21109",21,109,1992,4545,4076,469,10.3
"21109",21,109,1993,4393,3985,408,9.3
"21109",21,109,1994,4832,4385,447,9.3
"21109",21,109,1995,5351,4912,439,8.2
"21109",21,109,1996,6116,5733,383,6.3
"21109",21,109,1997,6763,6393,370,5.5
"21109",21,109,1998,6899,6591,308,4.5
"21109",21,109,1999,6883,6550,333,4.8
"21109",21,109,2000,5065,4779,286,5.6
"21109",21,109,2001,4894,4498,396,8.1
"21109",21,109,2002,4852,4480,372,7.7
"21109",21,109,2003,4878,4505,373,7.6
"21109",21,109,2004,4770,4464,306,6.4
"21109",21,109,2005,4767,4410,357,7.5
"21109",21,109,2006,4654,4191,463,9.9
"21109",21,109,2007,4340,3749,591,13.6
"21109",21,109,2008,4103,3639,464,11.3
"21109",21,109,2009,4297,3592,705,16.4
"21109",21,109,2010,5142,4419,723,14.1
"21109",21,109,2011,5294,4576,718,13.6
"21109",21,109,2012,5177,4568,609,11.8
"21109",21,109,2013,4834,4274,560,11.6
"21109",21,109,2014,4578,4053,525,11.5
"21109",21,109,2015,4323,3949,374,8.7
"21109",21,109,2016,4308,3977,331,7.7
"21109",21,109,2017,4203,3853,350,8.3
"21111",21,111,1990,353239,334949,18290,5.2
"21111",21,111,1991,349737,328679,21058,6
"21111",21,111,1992,351830,332202,19628,5.6
"21111",21,111,1993,352686,335090,17596,5
"21111",21,111,1994,356551,340963,15588,4.4
"21111",21,111,1995,360502,344125,16377,4.5
"21111",21,111,1996,360662,344528,16134,4.5
"21111",21,111,1997,370297,353602,16695,4.5
"21111",21,111,1998,372339,359083,13256,3.6
"21111",21,111,1999,378131,363792,14339,3.8
"21111",21,111,2000,364088,350740,13348,3.7
"21111",21,111,2001,355396,338825,16571,4.7
"21111",21,111,2002,348839,329254,19585,5.6
"21111",21,111,2003,347618,326521,21097,6.1
"21111",21,111,2004,347354,328837,18517,5.3
"21111",21,111,2005,351726,330869,20857,5.9
"21111",21,111,2006,355094,334975,20119,5.7
"21111",21,111,2007,356083,337283,18800,5.3
"21111",21,111,2008,355732,333279,22453,6.3
"21111",21,111,2009,360376,323842,36534,10.1
"21111",21,111,2010,378722,340806,37916,10
"21111",21,111,2011,378781,342935,35846,9.5
"21111",21,111,2012,382602,352234,30368,7.9
"21111",21,111,2013,385274,356481,28793,7.5
"21111",21,111,2014,377049,354329,22720,6
"21111",21,111,2015,374488,356476,18012,4.8
"21111",21,111,2016,383442,366245,17197,4.5
"21111",21,111,2017,394248,376784,17464,4.4
"21113",21,113,1990,16678,16022,656,3.9
"21113",21,113,1991,16738,16032,706,4.2
"21113",21,113,1992,17094,16410,684,4
"21113",21,113,1993,17743,17106,637,3.6
"21113",21,113,1994,17926,17403,523,2.9
"21113",21,113,1995,18525,18079,446,2.4
"21113",21,113,1996,19190,18731,459,2.4
"21113",21,113,1997,20083,19654,429,2.1
"21113",21,113,1998,20496,20152,344,1.7
"21113",21,113,1999,21082,20763,319,1.5
"21113",21,113,2000,20775,20164,611,2.9
"21113",21,113,2001,20660,19877,783,3.8
"21113",21,113,2002,20684,19806,878,4.2
"21113",21,113,2003,20891,19921,970,4.6
"21113",21,113,2004,21044,20131,913,4.3
"21113",21,113,2005,21888,20862,1026,4.7
"21113",21,113,2006,22720,21652,1068,4.7
"21113",21,113,2007,22825,21813,1012,4.4
"21113",21,113,2008,23019,21752,1267,5.5
"21113",21,113,2009,22791,20723,2068,9.1
"21113",21,113,2010,24710,22615,2095,8.5
"21113",21,113,2011,24650,22732,1918,7.8
"21113",21,113,2012,24812,23151,1661,6.7
"21113",21,113,2013,25084,23455,1629,6.5
"21113",21,113,2014,24886,23581,1305,5.2
"21113",21,113,2015,25054,23999,1055,4.2
"21113",21,113,2016,25412,24404,1008,4
"21113",21,113,2017,26051,25058,993,3.8
"21115",21,115,1990,8740,8041,699,8
"21115",21,115,1991,9289,8331,958,10.3
"21115",21,115,1992,9472,8671,801,8.5
"21115",21,115,1993,9818,9095,723,7.4
"21115",21,115,1994,9947,9279,668,6.7
"21115",21,115,1995,10331,9483,848,8.2
"21115",21,115,1996,9963,9046,917,9.2
"21115",21,115,1997,9819,9063,756,7.7
"21115",21,115,1998,9628,9010,618,6.4
"21115",21,115,1999,9276,8597,679,7.3
"21115",21,115,2000,9130,8607,523,5.7
"21115",21,115,2001,9269,8708,561,6.1
"21115",21,115,2002,9492,8903,589,6.2
"21115",21,115,2003,9705,9049,656,6.8
"21115",21,115,2004,9803,9166,637,6.5
"21115",21,115,2005,9712,9058,654,6.7
"21115",21,115,2006,9651,9028,623,6.5
"21115",21,115,2007,9666,9075,591,6.1
"21115",21,115,2008,9498,8844,654,6.9
"21115",21,115,2009,9922,8901,1021,10.3
"21115",21,115,2010,8925,7804,1121,12.6
"21115",21,115,2011,8691,7747,944,10.9
"21115",21,115,2012,8597,7724,873,10.2
"21115",21,115,2013,8363,7441,922,11
"21115",21,115,2014,8044,7303,741,9.2
"21115",21,115,2015,7629,6996,633,8.3
"21115",21,115,2016,7474,6747,727,9.7
"21115",21,115,2017,7392,6788,604,8.2
"21117",21,117,1990,75843,73365,2478,3.3
"21117",21,117,1991,75468,71737,3731,4.9
"21117",21,117,1992,75418,70967,4451,5.9
"21117",21,117,1993,75304,71523,3781,5
"21117",21,117,1994,75631,72243,3388,4.5
"21117",21,117,1995,76580,73336,3244,4.2
"21117",21,117,1996,76894,73755,3139,4.1
"21117",21,117,1997,78979,76008,2971,3.8
"21117",21,117,1998,79335,76756,2579,3.3
"21117",21,117,1999,79849,77292,2557,3.2
"21117",21,117,2000,83422,80744,2678,3.2
"21117",21,117,2001,82206,78724,3482,4.2
"21117",21,117,2002,80903,77416,3487,4.3
"21117",21,117,2003,81539,77636,3903,4.8
"21117",21,117,2004,83050,79255,3795,4.6
"21117",21,117,2005,84011,79788,4223,5
"21117",21,117,2006,83788,79636,4152,5
"21117",21,117,2007,83537,79535,4002,4.8
"21117",21,117,2008,83664,78687,4977,5.9
"21117",21,117,2009,84184,75890,8294,9.9
"21117",21,117,2010,83798,75611,8187,9.8
"21117",21,117,2011,83780,76372,7408,8.8
"21117",21,117,2012,84380,78150,6230,7.4
"21117",21,117,2013,85069,79105,5964,7
"21117",21,117,2014,83049,78442,4607,5.5
"21117",21,117,2015,82447,78780,3667,4.4
"21117",21,117,2016,83800,80302,3498,4.2
"21117",21,117,2017,86025,82582,3443,4
"21119",21,119,1990,5488,4970,518,9.4
"21119",21,119,1991,5500,4804,696,12.7
"21119",21,119,1992,5803,5079,724,12.5
"21119",21,119,1993,5908,5218,690,11.7
"21119",21,119,1994,5780,5251,529,9.2
"21119",21,119,1995,5901,5275,626,10.6
"21119",21,119,1996,5845,5230,615,10.5
"21119",21,119,1997,5821,5345,476,8.2
"21119",21,119,1998,5875,5502,373,6.3
"21119",21,119,1999,5889,5393,496,8.4
"21119",21,119,2000,5732,5314,418,7.3
"21119",21,119,2001,5659,5276,383,6.8
"21119",21,119,2002,5823,5429,394,6.8
"21119",21,119,2003,6006,5617,389,6.5
"21119",21,119,2004,6488,6085,403,6.2
"21119",21,119,2005,6666,6207,459,6.9
"21119",21,119,2006,6495,6041,454,7
"21119",21,119,2007,6232,5805,427,6.9
"21119",21,119,2008,6280,5856,424,6.8
"21119",21,119,2009,6563,5870,693,10.6
"21119",21,119,2010,5924,5126,798,13.5
"21119",21,119,2011,5849,5157,692,11.8
"21119",21,119,2012,5829,5025,804,13.8
"21119",21,119,2013,5589,4728,861,15.4
"21119",21,119,2014,5130,4559,571,11.1
"21119",21,119,2015,4818,4337,481,10
"21119",21,119,2016,4663,4132,531,11.4
"21119",21,119,2017,4576,4188,388,8.5
"21121",21,121,1990,10019,9228,791,7.9
"21121",21,121,1991,10062,9166,896,8.9
"21121",21,121,1992,10302,9335,967,9.4
"21121",21,121,1993,10412,9499,913,8.8
"21121",21,121,1994,10568,9758,810,7.7
"21121",21,121,1995,10783,10015,768,7.1
"21121",21,121,1996,11278,10036,1242,11
"21121",21,121,1997,11240,10179,1061,9.4
"21121",21,121,1998,11051,10373,678,6.1
"21121",21,121,1999,11263,10630,633,5.6
"21121",21,121,2000,11163,10525,638,5.7
"21121",21,121,2001,11218,10503,715,6.4
"21121",21,121,2002,11434,10636,798,7
"21121",21,121,2003,11610,10728,882,7.6
"21121",21,121,2004,11676,10914,762,6.5
"21121",21,121,2005,12093,11322,771,6.4
"21121",21,121,2006,12232,11401,831,6.8
"21121",21,121,2007,12621,11775,846,6.7
"21121",21,121,2008,12731,11759,972,7.6
"21121",21,121,2009,12862,11373,1489,11.6
"21121",21,121,2010,10648,9209,1439,13.5
"21121",21,121,2011,10634,9220,1414,13.3
"21121",21,121,2012,10555,9201,1354,12.8
"21121",21,121,2013,10526,9161,1365,13
"21121",21,121,2014,10110,9105,1005,9.9
"21121",21,121,2015,9772,8975,797,8.2
"21121",21,121,2016,9954,9158,796,8
"21121",21,121,2017,10208,9435,773,7.6
"21123",21,123,1990,5449,5147,302,5.5
"21123",21,123,1991,5623,5275,348,6.2
"21123",21,123,1992,5793,5461,332,5.7
"21123",21,123,1993,5608,5355,253,4.5
"21123",21,123,1994,5661,5411,250,4.4
"21123",21,123,1995,5773,5508,265,4.6
"21123",21,123,1996,6055,5811,244,4
"21123",21,123,1997,6123,5858,265,4.3
"21123",21,123,1998,6264,6010,254,4.1
"21123",21,123,1999,6320,6016,304,4.8
"21123",21,123,2000,6450,6166,284,4.4
"21123",21,123,2001,6367,6056,311,4.9
"21123",21,123,2002,6425,6079,346,5.4
"21123",21,123,2003,6579,6243,336,5.1
"21123",21,123,2004,6664,6331,333,5
"21123",21,123,2005,6884,6451,433,6.3
"21123",21,123,2006,7130,6735,395,5.5
"21123",21,123,2007,6933,6581,352,5.1
"21123",21,123,2008,6962,6510,452,6.5
"21123",21,123,2009,6997,6169,828,11.8
"21123",21,123,2010,6062,5378,684,11.3
"21123",21,123,2011,6046,5441,605,10
"21123",21,123,2012,5950,5440,510,8.6
"21123",21,123,2013,5889,5407,482,8.2
"21123",21,123,2014,5761,5381,380,6.6
"21123",21,123,2015,5858,5560,298,5.1
"21123",21,123,2016,5838,5564,274,4.7
"21123",21,123,2017,5967,5681,286,4.8
"21125",21,125,1990,18685,17383,1302,7
"21125",21,125,1991,18807,17330,1477,7.9
"21125",21,125,1992,19450,17839,1611,8.3
"21125",21,125,1993,20074,18629,1445,7.2
"21125",21,125,1994,20509,18996,1513,7.4
"21125",21,125,1995,21088,19770,1318,6.3
"21125",21,125,1996,21574,20148,1426,6.6
"21125",21,125,1997,22205,20782,1423,6.4
"21125",21,125,1998,22410,21223,1187,5.3
"21125",21,125,1999,23271,22188,1083,4.7
"21125",21,125,2000,24252,23241,1011,4.2
"21125",21,125,2001,25062,23817,1245,5
"21125",21,125,2002,24906,23441,1465,5.9
"21125",21,125,2003,24912,23256,1656,6.6
"21125",21,125,2004,25396,23961,1435,5.7
"21125",21,125,2005,25952,24505,1447,5.6
"21125",21,125,2006,25868,24367,1501,5.8
"21125",21,125,2007,26612,25204,1408,5.3
"21125",21,125,2008,26047,24326,1721,6.6
"21125",21,125,2009,26528,23826,2702,10.2
"21125",21,125,2010,24952,22105,2847,11.4
"21125",21,125,2011,24978,22114,2864,11.5
"21125",21,125,2012,24895,22361,2534,10.2
"21125",21,125,2013,24642,22244,2398,9.7
"21125",21,125,2014,24105,22267,1838,7.6
"21125",21,125,2015,23480,22022,1458,6.2
"21125",21,125,2016,24047,22558,1489,6.2
"21125",21,125,2017,24697,23243,1454,5.9
"21127",21,127,1990,4548,4027,521,11.5
"21127",21,127,1991,4692,4014,678,14.5
"21127",21,127,1992,4831,4183,648,13.4
"21127",21,127,1993,4812,4245,567,11.8
"21127",21,127,1994,5031,4431,600,11.9
"21127",21,127,1995,5188,4519,669,12.9
"21127",21,127,1996,5294,4622,672,12.7
"21127",21,127,1997,5195,4602,593,11.4
"21127",21,127,1998,5320,4794,526,9.9
"21127",21,127,1999,5603,4996,607,10.8
"21127",21,127,2000,5520,5139,381,6.9
"21127",21,127,2001,5549,5095,454,8.2
"21127",21,127,2002,5673,5226,447,7.9
"21127",21,127,2003,5738,5235,503,8.8
"21127",21,127,2004,5715,5261,454,7.9
"21127",21,127,2005,5809,5342,467,8
"21127",21,127,2006,5818,5337,481,8.3
"21127",21,127,2007,5815,5362,453,7.8
"21127",21,127,2008,5870,5368,502,8.6
"21127",21,127,2009,6208,5473,735,11.8
"21127",21,127,2010,5767,4983,784,13.6
"21127",21,127,2011,5774,5097,677,11.7
"21127",21,127,2012,5636,5039,597,10.6
"21127",21,127,2013,5578,4952,626,11.2
"21127",21,127,2014,5271,4766,505,9.6
"21127",21,127,2015,5128,4653,475,9.3
"21127",21,127,2016,5206,4652,554,10.6
"21127",21,127,2017,5123,4668,455,8.9
"21129",21,129,1990,2466,2211,255,10.3
"21129",21,129,1991,2470,2217,253,10.2
"21129",21,129,1992,2377,2111,266,11.2
"21129",21,129,1993,2415,2157,258,10.7
"21129",21,129,1994,2476,2246,230,9.3
"21129",21,129,1995,2494,2293,201,8.1
"21129",21,129,1996,2419,2264,155,6.4
"21129",21,129,1997,2618,2459,159,6.1
"21129",21,129,1998,2525,2371,154,6.1
"21129",21,129,1999,2486,2341,145,5.8
"21129",21,129,2000,2502,2355,147,5.9
"21129",21,129,2001,2523,2344,179,7.1
"21129",21,129,2002,2615,2418,197,7.5
"21129",21,129,2003,2644,2408,236,8.9
"21129",21,129,2004,2649,2448,201,7.6
"21129",21,129,2005,2692,2487,205,7.6
"21129",21,129,2006,2737,2536,201,7.3
"21129",21,129,2007,2822,2637,185,6.6
"21129",21,129,2008,2676,2479,197,7.4
"21129",21,129,2009,2785,2459,326,11.7
"21129",21,129,2010,2590,2263,327,12.6
"21129",21,129,2011,2512,2195,317,12.6
"21129",21,129,2012,2431,2124,307,12.6
"21129",21,129,2013,2371,2075,296,12.5
"21129",21,129,2014,2310,2086,224,9.7
"21129",21,129,2015,2072,1900,172,8.3
"21129",21,129,2016,1994,1807,187,9.4
"21129",21,129,2017,1952,1789,163,8.4
"21131",21,131,1990,4213,3871,342,8.1
"21131",21,131,1991,4330,3717,613,14.2
"21131",21,131,1992,4344,3927,417,9.6
"21131",21,131,1993,4438,4052,386,8.7
"21131",21,131,1994,4458,4038,420,9.4
"21131",21,131,1995,4397,4004,393,8.9
"21131",21,131,1996,4270,3977,293,6.9
"21131",21,131,1997,4439,4099,340,7.7
"21131",21,131,1998,4528,4271,257,5.7
"21131",21,131,1999,4436,4180,256,5.8
"21131",21,131,2000,3949,3718,231,5.8
"21131",21,131,2001,3880,3644,236,6.1
"21131",21,131,2002,3830,3506,324,8.5
"21131",21,131,2003,3724,3366,358,9.6
"21131",21,131,2004,3546,3254,292,8.2
"21131",21,131,2005,3586,3294,292,8.1
"21131",21,131,2006,3699,3376,323,8.7
"21131",21,131,2007,3561,3251,310,8.7
"21131",21,131,2008,3544,3251,293,8.3
"21131",21,131,2009,3622,3172,450,12.4
"21131",21,131,2010,3607,3141,466,12.9
"21131",21,131,2011,3632,3173,459,12.6
"21131",21,131,2012,3594,3081,513,14.3
"21131",21,131,2013,3495,2880,615,17.6
"21131",21,131,2014,3172,2764,408,12.9
"21131",21,131,2015,2932,2612,320,10.9
"21131",21,131,2016,2853,2474,379,13.3
"21131",21,131,2017,2789,2508,281,10.1
"21133",21,133,1990,8702,7882,820,9.4
"21133",21,133,1991,9054,7546,1508,16.7
"21133",21,133,1992,8678,7183,1495,17.2
"21133",21,133,1993,8307,7127,1180,14.2
"21133",21,133,1994,8112,7089,1023,12.6
"21133",21,133,1995,8086,7100,986,12.2
"21133",21,133,1996,7798,6938,860,11
"21133",21,133,1997,7749,7058,691,8.9
"21133",21,133,1998,7608,7034,574,7.5
"21133",21,133,1999,7906,7175,731,9.2
"21133",21,133,2000,8838,8149,689,7.8
"21133",21,133,2001,8849,8298,551,6.2
"21133",21,133,2002,8836,8106,730,8.3
"21133",21,133,2003,8991,8084,907,10.1
"21133",21,133,2004,8870,8243,627,7.1
"21133",21,133,2005,9036,8383,653,7.2
"21133",21,133,2006,9120,8435,685,7.5
"21133",21,133,2007,8747,8098,649,7.4
"21133",21,133,2008,8700,8102,598,6.9
"21133",21,133,2009,8789,7851,938,10.7
"21133",21,133,2010,8659,7669,990,11.4
"21133",21,133,2011,8883,7974,909,10.2
"21133",21,133,2012,8582,7425,1157,13.5
"21133",21,133,2013,8047,6703,1344,16.7
"21133",21,133,2014,7239,6345,894,12.3
"21133",21,133,2015,6859,6092,767,11.2
"21133",21,133,2016,6675,5873,802,12
"21133",21,133,2017,6541,5941,600,9.2
"21135",21,135,1990,5565,5034,531,9.5
"21135",21,135,1991,6052,5203,849,14
"21135",21,135,1992,5710,4847,863,15.1
"21135",21,135,1993,5760,4927,833,14.5
"21135",21,135,1994,5526,4881,645,11.7
"21135",21,135,1995,5469,4867,602,11
"21135",21,135,1996,5325,4712,613,11.5
"21135",21,135,1997,5330,4527,803,15.1
"21135",21,135,1998,5103,4489,614,12
"21135",21,135,1999,4763,4092,671,14.1
"21135",21,135,2000,5633,5151,482,8.6
"21135",21,135,2001,5583,5140,443,7.9
"21135",21,135,2002,5413,4995,418,7.7
"21135",21,135,2003,5597,5161,436,7.8
"21135",21,135,2004,5603,5141,462,8.2
"21135",21,135,2005,5577,5052,525,9.4
"21135",21,135,2006,5557,5105,452,8.1
"21135",21,135,2007,5602,5178,424,7.6
"21135",21,135,2008,5517,4991,526,9.5
"21135",21,135,2009,5598,4749,849,15.2
"21135",21,135,2010,5589,4818,771,13.8
"21135",21,135,2011,5517,4799,718,13
"21135",21,135,2012,5382,4755,627,11.6
"21135",21,135,2013,5293,4650,643,12.1
"21135",21,135,2014,5167,4669,498,9.6
"21135",21,135,2015,5054,4629,425,8.4
"21135",21,135,2016,5009,4539,470,9.4
"21135",21,135,2017,4930,4492,438,8.9
"21137",21,137,1990,9154,8512,642,7
"21137",21,137,1991,9081,8362,719,7.9
"21137",21,137,1992,9384,8753,631,6.7
"21137",21,137,1993,9717,9119,598,6.2
"21137",21,137,1994,9722,9161,561,5.8
"21137",21,137,1995,9739,9256,483,5
"21137",21,137,1996,10039,9564,475,4.7
"21137",21,137,1997,10243,9816,427,4.2
"21137",21,137,1998,10951,10531,420,3.8
"21137",21,137,1999,11060,10614,446,4
"21137",21,137,2000,10874,10431,443,4.1
"21137",21,137,2001,11130,10457,673,6
"21137",21,137,2002,11005,10243,762,6.9
"21137",21,137,2003,10996,10143,853,7.8
"21137",21,137,2004,10516,9764,752,7.2
"21137",21,137,2005,10652,9921,731,6.9
"21137",21,137,2006,10844,10075,769,7.1
"21137",21,137,2007,10611,9920,691,6.5
"21137",21,137,2008,10501,9718,783,7.5
"21137",21,137,2009,10658,9319,1339,12.6
"21137",21,137,2010,10625,9261,1364,12.8
"21137",21,137,2011,10405,9129,1276,12.3
"21137",21,137,2012,10102,9062,1040,10.3
"21137",21,137,2013,9918,8861,1057,10.7
"21137",21,137,2014,9320,8497,823,8.8
"21137",21,137,2015,9011,8402,609,6.8
"21137",21,137,2016,9142,8582,560,6.1
"21137",21,137,2017,9386,8853,533,5.7
"21139",21,139,1990,4502,4131,371,8.2
"21139",21,139,1991,4624,4158,466,10.1
"21139",21,139,1992,4665,4223,442,9.5
"21139",21,139,1993,4613,4243,370,8
"21139",21,139,1994,4664,4316,348,7.5
"21139",21,139,1995,4758,4447,311,6.5
"21139",21,139,1996,4730,4458,272,5.8
"21139",21,139,1997,4895,4559,336,6.9
"21139",21,139,1998,4888,4603,285,5.8
"21139",21,139,1999,4948,4684,264,5.3
"21139",21,139,2000,4950,4672,278,5.6
"21139",21,139,2001,4961,4644,317,6.4
"21139",21,139,2002,4880,4561,319,6.5
"21139",21,139,2003,4793,4464,329,6.9
"21139",21,139,2004,4780,4486,294,6.2
"21139",21,139,2005,4835,4554,281,5.8
"21139",21,139,2006,4908,4611,297,6.1
"21139",21,139,2007,4845,4583,262,5.4
"21139",21,139,2008,4717,4430,287,6.1
"21139",21,139,2009,4775,4303,472,9.9
"21139",21,139,2010,4035,3549,486,12
"21139",21,139,2011,4024,3583,441,11
"21139",21,139,2012,3973,3588,385,9.7
"21139",21,139,2013,3887,3503,384,9.9
"21139",21,139,2014,3756,3447,309,8.2
"21139",21,139,2015,3685,3420,265,7.2
"21139",21,139,2016,3707,3440,267,7.2
"21139",21,139,2017,3766,3482,284,7.5
"21141",21,141,1990,11915,11222,693,5.8
"21141",21,141,1991,11797,10914,883,7.5
"21141",21,141,1992,12313,11637,676,5.5
"21141",21,141,1993,12907,12264,643,5
"21141",21,141,1994,13339,12747,592,4.4
"21141",21,141,1995,13253,12680,573,4.3
"21141",21,141,1996,13111,12437,674,5.1
"21141",21,141,1997,13152,12529,623,4.7
"21141",21,141,1998,13140,12653,487,3.7
"21141",21,141,1999,13203,12745,458,3.5
"21141",21,141,2000,13321,12835,486,3.6
"21141",21,141,2001,13232,12358,874,6.6
"21141",21,141,2002,12744,11901,843,6.6
"21141",21,141,2003,12574,11789,785,6.2
"21141",21,141,2004,12155,11468,687,5.7
"21141",21,141,2005,12306,11518,788,6.4
"21141",21,141,2006,12487,11767,720,5.8
"21141",21,141,2007,12396,11735,661,5.3
"21141",21,141,2008,12367,11583,784,6.3
"21141",21,141,2009,12428,11075,1353,10.9
"21141",21,141,2010,12612,11362,1250,9.9
"21141",21,141,2011,12440,11327,1113,8.9
"21141",21,141,2012,12192,11271,921,7.6
"21141",21,141,2013,12134,11271,863,7.1
"21141",21,141,2014,11909,11236,673,5.7
"21141",21,141,2015,11682,11132,550,4.7
"21141",21,141,2016,11938,11420,518,4.3
"21141",21,141,2017,12161,11629,532,4.4
"21143",21,143,1990,2635,2434,201,7.6
"21143",21,143,1991,2774,2509,265,9.6
"21143",21,143,1992,2890,2658,232,8
"21143",21,143,1993,2955,2763,192,6.5
"21143",21,143,1994,3039,2843,196,6.4
"21143",21,143,1995,3168,2952,216,6.8
"21143",21,143,1996,3324,3077,247,7.4
"21143",21,143,1997,3397,3125,272,8
"21143",21,143,1998,3328,3139,189,5.7
"21143",21,143,1999,3367,3201,166,4.9
"21143",21,143,2000,3167,2989,178,5.6
"21143",21,143,2001,3299,3099,200,6.1
"21143",21,143,2002,3389,3163,226,6.7
"21143",21,143,2003,3205,2937,268,8.4
"21143",21,143,2004,3195,2973,222,6.9
"21143",21,143,2005,3217,2981,236,7.3
"21143",21,143,2006,3306,3086,220,6.7
"21143",21,143,2007,3278,3069,209,6.4
"21143",21,143,2008,3277,3027,250,7.6
"21143",21,143,2009,3362,2949,413,12.3
"21143",21,143,2010,2982,2636,346,11.6
"21143",21,143,2011,3078,2759,319,10.4
"21143",21,143,2012,3102,2817,285,9.2
"21143",21,143,2013,3092,2838,254,8.2
"21143",21,143,2014,2978,2770,208,7
"21143",21,143,2015,2955,2790,165,5.6
"21143",21,143,2016,3063,2887,176,5.7
"21143",21,143,2017,3107,2932,175,5.6
"21145",21,145,1990,30855,29347,1508,4.9
"21145",21,145,1991,31408,29489,1919,6.1
"21145",21,145,1992,31654,30030,1624,5.1
"21145",21,145,1993,31840,30394,1446,4.5
"21145",21,145,1994,32486,30799,1687,5.2
"21145",21,145,1995,32767,31378,1389,4.2
"21145",21,145,1996,33418,32013,1405,4.2
"21145",21,145,1997,33987,32210,1777,5.2
"21145",21,145,1998,33553,32072,1481,4.4
"21145",21,145,1999,33769,32493,1276,3.8
"21145",21,145,2000,31776,30312,1464,4.6
"21145",21,145,2001,31501,29878,1623,5.2
"21145",21,145,2002,31124,29271,1853,6
"21145",21,145,2003,30768,28817,1951,6.3
"21145",21,145,2004,30665,29015,1650,5.4
"21145",21,145,2005,31187,29378,1809,5.8
"21145",21,145,2006,31431,29750,1681,5.3
"21145",21,145,2007,31596,30059,1537,4.9
"21145",21,145,2008,31062,29269,1793,5.8
"21145",21,145,2009,31507,28746,2761,8.8
"21145",21,145,2010,30650,27876,2774,9.1
"21145",21,145,2011,30974,28299,2675,8.6
"21145",21,145,2012,30912,28451,2461,8
"21145",21,145,2013,30282,27892,2390,7.9
"21145",21,145,2014,29453,27389,2064,7
"21145",21,145,2015,28783,27137,1646,5.7
"21145",21,145,2016,29158,27475,1683,5.8
"21145",21,145,2017,29636,27835,1801,6.1
"21147",21,147,1990,4876,4146,730,15
"21147",21,147,1991,5430,4672,758,14
"21147",21,147,1992,5625,4909,716,12.7
"21147",21,147,1993,6073,5411,662,10.9
"21147",21,147,1994,6436,5928,508,7.9
"21147",21,147,1995,6308,5796,512,8.1
"21147",21,147,1996,6317,5599,718,11.4
"21147",21,147,1997,6341,5729,612,9.7
"21147",21,147,1998,6280,5753,527,8.4
"21147",21,147,1999,6352,5920,432,6.8
"21147",21,147,2000,6093,5690,403,6.6
"21147",21,147,2001,6368,5765,603,9.5
"21147",21,147,2002,6084,5506,578,9.5
"21147",21,147,2003,5868,5303,565,9.6
"21147",21,147,2004,6018,5550,468,7.8
"21147",21,147,2005,6015,5494,521,8.7
"21147",21,147,2006,5977,5371,606,10.1
"21147",21,147,2007,5841,5315,526,9
"21147",21,147,2008,5709,5161,548,9.6
"21147",21,147,2009,5861,5040,821,14
"21147",21,147,2010,5723,4896,827,14.5
"21147",21,147,2011,5690,4858,832,14.6
"21147",21,147,2012,5475,4753,722,13.2
"21147",21,147,2013,5342,4643,699,13.1
"21147",21,147,2014,5040,4508,532,10.6
"21147",21,147,2015,4835,4441,394,8.1
"21147",21,147,2016,4806,4432,374,7.8
"21147",21,147,2017,4886,4561,325,6.7
"21149",21,149,1990,4457,4083,374,8.4
"21149",21,149,1991,4382,3849,533,12.2
"21149",21,149,1992,4272,3704,568,13.3
"21149",21,149,1993,4419,3833,586,13.3
"21149",21,149,1994,4203,3818,385,9.2
"21149",21,149,1995,4270,3879,391,9.2
"21149",21,149,1996,4348,3994,354,8.1
"21149",21,149,1997,4616,4180,436,9.4
"21149",21,149,1998,4670,4340,330,7.1
"21149",21,149,1999,4539,4221,318,7
"21149",21,149,2000,4783,4543,240,5
"21149",21,149,2001,4661,4390,271,5.8
"21149",21,149,2002,4629,4334,295,6.4
"21149",21,149,2003,4649,4299,350,7.5
"21149",21,149,2004,4613,4313,300,6.5
"21149",21,149,2005,4642,4308,334,7.2
"21149",21,149,2006,4707,4354,353,7.5
"21149",21,149,2007,4573,4307,266,5.8
"21149",21,149,2008,4555,4232,323,7.1
"21149",21,149,2009,4561,4084,477,10.5
"21149",21,149,2010,4524,4062,462,10.2
"21149",21,149,2011,4564,4159,405,8.9
"21149",21,149,2012,4560,4212,348,7.6
"21149",21,149,2013,4479,4136,343,7.7
"21149",21,149,2014,4312,4037,275,6.4
"21149",21,149,2015,4214,4006,208,4.9
"21149",21,149,2016,4285,4076,209,4.9
"21149",21,149,2017,4401,4170,231,5.2
"21151",21,151,1990,30317,28463,1854,6.1
"21151",21,151,1991,29849,28244,1605,5.4
"21151",21,151,1992,29939,28646,1293,4.3
"21151",21,151,1993,31231,29876,1355,4.3
"21151",21,151,1994,31839,30385,1454,4.6
"21151",21,151,1995,32851,31301,1550,4.7
"21151",21,151,1996,33342,32232,1110,3.3
"21151",21,151,1997,34791,33720,1071,3.1
"21151",21,151,1998,35482,34612,870,2.5
"21151",21,151,1999,36588,35622,966,2.6
"21151",21,151,2000,37585,36255,1330,3.5
"21151",21,151,2001,37620,35854,1766,4.7
"21151",21,151,2002,37890,35916,1974,5.2
"21151",21,151,2003,39490,37433,2057,5.2
"21151",21,151,2004,40092,38101,1991,5
"21151",21,151,2005,41502,39467,2035,4.9
"21151",21,151,2006,42742,40699,2043,4.8
"21151",21,151,2007,42634,40622,2012,4.7
"21151",21,151,2008,42850,40496,2354,5.5
"21151",21,151,2009,43187,39256,3931,9.1
"21151",21,151,2010,43050,39386,3664,8.5
"21151",21,151,2011,44056,40587,3469,7.9
"21151",21,151,2012,44628,41617,3011,6.7
"21151",21,151,2013,45747,42740,3007,6.6
"21151",21,151,2014,45264,42813,2451,5.4
"21151",21,151,2015,44515,42571,1944,4.4
"21151",21,151,2016,44495,42600,1895,4.3
"21151",21,151,2017,45448,43494,1954,4.3
"21153",21,153,1990,4300,3641,659,15.3
"21153",21,153,1991,4459,3658,801,18
"21153",21,153,1992,4352,3651,701,16.1
"21153",21,153,1993,4343,3672,671,15.5
"21153",21,153,1994,4603,3972,631,13.7
"21153",21,153,1995,4863,4119,744,15.3
"21153",21,153,1996,4827,4120,707,14.6
"21153",21,153,1997,4826,4138,688,14.3
"21153",21,153,1998,5087,4400,687,13.5
"21153",21,153,1999,5136,4436,700,13.6
"21153",21,153,2000,4468,4000,468,10.5
"21153",21,153,2001,4489,4043,446,9.9
"21153",21,153,2002,4514,4005,509,11.3
"21153",21,153,2003,4555,4018,537,11.8
"21153",21,153,2004,4527,3958,569,12.6
"21153",21,153,2005,4479,3957,522,11.7
"21153",21,153,2006,4326,3886,440,10.2
"21153",21,153,2007,4346,3896,450,10.4
"21153",21,153,2008,4261,3805,456,10.7
"21153",21,153,2009,4473,3649,824,18.4
"21153",21,153,2010,4290,3411,879,20.5
"21153",21,153,2011,4150,3439,711,17.1
"21153",21,153,2012,4036,3343,693,17.2
"21153",21,153,2013,4002,3299,703,17.6
"21153",21,153,2014,3721,3201,520,14
"21153",21,153,2015,3509,2985,524,14.9
"21153",21,153,2016,3285,2659,626,19.1
"21153",21,153,2017,3119,2629,490,15.7
"21155",21,155,1990,7679,7232,447,5.8
"21155",21,155,1991,8031,7421,610,7.6
"21155",21,155,1992,8406,7810,596,7.1
"21155",21,155,1993,8421,7738,683,8.1
"21155",21,155,1994,8340,7431,909,10.9
"21155",21,155,1995,8474,7853,621,7.3
"21155",21,155,1996,8827,8172,655,7.4
"21155",21,155,1997,9371,8708,663,7.1
"21155",21,155,1998,10359,9712,647,6.2
"21155",21,155,1999,11034,10425,609,5.5
"21155",21,155,2000,8628,8196,432,5
"21155",21,155,2001,8779,8276,503,5.7
"21155",21,155,2002,8953,8498,455,5.1
"21155",21,155,2003,9373,8846,527,5.6
"21155",21,155,2004,9053,8599,454,5
"21155",21,155,2005,9340,8805,535,5.7
"21155",21,155,2006,10172,9644,528,5.2
"21155",21,155,2007,10271,9743,528,5.1
"21155",21,155,2008,10228,9570,658,6.4
"21155",21,155,2009,10166,8823,1343,13.2
"21155",21,155,2010,9110,7961,1149,12.6
"21155",21,155,2011,9200,8203,997,10.8
"21155",21,155,2012,9175,8363,812,8.9
"21155",21,155,2013,9297,8539,758,8.2
"21155",21,155,2014,9182,8596,586,6.4
"21155",21,155,2015,9211,8763,448,4.9
"21155",21,155,2016,9524,9126,398,4.2
"21155",21,155,2017,9589,9197,392,4.1
"21157",21,157,1990,12540,11579,961,7.7
"21157",21,157,1991,12926,11754,1172,9.1
"21157",21,157,1992,13120,12011,1109,8.5
"21157",21,157,1993,13305,12263,1042,7.8
"21157",21,157,1994,13450,12500,950,7.1
"21157",21,157,1995,13693,12939,754,5.5
"21157",21,157,1996,14226,13381,845,5.9
"21157",21,157,1997,14560,13548,1012,7
"21157",21,157,1998,14609,13702,907,6.2
"21157",21,157,1999,14754,13917,837,5.7
"21157",21,157,2000,14821,14066,755,5.1
"21157",21,157,2001,14854,13905,949,6.4
"21157",21,157,2002,14579,13488,1091,7.5
"21157",21,157,2003,14432,13346,1086,7.5
"21157",21,157,2004,14211,13271,940,6.6
"21157",21,157,2005,14427,13489,938,6.5
"21157",21,157,2006,14736,13842,894,6.1
"21157",21,157,2007,14796,13945,851,5.8
"21157",21,157,2008,14718,13791,927,6.3
"21157",21,157,2009,14669,13119,1550,10.6
"21157",21,157,2010,15404,13783,1621,10.5
"21157",21,157,2011,15441,14012,1429,9.3
"21157",21,157,2012,15369,14125,1244,8.1
"21157",21,157,2013,15323,14079,1244,8.1
"21157",21,157,2014,14946,13939,1007,6.7
"21157",21,157,2015,14846,14017,829,5.6
"21157",21,157,2016,15016,14148,868,5.8
"21157",21,157,2017,15180,14285,895,5.9
"21159",21,159,1990,3609,3333,276,7.6
"21159",21,159,1991,3555,3197,358,10.1
"21159",21,159,1992,3683,3297,386,10.5
"21159",21,159,1993,3596,3202,394,11
"21159",21,159,1994,3313,3042,271,8.2
"21159",21,159,1995,3466,3055,411,11.9
"21159",21,159,1996,3289,2819,470,14.3
"21159",21,159,1997,3102,2773,329,10.6
"21159",21,159,1998,3005,2674,331,11
"21159",21,159,1999,3105,2715,390,12.6
"21159",21,159,2000,3464,3213,251,7.2
"21159",21,159,2001,3712,3467,245,6.6
"21159",21,159,2002,3817,3545,272,7.1
"21159",21,159,2003,3917,3596,321,8.2
"21159",21,159,2004,3642,3374,268,7.4
"21159",21,159,2005,3672,3390,282,7.7
"21159",21,159,2006,3600,3334,266,7.4
"21159",21,159,2007,3445,3175,270,7.8
"21159",21,159,2008,3512,3245,267,7.6
"21159",21,159,2009,3818,3386,432,11.3
"21159",21,159,2010,3998,3586,412,10.3
"21159",21,159,2011,3870,3522,348,9
"21159",21,159,2012,3768,3424,344,9.1
"21159",21,159,2013,3641,3286,355,9.8
"21159",21,159,2014,3433,3120,313,9.1
"21159",21,159,2015,3236,2927,309,9.5
"21159",21,159,2016,3145,2825,320,10.2
"21159",21,159,2017,3315,3073,242,7.3
"21161",21,161,1990,8042,7702,340,4.2
"21161",21,161,1991,8068,7529,539,6.7
"21161",21,161,1992,8310,7737,573,6.9
"21161",21,161,1993,8555,7834,721,8.4
"21161",21,161,1994,8527,8086,441,5.2
"21161",21,161,1995,8597,8126,471,5.5
"21161",21,161,1996,8612,8189,423,4.9
"21161",21,161,1997,8386,7998,388,4.6
"21161",21,161,1998,8477,8211,266,3.1
"21161",21,161,1999,8575,8313,262,3.1
"21161",21,161,2000,8337,8027,310,3.7
"21161",21,161,2001,8487,8094,393,4.6
"21161",21,161,2002,8432,7995,437,5.2
"21161",21,161,2003,8770,8258,512,5.8
"21161",21,161,2004,8723,8229,494,5.7
"21161",21,161,2005,8732,8184,548,6.3
"21161",21,161,2006,8706,8250,456,5.2
"21161",21,161,2007,8809,8404,405,4.6
"21161",21,161,2008,8777,8254,523,6
"21161",21,161,2009,8824,7869,955,10.8
"21161",21,161,2010,7892,7004,888,11.3
"21161",21,161,2011,7660,6871,789,10.3
"21161",21,161,2012,7619,6901,718,9.4
"21161",21,161,2013,7792,7013,779,10
"21161",21,161,2014,7735,7123,612,7.9
"21161",21,161,2015,7447,6998,449,6
"21161",21,161,2016,7313,6855,458,6.3
"21161",21,161,2017,7376,6927,449,6.1
"21163",21,163,1990,8913,8345,568,6.4
"21163",21,163,1991,9002,8337,665,7.4
"21163",21,163,1992,9229,8631,598,6.5
"21163",21,163,1993,9296,8756,540,5.8
"21163",21,163,1994,9403,8910,493,5.2
"21163",21,163,1995,9782,9272,510,5.2
"21163",21,163,1996,10305,9815,490,4.8
"21163",21,163,1997,10546,10060,486,4.6
"21163",21,163,1998,10788,10357,431,4
"21163",21,163,1999,10952,10467,485,4.4
"21163",21,163,2000,11781,11306,475,4
"21163",21,163,2001,11655,11059,596,5.1
"21163",21,163,2002,11596,10920,676,5.8
"21163",21,163,2003,11590,10863,727,6.3
"21163",21,163,2004,11912,11204,708,5.9
"21163",21,163,2005,12179,11324,855,7
"21163",21,163,2006,12019,11255,764,6.4
"21163",21,163,2007,11617,10918,699,6
"21163",21,163,2008,11518,10630,888,7.7
"21163",21,163,2009,11493,10014,1479,12.9
"21163",21,163,2010,12338,10882,1456,11.8
"21163",21,163,2011,12815,11370,1445,11.3
"21163",21,163,2012,12631,11398,1233,9.8
"21163",21,163,2013,12534,11409,1125,9
"21163",21,163,2014,12110,11255,855,7.1
"21163",21,163,2015,11795,11140,655,5.6
"21163",21,163,2016,11966,11339,627,5.2
"21163",21,163,2017,12211,11579,632,5.2
"21165",21,165,1990,2326,1998,328,14.1
"21165",21,165,1991,2250,1873,377,16.8
"21165",21,165,1992,2209,1917,292,13.2
"21165",21,165,1993,2223,1903,320,14.4
"21165",21,165,1994,2319,2008,311,13.4
"21165",21,165,1995,2422,2163,259,10.7
"21165",21,165,1996,2580,2353,227,8.8
"21165",21,165,1997,2799,2538,261,9.3
"21165",21,165,1998,2924,2725,199,6.8
"21165",21,165,1999,2929,2731,198,6.8
"21165",21,165,2000,2614,2451,163,6.2
"21165",21,165,2001,2647,2442,205,7.7
"21165",21,165,2002,2620,2407,213,8.1
"21165",21,165,2003,2667,2423,244,9.1
"21165",21,165,2004,2596,2413,183,7
"21165",21,165,2005,2600,2389,211,8.1
"21165",21,165,2006,2654,2428,226,8.5
"21165",21,165,2007,2637,2413,224,8.5
"21165",21,165,2008,2582,2327,255,9.9
"21165",21,165,2009,2602,2174,428,16.4
"21165",21,165,2010,2560,2163,397,15.5
"21165",21,165,2011,2543,2185,358,14.1
"21165",21,165,2012,2545,2249,296,11.6
"21165",21,165,2013,2489,2189,300,12.1
"21165",21,165,2014,2354,2123,231,9.8
"21165",21,165,2015,2372,2169,203,8.6
"21165",21,165,2016,2412,2203,209,8.7
"21165",21,165,2017,2385,2177,208,8.7
"21167",21,167,1990,9595,9015,580,6
"21167",21,167,1991,9624,9025,599,6.2
"21167",21,167,1992,9991,9211,780,7.8
"21167",21,167,1993,10397,9752,645,6.2
"21167",21,167,1994,10647,10178,469,4.4
"21167",21,167,1995,10498,10111,387,3.7
"21167",21,167,1996,10510,10096,414,3.9
"21167",21,167,1997,10832,10407,425,3.9
"21167",21,167,1998,10899,10529,370,3.4
"21167",21,167,1999,10975,10627,348,3.2
"21167",21,167,2000,10744,10338,406,3.8
"21167",21,167,2001,10736,10192,544,5.1
"21167",21,167,2002,10534,9959,575,5.5
"21167",21,167,2003,10460,9814,646,6.2
"21167",21,167,2004,10127,9599,528,5.2
"21167",21,167,2005,10466,9863,603,5.8
"21167",21,167,2006,10588,9975,613,5.8
"21167",21,167,2007,10620,10073,547,5.2
"21167",21,167,2008,10453,9797,656,6.3
"21167",21,167,2009,10450,9266,1184,11.3
"21167",21,167,2010,10532,9353,1179,11.2
"21167",21,167,2011,10234,9173,1061,10.4
"21167",21,167,2012,10246,9401,845,8.2
"21167",21,167,2013,10190,9390,800,7.9
"21167",21,167,2014,9890,9279,611,6.2
"21167",21,167,2015,9782,9295,487,5
"21167",21,167,2016,10002,9521,481,4.8
"21167",21,167,2017,10114,9622,492,4.9
"21169",21,169,1990,4348,4118,230,5.3
"21169",21,169,1991,4454,4109,345,7.7
"21169",21,169,1992,4501,4182,319,7.1
"21169",21,169,1993,4567,4315,252,5.5
"21169",21,169,1994,4702,4489,213,4.5
"21169",21,169,1995,4776,4511,265,5.5
"21169",21,169,1996,4871,4567,304,6.2
"21169",21,169,1997,4801,4553,248,5.2
"21169",21,169,1998,4907,4676,231,4.7
"21169",21,169,1999,4995,4637,358,7.2
"21169",21,169,2000,4620,4412,208,4.5
"21169",21,169,2001,4598,4361,237,5.2
"21169",21,169,2002,4517,4287,230,5.1
"21169",21,169,2003,4520,4278,242,5.4
"21169",21,169,2004,4460,4259,201,4.5
"21169",21,169,2005,4476,4225,251,5.6
"21169",21,169,2006,4494,4249,245,5.5
"21169",21,169,2007,4425,4179,246,5.6
"21169",21,169,2008,4395,4088,307,7
"21169",21,169,2009,4390,3704,686,15.6
"21169",21,169,2010,4674,4051,623,13.3
"21169",21,169,2011,4611,4093,518,11.2
"21169",21,169,2012,4426,4074,352,8
"21169",21,169,2013,4333,3995,338,7.8
"21169",21,169,2014,4127,3876,251,6.1
"21169",21,169,2015,4009,3800,209,5.2
"21169",21,169,2016,4159,3969,190,4.6
"21169",21,169,2017,4176,4003,173,4.1
"21171",21,171,1990,5295,4949,346,6.5
"21171",21,171,1991,5114,4714,400,7.8
"21171",21,171,1992,4929,4675,254,5.2
"21171",21,171,1993,5238,5016,222,4.2
"21171",21,171,1994,5372,5134,238,4.4
"21171",21,171,1995,5476,5243,233,4.3
"21171",21,171,1996,5488,5140,348,6.3
"21171",21,171,1997,5446,5075,371,6.8
"21171",21,171,1998,5158,4970,188,3.6
"21171",21,171,1999,5449,4763,686,12.6
"21171",21,171,2000,5421,4982,439,8.1
"21171",21,171,2001,5198,4740,458,8.8
"21171",21,171,2002,5217,4874,343,6.6
"21171",21,171,2003,5284,4907,377,7.1
"21171",21,171,2004,5059,4793,266,5.3
"21171",21,171,2005,5038,4718,320,6.4
"21171",21,171,2006,5033,4719,314,6.2
"21171",21,171,2007,4858,4528,330,6.8
"21171",21,171,2008,4741,4349,392,8.3
"21171",21,171,2009,4751,4092,659,13.9
"21171",21,171,2010,4850,4331,519,10.7
"21171",21,171,2011,4834,4398,436,9
"21171",21,171,2012,4800,4454,346,7.2
"21171",21,171,2013,4743,4404,339,7.1
"21171",21,171,2014,4597,4343,254,5.5
"21171",21,171,2015,4611,4414,197,4.3
"21171",21,171,2016,4756,4561,195,4.1
"21171",21,171,2017,4857,4671,186,3.8
"21173",21,173,1990,10343,9223,1120,10.8
"21173",21,173,1991,10063,8641,1422,14.1
"21173",21,173,1992,9693,8817,876,9
"21173",21,173,1993,9716,8693,1023,10.5
"21173",21,173,1994,10243,9377,866,8.5
"21173",21,173,1995,10538,9821,717,6.8
"21173",21,173,1996,11213,10624,589,5.3
"21173",21,173,1997,11872,11300,572,4.8
"21173",21,173,1998,12480,11961,519,4.2
"21173",21,173,1999,12815,12159,656,5.1
"21173",21,173,2000,11266,10777,489,4.3
"21173",21,173,2001,11478,10771,707,6.2
"21173",21,173,2002,11411,10673,738,6.5
"21173",21,173,2003,11678,10920,758,6.5
"21173",21,173,2004,11540,10792,748,6.5
"21173",21,173,2005,11712,10903,809,6.9
"21173",21,173,2006,12139,11412,727,6
"21173",21,173,2007,12241,11532,709,5.8
"21173",21,173,2008,12230,11330,900,7.4
"21173",21,173,2009,12464,10918,1546,12.4
"21173",21,173,2010,12077,10603,1474,12.2
"21173",21,173,2011,12080,10727,1353,11.2
"21173",21,173,2012,12326,11237,1089,8.8
"21173",21,173,2013,12138,11110,1028,8.5
"21173",21,173,2014,11744,10867,877,7.5
"21173",21,173,2015,11796,11027,769,6.5
"21173",21,173,2016,11942,11174,768,6.4
"21173",21,173,2017,11829,11052,777,6.6
"21175",21,175,1990,4034,3625,409,10.1
"21175",21,175,1991,4287,3692,595,13.9
"21175",21,175,1992,4388,3834,554,12.6
"21175",21,175,1993,4464,3952,512,11.5
"21175",21,175,1994,4462,3958,504,11.3
"21175",21,175,1995,4558,4068,490,10.8
"21175",21,175,1996,4814,4341,473,9.8
"21175",21,175,1997,4909,4457,452,9.2
"21175",21,175,1998,5078,4655,423,8.3
"21175",21,175,1999,4971,4579,392,7.9
"21175",21,175,2000,4898,4583,315,6.4
"21175",21,175,2001,5231,4800,431,8.2
"21175",21,175,2002,5152,4686,466,9
"21175",21,175,2003,5175,4682,493,9.5
"21175",21,175,2004,5077,4636,441,8.7
"21175",21,175,2005,5010,4529,481,9.6
"21175",21,175,2006,5001,4565,436,8.7
"21175",21,175,2007,4969,4537,432,8.7
"21175",21,175,2008,4903,4427,476,9.7
"21175",21,175,2009,5100,4405,695,13.6
"21175",21,175,2010,5114,4447,667,13
"21175",21,175,2011,5232,4656,576,11
"21175",21,175,2012,5221,4666,555,10.6
"21175",21,175,2013,5057,4520,537,10.6
"21175",21,175,2014,4790,4339,451,9.4
"21175",21,175,2015,4497,4130,367,8.2
"21175",21,175,2016,4588,4226,362,7.9
"21175",21,175,2017,4644,4307,337,7.3
"21177",21,177,1990,12776,11656,1120,8.8
"21177",21,177,1991,12454,10927,1527,12.3
"21177",21,177,1992,11874,10405,1469,12.4
"21177",21,177,1993,11720,10428,1292,11
"21177",21,177,1994,11841,10715,1126,9.5
"21177",21,177,1995,12260,11198,1062,8.7
"21177",21,177,1996,12042,11041,1001,8.3
"21177",21,177,1997,12390,11309,1081,8.7
"21177",21,177,1998,12454,11542,912,7.3
"21177",21,177,1999,12667,11597,1070,8.4
"21177",21,177,2000,13152,12385,767,5.8
"21177",21,177,2001,13026,11957,1069,8.2
"21177",21,177,2002,13186,12137,1049,8
"21177",21,177,2003,13179,12121,1058,8
"21177",21,177,2004,12939,11969,970,7.5
"21177",21,177,2005,12827,11728,1099,8.6
"21177",21,177,2006,13012,11827,1185,9.1
"21177",21,177,2007,13548,12471,1077,7.9
"21177",21,177,2008,13098,11979,1119,8.5
"21177",21,177,2009,13842,12350,1492,10.8
"21177",21,177,2010,13040,11615,1425,10.9
"21177",21,177,2011,12942,11614,1328,10.3
"21177",21,177,2012,12413,11198,1215,9.8
"21177",21,177,2013,12963,11748,1215,9.4
"21177",21,177,2014,12355,11411,944,7.6
"21177",21,177,2015,11667,10833,834,7.1
"21177",21,177,2016,11647,10810,837,7.2
"21177",21,177,2017,11686,10903,783,6.7
"21179",21,179,1990,14746,13962,784,5.3
"21179",21,179,1991,15570,14488,1082,6.9
"21179",21,179,1992,15679,14417,1262,8
"21179",21,179,1993,15804,14792,1012,6.4
"21179",21,179,1994,16226,15223,1003,6.2
"21179",21,179,1995,17369,16166,1203,6.9
"21179",21,179,1996,17855,16566,1289,7.2
"21179",21,179,1997,18351,17211,1140,6.2
"21179",21,179,1998,18647,17675,972,5.2
"21179",21,179,1999,18961,17825,1136,6
"21179",21,179,2000,19731,18909,822,4.2
"21179",21,179,2001,19560,18556,1004,5.1
"21179",21,179,2002,19437,18290,1147,5.9
"21179",21,179,2003,19603,18416,1187,6.1
"21179",21,179,2004,19896,18872,1024,5.1
"21179",21,179,2005,20580,19280,1300,6.3
"21179",21,179,2006,21189,19953,1236,5.8
"21179",21,179,2007,21294,20066,1228,5.8
"21179",21,179,2008,21546,19976,1570,7.3
"21179",21,179,2009,22133,19398,2735,12.4
"21179",21,179,2010,21971,19514,2457,11.2
"21179",21,179,2011,21806,19488,2318,10.6
"21179",21,179,2012,21897,20086,1811,8.3
"21179",21,179,2013,21683,20046,1637,7.5
"21179",21,179,2014,21284,19984,1300,6.1
"21179",21,179,2015,21129,20066,1063,5
"21179",21,179,2016,21847,20853,994,4.5
"21179",21,179,2017,22487,21500,987,4.4
"21181",21,181,1990,3434,3242,192,5.6
"21181",21,181,1991,3519,3299,220,6.3
"21181",21,181,1992,3540,3335,205,5.8
"21181",21,181,1993,3586,3282,304,8.5
"21181",21,181,1994,3499,3284,215,6.1
"21181",21,181,1995,3350,3053,297,8.9
"21181",21,181,1996,3222,3061,161,5
"21181",21,181,1997,3315,3168,147,4.4
"21181",21,181,1998,3263,3140,123,3.8
"21181",21,181,1999,3137,3008,129,4.1
"21181",21,181,2000,3280,3050,230,7
"21181",21,181,2001,3225,3029,196,6.1
"21181",21,181,2002,3181,2960,221,6.9
"21181",21,181,2003,3206,2993,213,6.6
"21181",21,181,2004,2988,2793,195,6.5
"21181",21,181,2005,2999,2715,284,9.5
"21181",21,181,2006,2987,2786,201,6.7
"21181",21,181,2007,3016,2827,189,6.3
"21181",21,181,2008,3078,2854,224,7.3
"21181",21,181,2009,3157,2773,384,12.2
"21181",21,181,2010,3631,3264,367,10.1
"21181",21,181,2011,3585,3260,325,9.1
"21181",21,181,2012,3535,3244,291,8.2
"21181",21,181,2013,3530,3225,305,8.6
"21181",21,181,2014,3449,3182,267,7.7
"21181",21,181,2015,3327,3129,198,6
"21181",21,181,2016,3370,3184,186,5.5
"21181",21,181,2017,3455,3270,185,5.4
"21183",21,183,1990,8703,7972,731,8.4
"21183",21,183,1991,8945,7900,1045,11.7
"21183",21,183,1992,9095,8040,1055,11.6
"21183",21,183,1993,9155,8218,937,10.2
"21183",21,183,1994,9136,8358,778,8.5
"21183",21,183,1995,9178,8164,1014,11
"21183",21,183,1996,9842,9010,832,8.5
"21183",21,183,1997,10347,9479,868,8.4
"21183",21,183,1998,10174,9417,757,7.4
"21183",21,183,1999,10059,9210,849,8.4
"21183",21,183,2000,10618,10076,542,5.1
"21183",21,183,2001,10660,10017,643,6
"21183",21,183,2002,10811,10051,760,7
"21183",21,183,2003,11065,10230,835,7.5
"21183",21,183,2004,11129,10443,686,6.2
"21183",21,183,2005,11590,10832,758,6.5
"21183",21,183,2006,11813,11104,709,6
"21183",21,183,2007,12009,11381,628,5.2
"21183",21,183,2008,12504,11706,798,6.4
"21183",21,183,2009,12672,11442,1230,9.7
"21183",21,183,2010,10316,9159,1157,11.2
"21183",21,183,2011,10352,9332,1020,9.9
"21183",21,183,2012,10383,9482,901,8.7
"21183",21,183,2013,9901,8982,919,9.3
"21183",21,183,2014,9511,8780,731,7.7
"21183",21,183,2015,9411,8819,592,6.3
"21183",21,183,2016,9643,9002,641,6.6
"21183",21,183,2017,9816,9190,626,6.4
"21185",21,185,1990,17438,16912,526,3
"21185",21,185,1991,17950,17324,626,3.5
"21185",21,185,1992,18635,18072,563,3
"21185",21,185,1993,19534,19071,463,2.4
"21185",21,185,1994,20703,20243,460,2.2
"21185",21,185,1995,21537,21046,491,2.3
"21185",21,185,1996,22205,21654,551,2.5
"21185",21,185,1997,23252,22781,471,2
"21185",21,185,1998,24238,23781,457,1.9
"21185",21,185,1999,25283,24796,487,1.9
"21185",21,185,2000,24177,23456,721,3
"21185",21,185,2001,23938,23105,833,3.5
"21185",21,185,2002,23928,22963,965,4
"21185",21,185,2003,24449,23373,1076,4.4
"21185",21,185,2004,25192,24179,1013,4
"21185",21,185,2005,26226,24974,1252,4.8
"21185",21,185,2006,27396,26048,1348,4.9
"21185",21,185,2007,27555,26246,1309,4.8
"21185",21,185,2008,27753,26199,1554,5.6
"21185",21,185,2009,28068,25726,2342,8.3
"21185",21,185,2010,29248,27042,2206,7.5
"21185",21,185,2011,29260,27225,2035,7
"21185",21,185,2012,29797,28045,1752,5.9
"21185",21,185,2013,30308,28582,1726,5.7
"21185",21,185,2014,30238,28805,1433,4.7
"21185",21,185,2015,30687,29485,1202,3.9
"21185",21,185,2016,31643,30553,1090,3.4
"21185",21,185,2017,32553,31407,1146,3.5
"21187",21,187,1990,4287,4136,151,3.5
"21187",21,187,1991,4214,4026,188,4.5
"21187",21,187,1992,4450,4252,198,4.4
"21187",21,187,1993,4607,4415,192,4.2
"21187",21,187,1994,4492,4290,202,4.5
"21187",21,187,1995,4556,4371,185,4.1
"21187",21,187,1996,4522,4330,192,4.2
"21187",21,187,1997,4528,4356,172,3.8
"21187",21,187,1998,4371,4203,168,3.8
"21187",21,187,1999,4331,4198,133,3.1
"21187",21,187,2000,5019,4837,182,3.6
"21187",21,187,2001,5046,4831,215,4.3
"21187",21,187,2002,5075,4838,237,4.7
"21187",21,187,2003,5105,4853,252,4.9
"21187",21,187,2004,5020,4763,257,5.1
"21187",21,187,2005,5133,4835,298,5.8
"21187",21,187,2006,5220,4933,287,5.5
"21187",21,187,2007,5266,5001,265,5
"21187",21,187,2008,5297,4954,343,6.5
"21187",21,187,2009,5537,4996,541,9.8
"21187",21,187,2010,5915,5418,497,8.4
"21187",21,187,2011,5701,5266,435,7.6
"21187",21,187,2012,5750,5373,377,6.6
"21187",21,187,2013,5682,5322,360,6.3
"21187",21,187,2014,5519,5242,277,5
"21187",21,187,2015,5517,5294,223,4
"21187",21,187,2016,5630,5393,237,4.2
"21187",21,187,2017,5581,5341,240,4.3
"21189",21,189,1990,1376,1258,118,8.6
"21189",21,189,1991,1437,1320,117,8.1
"21189",21,189,1992,1530,1403,127,8.3
"21189",21,189,1993,1479,1401,78,5.3
"21189",21,189,1994,1511,1442,69,4.6
"21189",21,189,1995,1569,1472,97,6.2
"21189",21,189,1996,1572,1488,84,5.3
"21189",21,189,1997,1637,1552,85,5.2
"21189",21,189,1998,1711,1629,82,4.8
"21189",21,189,1999,1746,1653,93,5.3
"21189",21,189,2000,1532,1445,87,5.7
"21189",21,189,2001,1581,1473,108,6.8
"21189",21,189,2002,1605,1498,107,6.7
"21189",21,189,2003,1583,1448,135,8.5
"21189",21,189,2004,1572,1456,116,7.4
"21189",21,189,2005,1556,1436,120,7.7
"21189",21,189,2006,1534,1408,126,8.2
"21189",21,189,2007,1577,1432,145,9.2
"21189",21,189,2008,1528,1405,123,8
"21189",21,189,2009,1576,1411,165,10.5
"21189",21,189,2010,1362,1181,181,13.3
"21189",21,189,2011,1389,1206,183,13.2
"21189",21,189,2012,1327,1157,170,12.8
"21189",21,189,2013,1291,1128,163,12.6
"21189",21,189,2014,1177,1054,123,10.5
"21189",21,189,2015,1185,1069,116,9.8
"21189",21,189,2016,1169,1059,110,9.4
"21189",21,189,2017,1139,1047,92,8.1
"21191",21,191,1990,5702,5479,223,3.9
"21191",21,191,1991,5891,5469,422,7.2
"21191",21,191,1992,5968,5512,456,7.6
"21191",21,191,1993,5949,5608,341,5.7
"21191",21,191,1994,6105,5803,302,4.9
"21191",21,191,1995,6248,5950,298,4.8
"21191",21,191,1996,6444,6120,324,5
"21191",21,191,1997,6795,6323,472,6.9
"21191",21,191,1998,6560,6315,245,3.7
"21191",21,191,1999,6700,6441,259,3.9
"21191",21,191,2000,7199,6950,249,3.5
"21191",21,191,2001,7166,6840,326,4.5
"21191",21,191,2002,7164,6812,352,4.9
"21191",21,191,2003,7342,6889,453,6.2
"21191",21,191,2004,7392,7032,360,4.9
"21191",21,191,2005,7494,7069,425,5.7
"21191",21,191,2006,7514,7095,419,5.6
"21191",21,191,2007,7308,6881,427,5.8
"21191",21,191,2008,7296,6736,560,7.7
"21191",21,191,2009,7308,6407,901,12.3
"21191",21,191,2010,7387,6480,907,12.3
"21191",21,191,2011,7201,6421,780,10.8
"21191",21,191,2012,7064,6440,624,8.8
"21191",21,191,2013,7016,6428,588,8.4
"21191",21,191,2014,6754,6304,450,6.7
"21191",21,191,2015,6608,6253,355,5.4
"21191",21,191,2016,6777,6446,331,4.9
"21191",21,191,2017,6952,6622,330,4.7
"21193",21,193,1990,10678,9785,893,8.4
"21193",21,193,1991,10927,9509,1418,13
"21193",21,193,1992,11287,10043,1244,11
"21193",21,193,1993,11477,10335,1142,10
"21193",21,193,1994,11378,10375,1003,8.8
"21193",21,193,1995,11679,10450,1229,10.5
"21193",21,193,1996,11416,10386,1030,9
"21193",21,193,1997,11596,10747,849,7.3
"21193",21,193,1998,11854,11059,795,6.7
"21193",21,193,1999,11707,10782,925,7.9
"21193",21,193,2000,10033,9365,668,6.7
"21193",21,193,2001,10336,9650,686,6.6
"21193",21,193,2002,10411,9590,821,7.9
"21193",21,193,2003,10555,9617,938,8.9
"21193",21,193,2004,10884,10048,836,7.7
"21193",21,193,2005,11300,10495,805,7.1
"21193",21,193,2006,11487,10700,787,6.9
"21193",21,193,2007,11415,10618,797,7
"21193",21,193,2008,11184,10420,764,6.8
"21193",21,193,2009,11640,10396,1244,10.7
"21193",21,193,2010,11065,9766,1299,11.7
"21193",21,193,2011,11020,9875,1145,10.4
"21193",21,193,2012,10957,9582,1375,12.5
"21193",21,193,2013,10407,8957,1450,13.9
"21193",21,193,2014,9529,8546,983,10.3
"21193",21,193,2015,9009,8209,800,8.9
"21193",21,193,2016,8753,7821,932,10.6
"21193",21,193,2017,8648,7936,712,8.2
"21195",21,195,1990,25577,23597,1980,7.7
"21195",21,195,1991,26699,23881,2818,10.6
"21195",21,195,1992,26821,23631,3190,11.9
"21195",21,195,1993,27066,23873,3193,11.8
"21195",21,195,1994,27166,24609,2557,9.4
"21195",21,195,1995,27830,25222,2608,9.4
"21195",21,195,1996,27268,24638,2630,9.6
"21195",21,195,1997,27623,25458,2165,7.8
"21195",21,195,1998,27319,25534,1785,6.5
"21195",21,195,1999,27482,25383,2099,7.6
"21195",21,195,2000,25018,23495,1523,6.1
"21195",21,195,2001,25169,23753,1416,5.6
"21195",21,195,2002,25028,23333,1695,6.8
"21195",21,195,2003,24225,22327,1898,7.8
"21195",21,195,2004,23933,22384,1549,6.5
"21195",21,195,2005,24724,23181,1543,6.2
"21195",21,195,2006,25085,23599,1486,5.9
"21195",21,195,2007,25145,23668,1477,5.9
"21195",21,195,2008,25688,24186,1502,5.8
"21195",21,195,2009,26346,23811,2535,9.6
"21195",21,195,2010,24504,21948,2556,10.4
"21195",21,195,2011,24323,22094,2229,9.2
"21195",21,195,2012,24197,21855,2342,9.7
"21195",21,195,2013,23294,20527,2767,11.9
"21195",21,195,2014,21975,19665,2310,10.5
"21195",21,195,2015,20891,18954,1937,9.3
"21195",21,195,2016,20324,18110,2214,10.9
"21195",21,195,2017,20466,18852,1614,7.9
"21197",21,197,1990,5110,4520,590,11.5
"21197",21,197,1991,5415,4736,679,12.5
"21197",21,197,1992,5784,5233,551,9.5
"21197",21,197,1993,6044,5475,569,9.4
"21197",21,197,1994,6453,5918,535,8.3
"21197",21,197,1995,6692,6225,467,7
"21197",21,197,1996,6950,6486,464,6.7
"21197",21,197,1997,6750,6277,473,7
"21197",21,197,1998,6614,6244,370,5.6
"21197",21,197,1999,6456,6080,376,5.8
"21197",21,197,2000,5836,5551,285,4.9
"21197",21,197,2001,5901,5487,414,7
"21197",21,197,2002,5731,5329,402,7
"21197",21,197,2003,5669,5158,511,9
"21197",21,197,2004,5518,5068,450,8.2
"21197",21,197,2005,5503,5079,424,7.7
"21197",21,197,2006,5607,5201,406,7.2
"21197",21,197,2007,5669,5295,374,6.6
"21197",21,197,2008,5440,4974,466,8.6
"21197",21,197,2009,5749,4856,893,15.5
"21197",21,197,2010,5290,4468,822,15.5
"21197",21,197,2011,5153,4487,666,12.9
"21197",21,197,2012,5069,4516,553,10.9
"21197",21,197,2013,5057,4513,544,10.8
"21197",21,197,2014,4966,4545,421,8.5
"21197",21,197,2015,4915,4571,344,7
"21197",21,197,2016,5009,4652,357,7.1
"21197",21,197,2017,5120,4782,338,6.6
"21199",21,199,1990,22920,20927,1993,8.7
"21199",21,199,1991,23262,21126,2136,9.2
"21199",21,199,1992,23160,21196,1964,8.5
"21199",21,199,1993,23502,21645,1857,7.9
"21199",21,199,1994,23783,22332,1451,6.1
"21199",21,199,1995,24103,22785,1318,5.5
"21199",21,199,1996,24464,23104,1360,5.6
"21199",21,199,1997,25333,23868,1465,5.8
"21199",21,199,1998,26164,24649,1515,5.8
"21199",21,199,1999,26151,24899,1252,4.8
"21199",21,199,2000,25802,24681,1121,4.3
"21199",21,199,2001,26612,24856,1756,6.6
"21199",21,199,2002,26218,24345,1873,7.1
"21199",21,199,2003,26428,24628,1800,6.8
"21199",21,199,2004,26365,24947,1418,5.4
"21199",21,199,2005,26782,25179,1603,6
"21199",21,199,2006,27255,25491,1764,6.5
"21199",21,199,2007,27166,25565,1601,5.9
"21199",21,199,2008,27087,25265,1822,6.7
"21199",21,199,2009,27808,24931,2877,10.3
"21199",21,199,2010,27776,24831,2945,10.6
"21199",21,199,2011,27525,24591,2934,10.7
"21199",21,199,2012,27305,24725,2580,9.4
"21199",21,199,2013,27242,24742,2500,9.2
"21199",21,199,2014,26254,24325,1929,7.3
"21199",21,199,2015,25801,24301,1500,5.8
"21199",21,199,2016,25895,24508,1387,5.4
"21199",21,199,2017,25539,24115,1424,5.6
"21201",21,201,1990,923,877,46,5
"21201",21,201,1991,928,860,68,7.3
"21201",21,201,1992,941,874,67,7.1
"21201",21,201,1993,947,886,61,6.4
"21201",21,201,1994,979,930,49,5
"21201",21,201,1995,1005,945,60,6
"21201",21,201,1996,997,950,47,4.7
"21201",21,201,1997,979,923,56,5.7
"21201",21,201,1998,1004,961,43,4.3
"21201",21,201,1999,1056,1005,51,4.8
"21201",21,201,2000,1098,1050,48,4.4
"21201",21,201,2001,1096,1044,52,4.7
"21201",21,201,2002,1070,1015,55,5.1
"21201",21,201,2003,1144,1077,67,5.9
"21201",21,201,2004,1087,1024,63,5.8
"21201",21,201,2005,1079,1003,76,7
"21201",21,201,2006,1051,995,56,5.3
"21201",21,201,2007,1065,1014,51,4.8
"21201",21,201,2008,984,924,60,6.1
"21201",21,201,2009,1068,962,106,9.9
"21201",21,201,2010,869,768,101,11.6
"21201",21,201,2011,859,763,96,11.2
"21201",21,201,2012,849,762,87,10.2
"21201",21,201,2013,849,756,93,11
"21201",21,201,2014,808,745,63,7.8
"21201",21,201,2015,796,745,51,6.4
"21201",21,201,2016,822,772,50,6.1
"21201",21,201,2017,838,786,52,6.2
"21203",21,203,1990,6177,5562,615,10
"21203",21,203,1991,6425,5774,651,10.1
"21203",21,203,1992,5812,5261,551,9.5
"21203",21,203,1993,5657,5177,480,8.5
"21203",21,203,1994,5820,5378,442,7.6
"21203",21,203,1995,6010,5599,411,6.8
"21203",21,203,1996,6092,5683,409,6.7
"21203",21,203,1997,6080,5716,364,6
"21203",21,203,1998,6122,5835,287,4.7
"21203",21,203,1999,6253,5913,340,5.4
"21203",21,203,2000,7184,6847,337,4.7
"21203",21,203,2001,7118,6663,455,6.4
"21203",21,203,2002,7038,6635,403,5.7
"21203",21,203,2003,7173,6773,400,5.6
"21203",21,203,2004,7159,6756,403,5.6
"21203",21,203,2005,7392,6864,528,7.1
"21203",21,203,2006,7539,7026,513,6.8
"21203",21,203,2007,7239,6762,477,6.6
"21203",21,203,2008,7221,6692,529,7.3
"21203",21,203,2009,7256,6296,960,13.2
"21203",21,203,2010,7028,6240,788,11.2
"21203",21,203,2011,7193,6369,824,11.5
"21203",21,203,2012,7190,6457,733,10.2
"21203",21,203,2013,7084,6428,656,9.3
"21203",21,203,2014,6880,6360,520,7.6
"21203",21,203,2015,6773,6334,439,6.5
"21203",21,203,2016,6596,6185,411,6.2
"21203",21,203,2017,6702,6314,388,5.8
"21205",21,205,1990,9396,8546,850,9
"21205",21,205,1991,9298,8499,799,8.6
"21205",21,205,1992,8972,8288,684,7.6
"21205",21,205,1993,9123,8489,634,6.9
"21205",21,205,1994,9140,8464,676,7.4
"21205",21,205,1995,9133,8575,558,6.1
"21205",21,205,1996,8823,8312,511,5.8
"21205",21,205,1997,9146,8681,465,5.1
"21205",21,205,1998,9304,8964,340,3.7
"21205",21,205,1999,9454,9094,360,3.8
"21205",21,205,2000,10829,10361,468,4.3
"21205",21,205,2001,11107,10452,655,5.9
"21205",21,205,2002,11221,10576,645,5.7
"21205",21,205,2003,12086,11440,646,5.3
"21205",21,205,2004,12245,11635,610,5
"21205",21,205,2005,12137,11439,698,5.8
"21205",21,205,2006,12199,11500,699,5.7
"21205",21,205,2007,12183,11532,651,5.3
"21205",21,205,2008,12332,11592,740,6
"21205",21,205,2009,12481,11344,1137,9.1
"21205",21,205,2010,10912,9807,1105,10.1
"21205",21,205,2011,11237,10168,1069,9.5
"21205",21,205,2012,11189,10258,931,8.3
"21205",21,205,2013,10929,10021,908,8.3
"21205",21,205,2014,10544,9809,735,7
"21205",21,205,2015,10454,9843,611,5.8
"21205",21,205,2016,10791,10160,631,5.8
"21205",21,205,2017,10711,10093,618,5.8
"21207",21,207,1990,6907,6465,442,6.4
"21207",21,207,1991,6939,5755,1184,17.1
"21207",21,207,1992,6816,6034,782,11.5
"21207",21,207,1993,6777,6119,658,9.7
"21207",21,207,1994,6618,6098,520,7.9
"21207",21,207,1995,6581,5948,633,9.6
"21207",21,207,1996,6422,5675,747,11.6
"21207",21,207,1997,6280,5404,876,13.9
"21207",21,207,1998,6316,4672,1644,26
"21207",21,207,1999,5810,5104,706,12.2
"21207",21,207,2000,7466,7041,425,5.7
"21207",21,207,2001,7760,7278,482,6.2
"21207",21,207,2002,7685,7095,590,7.7
"21207",21,207,2003,7804,7226,578,7.4
"21207",21,207,2004,7694,7230,464,6
"21207",21,207,2005,7864,7346,518,6.6
"21207",21,207,2006,8185,7650,535,6.5
"21207",21,207,2007,8136,7637,499,6.1
"21207",21,207,2008,8238,7635,603,7.3
"21207",21,207,2009,8413,7404,1009,12
"21207",21,207,2010,7297,6361,936,12.8
"21207",21,207,2011,7350,6488,862,11.7
"21207",21,207,2012,7224,6478,746,10.3
"21207",21,207,2013,7029,6216,813,11.6
"21207",21,207,2014,6578,5904,674,10.2
"21207",21,207,2015,6168,5446,722,11.7
"21207",21,207,2016,6169,5650,519,8.4
"21207",21,207,2017,6273,5824,449,7.2
"21209",21,209,1990,12985,12416,569,4.4
"21209",21,209,1991,12996,12387,609,4.7
"21209",21,209,1992,13290,12729,561,4.2
"21209",21,209,1993,13845,13339,506,3.7
"21209",21,209,1994,14261,13783,478,3.4
"21209",21,209,1995,14916,14499,417,2.8
"21209",21,209,1996,15466,15029,437,2.8
"21209",21,209,1997,16336,15939,397,2.4
"21209",21,209,1998,17205,16847,358,2.1
"21209",21,209,1999,18190,17834,356,2
"21209",21,209,2000,18430,17855,575,3.1
"21209",21,209,2001,18617,17888,729,3.9
"21209",21,209,2002,18820,17917,903,4.8
"21209",21,209,2003,19375,18335,1040,5.4
"21209",21,209,2004,19629,18751,878,4.5
"21209",21,209,2005,20631,19630,1001,4.9
"21209",21,209,2006,21915,20888,1027,4.7
"21209",21,209,2007,22332,21360,972,4.4
"21209",21,209,2008,22779,21542,1237,5.4
"21209",21,209,2009,22942,20731,2211,9.6
"21209",21,209,2010,25429,23216,2213,8.7
"21209",21,209,2011,25543,23511,2032,8
"21209",21,209,2012,25810,24124,1686,6.5
"21209",21,209,2013,26264,24667,1597,6.1
"21209",21,209,2014,26461,25170,1291,4.9
"21209",21,209,2015,26694,25634,1060,4
"21209",21,209,2016,27715,26646,1069,3.9
"21209",21,209,2017,28401,27339,1062,3.7
"21211",21,211,1990,13748,13358,390,2.8
"21211",21,211,1991,13656,13109,547,4
"21211",21,211,1992,14402,13970,432,3
"21211",21,211,1993,14875,14460,415,2.8
"21211",21,211,1994,15719,15376,343,2.2
"21211",21,211,1995,15979,15501,478,3
"21211",21,211,1996,16432,16026,406,2.5
"21211",21,211,1997,16348,15921,427,2.6
"21211",21,211,1998,17018,16644,374,2.2
"21211",21,211,1999,18001,17569,432,2.4
"21211",21,211,2000,18420,17867,553,3
"21211",21,211,2001,18343,17562,781,4.3
"21211",21,211,2002,18310,17449,861,4.7
"21211",21,211,2003,18705,17744,961,5.1
"21211",21,211,2004,19241,18397,844,4.4
"21211",21,211,2005,20059,19022,1037,5.2
"21211",21,211,2006,21058,19972,1086,5.2
"21211",21,211,2007,21258,20261,997,4.7
"21211",21,211,2008,21465,20235,1230,5.7
"21211",21,211,2009,21942,19886,2056,9.4
"21211",21,211,2010,21851,19900,1951,8.9
"21211",21,211,2011,21968,20222,1746,7.9
"21211",21,211,2012,22277,20888,1389,6.2
"21211",21,211,2013,22623,21250,1373,6.1
"21211",21,211,2014,22477,21365,1112,4.9
"21211",21,211,2015,22711,21792,919,4
"21211",21,211,2016,23595,22740,855,3.6
"21211",21,211,2017,24212,23333,879,3.6
"21213",21,213,1990,7960,7458,502,6.3
"21213",21,213,1991,7730,7164,566,7.3
"21213",21,213,1992,7920,7366,554,7
"21213",21,213,1993,8170,7576,594,7.3
"21213",21,213,1994,8082,7545,537,6.6
"21213",21,213,1995,8199,7792,407,5
"21213",21,213,1996,7531,7082,449,6
"21213",21,213,1997,7645,7309,336,4.4
"21213",21,213,1998,7893,7633,260,3.3
"21213",21,213,1999,8303,8034,269,3.2
"21213",21,213,2000,8510,8219,291,3.4
"21213",21,213,2001,8569,8105,464,5.4
"21213",21,213,2002,8322,7839,483,5.8
"21213",21,213,2003,8590,8110,480,5.6
"21213",21,213,2004,8610,8197,413,4.8
"21213",21,213,2005,8811,8319,492,5.6
"21213",21,213,2006,8998,8481,517,5.7
"21213",21,213,2007,9345,8873,472,5.1
"21213",21,213,2008,9364,8764,600,6.4
"21213",21,213,2009,9235,8043,1192,12.9
"21213",21,213,2010,8642,7521,1121,13
"21213",21,213,2011,8612,7662,950,11
"21213",21,213,2012,8965,8200,765,8.5
"21213",21,213,2013,8854,8189,665,7.5
"21213",21,213,2014,8481,7981,500,5.9
"21213",21,213,2015,8333,7935,398,4.8
"21213",21,213,2016,8402,8025,377,4.5
"21213",21,213,2017,8731,8334,397,4.5
"21215",21,215,1990,3390,3275,115,3.4
"21215",21,215,1991,3740,3579,161,4.3
"21215",21,215,1992,3833,3718,115,3
"21215",21,215,1993,4113,3976,137,3.3
"21215",21,215,1994,4400,4276,124,2.8
"21215",21,215,1995,4658,4481,177,3.8
"21215",21,215,1996,4598,4409,189,4.1
"21215",21,215,1997,4763,4553,210,4.4
"21215",21,215,1998,4896,4747,149,3
"21215",21,215,1999,5294,5113,181,3.4
"21215",21,215,2000,6559,6362,197,3
"21215",21,215,2001,6840,6561,279,4.1
"21215",21,215,2002,7028,6735,293,4.2
"21215",21,215,2003,7352,7018,334,4.5
"21215",21,215,2004,7670,7314,356,4.6
"21215",21,215,2005,8190,7752,438,5.3
"21215",21,215,2006,8763,8241,522,6
"21215",21,215,2007,8919,8387,532,6
"21215",21,215,2008,9172,8501,671,7.3
"21215",21,215,2009,9297,8339,958,10.3
"21215",21,215,2010,9205,8291,914,9.9
"21215",21,215,2011,9248,8411,837,9.1
"21215",21,215,2012,9263,8611,652,7
"21215",21,215,2013,9341,8740,601,6.4
"21215",21,215,2014,9148,8665,483,5.3
"21215",21,215,2015,9186,8789,397,4.3
"21215",21,215,2016,9571,9201,370,3.9
"21215",21,215,2017,9838,9460,378,3.8
"21217",21,217,1990,10898,10437,461,4.2
"21217",21,217,1991,10910,10273,637,5.8
"21217",21,217,1992,11214,10665,549,4.9
"21217",21,217,1993,11461,11022,439,3.8
"21217",21,217,1994,11594,11107,487,4.2
"21217",21,217,1995,11359,10847,512,4.5
"21217",21,217,1996,11318,10673,645,5.7
"21217",21,217,1997,11146,10066,1080,9.7
"21217",21,217,1998,11358,8742,2616,23
"21217",21,217,1999,9764,8228,1536,15.7
"21217",21,217,2000,11240,10660,580,5.2
"21217",21,217,2001,11768,11173,595,5.1
"21217",21,217,2002,11994,11358,636,5.3
"21217",21,217,2003,12125,11431,694,5.7
"21217",21,217,2004,12233,11615,618,5.1
"21217",21,217,2005,12891,12214,677,5.3
"21217",21,217,2006,13357,12726,631,4.7
"21217",21,217,2007,13726,12993,733,5.3
"21217",21,217,2008,13543,12723,820,6.1
"21217",21,217,2009,13762,12325,1437,10.4
"21217",21,217,2010,11802,10355,1447,12.3
"21217",21,217,2011,11925,10634,1291,10.8
"21217",21,217,2012,11685,10565,1120,9.6
"21217",21,217,2013,11389,10313,1076,9.4
"21217",21,217,2014,11266,10396,870,7.7
"21217",21,217,2015,11108,10400,708,6.4
"21217",21,217,2016,11598,10988,610,5.3
"21217",21,217,2017,12174,11604,570,4.7
"21219",21,219,1990,5144,4803,341,6.6
"21219",21,219,1991,4827,4438,389,8.1
"21219",21,219,1992,5169,4903,266,5.1
"21219",21,219,1993,5331,5106,225,4.2
"21219",21,219,1994,5518,5308,210,3.8
"21219",21,219,1995,5447,5196,251,4.6
"21219",21,219,1996,5373,5138,235,4.4
"21219",21,219,1997,5428,5172,256,4.7
"21219",21,219,1998,5379,5199,180,3.3
"21219",21,219,1999,5338,5175,163,3.1
"21219",21,219,2000,5778,5542,236,4.1
"21219",21,219,2001,5908,5526,382,6.5
"21219",21,219,2002,5791,5499,292,5
"21219",21,219,2003,5941,5678,263,4.4
"21219",21,219,2004,5534,5283,251,4.5
"21219",21,219,2005,5334,4986,348,6.5
"21219",21,219,2006,5133,4643,490,9.5
"21219",21,219,2007,5020,4693,327,6.5
"21219",21,219,2008,5229,4857,372,7.1
"21219",21,219,2009,5331,4694,637,11.9
"21219",21,219,2010,5676,5106,570,10
"21219",21,219,2011,5708,5210,498,8.7
"21219",21,219,2012,5674,5243,431,7.6
"21219",21,219,2013,5632,5214,418,7.4
"21219",21,219,2014,5455,5159,296,5.4
"21219",21,219,2015,5425,5172,253,4.7
"21219",21,219,2016,5511,5273,238,4.3
"21219",21,219,2017,5502,5278,224,4.1
"21221",21,221,1990,4960,4702,258,5.2
"21221",21,221,1991,5326,4985,341,6.4
"21221",21,221,1992,5463,5144,319,5.8
"21221",21,221,1993,5513,5177,336,6.1
"21221",21,221,1994,5638,5389,249,4.4
"21221",21,221,1995,5769,5494,275,4.8
"21221",21,221,1996,5879,5618,261,4.4
"21221",21,221,1997,5883,5592,291,4.9
"21221",21,221,1998,5773,5552,221,3.8
"21221",21,221,1999,5946,5763,183,3.1
"21221",21,221,2000,5977,5711,266,4.5
"21221",21,221,2001,5954,5614,340,5.7
"21221",21,221,2002,6005,5615,390,6.5
"21221",21,221,2003,6079,5721,358,5.9
"21221",21,221,2004,6395,6077,318,5
"21221",21,221,2005,6469,6044,425,6.6
"21221",21,221,2006,6707,6322,385,5.7
"21221",21,221,2007,6266,5900,366,5.8
"21221",21,221,2008,6246,5764,482,7.7
"21221",21,221,2009,6457,5460,997,15.4
"21221",21,221,2010,6440,5531,909,14.1
"21221",21,221,2011,6190,5487,703,11.4
"21221",21,221,2012,6034,5469,565,9.4
"21221",21,221,2013,6046,5500,546,9
"21221",21,221,2014,5711,5307,404,7.1
"21221",21,221,2015,5670,5343,327,5.8
"21221",21,221,2016,5757,5429,328,5.7
"21221",21,221,2017,5863,5525,338,5.8
"21223",21,223,1990,2885,2752,133,4.6
"21223",21,223,1991,2819,2655,164,5.8
"21223",21,223,1992,2858,2711,147,5.1
"21223",21,223,1993,2936,2800,136,4.6
"21223",21,223,1994,3027,2912,115,3.8
"21223",21,223,1995,3119,2994,125,4
"21223",21,223,1996,3128,2996,132,4.2
"21223",21,223,1997,3153,3015,138,4.4
"21223",21,223,1998,3182,3035,147,4.6
"21223",21,223,1999,3179,3090,89,2.8
"21223",21,223,2000,4105,3951,154,3.8
"21223",21,223,2001,4158,3936,222,5.3
"21223",21,223,2002,4116,3916,200,4.9
"21223",21,223,2003,4166,3933,233,5.6
"21223",21,223,2004,4279,4050,229,5.4
"21223",21,223,2005,4358,4080,278,6.4
"21223",21,223,2006,4440,4143,297,6.7
"21223",21,223,2007,4353,4085,268,6.2
"21223",21,223,2008,4339,4024,315,7.3
"21223",21,223,2009,4355,3845,510,11.7
"21223",21,223,2010,4088,3561,527,12.9
"21223",21,223,2011,4016,3559,457,11.4
"21223",21,223,2012,3988,3628,360,9
"21223",21,223,2013,3967,3637,330,8.3
"21223",21,223,2014,3873,3591,282,7.3
"21223",21,223,2015,3811,3595,216,5.7
"21223",21,223,2016,3836,3626,210,5.5
"21223",21,223,2017,3915,3720,195,5
"21225",21,225,1990,7078,6581,497,7
"21225",21,225,1991,7318,6669,649,8.9
"21225",21,225,1992,7214,6591,623,8.6
"21225",21,225,1993,6962,6344,618,8.9
"21225",21,225,1994,6670,6306,364,5.5
"21225",21,225,1995,6649,6199,450,6.8
"21225",21,225,1996,6420,5943,477,7.4
"21225",21,225,1997,6003,5443,560,9.3
"21225",21,225,1998,5806,5433,373,6.4
"21225",21,225,1999,6221,5833,388,6.2
"21225",21,225,2000,7447,7096,351,4.7
"21225",21,225,2001,7403,6995,408,5.5
"21225",21,225,2002,7585,7194,391,5.2
"21225",21,225,2003,7549,7080,469,6.2
"21225",21,225,2004,7232,6845,387,5.4
"21225",21,225,2005,7192,6764,428,6
"21225",21,225,2006,7179,6756,423,5.9
"21225",21,225,2007,7084,6691,393,5.5
"21225",21,225,2008,7654,7153,501,6.5
"21225",21,225,2009,7859,6967,892,11.4
"21225",21,225,2010,7687,6941,746,9.7
"21225",21,225,2011,7598,6914,684,9
"21225",21,225,2012,7024,6476,548,7.8
"21225",21,225,2013,6856,6328,528,7.7
"21225",21,225,2014,6752,6319,433,6.4
"21225",21,225,2015,6191,5777,414,6.7
"21225",21,225,2016,6241,5820,421,6.7
"21225",21,225,2017,6191,5821,370,6
"21227",21,227,1990,42804,39745,3059,7.1
"21227",21,227,1991,43037,40062,2975,6.9
"21227",21,227,1992,44250,41764,2486,5.6
"21227",21,227,1993,44474,42349,2125,4.8
"21227",21,227,1994,44828,43223,1605,3.6
"21227",21,227,1995,46279,44248,2031,4.4
"21227",21,227,1996,48219,45297,2922,6.1
"21227",21,227,1997,49387,46702,2685,5.4
"21227",21,227,1998,49152,47029,2123,4.3
"21227",21,227,1999,49898,48217,1681,3.4
"21227",21,227,2000,50447,48580,1867,3.7
"21227",21,227,2001,50031,47664,2367,4.7
"21227",21,227,2002,50382,47836,2546,5.1
"21227",21,227,2003,51487,48690,2797,5.4
"21227",21,227,2004,52523,50143,2380,4.5
"21227",21,227,2005,55266,52543,2723,4.9
"21227",21,227,2006,56606,53891,2715,4.8
"21227",21,227,2007,57538,55042,2496,4.3
"21227",21,227,2008,57842,54741,3101,5.4
"21227",21,227,2009,58570,52766,5804,9.9
"21227",21,227,2010,58221,52861,5360,9.2
"21227",21,227,2011,58969,54095,4874,8.3
"21227",21,227,2012,59961,55795,4166,6.9
"21227",21,227,2013,60475,56322,4153,6.9
"21227",21,227,2014,59313,56015,3298,5.6
"21227",21,227,2015,58932,56277,2655,4.5
"21227",21,227,2016,61301,58864,2437,4
"21227",21,227,2017,63289,60724,2565,4.1
"21229",21,229,1990,4842,4574,268,5.5
"21229",21,229,1991,4920,4591,329,6.7
"21229",21,229,1992,5174,4922,252,4.9
"21229",21,229,1993,5674,5472,202,3.6
"21229",21,229,1994,5598,5395,203,3.6
"21229",21,229,1995,5764,5543,221,3.8
"21229",21,229,1996,5817,5490,327,5.6
"21229",21,229,1997,5929,5661,268,4.5
"21229",21,229,1998,6111,5908,203,3.3
"21229",21,229,1999,5763,5538,225,3.9
"21229",21,229,2000,5247,5032,215,4.1
"21229",21,229,2001,5388,5071,317,5.9
"21229",21,229,2002,5282,4974,308,5.8
"21229",21,229,2003,5433,5123,310,5.7
"21229",21,229,2004,5167,4885,282,5.5
"21229",21,229,2005,5149,4840,309,6
"21229",21,229,2006,5360,5051,309,5.8
"21229",21,229,2007,5406,5105,301,5.6
"21229",21,229,2008,5400,5009,391,7.2
"21229",21,229,2009,5411,4709,702,13
"21229",21,229,2010,6089,5471,618,10.1
"21229",21,229,2011,6125,5557,568,9.3
"21229",21,229,2012,6211,5746,465,7.5
"21229",21,229,2013,6139,5716,423,6.9
"21229",21,229,2014,6118,5786,332,5.4
"21229",21,229,2015,6109,5844,265,4.3
"21229",21,229,2016,6240,5979,261,4.2
"21229",21,229,2017,6365,6105,260,4.1
"21231",21,231,1990,7056,6428,628,8.9
"21231",21,231,1991,7173,6461,712,9.9
"21231",21,231,1992,7222,6564,658,9.1
"21231",21,231,1993,7676,7102,574,7.5
"21231",21,231,1994,7763,7291,472,6.1
"21231",21,231,1995,7758,7240,518,6.7
"21231",21,231,1996,7707,7041,666,8.6
"21231",21,231,1997,7856,7212,644,8.2
"21231",21,231,1998,8155,7264,891,10.9
"21231",21,231,1999,8083,7545,538,6.7
"21231",21,231,2000,8207,7759,448,5.5
"21231",21,231,2001,8417,7805,612,7.3
"21231",21,231,2002,8687,8123,564,6.5
"21231",21,231,2003,8873,8283,590,6.6
"21231",21,231,2004,8891,8398,493,5.5
"21231",21,231,2005,8709,8177,532,6.1
"21231",21,231,2006,8684,8102,582,6.7
"21231",21,231,2007,8575,8014,561,6.5
"21231",21,231,2008,8389,7695,694,8.3
"21231",21,231,2009,8538,7364,1174,13.8
"21231",21,231,2010,8213,7059,1154,14.1
"21231",21,231,2011,7888,6763,1125,14.3
"21231",21,231,2012,7733,6730,1003,13
"21231",21,231,2013,7461,6572,889,11.9
"21231",21,231,2014,7250,6548,702,9.7
"21231",21,231,2015,7276,6703,573,7.9
"21231",21,231,2016,7546,6984,562,7.4
"21231",21,231,2017,7602,7025,577,7.6
"21233",21,233,1990,6011,5630,381,6.3
"21233",21,233,1991,5968,5434,534,8.9
"21233",21,233,1992,5965,5274,691,11.6
"21233",21,233,1993,5849,5332,517,8.8
"21233",21,233,1994,5718,5355,363,6.3
"21233",21,233,1995,5664,5199,465,8.2
"21233",21,233,1996,5647,5232,415,7.3
"21233",21,233,1997,5721,5319,402,7
"21233",21,233,1998,5583,5259,324,5.8
"21233",21,233,1999,5498,5108,390,7.1
"21233",21,233,2000,6805,6494,311,4.6
"21233",21,233,2001,6708,6400,308,4.6
"21233",21,233,2002,6715,6372,343,5.1
"21233",21,233,2003,6682,6241,441,6.6
"21233",21,233,2004,6548,6266,282,4.3
"21233",21,233,2005,6672,6337,335,5
"21233",21,233,2006,6643,6304,339,5.1
"21233",21,233,2007,6530,6148,382,5.8
"21233",21,233,2008,6403,5997,406,6.3
"21233",21,233,2009,6454,5835,619,9.6
"21233",21,233,2010,6121,5542,579,9.5
"21233",21,233,2011,6212,5713,499,8
"21233",21,233,2012,6252,5808,444,7.1
"21233",21,233,2013,6182,5742,440,7.1
"21233",21,233,2014,6282,5940,342,5.4
"21233",21,233,2015,6042,5731,311,5.1
"21233",21,233,2016,5914,5562,352,6
"21233",21,233,2017,5839,5532,307,5.3
"21235",21,235,1990,12740,11731,1009,7.9
"21235",21,235,1991,12691,11537,1154,9.1
"21235",21,235,1992,13067,11834,1233,9.4
"21235",21,235,1993,13339,12283,1056,7.9
"21235",21,235,1994,13457,12394,1063,7.9
"21235",21,235,1995,13625,12742,883,6.5
"21235",21,235,1996,14049,12819,1230,8.8
"21235",21,235,1997,14053,13034,1019,7.3
"21235",21,235,1998,13966,13187,779,5.6
"21235",21,235,1999,14445,13591,854,5.9
"21235",21,235,2000,14347,13647,700,4.9
"21235",21,235,2001,14575,13706,869,6
"21235",21,235,2002,14578,13554,1024,7
"21235",21,235,2003,13991,12965,1026,7.3
"21235",21,235,2004,14858,14005,853,5.7
"21235",21,235,2005,15358,14441,917,6
"21235",21,235,2006,15401,14459,942,6.1
"21235",21,235,2007,15011,14057,954,6.4
"21235",21,235,2008,15370,14241,1129,7.3
"21235",21,235,2009,15660,13894,1766,11.3
"21235",21,235,2010,14127,12346,1781,12.6
"21235",21,235,2011,13901,12228,1673,12
"21235",21,235,2012,13879,12400,1479,10.7
"21235",21,235,2013,13850,12382,1468,10.6
"21235",21,235,2014,13391,12222,1169,8.7
"21235",21,235,2015,13178,12288,890,6.8
"21235",21,235,2016,13431,12545,886,6.6
"21235",21,235,2017,13726,12927,799,5.8
"21237",21,237,1990,2371,2043,328,13.8
"21237",21,237,1991,2808,2453,355,12.6
"21237",21,237,1992,2976,2678,298,10
"21237",21,237,1993,3077,2740,337,11
"21237",21,237,1994,3118,2802,316,10.1
"21237",21,237,1995,3354,3095,259,7.7
"21237",21,237,1996,3349,3124,225,6.7
"21237",21,237,1997,3366,3107,259,7.7
"21237",21,237,1998,3380,3220,160,4.7
"21237",21,237,1999,3316,3148,168,5.1
"21237",21,237,2000,2531,2318,213,8.4
"21237",21,237,2001,2465,2250,215,8.7
"21237",21,237,2002,2414,2215,199,8.2
"21237",21,237,2003,2367,2139,228,9.6
"21237",21,237,2004,2332,2109,223,9.6
"21237",21,237,2005,2306,2076,230,10
"21237",21,237,2006,2327,2108,219,9.4
"21237",21,237,2007,2315,2090,225,9.7
"21237",21,237,2008,2313,2087,226,9.8
"21237",21,237,2009,2388,2067,321,13.4
"21237",21,237,2010,2152,1800,352,16.4
"21237",21,237,2011,2104,1791,313,14.9
"21237",21,237,2012,2103,1804,299,14.2
"21237",21,237,2013,2110,1811,299,14.2
"21237",21,237,2014,2054,1822,232,11.3
"21237",21,237,2015,1953,1759,194,9.9
"21237",21,237,2016,1973,1777,196,9.9
"21237",21,237,2017,1967,1790,177,9
"21239",21,239,1990,11348,10987,361,3.2
"21239",21,239,1991,11373,10940,433,3.8
"21239",21,239,1992,11467,11115,352,3.1
"21239",21,239,1993,11748,11360,388,3.3
"21239",21,239,1994,11927,11556,371,3.1
"21239",21,239,1995,12216,11946,270,2.2
"21239",21,239,1996,12587,12313,274,2.2
"21239",21,239,1997,13065,12780,285,2.2
"21239",21,239,1998,13375,13159,216,1.6
"21239",21,239,1999,13541,13320,221,1.6
"21239",21,239,2000,13479,13110,369,2.7
"21239",21,239,2001,13308,12790,518,3.9
"21239",21,239,2002,13063,12541,522,4
"21239",21,239,2003,12980,12461,519,4
"21239",21,239,2004,12972,12491,481,3.7
"21239",21,239,2005,13300,12747,553,4.2
"21239",21,239,2006,13479,12911,568,4.2
"21239",21,239,2007,13264,12751,513,3.9
"21239",21,239,2008,13134,12508,626,4.8
"21239",21,239,2009,12984,11916,1068,8.2
"21239",21,239,2010,14441,13394,1047,7.3
"21239",21,239,2011,14326,13393,933,6.5
"21239",21,239,2012,14127,13369,758,5.4
"21239",21,239,2013,14249,13494,755,5.3
"21239",21,239,2014,14224,13589,635,4.5
"21239",21,239,2015,14249,13746,503,3.5
"21239",21,239,2016,14611,14134,477,3.3
"21239",21,239,2017,14876,14390,486,3.3
"22001",22,1,1990,21750,20360,1390,6.4
"22001",22,1,1991,22233,20650,1583,7.1
"22001",22,1,1992,22166,20162,2004,9
"22001",22,1,1993,21619,19926,1693,7.8
"22001",22,1,1994,21894,20266,1628,7.4
"22001",22,1,1995,22107,20525,1582,7.2
"22001",22,1,1996,22846,21187,1659,7.3
"22001",22,1,1997,23231,21877,1354,5.8
"22001",22,1,1998,23666,22256,1410,6
"22001",22,1,1999,23337,21592,1745,7.5
"22001",22,1,2000,23944,22552,1392,5.8
"22001",22,1,2001,23711,22289,1422,6
"22001",22,1,2002,23645,22159,1486,6.3
"22001",22,1,2003,23938,22307,1631,6.8
"22001",22,1,2004,23899,22527,1372,5.7
"22001",22,1,2005,25409,23861,1548,6.1
"22001",22,1,2006,25931,24985,946,3.6
"22001",22,1,2007,26303,25315,988,3.8
"22001",22,1,2008,27106,25970,1136,4.2
"22001",22,1,2009,26174,24485,1689,6.5
"22001",22,1,2010,26130,24233,1897,7.3
"22001",22,1,2011,25791,24068,1723,6.7
"22001",22,1,2012,26135,24571,1564,6
"22001",22,1,2013,26330,24760,1570,6
"22001",22,1,2014,26689,25150,1539,5.8
"22001",22,1,2015,25858,24088,1770,6.8
"22001",22,1,2016,24564,22755,1809,7.4
"22001",22,1,2017,24151,22724,1427,5.9
"22003",22,3,1990,7538,6797,741,9.8
"22003",22,3,1991,7926,6932,994,12.5
"22003",22,3,1992,8179,7266,913,11.2
"22003",22,3,1993,8364,7493,871,10.4
"22003",22,3,1994,8345,7465,880,10.5
"22003",22,3,1995,8557,7772,785,9.2
"22003",22,3,1996,8712,8033,679,7.8
"22003",22,3,1997,8856,8220,636,7.2
"22003",22,3,1998,9064,8446,618,6.8
"22003",22,3,1999,9746,9126,620,6.4
"22003",22,3,2000,8737,8148,589,6.7
"22003",22,3,2001,8627,7981,646,7.5
"22003",22,3,2002,8695,7988,707,8.1
"22003",22,3,2003,8979,8195,784,8.7
"22003",22,3,2004,8750,8019,731,8.4
"22003",22,3,2005,8697,7854,843,9.7
"22003",22,3,2006,8710,8253,457,5.2
"22003",22,3,2007,8809,8308,501,5.7
"22003",22,3,2008,8870,8316,554,6.2
"22003",22,3,2009,9092,8240,852,9.4
"22003",22,3,2010,9395,8471,924,9.8
"22003",22,3,2011,9214,8375,839,9.1
"22003",22,3,2012,9098,8372,726,8
"22003",22,3,2013,8745,8086,659,7.5
"22003",22,3,2014,8911,8269,642,7.2
"22003",22,3,2015,8839,8224,615,7
"22003",22,3,2016,8919,8348,571,6.4
"22003",22,3,2017,9023,8548,475,5.3
"22005",22,5,1990,27198,25442,1756,6.5
"22005",22,5,1991,27730,25785,1945,7
"22005",22,5,1992,28437,26562,1875,6.6
"22005",22,5,1993,28137,26093,2044,7.3
"22005",22,5,1994,29268,26983,2285,7.8
"22005",22,5,1995,30056,28109,1947,6.5
"22005",22,5,1996,31359,29443,1916,6.1
"22005",22,5,1997,32199,30527,1672,5.2
"22005",22,5,1998,33622,31997,1625,4.8
"22005",22,5,1999,35234,33695,1539,4.4
"22005",22,5,2000,38466,36431,2035,5.3
"22005",22,5,2001,38751,36592,2159,5.6
"22005",22,5,2002,39392,36846,2546,6.5
"22005",22,5,2003,40892,38109,2783,6.8
"22005",22,5,2004,42704,39916,2788,6.5
"22005",22,5,2005,45815,42827,2988,6.5
"22005",22,5,2006,47386,45441,1945,4.1
"22005",22,5,2007,48952,47011,1941,4
"22005",22,5,2008,50938,48704,2234,4.4
"22005",22,5,2009,51521,48463,3058,5.9
"22005",22,5,2010,53392,49414,3978,7.5
"22005",22,5,2011,53941,50141,3800,7
"22005",22,5,2012,54849,51502,3347,6.1
"22005",22,5,2013,56781,53609,3172,5.6
"22005",22,5,2014,59751,56561,3190,5.3
"22005",22,5,2015,61748,58625,3123,5.1
"22005",22,5,2016,62130,59100,3030,4.9
"22005",22,5,2017,62243,59580,2663,4.3
"22007",22,7,1990,9317,8706,611,6.6
"22007",22,7,1991,9516,8791,725,7.6
"22007",22,7,1992,9038,8121,917,10.1
"22007",22,7,1993,9081,8167,914,10.1
"22007",22,7,1994,9180,8340,840,9.2
"22007",22,7,1995,9139,8405,734,8
"22007",22,7,1996,9165,8551,614,6.7
"22007",22,7,1997,9881,9306,575,5.8
"22007",22,7,1998,9796,9262,534,5.5
"22007",22,7,1999,9002,8358,644,7.2
"22007",22,7,2000,10014,9370,644,6.4
"22007",22,7,2001,10391,9761,630,6.1
"22007",22,7,2002,10471,9803,668,6.4
"22007",22,7,2003,10597,9881,716,6.8
"22007",22,7,2004,10478,9593,885,8.4
"22007",22,7,2005,10045,9053,992,9.9
"22007",22,7,2006,10204,9645,559,5.5
"22007",22,7,2007,10461,9973,488,4.7
"22007",22,7,2008,10671,10050,621,5.8
"22007",22,7,2009,10437,9598,839,8
"22007",22,7,2010,10067,8902,1165,11.6
"22007",22,7,2011,9974,8770,1204,12.1
"22007",22,7,2012,9950,8988,962,9.7
"22007",22,7,2013,9912,9090,822,8.3
"22007",22,7,2014,10075,9298,777,7.7
"22007",22,7,2015,9816,9044,772,7.9
"22007",22,7,2016,9227,8454,773,8.4
"22007",22,7,2017,8960,8299,661,7.4
"22009",22,9,1990,14504,13096,1408,9.7
"22009",22,9,1991,14374,12511,1863,13
"22009",22,9,1992,14586,12839,1747,12
"22009",22,9,1993,14511,13015,1496,10.3
"22009",22,9,1994,16052,14337,1715,10.7
"22009",22,9,1995,16114,14739,1375,8.5
"22009",22,9,1996,16093,14687,1406,8.7
"22009",22,9,1997,16371,15103,1268,7.7
"22009",22,9,1998,15981,14824,1157,7.2
"22009",22,9,1999,16054,15130,924,5.8
"22009",22,9,2000,15738,14732,1006,6.4
"22009",22,9,2001,15776,14618,1158,7.3
"22009",22,9,2002,15689,14547,1142,7.3
"22009",22,9,2003,15788,14432,1356,8.6
"22009",22,9,2004,15690,14423,1267,8.1
"22009",22,9,2005,16059,14730,1329,8.3
"22009",22,9,2006,15986,15177,809,5.1
"22009",22,9,2007,15993,15168,825,5.2
"22009",22,9,2008,16478,15485,993,6
"22009",22,9,2009,16420,15188,1232,7.5
"22009",22,9,2010,16867,15453,1414,8.4
"22009",22,9,2011,16638,15240,1398,8.4
"22009",22,9,2012,16369,15130,1239,7.6
"22009",22,9,2013,16000,14807,1193,7.5
"22009",22,9,2014,16153,14984,1169,7.2
"22009",22,9,2015,15989,14787,1202,7.5
"22009",22,9,2016,15718,14611,1107,7
"22009",22,9,2017,15644,14680,964,6.2
"22011",22,11,1990,11570,10850,720,6.2
"22011",22,11,1991,11388,10551,837,7.3
"22011",22,11,1992,12160,11074,1086,8.9
"22011",22,11,1993,12493,11490,1003,8
"22011",22,11,1994,12876,11758,1118,8.7
"22011",22,11,1995,12579,11676,903,7.2
"22011",22,11,1996,12618,11692,926,7.3
"22011",22,11,1997,12323,11469,854,6.9
"22011",22,11,1998,12210,11349,861,7.1
"22011",22,11,1999,12449,11617,832,6.7
"22011",22,11,2000,14032,13286,746,5.3
"22011",22,11,2001,13979,13095,884,6.3
"22011",22,11,2002,13869,12947,922,6.6
"22011",22,11,2003,14215,13173,1042,7.3
"22011",22,11,2004,13983,13055,928,6.6
"22011",22,11,2005,14318,13243,1075,7.5
"22011",22,11,2006,14464,13817,647,4.5
"22011",22,11,2007,14268,13567,701,4.9
"22011",22,11,2008,14643,13843,800,5.5
"22011",22,11,2009,14372,13239,1133,7.9
"22011",22,11,2010,14585,13429,1156,7.9
"22011",22,11,2011,14269,13098,1171,8.2
"22011",22,11,2012,14413,13327,1086,7.5
"22011",22,11,2013,14445,13381,1064,7.4
"22011",22,11,2014,14818,13810,1008,6.8
"22011",22,11,2015,15218,14253,965,6.3
"22011",22,11,2016,15098,14188,910,6
"22011",22,11,2017,14778,13989,789,5.3
"22013",22,13,1990,5998,5573,425,7.1
"22013",22,13,1991,6176,5625,551,8.9
"22013",22,13,1992,6448,5951,497,7.7
"22013",22,13,1993,6195,5766,429,6.9
"22013",22,13,1994,6352,5831,521,8.2
"22013",22,13,1995,6275,5691,584,9.3
"22013",22,13,1996,5990,5351,639,10.7
"22013",22,13,1997,5607,4577,1030,18.4
"22013",22,13,1998,5562,4977,585,10.5
"22013",22,13,1999,5510,5149,361,6.6
"22013",22,13,2000,5946,5545,401,6.7
"22013",22,13,2001,5914,5421,493,8.3
"22013",22,13,2002,5933,5418,515,8.7
"22013",22,13,2003,6001,5471,530,8.8
"22013",22,13,2004,6090,5581,509,8.4
"22013",22,13,2005,6270,5809,461,7.4
"22013",22,13,2006,6322,6005,317,5
"22013",22,13,2007,6575,6215,360,5.5
"22013",22,13,2008,6185,5786,399,6.5
"22013",22,13,2009,6263,5663,600,9.6
"22013",22,13,2010,5918,5324,594,10
"22013",22,13,2011,5860,5266,594,10.1
"22013",22,13,2012,5954,5417,537,9
"22013",22,13,2013,5947,5431,516,8.7
"22013",22,13,2014,5938,5467,471,7.9
"22013",22,13,2015,5810,5329,481,8.3
"22013",22,13,2016,5677,5247,430,7.6
"22013",22,13,2017,5629,5289,340,6
"22015",22,15,1990,40227,37808,2419,6
"22015",22,15,1991,40437,37829,2608,6.4
"22015",22,15,1992,40836,38297,2539,6.2
"22015",22,15,1993,40657,38183,2474,6.1
"22015",22,15,1994,42189,39499,2690,6.4
"22015",22,15,1995,42943,40441,2502,5.8
"22015",22,15,1996,44595,41903,2692,6
"22015",22,15,1997,45643,42935,2708,5.9
"22015",22,15,1998,45654,43170,2484,5.4
"22015",22,15,1999,45847,43857,1990,4.3
"22015",22,15,2000,47153,44895,2258,4.8
"22015",22,15,2001,47233,44737,2496,5.3
"22015",22,15,2002,46638,43786,2852,6.1
"22015",22,15,2003,47314,44298,3016,6.4
"22015",22,15,2004,48889,46211,2678,5.5
"22015",22,15,2005,51496,48695,2801,5.4
"22015",22,15,2006,52081,50119,1962,3.8
"22015",22,15,2007,53018,50847,2171,4.1
"22015",22,15,2008,54797,52337,2460,4.5
"22015",22,15,2009,53948,50699,3249,6
"22015",22,15,2010,56576,53152,3424,6.1
"22015",22,15,2011,56901,53561,3340,5.9
"22015",22,15,2012,57312,54006,3306,5.8
"22015",22,15,2013,56863,53437,3426,6
"22015",22,15,2014,58226,54880,3346,5.7
"22015",22,15,2015,58276,54982,3294,5.7
"22015",22,15,2016,57715,54656,3059,5.3
"22015",22,15,2017,56871,54310,2561,4.5
"22017",22,17,1990,113674,106510,7164,6.3
"22017",22,17,1991,113618,105693,7925,7
"22017",22,17,1992,114306,106978,7328,6.4
"22017",22,17,1993,111923,105085,6838,6.1
"22017",22,17,1994,114218,106408,7810,6.8
"22017",22,17,1995,115161,107619,7542,6.5
"22017",22,17,1996,116551,108956,7595,6.5
"22017",22,17,1997,117727,110047,7680,6.5
"22017",22,17,1998,118032,110809,7223,6.1
"22017",22,17,1999,115946,110867,5079,4.4
"22017",22,17,2000,115086,109145,5941,5.2
"22017",22,17,2001,114170,107314,6856,6
"22017",22,17,2002,111295,103628,7667,6.9
"22017",22,17,2003,111245,103290,7955,7.2
"22017",22,17,2004,113446,106374,7072,6.2
"22017",22,17,2005,117535,110343,7192,6.1
"22017",22,17,2006,117931,112544,5387,4.6
"22017",22,17,2007,118612,112445,6167,5.2
"22017",22,17,2008,121151,114249,6902,5.7
"22017",22,17,2009,118906,109753,9153,7.7
"22017",22,17,2010,116799,107285,9514,8.1
"22017",22,17,2011,115609,106425,9184,7.9
"22017",22,17,2012,113533,104787,8746,7.7
"22017",22,17,2013,110922,102176,8746,7.9
"22017",22,17,2014,111244,102954,8290,7.5
"22017",22,17,2015,110463,102578,7885,7.1
"22017",22,17,2016,107277,100207,7070,6.6
"22017",22,17,2017,105707,99592,6115,5.8
"22019",22,19,1990,78258,73770,4488,5.7
"22019",22,19,1991,82148,76093,6055,7.4
"22019",22,19,1992,82399,75891,6508,7.9
"22019",22,19,1993,79299,73648,5651,7.1
"22019",22,19,1994,82747,76861,5886,7.1
"22019",22,19,1995,84615,79517,5098,6
"22019",22,19,1996,87628,82638,4990,5.7
"22019",22,19,1997,89389,84131,5258,5.9
"22019",22,19,1998,89272,84625,4647,5.2
"22019",22,19,1999,90087,85495,4592,5.1
"22019",22,19,2000,86596,82198,4398,5.1
"22019",22,19,2001,85903,81011,4892,5.7
"22019",22,19,2002,84457,79566,4891,5.8
"22019",22,19,2003,85859,80333,5526,6.4
"22019",22,19,2004,86152,81319,4833,5.6
"22019",22,19,2005,91004,84177,6827,7.5
"22019",22,19,2006,89953,86466,3487,3.9
"22019",22,19,2007,91888,88154,3734,4.1
"22019",22,19,2008,94473,90245,4228,4.5
"22019",22,19,2009,92017,86222,5795,6.3
"22019",22,19,2010,87896,80851,7045,8
"22019",22,19,2011,87010,80317,6693,7.7
"22019",22,19,2012,87905,81839,6066,6.9
"22019",22,19,2013,89356,83592,5764,6.5
"22019",22,19,2014,94664,89060,5604,5.9
"22019",22,19,2015,99373,94014,5359,5.4
"22019",22,19,2016,103116,98206,4910,4.8
"22019",22,19,2017,108795,104505,4290,3.9
"22021",22,21,1990,3918,3614,304,7.8
"22021",22,21,1991,4006,3557,449,11.2
"22021",22,21,1992,4046,3654,392,9.7
"22021",22,21,1993,4275,3926,349,8.2
"22021",22,21,1994,4472,4071,401,9
"22021",22,21,1995,4311,3944,367,8.5
"22021",22,21,1996,4445,4003,442,9.9
"22021",22,21,1997,4351,3944,407,9.4
"22021",22,21,1998,4069,3723,346,8.5
"22021",22,21,1999,4295,3942,353,8.2
"22021",22,21,2000,4357,4060,297,6.8
"22021",22,21,2001,4341,4002,339,7.8
"22021",22,21,2002,4411,4055,356,8.1
"22021",22,21,2003,4399,3965,434,9.9
"22021",22,21,2004,4280,3914,366,8.6
"22021",22,21,2005,4328,4010,318,7.3
"22021",22,21,2006,4411,4220,191,4.3
"22021",22,21,2007,4546,4328,218,4.8
"22021",22,21,2008,4581,4342,239,5.2
"22021",22,21,2009,4601,4162,439,9.5
"22021",22,21,2010,4179,3726,453,10.8
"22021",22,21,2011,4103,3693,410,10
"22021",22,21,2012,4003,3653,350,8.7
"22021",22,21,2013,3958,3635,323,8.2
"22021",22,21,2014,4081,3765,316,7.7
"22021",22,21,2015,4034,3699,335,8.3
"22021",22,21,2016,3991,3687,304,7.6
"22021",22,21,2017,3866,3644,222,5.7
"22023",22,23,1990,4219,4045,174,4.1
"22023",22,23,1991,3950,3744,206,5.2
"22023",22,23,1992,3819,3524,295,7.7
"22023",22,23,1993,3615,3383,232,6.4
"22023",22,23,1994,3588,3364,224,6.2
"22023",22,23,1995,3677,3451,226,6.1
"22023",22,23,1996,3591,3393,198,5.5
"22023",22,23,1997,3650,3471,179,4.9
"22023",22,23,1998,4145,3973,172,4.1
"22023",22,23,1999,3831,3642,189,4.9
"22023",22,23,2000,4544,4316,228,5
"22023",22,23,2001,4458,4224,234,5.2
"22023",22,23,2002,4329,4097,232,5.4
"22023",22,23,2003,4325,4086,239,5.5
"22023",22,23,2004,4330,4104,226,5.2
"22023",22,23,2005,4461,4201,260,5.8
"22023",22,23,2006,3669,3535,134,3.7
"22023",22,23,2007,3559,3429,130,3.7
"22023",22,23,2008,3565,3407,158,4.4
"22023",22,23,2009,3113,2930,183,5.9
"22023",22,23,2010,3299,3092,207,6.3
"22023",22,23,2011,3250,3063,187,5.8
"22023",22,23,2012,3226,3057,169,5.2
"22023",22,23,2013,3313,3136,177,5.3
"22023",22,23,2014,3447,3276,171,5
"22023",22,23,2015,3673,3502,171,4.7
"22023",22,23,2016,3826,3659,167,4.4
"22023",22,23,2017,4036,3892,144,3.6
"22025",22,25,1990,4249,3913,336,7.9
"22025",22,25,1991,4549,4056,493,10.8
"22025",22,25,1992,4897,4349,548,11.2
"22025",22,25,1993,4975,4544,431,8.7
"22025",22,25,1994,5570,5021,549,9.9
"22025",22,25,1995,5235,4728,507,9.7
"22025",22,25,1996,4938,4409,529,10.7
"22025",22,25,1997,4875,4407,468,9.6
"22025",22,25,1998,4921,4433,488,9.9
"22025",22,25,1999,4862,4392,470,9.7
"22025",22,25,2000,4151,3760,391,9.4
"22025",22,25,2001,4085,3702,383,9.4
"22025",22,25,2002,4053,3658,395,9.7
"22025",22,25,2003,4123,3721,402,9.8
"22025",22,25,2004,4104,3779,325,7.9
"22025",22,25,2005,4156,3808,348,8.4
"22025",22,25,2006,4152,3916,236,5.7
"22025",22,25,2007,4162,3921,241,5.8
"22025",22,25,2008,4235,3949,286,6.8
"22025",22,25,2009,4262,3829,433,10.2
"22025",22,25,2010,4229,3792,437,10.3
"22025",22,25,2011,4060,3641,419,10.3
"22025",22,25,2012,3918,3568,350,8.9
"22025",22,25,2013,3900,3570,330,8.5
"22025",22,25,2014,3849,3538,311,8.1
"22025",22,25,2015,3620,3272,348,9.6
"22025",22,25,2016,3431,3113,318,9.3
"22025",22,25,2017,3449,3206,243,7
"22027",22,27,1990,6145,5783,362,5.9
"22027",22,27,1991,6109,5644,465,7.6
"22027",22,27,1992,6103,5570,533,8.7
"22027",22,27,1993,5699,5333,366,6.4
"22027",22,27,1994,5963,5442,521,8.7
"22027",22,27,1995,5822,5362,460,7.9
"22027",22,27,1996,5948,5400,548,9.2
"22027",22,27,1997,6170,5607,563,9.1
"22027",22,27,1998,5982,5507,475,7.9
"22027",22,27,1999,5693,5262,431,7.6
"22027",22,27,2000,6498,6081,417,6.4
"22027",22,27,2001,6743,6277,466,6.9
"22027",22,27,2002,6728,6253,475,7.1
"22027",22,27,2003,6790,6276,514,7.6
"22027",22,27,2004,6904,6440,464,6.7
"22027",22,27,2005,6930,6486,444,6.4
"22027",22,27,2006,6883,6554,329,4.8
"22027",22,27,2007,6710,6340,370,5.5
"22027",22,27,2008,6638,6223,415,6.3
"22027",22,27,2009,6642,6020,622,9.4
"22027",22,27,2010,6892,6289,603,8.7
"22027",22,27,2011,6866,6295,571,8.3
"22027",22,27,2012,7021,6498,523,7.4
"22027",22,27,2013,6525,6037,488,7.5
"22027",22,27,2014,6367,5893,474,7.4
"22027",22,27,2015,6197,5743,454,7.3
"22027",22,27,2016,5964,5567,397,6.7
"22027",22,27,2017,5877,5561,316,5.4
"22029",22,29,1990,8440,7574,866,10.3
"22029",22,29,1991,8626,7288,1338,15.5
"22029",22,29,1992,8629,7511,1118,13
"22029",22,29,1993,8340,7430,910,10.9
"22029",22,29,1994,8418,7440,978,11.6
"22029",22,29,1995,8253,7348,905,11
"22029",22,29,1996,8029,7058,971,12.1
"22029",22,29,1997,8269,7279,990,12
"22029",22,29,1998,8558,7318,1240,14.5
"22029",22,29,1999,8368,7335,1033,12.3
"22029",22,29,2000,7776,7118,658,8.5
"22029",22,29,2001,7562,6830,732,9.7
"22029",22,29,2002,7497,6742,755,10.1
"22029",22,29,2003,7278,6444,834,11.5
"22029",22,29,2004,7218,6487,731,10.1
"22029",22,29,2005,7361,6577,784,10.7
"22029",22,29,2006,7309,6833,476,6.5
"22029",22,29,2007,7333,6889,444,6.1
"22029",22,29,2008,7635,7067,568,7.4
"22029",22,29,2009,7483,6654,829,11.1
"22029",22,29,2010,7875,7093,782,9.9
"22029",22,29,2011,7813,7063,750,9.6
"22029",22,29,2012,7827,7137,690,8.8
"22029",22,29,2013,7806,7143,663,8.5
"22029",22,29,2014,7764,7094,670,8.6
"22029",22,29,2015,7553,6899,654,8.7
"22029",22,29,2016,7266,6668,598,8.2
"22029",22,29,2017,7160,6596,564,7.9
"22031",22,31,1990,9957,9119,838,8.4
"22031",22,31,1991,9880,8726,1154,11.7
"22031",22,31,1992,10220,9098,1122,11
"22031",22,31,1993,10063,9144,919,9.1
"22031",22,31,1994,10219,9363,856,8.4
"22031",22,31,1995,11298,10479,819,7.2
"22031",22,31,1996,10850,9861,989,9.1
"22031",22,31,1997,11063,10070,993,9
"22031",22,31,1998,10911,10142,769,7
"22031",22,31,1999,11239,10554,685,6.1
"22031",22,31,2000,10813,10143,670,6.2
"22031",22,31,2001,10756,10010,746,6.9
"22031",22,31,2002,10705,9787,918,8.6
"22031",22,31,2003,10744,9820,924,8.6
"22031",22,31,2004,11008,10179,829,7.5
"22031",22,31,2005,11419,10627,792,6.9
"22031",22,31,2006,11326,10765,561,5
"22031",22,31,2007,11384,10728,656,5.8
"22031",22,31,2008,11782,10937,845,7.2
"22031",22,31,2009,11452,10482,970,8.5
"22031",22,31,2010,11394,10392,1002,8.8
"22031",22,31,2011,11228,10278,950,8.5
"22031",22,31,2012,11195,10188,1007,9
"22031",22,31,2013,11013,10039,974,8.8
"22031",22,31,2014,11139,10233,906,8.1
"22031",22,31,2015,11096,10211,885,8
"22031",22,31,2016,10914,10114,800,7.3
"22031",22,31,2017,10700,10047,653,6.1
"22033",22,33,1990,195744,186262,9482,4.8
"22033",22,33,1991,198594,187943,10651,5.4
"22033",22,33,1992,202034,192360,9674,4.8
"22033",22,33,1993,196745,186514,10231,5.2
"22033",22,33,1994,199302,187645,11657,5.8
"22033",22,33,1995,199990,189679,10311,5.2
"22033",22,33,1996,202750,192767,9983,4.9
"22033",22,33,1997,203157,193428,9729,4.8
"22033",22,33,1998,205813,197323,8490,4.1
"22033",22,33,1999,208242,200959,7283,3.5
"22033",22,33,2000,207375,197789,9586,4.6
"22033",22,33,2001,202952,192284,10668,5.3
"22033",22,33,2002,199040,188157,10883,5.5
"22033",22,33,2003,200693,188806,11887,5.9
"22033",22,33,2004,203695,192105,11590,5.7
"22033",22,33,2005,212877,198114,14763,6.9
"22033",22,33,2006,213196,203836,9360,4.4
"22033",22,33,2007,216650,207813,8837,4.1
"22033",22,33,2008,218827,208563,10264,4.7
"22033",22,33,2009,217988,204476,13512,6.2
"22033",22,33,2010,221984,205112,16872,7.6
"22033",22,33,2011,221086,204338,16748,7.6
"22033",22,33,2012,222248,207284,14964,6.7
"22033",22,33,2013,225959,211944,14015,6.2
"22033",22,33,2014,232359,218971,13388,5.8
"22033",22,33,2015,235479,222699,12780,5.4
"22033",22,33,2016,232657,220709,11948,5.1
"22033",22,33,2017,232758,222513,10245,4.4
"22035",22,35,1990,3162,2740,422,13.3
"22035",22,35,1991,3431,2837,594,17.3
"22035",22,35,1992,3621,3067,554,15.3
"22035",22,35,1993,3440,2944,496,14.4
"22035",22,35,1994,3499,2911,588,16.8
"22035",22,35,1995,3345,2844,501,15
"22035",22,35,1996,3159,2657,502,15.9
"22035",22,35,1997,3105,2657,448,14.4
"22035",22,35,1998,3118,2678,440,14.1
"22035",22,35,1999,3041,2655,386,12.7
"22035",22,35,2000,3111,2810,301,9.7
"22035",22,35,2001,3113,2739,374,12
"22035",22,35,2002,3079,2709,370,12
"22035",22,35,2003,3109,2697,412,13.3
"22035",22,35,2004,3031,2616,415,13.7
"22035",22,35,2005,2926,2536,390,13.3
"22035",22,35,2006,3130,2864,266,8.5
"22035",22,35,2007,3069,2770,299,9.7
"22035",22,35,2008,3082,2757,325,10.5
"22035",22,35,2009,2976,2588,388,13
"22035",22,35,2010,2477,2038,439,17.7
"22035",22,35,2011,2342,1918,424,18.1
"22035",22,35,2012,2190,1751,439,20
"22035",22,35,2013,2272,1888,384,16.9
"22035",22,35,2014,2224,1898,326,14.7
"22035",22,35,2015,2220,1907,313,14.1
"22035",22,35,2016,2143,1896,247,11.5
"22035",22,35,2017,2076,1845,231,11.1
"22037",22,37,1990,7214,6781,433,6
"22037",22,37,1991,7521,7005,516,6.9
"22037",22,37,1992,7468,6983,485,6.5
"22037",22,37,1993,7624,7091,533,7
"22037",22,37,1994,7725,7114,611,7.9
"22037",22,37,1995,7635,7101,534,7
"22037",22,37,1996,7551,7013,538,7.1
"22037",22,37,1997,7500,7043,457,6.1
"22037",22,37,1998,7516,7078,438,5.8
"22037",22,37,1999,7481,7119,362,4.8
"22037",22,37,2000,8287,7811,476,5.7
"22037",22,37,2001,8103,7583,520,6.4
"22037",22,37,2002,7924,7382,542,6.8
"22037",22,37,2003,7963,7366,597,7.5
"22037",22,37,2004,7998,7427,571,7.1
"22037",22,37,2005,8204,7644,560,6.8
"22037",22,37,2006,7964,7577,387,4.9
"22037",22,37,2007,8052,7669,383,4.8
"22037",22,37,2008,8190,7748,442,5.4
"22037",22,37,2009,8105,7521,584,7.2
"22037",22,37,2010,8103,7427,676,8.3
"22037",22,37,2011,8049,7366,683,8.5
"22037",22,37,2012,7960,7361,599,7.5
"22037",22,37,2013,7954,7407,547,6.9
"22037",22,37,2014,8200,7670,530,6.5
"22037",22,37,2015,8226,7736,490,6
"22037",22,37,2016,8122,7655,467,5.7
"22037",22,37,2017,8110,7722,388,4.8
"22039",22,39,1990,11419,10583,836,7.3
"22039",22,39,1991,12422,11354,1068,8.6
"22039",22,39,1992,12432,11233,1199,9.6
"22039",22,39,1993,11997,11089,908,7.6
"22039",22,39,1994,12046,11130,916,7.6
"22039",22,39,1995,11738,10871,867,7.4
"22039",22,39,1996,11796,11049,747,6.3
"22039",22,39,1997,12032,11349,683,5.7
"22039",22,39,1998,12063,11421,642,5.3
"22039",22,39,1999,12036,11367,669,5.6
"22039",22,39,2000,12156,11432,724,6
"22039",22,39,2001,11954,11147,807,6.8
"22039",22,39,2002,11971,11095,876,7.3
"22039",22,39,2003,11828,10869,959,8.1
"22039",22,39,2004,11754,10950,804,6.8
"22039",22,39,2005,12148,11269,879,7.2
"22039",22,39,2006,12128,11563,565,4.7
"22039",22,39,2007,12333,11707,626,5.1
"22039",22,39,2008,12588,11910,678,5.4
"22039",22,39,2009,12714,11711,1003,7.9
"22039",22,39,2010,13141,12015,1126,8.6
"22039",22,39,2011,13026,11930,1096,8.4
"22039",22,39,2012,12833,11882,951,7.4
"22039",22,39,2013,12863,11991,872,6.8
"22039",22,39,2014,13149,12260,889,6.8
"22039",22,39,2015,13010,12030,980,7.5
"22039",22,39,2016,12700,11762,938,7.4
"22039",22,39,2017,12590,11844,746,5.9
"22041",22,41,1990,8844,8131,713,8.1
"22041",22,41,1991,9628,8568,1060,11
"22041",22,41,1992,10512,9351,1161,11
"22041",22,41,1993,10140,9228,912,9
"22041",22,41,1994,10520,9504,1016,9.7
"22041",22,41,1995,10961,10051,910,8.3
"22041",22,41,1996,9797,8850,947,9.7
"22041",22,41,1997,9744,8767,977,10
"22041",22,41,1998,9786,8742,1044,10.7
"22041",22,41,1999,9825,9059,766,7.8
"22041",22,41,2000,8220,7616,604,7.3
"22041",22,41,2001,8120,7410,710,8.7
"22041",22,41,2002,7947,7129,818,10.3
"22041",22,41,2003,8012,7217,795,9.9
"22041",22,41,2004,7759,7049,710,9.2
"22041",22,41,2005,7818,7103,715,9.1
"22041",22,41,2006,7799,7295,504,6.5
"22041",22,41,2007,7789,7268,521,6.7
"22041",22,41,2008,7862,7264,598,7.6
"22041",22,41,2009,7791,6953,838,10.8
"22041",22,41,2010,8333,7409,924,11.1
"22041",22,41,2011,7961,7032,929,11.7
"22041",22,41,2012,7696,6896,800,10.4
"22041",22,41,2013,7702,6927,775,10.1
"22041",22,41,2014,7608,6889,719,9.5
"22041",22,41,2015,7532,6803,729,9.7
"22041",22,41,2016,7295,6636,659,9
"22041",22,41,2017,7301,6753,548,7.5
"22043",22,43,1990,7079,6618,461,6.5
"22043",22,43,1991,6861,6255,606,8.8
"22043",22,43,1992,6988,6310,678,9.7
"22043",22,43,1993,6870,6362,508,7.4
"22043",22,43,1994,6559,5779,780,11.9
"22043",22,43,1995,6716,6100,616,9.2
"22043",22,43,1996,6373,5740,633,9.9
"22043",22,43,1997,6320,5758,562,8.9
"22043",22,43,1998,6565,6050,515,7.8
"22043",22,43,1999,6949,6483,466,6.7
"22043",22,43,2000,7918,7419,499,6.3
"22043",22,43,2001,7903,7366,537,6.8
"22043",22,43,2002,7912,7364,548,6.9
"22043",22,43,2003,7999,7368,631,7.9
"22043",22,43,2004,8136,7583,553,6.8
"22043",22,43,2005,8558,8015,543,6.3
"22043",22,43,2006,8667,8301,366,4.2
"22043",22,43,2007,8680,8276,404,4.7
"22043",22,43,2008,8937,8463,474,5.3
"22043",22,43,2009,8824,8135,689,7.8
"22043",22,43,2010,8590,7864,726,8.5
"22043",22,43,2011,8358,7655,703,8.4
"22043",22,43,2012,8224,7574,650,7.9
"22043",22,43,2013,8147,7550,597,7.3
"22043",22,43,2014,8422,7821,601,7.1
"22043",22,43,2015,8488,7866,622,7.3
"22043",22,43,2016,8343,7762,581,7
"22043",22,43,2017,8189,7672,517,6.3
"22045",22,45,1990,28959,27610,1349,4.7
"22045",22,45,1991,29980,28210,1770,5.9
"22045",22,45,1992,30197,27310,2887,9.6
"22045",22,45,1993,29159,27012,2147,7.4
"22045",22,45,1994,29740,27433,2307,7.8
"22045",22,45,1995,29907,27885,2022,6.8
"22045",22,45,1996,30804,29032,1772,5.8
"22045",22,45,1997,31924,30326,1598,5
"22045",22,45,1998,33871,31228,2643,7.8
"22045",22,45,1999,32399,29912,2487,7.7
"22045",22,45,2000,30531,28760,1771,5.8
"22045",22,45,2001,30868,29115,1753,5.7
"22045",22,45,2002,30521,28460,2061,6.8
"22045",22,45,2003,30739,28754,1985,6.5
"22045",22,45,2004,31228,29291,1937,6.2
"22045",22,45,2005,32671,30483,2188,6.7
"22045",22,45,2006,34260,32954,1306,3.8
"22045",22,45,2007,34429,33154,1275,3.7
"22045",22,45,2008,35239,33729,1510,4.3
"22045",22,45,2009,34245,31889,2356,6.9
"22045",22,45,2010,32240,29464,2776,8.6
"22045",22,45,2011,31877,29358,2519,7.9
"22045",22,45,2012,32236,30056,2180,6.8
"22045",22,45,2013,32283,30200,2083,6.5
"22045",22,45,2014,32610,30546,2064,6.3
"22045",22,45,2015,31878,29291,2587,8.1
"22045",22,45,2016,30177,27352,2825,9.4
"22045",22,45,2017,29495,27351,2144,7.3
"22047",22,47,1990,12729,11730,999,7.8
"22047",22,47,1991,13188,11919,1269,9.6
"22047",22,47,1992,13553,12224,1329,9.8
"22047",22,47,1993,13071,11762,1309,10
"22047",22,47,1994,13194,11672,1522,11.5
"22047",22,47,1995,12354,11115,1239,10
"22047",22,47,1996,12126,11070,1056,8.7
"22047",22,47,1997,12160,11214,946,7.8
"22047",22,47,1998,12417,11513,904,7.3
"22047",22,47,1999,12886,12068,818,6.3
"22047",22,47,2000,12638,11745,893,7.1
"22047",22,47,2001,12391,11464,927,7.5
"22047",22,47,2002,12160,11159,1001,8.2
"22047",22,47,2003,12215,11087,1128,9.2
"22047",22,47,2004,12262,11156,1106,9
"22047",22,47,2005,12609,11474,1135,9
"22047",22,47,2006,12295,11525,770,6.3
"22047",22,47,2007,12270,11548,722,5.9
"22047",22,47,2008,12522,11658,864,6.9
"22047",22,47,2009,12429,11251,1178,9.5
"22047",22,47,2010,14031,12622,1409,10
"22047",22,47,2011,13976,12529,1447,10.4
"22047",22,47,2012,13892,12589,1303,9.4
"22047",22,47,2013,14039,12869,1170,8.3
"22047",22,47,2014,14389,13261,1128,7.8
"22047",22,47,2015,14431,13375,1056,7.3
"22047",22,47,2016,14140,13175,965,6.8
"22047",22,47,2017,14142,13272,870,6.2
"22049",22,49,1990,6028,5735,293,4.9
"22049",22,49,1991,6525,6177,348,5.3
"22049",22,49,1992,6454,6088,366,5.7
"22049",22,49,1993,6195,5874,321,5.2
"22049",22,49,1994,6356,5975,381,6
"22049",22,49,1995,6308,5936,372,5.9
"22049",22,49,1996,6401,6005,396,6.2
"22049",22,49,1997,6130,5664,466,7.6
"22049",22,49,1998,6003,5621,382,6.4
"22049",22,49,1999,5653,5356,297,5.3
"22049",22,49,2000,6718,6334,384,5.7
"22049",22,49,2001,6658,6211,447,6.7
"22049",22,49,2002,6540,6114,426,6.5
"22049",22,49,2003,6531,5964,567,8.7
"22049",22,49,2004,6416,5986,430,6.7
"22049",22,49,2005,6412,6028,384,6
"22049",22,49,2006,6512,6230,282,4.3
"22049",22,49,2007,6471,6189,282,4.4
"22049",22,49,2008,6667,6339,328,4.9
"22049",22,49,2009,6514,6015,499,7.7
"22049",22,49,2010,7085,6568,517,7.3
"22049",22,49,2011,6945,6431,514,7.4
"22049",22,49,2012,6831,6366,465,6.8
"22049",22,49,2013,7025,6568,457,6.5
"22049",22,49,2014,7248,6822,426,5.9
"22049",22,49,2015,7267,6832,435,6
"22049",22,49,2016,7099,6705,394,5.6
"22049",22,49,2017,7004,6686,318,4.5
"22051",22,51,1990,227895,215122,12773,5.6
"22051",22,51,1991,233679,218011,15668,6.7
"22051",22,51,1992,232539,212874,19665,8.5
"22051",22,51,1993,231073,212178,18895,8.2
"22051",22,51,1994,235513,217163,18350,7.8
"22051",22,51,1995,236041,220182,15859,6.7
"22051",22,51,1996,238684,224477,14207,6
"22051",22,51,1997,242305,230027,12278,5.1
"22051",22,51,1998,244531,233127,11404,4.7
"22051",22,51,1999,242342,231934,10408,4.3
"22051",22,51,2000,232236,221554,10682,4.6
"22051",22,51,2001,227874,216932,10942,4.8
"22051",22,51,2002,223118,211580,11538,5.2
"22051",22,51,2003,222833,211306,11527,5.2
"22051",22,51,2004,224629,213733,10896,4.9
"22051",22,51,2005,,,,
"22051",22,51,2006,,,,
"22051",22,51,2007,221408,213445,7963,3.6
"22051",22,51,2008,217150,207481,9669,4.5
"22051",22,51,2009,211151,197827,13324,6.3
"22051",22,51,2010,216258,200303,15955,7.4
"22051",22,51,2011,213027,197665,15362,7.2
"22051",22,51,2012,212225,198018,14207,6.7
"22051",22,51,2013,213643,200234,13409,6.3
"22051",22,51,2014,218380,205264,13116,6
"22051",22,51,2015,219824,207184,12640,5.8
"22051",22,51,2016,216986,205572,11414,5.3
"22051",22,51,2017,215779,206008,9771,4.5
"22053",22,53,1990,11993,11186,807,6.7
"22053",22,53,1991,12701,11617,1084,8.5
"22053",22,53,1992,12486,11156,1330,10.7
"22053",22,53,1993,11641,10645,996,8.6
"22053",22,53,1994,11797,10813,984,8.3
"22053",22,53,1995,11833,11005,828,7
"22053",22,53,1996,11665,10814,851,7.3
"22053",22,53,1997,11921,11128,793,6.7
"22053",22,53,1998,11870,11145,725,6.1
"22053",22,53,1999,11439,10654,785,6.9
"22053",22,53,2000,12807,12056,751,5.9
"22053",22,53,2001,12843,12078,765,6
"22053",22,53,2002,13024,12266,758,5.8
"22053",22,53,2003,13498,12708,790,5.9
"22053",22,53,2004,13526,12832,694,5.1
"22053",22,53,2005,14294,13411,883,6.2
"22053",22,53,2006,14419,13935,484,3.4
"22053",22,53,2007,14599,14093,506,3.5
"22053",22,53,2008,15022,14419,603,4
"22053",22,53,2009,14684,13832,852,5.8
"22053",22,53,2010,13113,12124,989,7.5
"22053",22,53,2011,12907,11976,931,7.2
"22053",22,53,2012,12975,12131,844,6.5
"22053",22,53,2013,13163,12346,817,6.2
"22053",22,53,2014,13589,12789,800,5.9
"22053",22,53,2015,13621,12776,845,6.2
"22053",22,53,2016,13606,12790,816,6
"22053",22,53,2017,13679,13015,664,4.9
"22055",22,55,1990,82767,79340,3427,4.1
"22055",22,55,1991,85506,81414,4092,4.8
"22055",22,55,1992,85829,80589,5240,6.1
"22055",22,55,1993,84497,80396,4101,4.9
"22055",22,55,1994,87054,82766,4288,4.9
"22055",22,55,1995,88962,84807,4155,4.7
"22055",22,55,1996,91582,87767,3815,4.2
"22055",22,55,1997,95588,92003,3585,3.8
"22055",22,55,1998,98159,94196,3963,4
"22055",22,55,1999,95768,91786,3982,4.2
"22055",22,55,2000,97491,93498,3993,4.1
"22055",22,55,2001,99544,95345,4199,4.2
"22055",22,55,2002,98002,93450,4552,4.6
"22055",22,55,2003,97675,92904,4771,4.9
"22055",22,55,2004,98439,94047,4392,4.5
"22055",22,55,2005,104121,98670,5451,5.2
"22055",22,55,2006,107716,104316,3400,3.2
"22055",22,55,2007,110161,106874,3287,3
"22055",22,55,2008,113129,109279,3850,3.4
"22055",22,55,2009,111996,106294,5702,5.1
"22055",22,55,2010,113571,106487,7084,6.2
"22055",22,55,2011,113869,107117,6752,5.9
"22055",22,55,2012,116591,110733,5858,5
"22055",22,55,2013,118870,113007,5863,4.9
"22055",22,55,2014,122595,116553,6042,4.9
"22055",22,55,2015,120282,113456,6826,5.7
"22055",22,55,2016,114609,107602,7007,6.1
"22055",22,55,2017,113098,107552,5546,4.9
"22057",22,57,1990,36709,35207,1502,4.1
"22057",22,57,1991,37142,35391,1751,4.7
"22057",22,57,1992,36410,34113,2297,6.3
"22057",22,57,1993,36283,34093,2190,6
"22057",22,57,1994,37365,35210,2155,5.8
"22057",22,57,1995,37576,35799,1777,4.7
"22057",22,57,1996,38873,37328,1545,4
"22057",22,57,1997,41334,40061,1273,3.1
"22057",22,57,1998,43036,41715,1321,3.1
"22057",22,57,1999,41607,40074,1533,3.7
"22057",22,57,2000,41142,39295,1847,4.5
"22057",22,57,2001,42164,40257,1907,4.5
"22057",22,57,2002,42817,40796,2021,4.7
"22057",22,57,2003,43556,41434,2122,4.9
"22057",22,57,2004,43732,41574,2158,4.9
"22057",22,57,2005,45371,42664,2707,6
"22057",22,57,2006,46934,45416,1518,3.2
"22057",22,57,2007,48824,47397,1427,2.9
"22057",22,57,2008,50148,48386,1762,3.5
"22057",22,57,2009,48459,46247,2212,4.6
"22057",22,57,2010,45070,42305,2765,6.1
"22057",22,57,2011,44381,41664,2717,6.1
"22057",22,57,2012,45425,43027,2398,5.3
"22057",22,57,2013,46823,44522,2301,4.9
"22057",22,57,2014,48547,46213,2334,4.8
"22057",22,57,2015,46710,44181,2529,5.4
"22057",22,57,2016,43390,40672,2718,6.3
"22057",22,57,2017,41795,39604,2191,5.2
"22059",22,59,1990,5758,5497,261,4.5
"22059",22,59,1991,5892,5423,469,8
"22059",22,59,1992,6260,5770,490,7.8
"22059",22,59,1993,6041,5581,460,7.6
"22059",22,59,1994,5890,5407,483,8.2
"22059",22,59,1995,5675,5299,376,6.6
"22059",22,59,1996,5600,5287,313,5.6
"22059",22,59,1997,5458,5120,338,6.2
"22059",22,59,1998,5400,5056,344,6.4
"22059",22,59,1999,5280,4892,388,7.3
"22059",22,59,2000,5903,5559,344,5.8
"22059",22,59,2001,5955,5567,388,6.5
"22059",22,59,2002,6038,5566,472,7.8
"22059",22,59,2003,5864,5345,519,8.9
"22059",22,59,2004,5691,5333,358,6.3
"22059",22,59,2005,5796,5482,314,5.4
"22059",22,59,2006,6133,5914,219,3.6
"22059",22,59,2007,6249,6011,238,3.8
"22059",22,59,2008,6410,6151,259,4
"22059",22,59,2009,6418,5979,439,6.8
"22059",22,59,2010,6444,6024,420,6.5
"22059",22,59,2011,6689,6306,383,5.7
"22059",22,59,2012,6737,6395,342,5.1
"22059",22,59,2013,6973,6626,347,5
"22059",22,59,2014,6637,6290,347,5.2
"22059",22,59,2015,6617,6160,457,6.9
"22059",22,59,2016,6285,5870,415,6.6
"22059",22,59,2017,6172,5881,291,4.7
"22061",22,61,1990,17774,16888,886,5
"22061",22,61,1991,18342,17459,883,4.8
"22061",22,61,1992,18954,18446,508,2.7
"22061",22,61,1993,18234,17749,485,2.7
"22061",22,61,1994,18034,17507,527,2.9
"22061",22,61,1995,18228,17681,547,3
"22061",22,61,1996,18383,17827,556,3
"22061",22,61,1997,18521,17888,633,3.4
"22061",22,61,1998,18797,18282,515,2.7
"22061",22,61,1999,19288,18830,458,2.4
"22061",22,61,2000,19104,18072,1032,5.4
"22061",22,61,2001,18691,17537,1154,6.2
"22061",22,61,2002,18551,17327,1224,6.6
"22061",22,61,2003,18241,16975,1266,6.9
"22061",22,61,2004,18335,17144,1191,6.5
"22061",22,61,2005,18616,17335,1281,6.9
"22061",22,61,2006,18616,17731,885,4.8
"22061",22,61,2007,18918,17984,934,4.9
"22061",22,61,2008,19417,18356,1061,5.5
"22061",22,61,2009,19299,17863,1436,7.4
"22061",22,61,2010,20309,18533,1776,8.7
"22061",22,61,2011,20086,18229,1857,9.2
"22061",22,61,2012,19485,17806,1679,8.6
"22061",22,61,2013,20549,18936,1613,7.8
"22061",22,61,2014,20707,19141,1566,7.6
"22061",22,61,2015,21098,19621,1477,7
"22061",22,61,2016,21515,20181,1334,6.2
"22061",22,61,2017,21674,20549,1125,5.2
"22063",22,63,1990,33458,31109,2349,7
"22063",22,63,1991,34471,31562,2909,8.4
"22063",22,63,1992,35045,32477,2568,7.3
"22063",22,63,1993,35127,32182,2945,8.4
"22063",22,63,1994,36414,33152,3262,9
"22063",22,63,1995,37401,34511,2890,7.7
"22063",22,63,1996,38921,36205,2716,7
"22063",22,63,1997,39970,37659,2311,5.8
"22063",22,63,1998,41890,39740,2150,5.1
"22063",22,63,1999,43958,41844,2114,4.8
"22063",22,63,2000,44859,42326,2533,5.6
"22063",22,63,2001,45223,42673,2550,5.6
"22063",22,63,2002,46225,43308,2917,6.3
"22063",22,63,2003,48057,44765,3292,6.9
"22063",22,63,2004,50397,47098,3299,6.5
"22063",22,63,2005,53346,50173,3173,5.9
"22063",22,63,2006,54234,52035,2199,4.1
"22063",22,63,2007,55882,53715,2167,3.9
"22063",22,63,2008,58417,55863,2554,4.4
"22063",22,63,2009,58952,55356,3596,6.1
"22063",22,63,2010,61281,56675,4606,7.5
"22063",22,63,2011,61455,56967,4488,7.3
"22063",22,63,2012,62147,58167,3980,6.4
"22063",22,63,2013,64070,60324,3746,5.8
"22063",22,63,2014,66663,62991,3672,5.5
"22063",22,63,2015,68399,64895,3504,5.1
"22063",22,63,2016,68835,65361,3474,5
"22063",22,63,2017,68804,65914,2890,4.2
"22065",22,65,1990,4623,4106,517,11.2
"22065",22,65,1991,4727,4075,652,13.8
"22065",22,65,1992,4964,4351,613,12.3
"22065",22,65,1993,4961,4343,618,12.5
"22065",22,65,1994,5300,4671,629,11.9
"22065",22,65,1995,5607,4901,706,12.6
"22065",22,65,1996,5657,4973,684,12.1
"22065",22,65,1997,5515,4856,659,11.9
"22065",22,65,1998,5481,4812,669,12.2
"22065",22,65,1999,5435,5009,426,7.8
"22065",22,65,2000,4978,4577,401,8.1
"22065",22,65,2001,5089,4598,491,9.6
"22065",22,65,2002,5014,4492,522,10.4
"22065",22,65,2003,4969,4424,545,11
"22065",22,65,2004,4680,4220,460,9.8
"22065",22,65,2005,4682,4251,431,9.2
"22065",22,65,2006,4570,4282,288,6.3
"22065",22,65,2007,4453,4153,300,6.7
"22065",22,65,2008,4685,4313,372,7.9
"22065",22,65,2009,4679,4237,442,9.4
"22065",22,65,2010,4170,3668,502,12
"22065",22,65,2011,3980,3476,504,12.7
"22065",22,65,2012,3891,3422,469,12.1
"22065",22,65,2013,3959,3522,437,11
"22065",22,65,2014,3928,3493,435,11.1
"22065",22,65,2015,3910,3546,364,9.3
"22065",22,65,2016,3843,3500,343,8.9
"22065",22,65,2017,3823,3513,310,8.1
"22067",22,67,1990,12361,11315,1046,8.5
"22067",22,67,1991,12789,11545,1244,9.7
"22067",22,67,1992,13226,12006,1220,9.2
"22067",22,67,1993,12873,11683,1190,9.2
"22067",22,67,1994,12746,11236,1510,11.8
"22067",22,67,1995,12457,11308,1149,9.2
"22067",22,67,1996,12714,11313,1401,11
"22067",22,67,1997,12386,10808,1578,12.7
"22067",22,67,1998,12308,10872,1436,11.7
"22067",22,67,1999,11952,10746,1206,10.1
"22067",22,67,2000,12489,11532,957,7.7
"22067",22,67,2001,12636,11563,1073,8.5
"22067",22,67,2002,12439,11357,1082,8.7
"22067",22,67,2003,12635,11354,1281,10.1
"22067",22,67,2004,11906,10693,1213,10.2
"22067",22,67,2005,11717,10640,1077,9.2
"22067",22,67,2006,11526,10750,776,6.7
"22067",22,67,2007,11673,10727,946,8.1
"22067",22,67,2008,11885,10815,1070,9
"22067",22,67,2009,11559,9886,1673,14.5
"22067",22,67,2010,11097,9385,1712,15.4
"22067",22,67,2011,11062,9466,1596,14.4
"22067",22,67,2012,11243,9778,1465,13
"22067",22,67,2013,11117,9739,1378,12.4
"22067",22,67,2014,11180,9921,1259,11.3
"22067",22,67,2015,10839,9647,1192,11
"22067",22,67,2016,10644,9616,1028,9.7
"22067",22,67,2017,10420,9587,833,8
"22069",22,69,1990,15043,13820,1223,8.1
"22069",22,69,1991,15458,14120,1338,8.7
"22069",22,69,1992,15955,14672,1283,8
"22069",22,69,1993,15903,14795,1108,7
"22069",22,69,1994,15929,14796,1133,7.1
"22069",22,69,1995,16663,15422,1241,7.4
"22069",22,69,1996,17307,16021,1286,7.4
"22069",22,69,1997,17016,15790,1226,7.2
"22069",22,69,1998,17280,16226,1054,6.1
"22069",22,69,1999,17926,17022,904,5
"22069",22,69,2000,16622,15644,978,5.9
"22069",22,69,2001,16886,15753,1133,6.7
"22069",22,69,2002,16508,15336,1172,7.1
"22069",22,69,2003,16643,15379,1264,7.6
"22069",22,69,2004,17243,16126,1117,6.5
"22069",22,69,2005,17850,16615,1235,6.9
"22069",22,69,2006,17839,17016,823,4.6
"22069",22,69,2007,17455,16557,898,5.1
"22069",22,69,2008,17347,16286,1061,6.1
"22069",22,69,2009,17347,15944,1403,8.1
"22069",22,69,2010,16590,15101,1489,9
"22069",22,69,2011,16143,14652,1491,9.2
"22069",22,69,2012,16036,14601,1435,8.9
"22069",22,69,2013,16827,15425,1402,8.3
"22069",22,69,2014,16924,15604,1320,7.8
"22069",22,69,2015,16600,15335,1265,7.6
"22069",22,69,2016,16750,15627,1123,6.7
"22069",22,69,2017,16450,15468,982,6
"22071",22,71,1990,206740,192133,14607,7.1
"22071",22,71,1991,208066,191406,16660,8
"22071",22,71,1992,204982,184792,20190,9.8
"22071",22,71,1993,203760,183388,20372,10
"22071",22,71,1994,206934,186466,20468,9.9
"22071",22,71,1995,207117,188107,19010,9.2
"22071",22,71,1996,208234,189844,18390,8.8
"22071",22,71,1997,208253,193270,14983,7.2
"22071",22,71,1998,209167,194813,14354,6.9
"22071",22,71,1999,204901,193110,11791,5.8
"22071",22,71,2000,211299,199774,11525,5.5
"22071",22,71,2001,206259,194236,12023,5.8
"22071",22,71,2002,200243,187637,12606,6.3
"22071",22,71,2003,197740,185357,12383,6.3
"22071",22,71,2004,196115,184460,11655,5.9
"22071",22,71,2005,,,,
"22071",22,71,2006,,,,
"22071",22,71,2007,107655,102197,5458,5.1
"22071",22,71,2008,133877,125795,8082,6
"22071",22,71,2009,145831,134275,11556,7.9
"22071",22,71,2010,162592,148465,14127,8.7
"22071",22,71,2011,165726,151413,14313,8.6
"22071",22,71,2012,168791,155488,13303,7.9
"22071",22,71,2013,173465,160741,12724,7.3
"22071",22,71,2014,179296,166838,12458,6.9
"22071",22,71,2015,182334,170454,11880,6.5
"22071",22,71,2016,180378,169836,10542,5.8
"22071",22,71,2017,179465,170264,9201,5.1
"22073",22,73,1990,65848,62230,3618,5.5
"22073",22,73,1991,66889,62859,4030,6
"22073",22,73,1992,66911,63114,3797,5.7
"22073",22,73,1993,65086,61347,3739,5.7
"22073",22,73,1994,65228,61195,4033,6.2
"22073",22,73,1995,66935,63312,3623,5.4
"22073",22,73,1996,68420,64403,4017,5.9
"22073",22,73,1997,68948,64768,4180,6.1
"22073",22,73,1998,69087,65436,3651,5.3
"22073",22,73,1999,69770,67183,2587,3.7
"22073",22,73,2000,69948,66628,3320,4.7
"22073",22,73,2001,70916,67059,3857,5.4
"22073",22,73,2002,71186,67387,3799,5.3
"22073",22,73,2003,71690,67389,4301,6
"22073",22,73,2004,71537,67496,4041,5.6
"22073",22,73,2005,72428,67986,4442,6.1
"22073",22,73,2006,71899,68849,3050,4.2
"22073",22,73,2007,71680,68068,3612,5
"22073",22,73,2008,71854,68131,3723,5.2
"22073",22,73,2009,71098,66155,4943,7
"22073",22,73,2010,70729,64888,5841,8.3
"22073",22,73,2011,69852,64029,5823,8.3
"22073",22,73,2012,70713,65263,5450,7.7
"22073",22,73,2013,70977,65856,5121,7.2
"22073",22,73,2014,72082,67040,5042,7
"22073",22,73,2015,72398,67583,4815,6.7
"22073",22,73,2016,71718,67371,4347,6.1
"22073",22,73,2017,70946,67215,3731,5.3
"22075",22,75,1990,10156,9532,624,6.1
"22075",22,75,1991,10299,9573,726,7
"22075",22,75,1992,10515,9364,1151,10.9
"22075",22,75,1993,10224,9203,1021,10
"22075",22,75,1994,10466,9415,1051,10
"22075",22,75,1995,10505,9636,869,8.3
"22075",22,75,1996,10566,9893,673,6.4
"22075",22,75,1997,10939,10341,598,5.5
"22075",22,75,1998,11198,10570,628,5.6
"22075",22,75,1999,11183,10527,656,5.9
"22075",22,75,2000,11041,10398,643,5.8
"22075",22,75,2001,11000,10383,617,5.6
"22075",22,75,2002,10904,10219,685,6.3
"22075",22,75,2003,11092,10428,664,6
"22075",22,75,2004,11541,10905,636,5.5
"22075",22,75,2005,,,,
"22075",22,75,2006,,,,
"22075",22,75,2007,9015,8662,353,3.9
"22075",22,75,2008,8477,8076,401,4.7
"22075",22,75,2009,7974,7456,518,6.5
"22075",22,75,2010,10028,9420,608,6.1
"22075",22,75,2011,10086,9448,638,6.3
"22075",22,75,2012,10126,9525,601,5.9
"22075",22,75,2013,10057,9486,571,5.7
"22075",22,75,2014,10251,9666,585,5.7
"22075",22,75,2015,10344,9765,579,5.6
"22075",22,75,2016,10208,9664,544,5.3
"22075",22,75,2017,10149,9680,469,4.6
"22077",22,77,1990,9022,8173,849,9.4
"22077",22,77,1991,9182,8145,1037,11.3
"22077",22,77,1992,9194,8303,891,9.7
"22077",22,77,1993,9700,8803,897,9.2
"22077",22,77,1994,9859,8777,1082,11
"22077",22,77,1995,9325,8435,890,9.5
"22077",22,77,1996,9240,8492,748,8.1
"22077",22,77,1997,9401,8643,758,8.1
"22077",22,77,1998,9531,8835,696,7.3
"22077",22,77,1999,9613,9027,586,6.1
"22077",22,77,2000,9766,9150,616,6.3
"22077",22,77,2001,9538,8881,657,6.9
"22077",22,77,2002,9334,8680,654,7
"22077",22,77,2003,9388,8670,718,7.6
"22077",22,77,2004,9497,8785,712,7.5
"22077",22,77,2005,9917,9037,880,8.9
"22077",22,77,2006,9501,9023,478,5
"22077",22,77,2007,9516,9069,447,4.7
"22077",22,77,2008,9660,9147,513,5.3
"22077",22,77,2009,9516,8856,660,6.9
"22077",22,77,2010,10001,9134,867,8.7
"22077",22,77,2011,9980,9068,912,9.1
"22077",22,77,2012,9883,9074,809,8.2
"22077",22,77,2013,9910,9158,752,7.6
"22077",22,77,2014,10119,9405,714,7.1
"22077",22,77,2015,10143,9473,670,6.6
"22077",22,77,2016,9983,9338,645,6.5
"22077",22,77,2017,9974,9416,558,5.6
"22079",22,79,1990,55984,52663,3321,5.9
"22079",22,79,1991,56286,52497,3789,6.7
"22079",22,79,1992,56250,52595,3655,6.5
"22079",22,79,1993,55771,52453,3318,5.9
"22079",22,79,1994,56796,53156,3640,6.4
"22079",22,79,1995,57894,54325,3569,6.2
"22079",22,79,1996,57952,54311,3641,6.3
"22079",22,79,1997,57838,54436,3402,5.9
"22079",22,79,1998,58752,55673,3079,5.2
"22079",22,79,1999,60027,57415,2612,4.4
"22079",22,79,2000,55791,52767,3024,5.4
"22079",22,79,2001,55644,52311,3333,6
"22079",22,79,2002,55821,52407,3414,6.1
"22079",22,79,2003,55951,52323,3628,6.5
"22079",22,79,2004,56418,53279,3139,5.6
"22079",22,79,2005,59209,55567,3642,6.2
"22079",22,79,2006,59660,57225,2435,4.1
"22079",22,79,2007,59862,57345,2517,4.2
"22079",22,79,2008,62250,59372,2878,4.6
"22079",22,79,2009,60738,56864,3874,6.4
"22079",22,79,2010,58820,54349,4471,7.6
"22079",22,79,2011,58206,53753,4453,7.7
"22079",22,79,2012,57231,53206,4025,7
"22079",22,79,2013,57207,53286,3921,6.9
"22079",22,79,2014,58112,54224,3888,6.7
"22079",22,79,2015,58288,54524,3764,6.5
"22079",22,79,2016,57404,53879,3525,6.1
"22079",22,79,2017,56356,53190,3166,5.6
"22081",22,81,1990,3703,3399,304,8.2
"22081",22,81,1991,3789,3307,482,12.7
"22081",22,81,1992,3769,3368,401,10.6
"22081",22,81,1993,3727,3396,331,8.9
"22081",22,81,1994,3811,3457,354,9.3
"22081",22,81,1995,3802,3427,375,9.9
"22081",22,81,1996,3764,3293,471,12.5
"22081",22,81,1997,3570,2771,799,22.4
"22081",22,81,1998,3340,2902,438,13.1
"22081",22,81,1999,3309,3050,259,7.8
"22081",22,81,2000,3555,3308,247,6.9
"22081",22,81,2001,3593,3304,289,8
"22081",22,81,2002,3632,3331,301,8.3
"22081",22,81,2003,3648,3297,351,9.6
"22081",22,81,2004,3559,3204,355,10
"22081",22,81,2005,3342,3046,296,8.9
"22081",22,81,2006,3252,3047,205,6.3
"22081",22,81,2007,3470,3241,229,6.6
"22081",22,81,2008,3505,3231,274,7.8
"22081",22,81,2009,3517,3182,335,9.5
"22081",22,81,2010,4020,3680,340,8.5
"22081",22,81,2011,4049,3737,312,7.7
"22081",22,81,2012,3946,3657,289,7.3
"22081",22,81,2013,3858,3567,291,7.5
"22081",22,81,2014,3997,3708,289,7.2
"22081",22,81,2015,3923,3651,272,6.9
"22081",22,81,2016,3817,3588,229,6
"22081",22,81,2017,3862,3660,202,5.2
"22083",22,83,1990,8417,7664,753,8.9
"22083",22,83,1991,8475,7514,961,11.3
"22083",22,83,1992,8710,7716,994,11.4
"22083",22,83,1993,8380,7560,820,9.8
"22083",22,83,1994,8290,7338,952,11.5
"22083",22,83,1995,8121,7296,825,10.2
"22083",22,83,1996,7902,7129,773,9.8
"22083",22,83,1997,8132,7309,823,10.1
"22083",22,83,1998,8142,7324,818,10
"22083",22,83,1999,8223,7583,640,7.8
"22083",22,83,2000,8687,8088,599,6.9
"22083",22,83,2001,8591,7939,652,7.6
"22083",22,83,2002,8391,7698,693,8.3
"22083",22,83,2003,8720,7957,763,8.8
"22083",22,83,2004,8458,7758,700,8.3
"22083",22,83,2005,8560,7895,665,7.8
"22083",22,83,2006,8588,8136,452,5.3
"22083",22,83,2007,8710,8162,548,6.3
"22083",22,83,2008,8899,8316,583,6.6
"22083",22,83,2009,8906,8038,868,9.7
"22083",22,83,2010,8802,7834,968,11
"22083",22,83,2011,8796,7839,957,10.9
"22083",22,83,2012,8666,7823,843,9.7
"22083",22,83,2013,8663,7828,835,9.6
"22083",22,83,2014,8733,7971,762,8.7
"22083",22,83,2015,8680,7921,759,8.7
"22083",22,83,2016,8464,7838,626,7.4
"22083",22,83,2017,8364,7853,511,6.1
"22085",22,85,1990,8465,8089,376,4.4
"22085",22,85,1991,8747,8151,596,6.8
"22085",22,85,1992,9256,8554,702,7.6
"22085",22,85,1993,8982,8407,575,6.4
"22085",22,85,1994,8946,8405,541,6
"22085",22,85,1995,8893,8314,579,6.5
"22085",22,85,1996,9158,8534,624,6.8
"22085",22,85,1997,9011,8488,523,5.8
"22085",22,85,1998,9122,8358,764,8.4
"22085",22,85,1999,8524,7991,533,6.3
"22085",22,85,2000,9313,8825,488,5.2
"22085",22,85,2001,9295,8703,592,6.4
"22085",22,85,2002,9249,8532,717,7.8
"22085",22,85,2003,9348,8657,691,7.4
"22085",22,85,2004,9286,8714,572,6.2
"22085",22,85,2005,9459,8878,581,6.1
"22085",22,85,2006,9579,9201,378,3.9
"22085",22,85,2007,9441,9018,423,4.5
"22085",22,85,2008,9653,9170,483,5
"22085",22,85,2009,9452,8683,769,8.1
"22085",22,85,2010,9673,8970,703,7.3
"22085",22,85,2011,9460,8785,675,7.1
"22085",22,85,2012,9213,8572,641,7
"22085",22,85,2013,9190,8569,621,6.8
"22085",22,85,2014,9223,8618,605,6.6
"22085",22,85,2015,9493,8815,678,7.1
"22085",22,85,2016,9160,8528,632,6.9
"22085",22,85,2017,8802,8318,484,5.5
"22087",22,87,1990,31338,28899,2439,7.8
"22087",22,87,1991,31586,28951,2635,8.3
"22087",22,87,1992,31338,28078,3260,10.4
"22087",22,87,1993,31183,28070,3113,10
"22087",22,87,1994,31856,28803,3053,9.6
"22087",22,87,1995,32174,29174,3000,9.3
"22087",22,87,1996,32267,29755,2512,7.8
"22087",22,87,1997,32604,30509,2095,6.4
"22087",22,87,1998,32764,30838,1926,5.9
"22087",22,87,1999,32261,30605,1656,5.1
"22087",22,87,2000,32271,30510,1761,5.5
"22087",22,87,2001,31642,29830,1812,5.7
"22087",22,87,2002,30933,29041,1892,6.1
"22087",22,87,2003,30655,28767,1888,6.2
"22087",22,87,2004,30582,28929,1653,5.4
"22087",22,87,2005,,,,
"22087",22,87,2006,,,,
"22087",22,87,2007,9757,9336,421,4.3
"22087",22,87,2008,17556,16765,791,4.5
"22087",22,87,2009,18076,16950,1126,6.2
"22087",22,87,2010,15951,14621,1330,8.3
"22087",22,87,2011,16856,15424,1432,8.5
"22087",22,87,2012,17640,16235,1405,8
"22087",22,87,2013,18518,17148,1370,7.4
"22087",22,87,2014,19251,17914,1337,6.9
"22087",22,87,2015,19756,18451,1305,6.6
"22087",22,87,2016,19592,18404,1188,6.1
"22087",22,87,2017,19477,18459,1018,5.2
"22089",22,89,1990,19680,18486,1194,6.1
"22089",22,89,1991,20435,18935,1500,7.3
"22089",22,89,1992,20810,18653,2157,10.4
"22089",22,89,1993,21287,18944,2343,11
"22089",22,89,1994,21737,19734,2003,9.2
"22089",22,89,1995,22027,20287,1740,7.9
"22089",22,89,1996,22779,21070,1709,7.5
"22089",22,89,1997,23271,21991,1280,5.5
"22089",22,89,1998,23885,22631,1254,5.3
"22089",22,89,1999,24105,22835,1270,5.3
"22089",22,89,2000,23964,22627,1337,5.6
"22089",22,89,2001,23722,22431,1291,5.4
"22089",22,89,2002,23495,22163,1332,5.7
"22089",22,89,2003,23553,22225,1328,5.6
"22089",22,89,2004,23964,22707,1257,5.2
"22089",22,89,2005,,,,
"22089",22,89,2006,,,,
"22089",22,89,2007,26273,25275,998,3.8
"22089",22,89,2008,24794,23627,1167,4.7
"22089",22,89,2009,23740,22192,1548,6.5
"22089",22,89,2010,25481,23594,1887,7.4
"22089",22,89,2011,24836,23044,1792,7.2
"22089",22,89,2012,24715,23094,1621,6.6
"22089",22,89,2013,24931,23368,1563,6.3
"22089",22,89,2014,25517,23962,1555,6.1
"22089",22,89,2015,25657,24188,1469,5.7
"22089",22,89,2016,25381,24037,1344,5.3
"22089",22,89,2017,25219,24085,1134,4.5
"22091",22,91,1990,3639,3400,239,6.6
"22091",22,91,1991,3722,3451,271,7.3
"22091",22,91,1992,3855,3588,267,6.9
"22091",22,91,1993,3879,3599,280,7.2
"22091",22,91,1994,3973,3672,301,7.6
"22091",22,91,1995,4010,3708,302,7.5
"22091",22,91,1996,3985,3701,284,7.1
"22091",22,91,1997,3907,3645,262,6.7
"22091",22,91,1998,3839,3608,231,6
"22091",22,91,1999,3891,3698,193,5
"22091",22,91,2000,4064,3830,234,5.8
"22091",22,91,2001,3967,3713,254,6.4
"22091",22,91,2002,3892,3636,256,6.6
"22091",22,91,2003,3875,3605,270,7
"22091",22,91,2004,3921,3658,263,6.7
"22091",22,91,2005,4370,3756,614,14.1
"22091",22,91,2006,4221,3886,335,7.9
"22091",22,91,2007,4216,3899,317,7.5
"22091",22,91,2008,4284,3903,381,8.9
"22091",22,91,2009,4232,3773,459,10.8
"22091",22,91,2010,4716,4097,619,13.1
"22091",22,91,2011,4637,4002,635,13.7
"22091",22,91,2012,4600,4045,555,12.1
"22091",22,91,2013,4574,4056,518,11.3
"22091",22,91,2014,4541,4085,456,10
"22091",22,91,2015,4538,4126,412,9.1
"22091",22,91,2016,4400,4064,336,7.6
"22091",22,91,2017,4386,4098,288,6.6
"22093",22,93,1990,8881,8182,699,7.9
"22093",22,93,1991,8815,8050,765,8.7
"22093",22,93,1992,8794,7933,861,9.8
"22093",22,93,1993,8745,7752,993,11.4
"22093",22,93,1994,8851,7854,997,11.3
"22093",22,93,1995,8742,7884,858,9.8
"22093",22,93,1996,8863,7952,911,10.3
"22093",22,93,1997,8744,8064,680,7.8
"22093",22,93,1998,8818,8129,689,7.8
"22093",22,93,1999,9056,8177,879,9.7
"22093",22,93,2000,8864,8102,762,8.6
"22093",22,93,2001,8779,7967,812,9.2
"22093",22,93,2002,8683,7887,796,9.2
"22093",22,93,2003,8807,7927,880,10
"22093",22,93,2004,8804,7938,866,9.8
"22093",22,93,2005,9021,8067,954,10.6
"22093",22,93,2006,8412,7846,566,6.7
"22093",22,93,2007,8634,8037,597,6.9
"22093",22,93,2008,9190,8505,685,7.5
"22093",22,93,2009,9335,8470,865,9.3
"22093",22,93,2010,10130,8949,1181,11.7
"22093",22,93,2011,9943,8738,1205,12.1
"22093",22,93,2012,9661,8684,977,10.1
"22093",22,93,2013,9680,8781,899,9.3
"22093",22,93,2014,9784,8940,844,8.6
"22093",22,93,2015,9822,8989,833,8.5
"22093",22,93,2016,9628,8910,718,7.5
"22093",22,93,2017,9547,8919,628,6.6
"22095",22,95,1990,17966,16537,1429,8
"22095",22,95,1991,18762,16822,1940,10.3
"22095",22,95,1992,18625,16508,2117,11.4
"22095",22,95,1993,19189,16615,2574,13.4
"22095",22,95,1994,19272,17109,2163,11.2
"22095",22,95,1995,19424,17414,2010,10.3
"22095",22,95,1996,20023,17920,2103,10.5
"22095",22,95,1997,19920,18383,1537,7.7
"22095",22,95,1998,20332,18823,1509,7.4
"22095",22,95,1999,20438,18940,1498,7.3
"22095",22,95,2000,20065,18702,1363,6.8
"22095",22,95,2001,20030,18657,1373,6.9
"22095",22,95,2002,19834,18415,1419,7.2
"22095",22,95,2003,20064,18662,1402,7
"22095",22,95,2004,20520,19108,1412,6.9
"22095",22,95,2005,,,,
"22095",22,95,2006,,,,
"22095",22,95,2007,22505,21380,1125,5
"22095",22,95,2008,21176,19887,1289,6.1
"22095",22,95,2009,20455,18691,1764,8.6
"22095",22,95,2010,21535,19252,2283,10.6
"22095",22,95,2011,20953,18736,2217,10.6
"22095",22,95,2012,20513,18611,1902,9.3
"22095",22,95,2013,20104,18361,1743,8.7
"22095",22,95,2014,20411,18777,1634,8
"22095",22,95,2015,20412,18885,1527,7.5
"22095",22,95,2016,20100,18731,1369,6.8
"22095",22,95,2017,19975,18760,1215,6.1
"22097",22,97,1990,29805,27318,2487,8.3
"22097",22,97,1991,30579,27651,2928,9.6
"22097",22,97,1992,30269,27124,3145,10.4
"22097",22,97,1993,29597,26858,2739,9.3
"22097",22,97,1994,30252,27246,3006,9.9
"22097",22,97,1995,30300,27704,2596,8.6
"22097",22,97,1996,30829,28459,2370,7.7
"22097",22,97,1997,32025,29566,2459,7.7
"22097",22,97,1998,32488,30098,2390,7.4
"22097",22,97,1999,31590,29293,2297,7.3
"22097",22,97,2000,32791,30658,2133,6.5
"22097",22,97,2001,32884,30611,2273,6.9
"22097",22,97,2002,32921,30552,2369,7.2
"22097",22,97,2003,33588,31023,2565,7.6
"22097",22,97,2004,34477,32213,2264,6.6
"22097",22,97,2005,37026,34372,2654,7.2
"22097",22,97,2006,37534,35842,1692,4.5
"22097",22,97,2007,37493,35764,1729,4.6
"22097",22,97,2008,38127,36090,2037,5.3
"22097",22,97,2009,38089,35268,2821,7.4
"22097",22,97,2010,34308,31015,3293,9.6
"22097",22,97,2011,33637,30471,3166,9.4
"22097",22,97,2012,33401,30626,2775,8.3
"22097",22,97,2013,33711,31077,2634,7.8
"22097",22,97,2014,34242,31621,2621,7.7
"22097",22,97,2015,33839,31121,2718,8
"22097",22,97,2016,32880,30235,2645,8
"22097",22,97,2017,32148,29992,2156,6.7
"22099",22,99,1990,19012,17943,1069,5.6
"22099",22,99,1991,19421,18099,1322,6.8
"22099",22,99,1992,19413,17807,1606,8.3
"22099",22,99,1993,18873,17608,1265,6.7
"22099",22,99,1994,19732,18175,1557,7.9
"22099",22,99,1995,19689,18328,1361,6.9
"22099",22,99,1996,20175,18927,1248,6.2
"22099",22,99,1997,21113,19815,1298,6.1
"22099",22,99,1998,21871,20341,1530,7
"22099",22,99,1999,21013,19769,1244,5.9
"22099",22,99,2000,21381,20193,1188,5.6
"22099",22,99,2001,22142,20721,1421,6.4
"22099",22,99,2002,21797,20311,1486,6.8
"22099",22,99,2003,21536,20228,1308,6.1
"22099",22,99,2004,21705,20482,1223,5.6
"22099",22,99,2005,22687,21322,1365,6
"22099",22,99,2006,23191,22304,887,3.8
"22099",22,99,2007,23666,22792,874,3.7
"22099",22,99,2008,24286,23264,1022,4.2
"22099",22,99,2009,23819,22252,1567,6.6
"22099",22,99,2010,24050,22137,1913,8
"22099",22,99,2011,24085,22309,1776,7.4
"22099",22,99,2012,24223,22716,1507,6.2
"22099",22,99,2013,24303,22872,1431,5.9
"22099",22,99,2014,24705,23282,1423,5.8
"22099",22,99,2015,24120,22460,1660,6.9
"22099",22,99,2016,23015,21237,1778,7.7
"22099",22,99,2017,22562,21190,1372,6.1
"22101",22,101,1990,24692,23141,1551,6.3
"22101",22,101,1991,25431,23451,1980,7.8
"22101",22,101,1992,24752,21600,3152,12.7
"22101",22,101,1993,23621,21470,2151,9.1
"22101",22,101,1994,24085,21832,2253,9.4
"22101",22,101,1995,24078,21987,2091,8.7
"22101",22,101,1996,24092,22374,1718,7.1
"22101",22,101,1997,25602,24117,1485,5.8
"22101",22,101,1998,25879,23934,1945,7.5
"22101",22,101,1999,23797,21233,2564,10.8
"22101",22,101,2000,22530,20866,1664,7.4
"22101",22,101,2001,22630,21031,1599,7.1
"22101",22,101,2002,21993,20311,1682,7.6
"22101",22,101,2003,22167,20509,1658,7.5
"22101",22,101,2004,21797,19903,1894,8.7
"22101",22,101,2005,22426,20448,1978,8.8
"22101",22,101,2006,23157,22071,1086,4.7
"22101",22,101,2007,23359,22360,999,4.3
"22101",22,101,2008,23734,22573,1161,4.9
"22101",22,101,2009,23070,21326,1744,7.6
"22101",22,101,2010,25185,22815,2370,9.4
"22101",22,101,2011,25136,22898,2238,8.9
"22101",22,101,2012,25413,23510,1903,7.5
"22101",22,101,2013,24985,23343,1642,6.6
"22101",22,101,2014,25366,23770,1596,6.3
"22101",22,101,2015,24306,22455,1851,7.6
"22101",22,101,2016,21986,19930,2056,9.4
"22101",22,101,2017,20410,18785,1625,8
"22103",22,103,1990,68345,64307,4038,5.9
"22103",22,103,1991,71740,66745,4995,7
"22103",22,103,1992,73287,66949,6338,8.6
"22103",22,103,1993,75660,69220,6440,8.5
"22103",22,103,1994,79698,73480,6218,7.8
"22103",22,103,1995,82561,77131,5430,6.6
"22103",22,103,1996,86226,81613,4613,5.3
"22103",22,103,1997,90849,86710,4139,4.6
"22103",22,103,1998,94233,90315,3918,4.2
"22103",22,103,1999,95591,92254,3337,3.5
"22103",22,103,2000,96612,92428,4184,4.3
"22103",22,103,2001,97371,92825,4546,4.7
"22103",22,103,2002,98187,93287,4900,5
"22103",22,103,2003,100593,95728,4865,4.8
"22103",22,103,2004,103963,99467,4496,4.3
"22103",22,103,2005,,,,
"22103",22,103,2006,,,,
"22103",22,103,2007,116435,112699,3736,3.2
"22103",22,103,2008,111695,107230,4465,4
"22103",22,103,2009,107777,101926,5851,5.4
"22103",22,103,2010,108755,101906,6849,6.3
"22103",22,103,2011,107963,101175,6788,6.3
"22103",22,103,2012,108755,102332,6423,5.9
"22103",22,103,2013,111065,104680,6385,5.7
"22103",22,103,2014,115130,108605,6525,5.7
"22103",22,103,2015,117664,111321,6343,5.4
"22103",22,103,2016,117759,111928,5831,5
"22103",22,103,2017,117253,112244,5009,4.3
"22105",22,105,1990,35325,32042,3283,9.3
"22105",22,105,1991,36197,32519,3678,10.2
"22105",22,105,1992,37945,34480,3465,9.1
"22105",22,105,1993,38555,34870,3685,9.6
"22105",22,105,1994,41225,36921,4304,10.4
"22105",22,105,1995,41586,37935,3651,8.8
"22105",22,105,1996,42255,38583,3672,8.7
"22105",22,105,1997,42149,38924,3225,7.7
"22105",22,105,1998,42940,39612,3328,7.8
"22105",22,105,1999,43815,41011,2804,6.4
"22105",22,105,2000,45252,42326,2926,6.5
"22105",22,105,2001,45853,42698,3155,6.9
"22105",22,105,2002,45405,42221,3184,7
"22105",22,105,2003,46732,43371,3361,7.2
"22105",22,105,2004,47876,44588,3288,6.9
"22105",22,105,2005,50534,45709,4825,9.5
"22105",22,105,2006,50843,48237,2606,5.1
"22105",22,105,2007,52370,49959,2411,4.6
"22105",22,105,2008,53318,50302,3016,5.7
"22105",22,105,2009,52708,48680,4028,7.6
"22105",22,105,2010,53664,48451,5213,9.7
"22105",22,105,2011,53286,48168,5118,9.6
"22105",22,105,2012,53029,48506,4523,8.5
"22105",22,105,2013,52934,48682,4252,8
"22105",22,105,2014,53829,49719,4110,7.6
"22105",22,105,2015,54314,50388,3926,7.2
"22105",22,105,2016,54284,50636,3648,6.7
"22105",22,105,2017,55118,52001,3117,5.7
"22107",22,107,1990,2657,2461,196,7.4
"22107",22,107,1991,2748,2503,245,8.9
"22107",22,107,1992,2994,2752,242,8.1
"22107",22,107,1993,3056,2805,251,8.2
"22107",22,107,1994,3129,2854,275,8.8
"22107",22,107,1995,3138,2869,269,8.6
"22107",22,107,1996,3049,2785,264,8.7
"22107",22,107,1997,3076,2831,245,8
"22107",22,107,1998,3096,2848,248,8
"22107",22,107,1999,3112,2909,203,6.5
"22107",22,107,2000,2484,2295,189,7.6
"22107",22,107,2001,2254,2057,197,8.7
"22107",22,107,2002,2307,2106,201,8.7
"22107",22,107,2003,2403,2181,222,9.2
"22107",22,107,2004,2271,2077,194,8.5
"22107",22,107,2005,2300,1985,315,13.7
"22107",22,107,2006,2328,2143,185,7.9
"22107",22,107,2007,2212,2046,166,7.5
"22107",22,107,2008,2133,1951,182,8.5
"22107",22,107,2009,2051,1804,247,12
"22107",22,107,2010,2121,1828,293,13.8
"22107",22,107,2011,1979,1723,256,12.9
"22107",22,107,2012,1815,1619,196,10.8
"22107",22,107,2013,1767,1601,166,9.4
"22107",22,107,2014,1787,1619,168,9.4
"22107",22,107,2015,1720,1552,168,9.8
"22107",22,107,2016,1629,1470,159,9.8
"22107",22,107,2017,1559,1428,131,8.4
"22109",22,109,1990,40524,38758,1766,4.4
"22109",22,109,1991,41532,39282,2250,5.4
"22109",22,109,1992,41684,38217,3467,8.3
"22109",22,109,1993,40616,38159,2457,6
"22109",22,109,1994,41919,39517,2402,5.7
"22109",22,109,1995,42397,40150,2247,5.3
"22109",22,109,1996,44254,42295,1959,4.4
"22109",22,109,1997,47209,45544,1665,3.5
"22109",22,109,1998,49442,47758,1684,3.4
"22109",22,109,1999,47810,45823,1987,4.2
"22109",22,109,2000,45879,43746,2133,4.6
"22109",22,109,2001,47155,44940,2215,4.7
"22109",22,109,2002,47735,45417,2318,4.9
"22109",22,109,2003,48476,46055,2421,5
"22109",22,109,2004,48592,46114,2478,5.1
"22109",22,109,2005,51003,47669,3334,6.5
"22109",22,109,2006,52669,50862,1807,3.4
"22109",22,109,2007,54759,53108,1651,3
"22109",22,109,2008,56498,54376,2122,3.8
"22109",22,109,2009,54316,51695,2621,4.8
"22109",22,109,2010,50910,47617,3293,6.5
"22109",22,109,2011,49902,46798,3104,6.2
"22109",22,109,2012,51017,48306,2711,5.3
"22109",22,109,2013,53032,50362,2670,5
"22109",22,109,2014,54745,52085,2660,4.9
"22109",22,109,2015,53101,49928,3173,6
"22109",22,109,2016,49060,45654,3406,6.9
"22109",22,109,2017,47102,44420,2682,5.7
"22111",22,111,1990,8554,8036,518,6.1
"22111",22,111,1991,8714,8047,667,7.7
"22111",22,111,1992,9643,8980,663,6.9
"22111",22,111,1993,10564,9975,589,5.6
"22111",22,111,1994,10928,10301,627,5.7
"22111",22,111,1995,11027,10464,563,5.1
"22111",22,111,1996,11266,10569,697,6.2
"22111",22,111,1997,11869,11221,648,5.5
"22111",22,111,1998,11954,11318,636,5.3
"22111",22,111,1999,12527,12025,502,4
"22111",22,111,2000,10204,9623,581,5.7
"22111",22,111,2001,10414,9788,626,6
"22111",22,111,2002,10416,9756,660,6.3
"22111",22,111,2003,10535,9756,779,7.4
"22111",22,111,2004,10388,9712,676,6.5
"22111",22,111,2005,10458,9805,653,6.2
"22111",22,111,2006,10347,9888,459,4.4
"22111",22,111,2007,10198,9679,519,5.1
"22111",22,111,2008,10179,9618,561,5.5
"22111",22,111,2009,10301,9205,1096,10.6
"22111",22,111,2010,9674,8667,1007,10.4
"22111",22,111,2011,9345,8464,881,9.4
"22111",22,111,2012,9220,8457,763,8.3
"22111",22,111,2013,9166,8451,715,7.8
"22111",22,111,2014,9385,8679,706,7.5
"22111",22,111,2015,9371,8700,671,7.2
"22111",22,111,2016,9264,8659,605,6.5
"22111",22,111,2017,9147,8636,511,5.6
"22113",22,113,1990,20186,19082,1104,5.5
"22113",22,113,1991,19951,18405,1546,7.7
"22113",22,113,1992,21315,19177,2138,10
"22113",22,113,1993,21174,19609,1565,7.4
"22113",22,113,1994,22103,20614,1489,6.7
"22113",22,113,1995,22292,20975,1317,5.9
"22113",22,113,1996,22690,21495,1195,5.3
"22113",22,113,1997,23080,21904,1176,5.1
"22113",22,113,1998,23142,21547,1595,6.9
"22113",22,113,1999,21866,20373,1493,6.8
"22113",22,113,2000,23345,22103,1242,5.3
"22113",22,113,2001,23584,22260,1324,5.6
"22113",22,113,2002,22803,21259,1544,6.8
"22113",22,113,2003,23024,21478,1546,6.7
"22113",22,113,2004,22839,21482,1357,5.9
"22113",22,113,2005,23387,21973,1414,6
"22113",22,113,2006,23969,23036,933,3.9
"22113",22,113,2007,24128,23198,930,3.9
"22113",22,113,2008,24629,23547,1082,4.4
"22113",22,113,2009,24638,23018,1620,6.6
"22113",22,113,2010,25637,23770,1867,7.3
"22113",22,113,2011,25357,23684,1673,6.6
"22113",22,113,2012,25807,24326,1481,5.7
"22113",22,113,2013,26113,24652,1461,5.6
"22113",22,113,2014,26558,25072,1486,5.6
"22113",22,113,2015,25883,24085,1798,6.9
"22113",22,113,2016,24757,22879,1878,7.6
"22113",22,113,2017,24349,22895,1454,6
"22115",22,115,1990,16523,15391,1132,6.9
"22115",22,115,1991,16069,14983,1086,6.8
"22115",22,115,1992,16680,15413,1267,7.6
"22115",22,115,1993,16945,15709,1236,7.3
"22115",22,115,1994,17040,15521,1519,8.9
"22115",22,115,1995,16935,15794,1141,6.7
"22115",22,115,1996,17139,15986,1153,6.7
"22115",22,115,1997,16958,15875,1083,6.4
"22115",22,115,1998,17406,16335,1071,6.2
"22115",22,115,1999,17109,16134,975,5.7
"22115",22,115,2000,18330,17203,1127,6.1
"22115",22,115,2001,18499,17282,1217,6.6
"22115",22,115,2002,18379,17147,1232,6.7
"22115",22,115,2003,18600,17373,1227,6.6
"22115",22,115,2004,19705,18652,1053,5.3
"22115",22,115,2005,21068,19829,1239,5.9
"22115",22,115,2006,21538,20671,867,4
"22115",22,115,2007,21174,20195,979,4.6
"22115",22,115,2008,20886,19869,1017,4.9
"22115",22,115,2009,20574,19195,1379,6.7
"22115",22,115,2010,18553,16958,1595,8.6
"22115",22,115,2011,19235,17501,1734,9
"22115",22,115,2012,18881,17320,1561,8.3
"22115",22,115,2013,17876,16299,1577,8.8
"22115",22,115,2014,17456,15963,1493,8.6
"22115",22,115,2015,17461,16103,1358,7.8
"22115",22,115,2016,16966,15742,1224,7.2
"22115",22,115,2017,16368,15310,1058,6.5
"22117",22,117,1990,15933,14616,1317,8.3
"22117",22,117,1991,16015,14315,1700,10.6
"22117",22,117,1992,16433,14709,1724,10.5
"22117",22,117,1993,16153,14755,1398,8.7
"22117",22,117,1994,17078,15571,1507,8.8
"22117",22,117,1995,16973,15575,1398,8.2
"22117",22,117,1996,16770,15459,1311,7.8
"22117",22,117,1997,16734,15474,1260,7.5
"22117",22,117,1998,16471,15208,1263,7.7
"22117",22,117,1999,16255,15319,936,5.8
"22117",22,117,2000,16815,15769,1046,6.2
"22117",22,117,2001,17064,15836,1228,7.2
"22117",22,117,2002,16711,15467,1244,7.4
"22117",22,117,2003,16550,15244,1306,7.9
"22117",22,117,2004,16272,15043,1229,7.6
"22117",22,117,2005,16300,14652,1648,10.1
"22117",22,117,2006,15527,14614,913,5.9
"22117",22,117,2007,15885,14958,927,5.8
"22117",22,117,2008,16067,15023,1044,6.5
"22117",22,117,2009,15715,14334,1381,8.8
"22117",22,117,2010,17114,15469,1645,9.6
"22117",22,117,2011,16615,15039,1576,9.5
"22117",22,117,2012,16478,15026,1452,8.8
"22117",22,117,2013,16423,15050,1373,8.4
"22117",22,117,2014,16984,15647,1337,7.9
"22117",22,117,2015,17072,15769,1303,7.6
"22117",22,117,2016,16983,15795,1188,7
"22117",22,117,2017,16976,15997,979,5.8
"22119",22,119,1990,17798,16262,1536,8.6
"22119",22,119,1991,17765,16101,1664,9.4
"22119",22,119,1992,18063,16256,1807,10
"22119",22,119,1993,17632,15991,1641,9.3
"22119",22,119,1994,18598,16426,2172,11.7
"22119",22,119,1995,18616,16681,1935,10.4
"22119",22,119,1996,18791,17068,1723,9.2
"22119",22,119,1997,18969,17350,1619,8.5
"22119",22,119,1998,19208,17602,1606,8.4
"22119",22,119,1999,18893,17713,1180,6.2
"22119",22,119,2000,18485,17353,1132,6.1
"22119",22,119,2001,18373,17049,1324,7.2
"22119",22,119,2002,17977,16528,1449,8.1
"22119",22,119,2003,18384,16834,1550,8.4
"22119",22,119,2004,18813,17506,1307,6.9
"22119",22,119,2005,19464,18212,1252,6.4
"22119",22,119,2006,19677,18808,869,4.4
"22119",22,119,2007,19807,18777,1030,5.2
"22119",22,119,2008,20297,19026,1271,6.3
"22119",22,119,2009,19627,17928,1699,8.7
"22119",22,119,2010,16831,15083,1748,10.4
"22119",22,119,2011,16569,14900,1669,10.1
"22119",22,119,2012,16084,14536,1548,9.6
"22119",22,119,2013,15713,14210,1503,9.6
"22119",22,119,2014,15700,14328,1372,8.7
"22119",22,119,2015,15608,14231,1377,8.8
"22119",22,119,2016,15232,13938,1294,8.5
"22119",22,119,2017,14869,13848,1021,6.9
"22121",22,121,1990,9205,8642,563,6.1
"22121",22,121,1991,9343,8681,662,7.1
"22121",22,121,1992,9436,8822,614,6.5
"22121",22,121,1993,9302,8596,706,7.6
"22121",22,121,1994,9476,8655,821,8.7
"22121",22,121,1995,9528,8857,671,7
"22121",22,121,1996,9704,9118,586,6
"22121",22,121,1997,9641,9117,524,5.4
"22121",22,121,1998,9891,9415,476,4.8
"22121",22,121,1999,9916,9507,409,4.1
"22121",22,121,2000,10181,9642,539,5.3
"22121",22,121,2001,10022,9455,567,5.7
"22121",22,121,2002,9880,9286,594,6
"22121",22,121,2003,10007,9296,711,7.1
"22121",22,121,2004,10212,9518,694,6.8
"22121",22,121,2005,10456,9720,736,7
"22121",22,121,2006,10410,9956,454,4.4
"22121",22,121,2007,10632,10195,437,4.1
"22121",22,121,2008,10779,10246,533,4.9
"22121",22,121,2009,10650,9937,713,6.7
"22121",22,121,2010,11924,10986,938,7.9
"22121",22,121,2011,11927,10999,928,7.8
"22121",22,121,2012,11908,11088,820,6.9
"22121",22,121,2013,12294,11540,754,6.1
"22121",22,121,2014,12900,12149,751,5.8
"22121",22,121,2015,13281,12537,744,5.6
"22121",22,121,2016,13270,12566,704,5.3
"22121",22,121,2017,13283,12668,615,4.6
"22123",22,123,1990,5034,4440,594,11.8
"22123",22,123,1991,5350,4439,911,17
"22123",22,123,1992,5487,4609,878,16
"22123",22,123,1993,5354,4603,751,14
"22123",22,123,1994,5215,4204,1011,19.4
"22123",22,123,1995,5252,4396,856,16.3
"22123",22,123,1996,5126,4413,713,13.9
"22123",22,123,1997,5282,4536,746,14.1
"22123",22,123,1998,5287,4597,690,13.1
"22123",22,123,1999,5322,4606,716,13.5
"22123",22,123,2000,4862,4395,467,9.6
"22123",22,123,2001,4875,4337,538,11
"22123",22,123,2002,4775,4238,537,11.2
"22123",22,123,2003,4746,4104,642,13.5
"22123",22,123,2004,4575,3978,597,13
"22123",22,123,2005,4732,4210,522,11
"22123",22,123,2006,5055,4712,343,6.8
"22123",22,123,2007,4485,4059,426,9.5
"22123",22,123,2008,4469,4002,467,10.4
"22123",22,123,2009,4491,3760,731,16.3
"22123",22,123,2010,4452,3727,725,16.3
"22123",22,123,2011,4268,3590,678,15.9
"22123",22,123,2012,4160,3594,566,13.6
"22123",22,123,2013,4247,3707,540,12.7
"22123",22,123,2014,4250,3695,555,13.1
"22123",22,123,2015,4129,3574,555,13.4
"22123",22,123,2016,4112,3622,490,11.9
"22123",22,123,2017,4019,3625,394,9.8
"22125",22,125,1990,3740,3486,254,6.8
"22125",22,125,1991,4012,3748,264,6.6
"22125",22,125,1992,4146,3905,241,5.8
"22125",22,125,1993,3631,3359,272,7.5
"22125",22,125,1994,3910,3572,338,8.6
"22125",22,125,1995,3613,3348,265,7.3
"22125",22,125,1996,3647,3388,259,7.1
"22125",22,125,1997,3767,3508,259,6.9
"22125",22,125,1998,3686,3482,204,5.5
"22125",22,125,1999,3693,3530,163,4.4
"22125",22,125,2000,4816,4492,324,6.7
"22125",22,125,2001,4746,4392,354,7.5
"22125",22,125,2002,4657,4310,347,7.5
"22125",22,125,2003,4701,4334,367,7.8
"22125",22,125,2004,4699,4369,330,7
"22125",22,125,2005,4932,4533,399,8.1
"22125",22,125,2006,4830,4572,258,5.3
"22125",22,125,2007,4788,4521,267,5.6
"22125",22,125,2008,4803,4525,278,5.8
"22125",22,125,2009,4743,4387,356,7.5
"22125",22,125,2010,5237,4885,352,6.7
"22125",22,125,2011,5138,4799,339,6.6
"22125",22,125,2012,5131,4820,311,6.1
"22125",22,125,2013,5228,4919,309,5.9
"22125",22,125,2014,5366,5060,306,5.7
"22125",22,125,2015,5415,5129,286,5.3
"22125",22,125,2016,5340,5065,275,5.1
"22125",22,125,2017,5330,5106,224,4.2
"22127",22,127,1990,6166,5906,260,4.2
"22127",22,127,1991,6019,5623,396,6.6
"22127",22,127,1992,6078,5749,329,5.4
"22127",22,127,1993,6196,5948,248,4
"22127",22,127,1994,6348,6026,322,5.1
"22127",22,127,1995,6526,6141,385,5.9
"22127",22,127,1996,6557,6130,427,6.5
"22127",22,127,1997,6695,6298,397,5.9
"22127",22,127,1998,6585,6152,433,6.6
"22127",22,127,1999,6427,6034,393,6.1
"22127",22,127,2000,6047,5650,397,6.6
"22127",22,127,2001,6099,5641,458,7.5
"22127",22,127,2002,6056,5596,460,7.6
"22127",22,127,2003,6205,5674,531,8.6
"22127",22,127,2004,6017,5610,407,6.8
"22127",22,127,2005,6243,5843,400,6.4
"22127",22,127,2006,6349,6062,287,4.5
"22127",22,127,2007,6375,6054,321,5
"22127",22,127,2008,6499,6128,371,5.7
"22127",22,127,2009,6504,5959,545,8.4
"22127",22,127,2010,5813,5270,543,9.3
"22127",22,127,2011,5651,5119,532,9.4
"22127",22,127,2012,5690,5205,485,8.5
"22127",22,127,2013,5377,4938,439,8.2
"22127",22,127,2014,5426,5016,410,7.6
"22127",22,127,2015,5347,4895,452,8.5
"22127",22,127,2016,5197,4795,402,7.7
"22127",22,127,2017,5059,4732,327,6.5
"23001",23,1,1990,56390,52567,3823,6.8
"23001",23,1,1991,57116,51913,5203,9.1
"23001",23,1,1992,56685,51829,4856,8.6
"23001",23,1,1993,56192,51761,4431,7.9
"23001",23,1,1994,55726,51715,4011,7.2
"23001",23,1,1995,56922,53518,3404,6
"23001",23,1,1996,57515,54148,3367,5.9
"23001",23,1,1997,57189,54032,3157,5.5
"23001",23,1,1998,57872,55065,2807,4.9
"23001",23,1,1999,59645,57326,2319,3.9
"23001",23,1,2000,55712,53809,1903,3.4
"23001",23,1,2001,55097,52910,2187,4
"23001",23,1,2002,55568,53142,2426,4.4
"23001",23,1,2003,56145,53348,2797,5
"23001",23,1,2004,55961,53433,2528,4.5
"23001",23,1,2005,57033,54212,2821,4.9
"23001",23,1,2006,57735,55073,2662,4.6
"23001",23,1,2007,58125,55454,2671,4.6
"23001",23,1,2008,58148,54929,3219,5.5
"23001",23,1,2009,57854,52990,4864,8.4
"23001",23,1,2010,55909,51116,4793,8.6
"23001",23,1,2011,56041,51497,4544,8.1
"23001",23,1,2012,56388,52019,4369,7.7
"23001",23,1,2013,56466,52696,3770,6.7
"23001",23,1,2014,55900,52862,3038,5.4
"23001",23,1,2015,54804,52518,2286,4.2
"23001",23,1,2016,55338,53352,1986,3.6
"23001",23,1,2017,55700,53961,1739,3.1
"23003",23,3,1990,38969,36275,2694,6.9
"23003",23,3,1991,41211,37317,3894,9.4
"23003",23,3,1992,41171,36939,4232,10.3
"23003",23,3,1993,39505,35240,4265,10.8
"23003",23,3,1994,38430,33904,4526,11.8
"23003",23,3,1995,38584,34529,4055,10.5
"23003",23,3,1996,38344,34833,3511,9.2
"23003",23,3,1997,38300,34936,3364,8.8
"23003",23,3,1998,37222,34563,2659,7.1
"23003",23,3,1999,37561,35513,2048,5.5
"23003",23,3,2000,34925,33453,1472,4.2
"23003",23,3,2001,34048,32504,1544,4.5
"23003",23,3,2002,34026,32268,1758,5.2
"23003",23,3,2003,34421,32324,2097,6.1
"23003",23,3,2004,34321,32196,2125,6.2
"23003",23,3,2005,35237,32903,2334,6.6
"23003",23,3,2006,35544,33233,2311,6.5
"23003",23,3,2007,35128,32921,2207,6.3
"23003",23,3,2008,34952,32506,2446,7
"23003",23,3,2009,34534,31175,3359,9.7
"23003",23,3,2010,34717,31344,3373,9.7
"23003",23,3,2011,34531,31148,3383,9.8
"23003",23,3,2012,34192,31008,3184,9.3
"23003",23,3,2013,33869,30955,2914,8.6
"23003",23,3,2014,32947,30441,2506,7.6
"23003",23,3,2015,31704,29829,1875,5.9
"23003",23,3,2016,31470,29762,1708,5.4
"23003",23,3,2017,31616,30094,1522,4.8
"23005",23,5,1990,133386,128316,5070,3.8
"23005",23,5,1991,133251,125343,7908,5.9
"23005",23,5,1992,132937,125605,7332,5.5
"23005",23,5,1993,128839,121823,7016,5.4
"23005",23,5,1994,128172,122135,6037,4.7
"23005",23,5,1995,131033,126172,4861,3.7
"23005",23,5,1996,137157,133032,4125,3
"23005",23,5,1997,139510,135713,3797,2.7
"23005",23,5,1998,139776,136296,3480,2.5
"23005",23,5,1999,141602,138420,3182,2.2
"23005",23,5,2000,149932,146206,3726,2.5
"23005",23,5,2001,149431,145219,4212,2.8
"23005",23,5,2002,149285,144479,4806,3.2
"23005",23,5,2003,151456,146156,5300,3.5
"23005",23,5,2004,153456,148302,5154,3.4
"23005",23,5,2005,155620,149953,5667,3.6
"23005",23,5,2006,156163,150916,5247,3.4
"23005",23,5,2007,157386,151982,5404,3.4
"23005",23,5,2008,157278,150651,6627,4.2
"23005",23,5,2009,156176,146081,10095,6.5
"23005",23,5,2010,156017,145846,10171,6.5
"23005",23,5,2011,158118,148107,10011,6.3
"23005",23,5,2012,159792,150251,9541,6
"23005",23,5,2013,160923,152393,8530,5.3
"23005",23,5,2014,159167,152135,7032,4.4
"23005",23,5,2015,157921,152496,5425,3.4
"23005",23,5,2016,161973,157249,4724,2.9
"23005",23,5,2017,165341,161135,4206,2.5
"23007",23,7,1990,14490,13567,923,6.4
"23007",23,7,1991,14989,13705,1284,8.6
"23007",23,7,1992,15038,13816,1222,8.1
"23007",23,7,1993,14907,13817,1090,7.3
"23007",23,7,1994,14480,13396,1084,7.5
"23007",23,7,1995,14989,13969,1020,6.8
"23007",23,7,1996,15337,14336,1001,6.5
"23007",23,7,1997,15061,13942,1119,7.4
"23007",23,7,1998,14401,13412,989,6.9
"23007",23,7,1999,14957,13953,1004,6.7
"23007",23,7,2000,14492,13760,732,5.1
"23007",23,7,2001,14111,13360,751,5.3
"23007",23,7,2002,14210,13487,723,5.1
"23007",23,7,2003,14276,13440,836,5.9
"23007",23,7,2004,14480,13662,818,5.6
"23007",23,7,2005,14639,13793,846,5.8
"23007",23,7,2006,14398,13574,824,5.7
"23007",23,7,2007,14111,13254,857,6.1
"23007",23,7,2008,14238,13229,1009,7.1
"23007",23,7,2009,14375,12877,1498,10.4
"23007",23,7,2010,15502,14071,1431,9.2
"23007",23,7,2011,15477,14076,1401,9.1
"23007",23,7,2012,15486,14145,1341,8.7
"23007",23,7,2013,15395,14209,1186,7.7
"23007",23,7,2014,14937,13963,974,6.5
"23007",23,7,2015,14534,13843,691,4.8
"23007",23,7,2016,14446,13800,646,4.5
"23007",23,7,2017,14537,13952,585,4
"23009",23,9,1990,24616,23384,1232,5
"23009",23,9,1991,25604,23826,1778,6.9
"23009",23,9,1992,25761,23821,1940,7.5
"23009",23,9,1993,25389,23437,1952,7.7
"23009",23,9,1994,26006,24064,1942,7.5
"23009",23,9,1995,26468,24681,1787,6.8
"23009",23,9,1996,27068,25484,1584,5.9
"23009",23,9,1997,27581,26057,1524,5.5
"23009",23,9,1998,27265,25866,1399,5.1
"23009",23,9,1999,28357,26916,1441,5.1
"23009",23,9,2000,28872,27707,1165,4
"23009",23,9,2001,28708,27524,1184,4.1
"23009",23,9,2002,28867,27624,1243,4.3
"23009",23,9,2003,29246,27783,1463,5
"23009",23,9,2004,29475,27969,1506,5.1
"23009",23,9,2005,29883,28227,1656,5.5
"23009",23,9,2006,29801,28224,1577,5.3
"23009",23,9,2007,29442,27835,1607,5.5
"23009",23,9,2008,29690,27891,1799,6.1
"23009",23,9,2009,29339,26796,2543,8.7
"23009",23,9,2010,29815,27185,2630,8.8
"23009",23,9,2011,30097,27430,2667,8.9
"23009",23,9,2012,29970,27377,2593,8.7
"23009",23,9,2013,30101,27728,2373,7.9
"23009",23,9,2014,29784,27755,2029,6.8
"23009",23,9,2015,29065,27442,1623,5.6
"23009",23,9,2016,29180,27862,1318,4.5
"23009",23,9,2017,29396,28282,1114,3.8
"23011",23,11,1990,61194,58451,2743,4.5
"23011",23,11,1991,61513,57246,4267,6.9
"23011",23,11,1992,61380,56994,4386,7.1
"23011",23,11,1993,59313,55067,4246,7.2
"23011",23,11,1994,58239,54265,3974,6.8
"23011",23,11,1995,59741,55677,4064,6.8
"23011",23,11,1996,60816,57336,3480,5.7
"23011",23,11,1997,60135,56806,3329,5.5
"23011",23,11,1998,58974,55811,3163,5.4
"23011",23,11,1999,59518,56910,2608,4.4
"23011",23,11,2000,61345,59188,2157,3.5
"23011",23,11,2001,60739,58420,2319,3.8
"23011",23,11,2002,60453,57881,2572,4.3
"23011",23,11,2003,60881,57797,3084,5.1
"23011",23,11,2004,60984,58038,2946,4.8
"23011",23,11,2005,62219,59093,3126,5
"23011",23,11,2006,63015,60232,2783,4.4
"23011",23,11,2007,62804,59929,2875,4.6
"23011",23,11,2008,63377,60001,3376,5.3
"23011",23,11,2009,63115,58337,4778,7.6
"23011",23,11,2010,62924,58135,4789,7.6
"23011",23,11,2011,63279,58540,4739,7.5
"23011",23,11,2012,63164,58636,4528,7.2
"23011",23,11,2013,63868,59883,3985,6.2
"23011",23,11,2014,63301,59896,3405,5.4
"23011",23,11,2015,61626,59013,2613,4.2
"23011",23,11,2016,62297,60028,2269,3.6
"23011",23,11,2017,62793,60775,2018,3.2
"23013",23,13,1990,18127,17187,940,5.2
"23013",23,13,1991,18680,17454,1226,6.6
"23013",23,13,1992,18613,17438,1175,6.3
"23013",23,13,1993,18655,17614,1041,5.6
"23013",23,13,1994,19072,18098,974,5.1
"23013",23,13,1995,20245,19404,841,4.2
"23013",23,13,1996,20794,20039,755,3.6
"23013",23,13,1997,20072,19277,795,4
"23013",23,13,1998,19833,19162,671,3.4
"23013",23,13,1999,19894,19321,573,2.9
"23013",23,13,2000,21024,20440,584,2.8
"23013",23,13,2001,20956,20310,646,3.1
"23013",23,13,2002,21076,20380,696,3.3
"23013",23,13,2003,21230,20336,894,4.2
"23013",23,13,2004,21393,20618,775,3.6
"23013",23,13,2005,21374,20474,900,4.2
"23013",23,13,2006,21421,20521,900,4.2
"23013",23,13,2007,21090,20174,916,4.3
"23013",23,13,2008,20926,19821,1105,5.3
"23013",23,13,2009,20559,18936,1623,7.9
"23013",23,13,2010,20391,18883,1508,7.4
"23013",23,13,2011,20451,18948,1503,7.3
"23013",23,13,2012,20617,19190,1427,6.9
"23013",23,13,2013,20785,19551,1234,5.9
"23013",23,13,2014,20642,19579,1063,5.1
"23013",23,13,2015,20475,19635,840,4.1
"23013",23,13,2016,20709,19981,728,3.5
"23013",23,13,2017,20727,20077,650,3.1
"23015",23,15,1990,15361,14828,533,3.5
"23015",23,15,1991,15827,14963,864,5.5
"23015",23,15,1992,16252,15300,952,5.9
"23015",23,15,1993,16238,15251,987,6.1
"23015",23,15,1994,15904,15045,859,5.4
"23015",23,15,1995,16657,15858,799,4.8
"23015",23,15,1996,17060,16384,676,4
"23015",23,15,1997,16884,16249,635,3.8
"23015",23,15,1998,16971,16399,572,3.4
"23015",23,15,1999,17533,17038,495,2.8
"23015",23,15,2000,17911,17370,541,3
"23015",23,15,2001,17645,17055,590,3.3
"23015",23,15,2002,17556,16929,627,3.6
"23015",23,15,2003,17788,17045,743,4.2
"23015",23,15,2004,18024,17318,706,3.9
"23015",23,15,2005,18258,17442,816,4.5
"23015",23,15,2006,18493,17715,778,4.2
"23015",23,15,2007,18187,17424,763,4.2
"23015",23,15,2008,18319,17371,948,5.2
"23015",23,15,2009,17918,16561,1357,7.6
"23015",23,15,2010,17122,15824,1298,7.6
"23015",23,15,2011,17130,15797,1333,7.8
"23015",23,15,2012,17256,15993,1263,7.3
"23015",23,15,2013,17367,16186,1181,6.8
"23015",23,15,2014,17202,16185,1017,5.9
"23015",23,15,2015,16727,15983,744,4.4
"23015",23,15,2016,17014,16385,629,3.7
"23015",23,15,2017,17077,16526,551,3.2
"23017",23,17,1990,25183,23427,1756,7
"23017",23,17,1991,25717,23279,2438,9.5
"23017",23,17,1992,25872,23636,2236,8.6
"23017",23,17,1993,25491,23193,2298,9
"23017",23,17,1994,24882,22593,2289,9.2
"23017",23,17,1995,25344,23460,1884,7.4
"23017",23,17,1996,26026,24376,1650,6.3
"23017",23,17,1997,25982,24328,1654,6.4
"23017",23,17,1998,26340,24722,1618,6.1
"23017",23,17,1999,26372,24674,1698,6.4
"23017",23,17,2000,27828,26687,1141,4.1
"23017",23,17,2001,27532,26244,1288,4.7
"23017",23,17,2002,27419,25918,1501,5.5
"23017",23,17,2003,27643,26037,1606,5.8
"23017",23,17,2004,27705,26137,1568,5.7
"23017",23,17,2005,28122,26492,1630,5.8
"23017",23,17,2006,28503,26889,1614,5.7
"23017",23,17,2007,28305,26645,1660,5.9
"23017",23,17,2008,28212,26254,1958,6.9
"23017",23,17,2009,28053,25049,3004,10.7
"23017",23,17,2010,27923,24935,2988,10.7
"23017",23,17,2011,27867,24942,2925,10.5
"23017",23,17,2012,27903,25196,2707,9.7
"23017",23,17,2013,27768,25469,2299,8.3
"23017",23,17,2014,27347,25430,1917,7
"23017",23,17,2015,26532,25087,1445,5.4
"23017",23,17,2016,26567,25338,1229,4.6
"23017",23,17,2017,26917,25901,1016,3.8
"23019",23,19,1990,74551,70218,4333,5.8
"23019",23,19,1991,75492,69558,5934,7.9
"23019",23,19,1992,75427,70068,5359,7.1
"23019",23,19,1993,73758,68585,5173,7
"23019",23,19,1994,72535,67117,5418,7.5
"23019",23,19,1995,74131,69446,4685,6.3
"23019",23,19,1996,75547,71472,4075,5.4
"23019",23,19,1997,74793,70667,4126,5.5
"23019",23,19,1998,74997,71546,3451,4.6
"23019",23,19,1999,77190,74015,3175,4.1
"23019",23,19,2000,75494,72700,2794,3.7
"23019",23,19,2001,75763,72646,3117,4.1
"23019",23,19,2002,76195,72681,3514,4.6
"23019",23,19,2003,76852,72290,4562,5.9
"23019",23,19,2004,75961,71771,4190,5.5
"23019",23,19,2005,77286,73351,3935,5.1
"23019",23,19,2006,77596,73751,3845,5
"23019",23,19,2007,78551,74526,4025,5.1
"23019",23,19,2008,78814,74277,4537,5.8
"23019",23,19,2009,78535,72099,6436,8.2
"23019",23,19,2010,79017,72321,6696,8.5
"23019",23,19,2011,79566,72972,6594,8.3
"23019",23,19,2012,79928,73723,6205,7.8
"23019",23,19,2013,80082,74603,5479,6.8
"23019",23,19,2014,78956,74139,4817,6.1
"23019",23,19,2015,76866,73225,3641,4.7
"23019",23,19,2016,76988,73648,3340,4.3
"23019",23,19,2017,77131,74271,2860,3.7
"23021",23,21,1990,8688,8132,556,6.4
"23021",23,21,1991,8885,8057,828,9.3
"23021",23,21,1992,8762,7982,780,8.9
"23021",23,21,1993,8459,7689,770,9.1
"23021",23,21,1994,8393,7607,786,9.4
"23021",23,21,1995,8472,7787,685,8.1
"23021",23,21,1996,8566,7914,652,7.6
"23021",23,21,1997,8457,7801,656,7.8
"23021",23,21,1998,8279,7729,550,6.6
"23021",23,21,1999,8302,7737,565,6.8
"23021",23,21,2000,7964,7545,419,5.3
"23021",23,21,2001,7886,7440,446,5.7
"23021",23,21,2002,7477,6960,517,6.9
"23021",23,21,2003,7461,6875,586,7.9
"23021",23,21,2004,7329,6827,502,6.8
"23021",23,21,2005,7517,6964,553,7.4
"23021",23,21,2006,7537,7035,502,6.7
"23021",23,21,2007,7426,6869,557,7.5
"23021",23,21,2008,7401,6781,620,8.4
"23021",23,21,2009,7376,6474,902,12.2
"23021",23,21,2010,7962,7110,852,10.7
"23021",23,21,2011,7944,7137,807,10.2
"23021",23,21,2012,7880,7132,748,9.5
"23021",23,21,2013,7894,7197,697,8.8
"23021",23,21,2014,7697,7137,560,7.3
"23021",23,21,2015,7452,7041,411,5.5
"23021",23,21,2016,7476,7103,373,5
"23021",23,21,2017,7543,7240,303,4
"23023",23,23,1990,16194,15627,567,3.5
"23023",23,23,1991,16564,15663,901,5.4
"23023",23,23,1992,16331,15451,880,5.4
"23023",23,23,1993,15777,14942,835,5.3
"23023",23,23,1994,15643,14917,726,4.6
"23023",23,23,1995,15855,15182,673,4.2
"23023",23,23,1996,15842,15191,651,4.1
"23023",23,23,1997,15700,15111,589,3.8
"23023",23,23,1998,15483,14982,501,3.2
"23023",23,23,1999,16249,15774,475,2.9
"23023",23,23,2000,18950,18444,506,2.7
"23023",23,23,2001,18452,17873,579,3.1
"23023",23,23,2002,18064,17431,633,3.5
"23023",23,23,2003,18282,17570,712,3.9
"23023",23,23,2004,18520,17835,685,3.7
"23023",23,23,2005,18535,17724,811,4.4
"23023",23,23,2006,18721,17977,744,4
"23023",23,23,2007,18899,18164,735,3.9
"23023",23,23,2008,19055,18137,918,4.8
"23023",23,23,2009,18686,17355,1331,7.1
"23023",23,23,2010,19219,17940,1279,6.7
"23023",23,23,2011,19145,17851,1294,6.8
"23023",23,23,2012,19210,17941,1269,6.6
"23023",23,23,2013,19124,18049,1075,5.6
"23023",23,23,2014,19029,18165,864,4.5
"23023",23,23,2015,18934,18268,666,3.5
"23023",23,23,2016,19192,18622,570,3
"23023",23,23,2017,19398,18875,523,2.7
"23025",23,25,1990,24593,22897,1696,6.9
"23025",23,25,1991,25792,23181,2611,10.1
"23025",23,25,1992,26375,23775,2600,9.9
"23025",23,25,1993,25392,22870,2522,9.9
"23025",23,25,1994,25153,22580,2573,10.2
"23025",23,25,1995,25524,23159,2365,9.3
"23025",23,25,1996,26282,24115,2167,8.2
"23025",23,25,1997,26220,23964,2256,8.6
"23025",23,25,1998,25464,23512,1952,7.7
"23025",23,25,1999,25678,23842,1836,7.2
"23025",23,25,2000,25258,24049,1209,4.8
"23025",23,25,2001,24623,23141,1482,6
"23025",23,25,2002,24438,22730,1708,7
"23025",23,25,2003,24586,22681,1905,7.7
"23025",23,25,2004,24369,22570,1799,7.4
"23025",23,25,2005,24780,22888,1892,7.6
"23025",23,25,2006,25193,23489,1704,6.8
"23025",23,25,2007,24886,23165,1721,6.9
"23025",23,25,2008,24775,22814,1961,7.9
"23025",23,25,2009,24650,21952,2698,10.9
"23025",23,25,2010,24679,21939,2740,11.1
"23025",23,25,2011,24691,22008,2683,10.9
"23025",23,25,2012,24628,22162,2466,10
"23025",23,25,2013,24811,22538,2273,9.2
"23025",23,25,2014,24318,22411,1907,7.8
"23025",23,25,2015,23634,22086,1548,6.5
"23025",23,25,2016,23486,22165,1321,5.6
"23025",23,25,2017,23345,22223,1122,4.8
"23027",23,27,1990,16181,14998,1183,7.3
"23027",23,27,1991,16798,15218,1580,9.4
"23027",23,27,1992,16938,15457,1481,8.7
"23027",23,27,1993,17032,15541,1491,8.8
"23027",23,27,1994,16955,15577,1378,8.1
"23027",23,27,1995,17738,16434,1304,7.4
"23027",23,27,1996,19773,18581,1192,6
"23027",23,27,1997,20322,19169,1153,5.7
"23027",23,27,1998,20387,19329,1058,5.2
"23027",23,27,1999,21651,20741,910,4.2
"23027",23,27,2000,19142,18390,752,3.9
"23027",23,27,2001,19415,18587,828,4.3
"23027",23,27,2002,19311,18380,931,4.8
"23027",23,27,2003,19698,18600,1098,5.6
"23027",23,27,2004,19374,18382,992,5.1
"23027",23,27,2005,19519,18465,1054,5.4
"23027",23,27,2006,19537,18528,1009,5.2
"23027",23,27,2007,18872,17847,1025,5.4
"23027",23,27,2008,19082,17893,1189,6.2
"23027",23,27,2009,19025,17338,1687,8.9
"23027",23,27,2010,20407,18675,1732,8.5
"23027",23,27,2011,20395,18709,1686,8.3
"23027",23,27,2012,20684,18977,1707,8.3
"23027",23,27,2013,21009,19502,1507,7.2
"23027",23,27,2014,20836,19576,1260,6
"23027",23,27,2015,20617,19543,1074,5.2
"23027",23,27,2016,20861,19988,873,4.2
"23027",23,27,2017,21095,20338,757,3.6
"23029",23,29,1990,15539,14357,1182,7.6
"23029",23,29,1991,16491,14852,1639,9.9
"23029",23,29,1992,16626,14970,1656,10
"23029",23,29,1993,16351,14396,1955,12
"23029",23,29,1994,15895,14008,1887,11.9
"23029",23,29,1995,16422,14795,1627,9.9
"23029",23,29,1996,16706,15119,1587,9.5
"23029",23,29,1997,16681,14953,1728,10.4
"23029",23,29,1998,16227,14665,1562,9.6
"23029",23,29,1999,16382,14973,1409,8.6
"23029",23,29,2000,15809,14866,943,6
"23029",23,29,2001,15397,14363,1034,6.7
"23029",23,29,2002,15201,14021,1180,7.8
"23029",23,29,2003,15364,14035,1329,8.7
"23029",23,29,2004,15044,13900,1144,7.6
"23029",23,29,2005,15343,14037,1306,8.5
"23029",23,29,2006,15182,14040,1142,7.5
"23029",23,29,2007,14494,13383,1111,7.7
"23029",23,29,2008,14516,13275,1241,8.5
"23029",23,29,2009,14393,12808,1585,11
"23029",23,29,2010,14945,13332,1613,10.8
"23029",23,29,2011,14889,13312,1577,10.6
"23029",23,29,2012,14751,13227,1524,10.3
"23029",23,29,2013,14636,13281,1355,9.3
"23029",23,29,2014,14383,13210,1173,8.2
"23029",23,29,2015,13992,13098,894,6.4
"23029",23,29,2016,14010,13233,777,5.5
"23029",23,29,2017,14070,13379,691,4.9
"23031",23,31,1990,89556,85251,4305,4.8
"23031",23,31,1991,91168,84897,6271,6.9
"23031",23,31,1992,90295,84251,6044,6.7
"23031",23,31,1993,87531,81970,5561,6.4
"23031",23,31,1994,86169,81219,4950,5.7
"23031",23,31,1995,89391,85455,3936,4.4
"23031",23,31,1996,93859,90225,3634,3.9
"23031",23,31,1997,93876,90543,3333,3.6
"23031",23,31,1998,93715,90752,2963,3.2
"23031",23,31,1999,97629,94954,2675,2.7
"23031",23,31,2000,103477,100722,2755,2.7
"23031",23,31,2001,104520,100960,3560,3.4
"23031",23,31,2002,106088,101626,4462,4.2
"23031",23,31,2003,108219,103259,4960,4.6
"23031",23,31,2004,109570,105195,4375,4
"23031",23,31,2005,111780,107108,4672,4.2
"23031",23,31,2006,112709,108346,4363,3.9
"23031",23,31,2007,112738,108199,4539,4
"23031",23,31,2008,112858,107347,5511,4.9
"23031",23,31,2009,111656,103107,8549,7.7
"23031",23,31,2010,108635,99974,8661,8
"23031",23,31,2011,109659,101611,8048,7.3
"23031",23,31,2012,110789,103143,7646,6.9
"23031",23,31,2013,111315,104279,7036,6.3
"23031",23,31,2014,109862,104187,5675,5.2
"23031",23,31,2015,108483,104220,4263,3.9
"23031",23,31,2016,111149,107396,3753,3.4
"23031",23,31,2017,113416,110116,3300,2.9
"24001",24,1,1990,32436,28861,3575,11
"24001",24,1,1991,32987,28927,4060,12.3
"24001",24,1,1992,33178,28683,4495,13.5
"24001",24,1,1993,32727,28938,3789,11.6
"24001",24,1,1994,32287,29100,3187,9.9
"24001",24,1,1995,32785,29738,3047,9.3
"24001",24,1,1996,32853,29893,2960,9
"24001",24,1,1997,33299,30061,3238,9.7
"24001",24,1,1998,32878,30027,2851,8.7
"24001",24,1,1999,32159,29834,2325,7.2
"24001",24,1,2000,32899,30942,1957,5.9
"24001",24,1,2001,33110,31028,2082,6.3
"24001",24,1,2002,33406,31346,2060,6.2
"24001",24,1,2003,34654,32589,2065,6
"24001",24,1,2004,35077,32940,2137,6.1
"24001",24,1,2005,35318,33166,2152,6.1
"24001",24,1,2006,35178,33192,1986,5.6
"24001",24,1,2007,34917,33139,1778,5.1
"24001",24,1,2008,35327,33330,1997,5.7
"24001",24,1,2009,36201,33120,3081,8.5
"24001",24,1,2010,34417,31204,3213,9.3
"24001",24,1,2011,34087,31001,3086,9.1
"24001",24,1,2012,33847,30830,3017,8.9
"24001",24,1,2013,33624,30772,2852,8.5
"24001",24,1,2014,33315,30784,2531,7.6
"24001",24,1,2015,32391,30133,2258,7
"24001",24,1,2016,32618,30588,2030,6.2
"24001",24,1,2017,32514,30640,1874,5.8
"24003",24,3,1990,231124,223411,7713,3.3
"24003",24,3,1991,231709,219977,11732,5.1
"24003",24,3,1992,234856,221325,13531,5.8
"24003",24,3,1993,239833,226788,13045,5.4
"24003",24,3,1994,241357,230872,10485,4.3
"24003",24,3,1995,245676,235865,9811,4
"24003",24,3,1996,249968,239637,10331,4.1
"24003",24,3,1997,254051,244353,9698,3.8
"24003",24,3,1998,254320,245759,8561,3.4
"24003",24,3,1999,256773,249511,7262,2.8
"24003",24,3,2000,267502,259373,8129,3
"24003",24,3,2001,270943,261656,9287,3.4
"24003",24,3,2002,272721,262101,10620,3.9
"24003",24,3,2003,271014,260711,10303,3.8
"24003",24,3,2004,271155,261113,10042,3.7
"24003",24,3,2005,274457,264791,9666,3.5
"24003",24,3,2006,277964,268698,9266,3.3
"24003",24,3,2007,279882,271502,8380,3
"24003",24,3,2008,283135,272533,10602,3.7
"24003",24,3,2009,286650,268409,18241,6.4
"24003",24,3,2010,286058,266347,19711,6.9
"24003",24,3,2011,289334,271043,18291,6.3
"24003",24,3,2012,293690,276061,17629,6
"24003",24,3,2013,296541,279673,16868,5.7
"24003",24,3,2014,297831,282762,15069,5.1
"24003",24,3,2015,301862,288620,13242,4.4
"24003",24,3,2016,305361,293739,11622,3.8
"24003",24,3,2017,309214,298195,11019,3.6
"24005",24,5,1990,381809,364422,17387,4.6
"24005",24,5,1991,381599,357608,23991,6.3
"24005",24,5,1992,384778,357202,27576,7.2
"24005",24,5,1993,387268,361351,25917,6.7
"24005",24,5,1994,384677,363068,21609,5.6
"24005",24,5,1995,388026,367570,20456,5.3
"24005",24,5,1996,393054,372063,20991,5.3
"24005",24,5,1997,397580,377271,20309,5.1
"24005",24,5,1998,394455,376425,18030,4.6
"24005",24,5,1999,393674,378792,14882,3.8
"24005",24,5,2000,408295,393073,15222,3.7
"24005",24,5,2001,412304,395297,17007,4.1
"24005",24,5,2002,414450,395451,18999,4.6
"24005",24,5,2003,413908,394519,19389,4.7
"24005",24,5,2004,413537,395206,18331,4.4
"24005",24,5,2005,419256,401317,17939,4.3
"24005",24,5,2006,425938,409160,16778,3.9
"24005",24,5,2007,427026,411968,15058,3.5
"24005",24,5,2008,430124,411253,18871,4.4
"24005",24,5,2009,432708,400615,32093,7.4
"24005",24,5,2010,431512,395902,35610,8.3
"24005",24,5,2011,435544,402056,33488,7.7
"24005",24,5,2012,440254,407889,32365,7.4
"24005",24,5,2013,442215,411834,30381,6.9
"24005",24,5,2014,442036,415127,26909,6.1
"24005",24,5,2015,446382,422797,23585,5.3
"24005",24,5,2016,447980,427142,20838,4.7
"24005",24,5,2017,453197,433601,19596,4.3
"24009",24,9,1990,27857,26872,985,3.5
"24009",24,9,1991,29541,27726,1815,6.1
"24009",24,9,1992,30805,28996,1809,5.9
"24009",24,9,1993,31332,29864,1468,4.7
"24009",24,9,1994,32941,31712,1229,3.7
"24009",24,9,1995,34203,32832,1371,4
"24009",24,9,1996,35362,33900,1462,4.1
"24009",24,9,1997,36206,34908,1298,3.6
"24009",24,9,1998,37263,35969,1294,3.5
"24009",24,9,1999,37956,36966,990,2.6
"24009",24,9,2000,40363,39142,1221,3
"24009",24,9,2001,41159,39852,1307,3.2
"24009",24,9,2002,42746,41271,1475,3.5
"24009",24,9,2003,44406,42865,1541,3.5
"24009",24,9,2004,45176,43634,1542,3.4
"24009",24,9,2005,46014,44445,1569,3.4
"24009",24,9,2006,47040,45559,1481,3.1
"24009",24,9,2007,47616,46280,1336,2.8
"24009",24,9,2008,48813,47130,1683,3.4
"24009",24,9,2009,48935,46072,2863,5.9
"24009",24,9,2010,47829,44545,3284,6.9
"24009",24,9,2011,47713,44612,3101,6.5
"24009",24,9,2012,47706,44715,2991,6.3
"24009",24,9,2013,47759,44934,2825,5.9
"24009",24,9,2014,47282,44766,2516,5.3
"24009",24,9,2015,47161,44999,2162,4.6
"24009",24,9,2016,49089,47195,1894,3.9
"24009",24,9,2017,49925,48123,1802,3.6
"24011",24,11,1990,13922,13319,603,4.3
"24011",24,11,1991,14103,13078,1025,7.3
"24011",24,11,1992,14820,13571,1249,8.4
"24011",24,11,1993,15117,13937,1180,7.8
"24011",24,11,1994,14976,14230,746,5
"24011",24,11,1995,15455,14620,835,5.4
"24011",24,11,1996,15740,14789,951,6
"24011",24,11,1997,16007,15189,818,5.1
"24011",24,11,1998,16117,15431,686,4.3
"24011",24,11,1999,15852,15326,526,3.3
"24011",24,11,2000,15358,14802,556,3.6
"24011",24,11,2001,15512,14799,713,4.6
"24011",24,11,2002,15867,15144,723,4.6
"24011",24,11,2003,15611,14808,803,5.1
"24011",24,11,2004,15971,15218,753,4.7
"24011",24,11,2005,16172,15464,708,4.4
"24011",24,11,2006,16060,15359,701,4.4
"24011",24,11,2007,16199,15529,670,4.1
"24011",24,11,2008,16468,15590,878,5.3
"24011",24,11,2009,16438,14959,1479,9
"24011",24,11,2010,17420,15810,1610,9.2
"24011",24,11,2011,17482,15973,1509,8.6
"24011",24,11,2012,17610,16247,1363,7.7
"24011",24,11,2013,17683,16458,1225,6.9
"24011",24,11,2014,17434,16344,1090,6.3
"24011",24,11,2015,17524,16571,953,5.4
"24011",24,11,2016,17772,16925,847,4.8
"24011",24,11,2017,17936,17167,769,4.3
"24013",24,13,1990,68304,65813,2491,3.6
"24013",24,13,1991,69621,65675,3946,5.7
"24013",24,13,1992,70896,66666,4230,6
"24013",24,13,1993,72310,68475,3835,5.3
"24013",24,13,1994,73488,70293,3195,4.3
"24013",24,13,1995,76006,72875,3131,4.1
"24013",24,13,1996,78506,75238,3268,4.2
"24013",24,13,1997,80689,77632,3057,3.8
"24013",24,13,1998,81401,78851,2550,3.1
"24013",24,13,1999,82628,80556,2072,2.5
"24013",24,13,2000,83928,81422,2506,3
"24013",24,13,2001,85611,82879,2732,3.2
"24013",24,13,2002,87782,84643,3139,3.6
"24013",24,13,2003,89032,85819,3213,3.6
"24013",24,13,2004,90108,86984,3124,3.5
"24013",24,13,2005,91900,88855,3045,3.3
"24013",24,13,2006,94352,91368,2984,3.2
"24013",24,13,2007,93995,91246,2749,2.9
"24013",24,13,2008,95024,91551,3473,3.7
"24013",24,13,2009,95197,89095,6102,6.4
"24013",24,13,2010,92595,86280,6315,6.8
"24013",24,13,2011,92837,87140,5697,6.1
"24013",24,13,2012,93262,87755,5507,5.9
"24013",24,13,2013,93057,87953,5104,5.5
"24013",24,13,2014,92699,88247,4452,4.8
"24013",24,13,2015,93340,89412,3928,4.2
"24013",24,13,2016,93662,90261,3401,3.6
"24013",24,13,2017,94869,91658,3211,3.4
"24015",24,15,1990,36035,32460,3575,9.9
"24015",24,15,1991,36600,32293,4307,11.8
"24015",24,15,1992,36485,32559,3926,10.8
"24015",24,15,1993,37065,33902,3163,8.5
"24015",24,15,1994,37261,34317,2944,7.9
"24015",24,15,1995,38561,35533,3028,7.9
"24015",24,15,1996,40893,36758,4135,10.1
"24015",24,15,1997,40886,37719,3167,7.7
"24015",24,15,1998,41340,38632,2708,6.6
"24015",24,15,1999,41448,39537,1911,4.6
"24015",24,15,2000,45771,44149,1622,3.5
"24015",24,15,2001,46301,44493,1808,3.9
"24015",24,15,2002,46977,44878,2099,4.5
"24015",24,15,2003,47811,45366,2445,5.1
"24015",24,15,2004,48611,46491,2120,4.4
"24015",24,15,2005,49714,47424,2290,4.6
"24015",24,15,2006,50626,48411,2215,4.4
"24015",24,15,2007,50522,48588,1934,3.8
"24015",24,15,2008,50885,48298,2587,5.1
"24015",24,15,2009,51045,46415,4630,9.1
"24015",24,15,2010,51979,47029,4950,9.5
"24015",24,15,2011,52098,47471,4627,8.9
"24015",24,15,2012,51885,47560,4325,8.3
"24015",24,15,2013,52245,48224,4021,7.7
"24015",24,15,2014,52505,49048,3457,6.6
"24015",24,15,2015,52742,49594,3148,6
"24015",24,15,2016,52958,50194,2764,5.2
"24015",24,15,2017,53107,50558,2549,4.8
"24017",24,17,1990,53937,52438,1499,2.8
"24017",24,17,1991,55226,52754,2472,4.5
"24017",24,17,1992,56748,53556,3192,5.6
"24017",24,17,1993,56108,53574,2534,4.5
"24017",24,17,1994,57570,55488,2082,3.6
"24017",24,17,1995,58805,56581,2224,3.8
"24017",24,17,1996,59257,57149,2108,3.6
"24017",24,17,1997,60145,57798,2347,3.9
"24017",24,17,1998,60851,58950,1901,3.1
"24017",24,17,1999,61954,60389,1565,2.5
"24017",24,17,2000,65114,63181,1933,3
"24017",24,17,2001,66254,64161,2093,3.2
"24017",24,17,2002,67837,65463,2374,3.5
"24017",24,17,2003,69873,67475,2398,3.4
"24017",24,17,2004,71076,68665,2411,3.4
"24017",24,17,2005,72704,70220,2484,3.4
"24017",24,17,2006,74435,72087,2348,3.2
"24017",24,17,2007,75920,73725,2195,2.9
"24017",24,17,2008,77637,74846,2791,3.6
"24017",24,17,2009,78070,73500,4570,5.9
"24017",24,17,2010,78219,72812,5407,6.9
"24017",24,17,2011,78996,73697,5299,6.7
"24017",24,17,2012,79554,74249,5305,6.7
"24017",24,17,2013,80254,75072,5182,6.5
"24017",24,17,2014,80250,75644,4606,5.7
"24017",24,17,2015,80764,76752,4012,5
"24017",24,17,2016,84413,80834,3579,4.2
"24017",24,17,2017,85792,82373,3419,4
"24019",24,19,1990,15785,14640,1145,7.3
"24019",24,19,1991,15785,14249,1536,9.7
"24019",24,19,1992,15117,13181,1936,12.8
"24019",24,19,1993,15595,13976,1619,10.4
"24019",24,19,1994,15199,13809,1390,9.1
"24019",24,19,1995,15796,14245,1551,9.8
"24019",24,19,1996,15611,13907,1704,10.9
"24019",24,19,1997,15663,14038,1625,10.4
"24019",24,19,1998,16119,14588,1531,9.5
"24019",24,19,1999,15419,14277,1142,7.4
"24019",24,19,2000,15588,14787,801,5.1
"24019",24,19,2001,16031,15025,1006,6.3
"24019",24,19,2002,16353,15292,1061,6.5
"24019",24,19,2003,16322,15204,1118,6.8
"24019",24,19,2004,17035,16040,995,5.8
"24019",24,19,2005,16998,16075,923,5.4
"24019",24,19,2006,16762,15802,960,5.7
"24019",24,19,2007,16661,15700,961,5.8
"24019",24,19,2008,16636,15518,1118,6.7
"24019",24,19,2009,16870,15073,1797,10.7
"24019",24,19,2010,16551,14667,1884,11.4
"24019",24,19,2011,16525,14688,1837,11.1
"24019",24,19,2012,16174,14421,1753,10.8
"24019",24,19,2013,15957,14401,1556,9.8
"24019",24,19,2014,15805,14480,1325,8.4
"24019",24,19,2015,15846,14714,1132,7.1
"24019",24,19,2016,15984,14992,992,6.2
"24019",24,19,2017,15743,14844,899,5.7
"24021",24,21,1990,83985,80644,3341,4
"24021",24,21,1991,86261,81409,4852,5.6
"24021",24,21,1992,88752,83759,4993,5.6
"24021",24,21,1993,89670,85518,4152,4.6
"24021",24,21,1994,93828,90035,3793,4
"24021",24,21,1995,96375,92472,3903,4
"24021",24,21,1996,97246,93872,3374,3.5
"24021",24,21,1997,98686,95033,3653,3.7
"24021",24,21,1998,99226,96424,2802,2.8
"24021",24,21,1999,100836,98617,2219,2.2
"24021",24,21,2000,109593,106609,2984,2.7
"24021",24,21,2001,111918,108398,3520,3.1
"24021",24,21,2002,115010,111058,3952,3.4
"24021",24,21,2003,116690,112660,4030,3.5
"24021",24,21,2004,117954,114042,3912,3.3
"24021",24,21,2005,120349,116571,3778,3.1
"24021",24,21,2006,122779,118916,3863,3.1
"24021",24,21,2007,123692,120143,3549,2.9
"24021",24,21,2008,123410,118950,4460,3.6
"24021",24,21,2009,124142,116345,7797,6.3
"24021",24,21,2010,127907,119078,8829,6.9
"24021",24,21,2011,128566,120294,8272,6.4
"24021",24,21,2012,128605,120756,7849,6.1
"24021",24,21,2013,128453,121082,7371,5.7
"24021",24,21,2014,128206,121728,6478,5.1
"24021",24,21,2015,128928,123176,5752,4.5
"24021",24,21,2016,129447,124392,5055,3.9
"24021",24,21,2017,131266,126505,4761,3.6
"24023",24,23,1990,13471,12210,1261,9.4
"24023",24,23,1991,13524,11829,1695,12.5
"24023",24,23,1992,13633,11777,1856,13.6
"24023",24,23,1993,13901,12126,1775,12.8
"24023",24,23,1994,13668,12145,1523,11.1
"24023",24,23,1995,14029,12576,1453,10.4
"24023",24,23,1996,14420,12855,1565,10.9
"24023",24,23,1997,14457,12512,1945,13.5
"24023",24,23,1998,14438,12907,1531,10.6
"24023",24,23,1999,13472,12320,1152,8.6
"24023",24,23,2000,14516,13759,757,5.2
"24023",24,23,2001,14930,14136,794,5.3
"24023",24,23,2002,15522,14681,841,5.4
"24023",24,23,2003,15569,14759,810,5.2
"24023",24,23,2004,16223,15428,795,4.9
"24023",24,23,2005,16519,15725,794,4.8
"24023",24,23,2006,16763,15950,813,4.8
"24023",24,23,2007,16673,15945,728,4.4
"24023",24,23,2008,16788,15975,813,4.8
"24023",24,23,2009,16815,15510,1305,7.8
"24023",24,23,2010,15806,14404,1402,8.9
"24023",24,23,2011,15810,14483,1327,8.4
"24023",24,23,2012,15829,14517,1312,8.3
"24023",24,23,2013,15748,14480,1268,8.1
"24023",24,23,2014,15560,14450,1110,7.1
"24023",24,23,2015,15688,14701,987,6.3
"24023",24,23,2016,15601,14718,883,5.7
"24023",24,23,2017,15612,14798,814,5.2
"24025",24,25,1990,97847,93582,4265,4.4
"24025",24,25,1991,99833,93704,6129,6.1
"24025",24,25,1992,103334,95852,7482,7.2
"24025",24,25,1993,104173,97592,6581,6.3
"24025",24,25,1994,106236,99954,6282,5.9
"24025",24,25,1995,108609,102556,6053,5.6
"24025",24,25,1996,111168,105183,5985,5.4
"24025",24,25,1997,113478,107856,5622,5
"24025",24,25,1998,113617,108588,5029,4.4
"24025",24,25,1999,114305,110610,3695,3.2
"24025",24,25,2000,119865,115950,3915,3.3
"24025",24,25,2001,121814,117329,4485,3.7
"24025",24,25,2002,123984,118753,5231,4.2
"24025",24,25,2003,125175,119790,5385,4.3
"24025",24,25,2004,126001,120936,5065,4
"24025",24,25,2005,129191,124093,5098,3.9
"24025",24,25,2006,132228,127445,4783,3.6
"24025",24,25,2007,131696,127310,4386,3.3
"24025",24,25,2008,133271,127825,5446,4.1
"24025",24,25,2009,134560,124971,9589,7.1
"24025",24,25,2010,132786,122448,10338,7.8
"24025",24,25,2011,133823,124168,9655,7.2
"24025",24,25,2012,135557,126142,9415,6.9
"24025",24,25,2013,135688,126864,8824,6.5
"24025",24,25,2014,135428,127739,7689,5.7
"24025",24,25,2015,136301,129612,6689,4.9
"24025",24,25,2016,137176,131393,5783,4.2
"24025",24,25,2017,138729,133327,5402,3.9
"24027",24,27,1990,113015,110229,2786,2.5
"24027",24,27,1991,114636,110325,4311,3.8
"24027",24,27,1992,117383,112356,5027,4.3
"24027",24,27,1993,122011,117300,4711,3.9
"24027",24,27,1994,125367,120860,4507,3.6
"24027",24,27,1995,129414,125156,4258,3.3
"24027",24,27,1996,133258,129136,4122,3.1
"24027",24,27,1997,137126,133228,3898,2.8
"24027",24,27,1998,139352,135988,3364,2.4
"24027",24,27,1999,143613,141035,2578,1.8
"24027",24,27,2000,144594,140938,3656,2.5
"24027",24,27,2001,148307,143845,4462,3
"24027",24,27,2002,150300,145126,5174,3.4
"24027",24,27,2003,150740,145719,5021,3.3
"24027",24,27,2004,151348,146452,4896,3.2
"24027",24,27,2005,154170,149405,4765,3.1
"24027",24,27,2006,158285,153768,4517,2.9
"24027",24,27,2007,159215,155198,4017,2.5
"24027",24,27,2008,161287,156349,4938,3.1
"24027",24,27,2009,163780,155290,8490,5.2
"24027",24,27,2010,160630,151610,9020,5.6
"24027",24,27,2011,163945,155433,8512,5.2
"24027",24,27,2012,168214,159777,8437,5
"24027",24,27,2013,171319,163070,8249,4.8
"24027",24,27,2014,173617,166114,7503,4.3
"24027",24,27,2015,177290,170550,6740,3.8
"24027",24,27,2016,180344,174403,5941,3.3
"24027",24,27,2017,182804,177062,5742,3.1
"24029",24,29,1990,9379,8852,527,5.6
"24029",24,29,1991,9498,8816,682,7.2
"24029",24,29,1992,9676,8884,792,8.2
"24029",24,29,1993,9761,9064,697,7.1
"24029",24,29,1994,9872,9302,570,5.8
"24029",24,29,1995,10283,9605,678,6.6
"24029",24,29,1996,10299,9452,847,8.2
"24029",24,29,1997,10216,9500,716,7
"24029",24,29,1998,10504,9884,620,5.9
"24029",24,29,1999,10010,9625,385,3.8
"24029",24,29,2000,10065,9674,391,3.9
"24029",24,29,2001,10392,9969,423,4.1
"24029",24,29,2002,10805,10326,479,4.4
"24029",24,29,2003,10256,9750,506,4.9
"24029",24,29,2004,10758,10297,461,4.3
"24029",24,29,2005,10919,10462,457,4.2
"24029",24,29,2006,11004,10576,428,3.9
"24029",24,29,2007,11125,10735,390,3.5
"24029",24,29,2008,11024,10500,524,4.8
"24029",24,29,2009,10886,10061,825,7.6
"24029",24,29,2010,10630,9693,937,8.8
"24029",24,29,2011,10768,9900,868,8.1
"24029",24,29,2012,10628,9818,810,7.6
"24029",24,29,2013,10347,9605,742,7.2
"24029",24,29,2014,10361,9695,666,6.4
"24029",24,29,2015,10608,10043,565,5.3
"24029",24,29,2016,10306,9805,501,4.9
"24029",24,29,2017,10308,9846,462,4.5
"24031",24,31,1990,439402,428862,10540,2.4
"24031",24,31,1991,442140,427558,14582,3.3
"24031",24,31,1992,449828,433162,16666,3.7
"24031",24,31,1993,448482,432865,15617,3.5
"24031",24,31,1994,459378,445658,13720,3
"24031",24,31,1995,462500,449093,13407,2.9
"24031",24,31,1996,466495,453768,12727,2.7
"24031",24,31,1997,464209,452425,11784,2.5
"24031",24,31,1998,469919,459322,10597,2.3
"24031",24,31,1999,475247,466434,8813,1.9
"24031",24,31,2000,487647,474773,12874,2.6
"24031",24,31,2001,492186,477132,15054,3.1
"24031",24,31,2002,497631,480430,17201,3.5
"24031",24,31,2003,498402,481984,16418,3.3
"24031",24,31,2004,497950,482101,15849,3.2
"24031",24,31,2005,504410,488676,15734,3.1
"24031",24,31,2006,510593,495926,14667,2.9
"24031",24,31,2007,509769,496401,13368,2.6
"24031",24,31,2008,515987,499705,16282,3.2
"24031",24,31,2009,522421,494565,27856,5.3
"24031",24,31,2010,532549,502710,29839,5.6
"24031",24,31,2011,536832,508549,28283,5.3
"24031",24,31,2012,540427,512438,27989,5.2
"24031",24,31,2013,543124,516264,26860,4.9
"24031",24,31,2014,545005,521063,23942,4.4
"24031",24,31,2015,549111,527763,21348,3.9
"24031",24,31,2016,548401,529491,18910,3.4
"24031",24,31,2017,557412,539132,18280,3.3
"24033",24,33,1990,425173,410389,14784,3.5
"24033",24,33,1991,430972,409530,21442,5
"24033",24,33,1992,437449,412276,25173,5.8
"24033",24,33,1993,431050,407899,23151,5.4
"24033",24,33,1994,440626,420217,20409,4.6
"24033",24,33,1995,444634,423522,21112,4.7
"24033",24,33,1996,443885,422316,21569,4.9
"24033",24,33,1997,446079,424231,21848,4.9
"24033",24,33,1998,441370,422589,18781,4.3
"24033",24,33,1999,440861,425229,15632,3.5
"24033",24,33,2000,429199,413296,15903,3.7
"24033",24,33,2001,432379,414310,18069,4.2
"24033",24,33,2002,437903,416730,21173,4.8
"24033",24,33,2003,441104,420528,20576,4.7
"24033",24,33,2004,440080,420448,19632,4.5
"24033",24,33,2005,442341,422550,19791,4.5
"24033",24,33,2006,444907,426421,18486,4.2
"24033",24,33,2007,445492,429521,15971,3.6
"24033",24,33,2008,450361,430909,19452,4.3
"24033",24,33,2009,457576,425799,31777,6.9
"24033",24,33,2010,479606,443635,35971,7.5
"24033",24,33,2011,482913,446857,36056,7.5
"24033",24,33,2012,484964,449665,35299,7.3
"24033",24,33,2013,486011,452439,33572,6.9
"24033",24,33,2014,486971,457449,29522,6.1
"24033",24,33,2015,488148,462577,25571,5.2
"24033",24,33,2016,503489,481107,22382,4.4
"24033",24,33,2017,511766,490451,21315,4.2
"24035",24,35,1990,18045,17439,606,3.4
"24035",24,35,1991,18259,17253,1006,5.5
"24035",24,35,1992,18574,17328,1246,6.7
"24035",24,35,1993,18793,17737,1056,5.6
"24035",24,35,1994,18874,17958,916,4.9
"24035",24,35,1995,19353,18483,870,4.5
"24035",24,35,1996,20186,19254,932,4.6
"24035",24,35,1997,20719,19885,834,4
"24035",24,35,1998,20952,20175,777,3.7
"24035",24,35,1999,21352,20743,609,2.9
"24035",24,35,2000,22697,21999,698,3.1
"24035",24,35,2001,23099,22314,785,3.4
"24035",24,35,2002,23714,22860,854,3.6
"24035",24,35,2003,24229,23313,916,3.8
"24035",24,35,2004,24476,23602,874,3.6
"24035",24,35,2005,25037,24160,877,3.5
"24035",24,35,2006,25798,24931,867,3.4
"24035",24,35,2007,26036,25230,806,3.1
"24035",24,35,2008,26645,25577,1068,4
"24035",24,35,2009,27043,25239,1804,6.7
"24035",24,35,2010,26141,24232,1909,7.3
"24035",24,35,2011,26608,24800,1808,6.8
"24035",24,35,2012,26731,25041,1690,6.3
"24035",24,35,2013,26466,24922,1544,5.8
"24035",24,35,2014,26401,25057,1344,5.1
"24035",24,35,2015,26706,25504,1202,4.5
"24035",24,35,2016,26753,25708,1045,3.9
"24035",24,35,2017,27125,26126,999,3.7
"24037",24,37,1990,38132,36543,1589,4.2
"24037",24,37,1991,40032,37798,2234,5.6
"24037",24,37,1992,39489,36826,2663,6.7
"24037",24,37,1993,40622,38294,2328,5.7
"24037",24,37,1994,40544,38578,1966,4.8
"24037",24,37,1995,41711,39647,2064,4.9
"24037",24,37,1996,44564,42456,2108,4.7
"24037",24,37,1997,48900,46810,2090,4.3
"24037",24,37,1998,46596,44809,1787,3.8
"24037",24,37,1999,49547,47985,1562,3.2
"24037",24,37,2000,44340,42894,1446,3.3
"24037",24,37,2001,45586,44066,1520,3.3
"24037",24,37,2002,47500,45788,1712,3.6
"24037",24,37,2003,48588,46911,1677,3.5
"24037",24,37,2004,49138,47466,1672,3.4
"24037",24,37,2005,49151,47414,1737,3.5
"24037",24,37,2006,50472,48769,1703,3.4
"24037",24,37,2007,50810,49312,1498,2.9
"24037",24,37,2008,52100,50223,1877,3.6
"24037",24,37,2009,53739,50736,3003,5.6
"24037",24,37,2010,53617,50114,3503,6.5
"24037",24,37,2011,54265,50842,3423,6.3
"24037",24,37,2012,54490,51102,3388,6.2
"24037",24,37,2013,54260,51028,3232,6
"24037",24,37,2014,54142,51236,2906,5.4
"24037",24,37,2015,54759,52108,2651,4.8
"24037",24,37,2016,55122,52783,2339,4.2
"24037",24,37,2017,55310,53104,2206,4
"24039",24,39,1990,11106,9452,1654,14.9
"24039",24,39,1991,11072,9631,1441,13
"24039",24,39,1992,11141,9774,1367,12.3
"24039",24,39,1993,11428,10057,1371,12
"24039",24,39,1994,11745,10392,1353,11.5
"24039",24,39,1995,11294,10088,1206,10.7
"24039",24,39,1996,11594,10414,1180,10.2
"24039",24,39,1997,11503,10410,1093,9.5
"24039",24,39,1998,11959,10860,1099,9.2
"24039",24,39,1999,11370,10498,872,7.7
"24039",24,39,2000,10449,9795,654,6.3
"24039",24,39,2001,10860,10137,723,6.7
"24039",24,39,2002,11097,10356,741,6.7
"24039",24,39,2003,10983,10265,718,6.5
"24039",24,39,2004,11300,10570,730,6.5
"24039",24,39,2005,11436,10745,691,6
"24039",24,39,2006,11270,10647,623,5.5
"24039",24,39,2007,11168,10573,595,5.3
"24039",24,39,2008,11263,10547,716,6.4
"24039",24,39,2009,11103,10053,1050,9.5
"24039",24,39,2010,9944,8762,1182,11.9
"24039",24,39,2011,9890,8735,1155,11.7
"24039",24,39,2012,9747,8650,1097,11.3
"24039",24,39,2013,9582,8559,1023,10.7
"24039",24,39,2014,9287,8410,877,9.4
"24039",24,39,2015,9214,8454,760,8.2
"24039",24,39,2016,9277,8604,673,7.3
"24039",24,39,2017,9436,8793,643,6.8
"24041",24,41,1990,16375,15899,476,2.9
"24041",24,41,1991,16515,15745,770,4.7
"24041",24,41,1992,16984,16086,898,5.3
"24041",24,41,1993,17169,16458,711,4.1
"24041",24,41,1994,17358,16753,605,3.5
"24041",24,41,1995,17896,17266,630,3.5
"24041",24,41,1996,18151,17408,743,4.1
"24041",24,41,1997,18624,17848,776,4.2
"24041",24,41,1998,19022,18303,719,3.8
"24041",24,41,1999,18816,18277,539,2.9
"24041",24,41,2000,17513,16926,587,3.4
"24041",24,41,2001,18110,17472,638,3.5
"24041",24,41,2002,18652,17950,702,3.8
"24041",24,41,2003,18588,17788,800,4.3
"24041",24,41,2004,18695,17929,766,4.1
"24041",24,41,2005,18922,18184,738,3.9
"24041",24,41,2006,18944,18264,680,3.6
"24041",24,41,2007,18864,18231,633,3.4
"24041",24,41,2008,19212,18411,801,4.2
"24041",24,41,2009,18706,17352,1354,7.2
"24041",24,41,2010,19401,17857,1544,8
"24041",24,41,2011,19450,18001,1449,7.4
"24041",24,41,2012,19414,18016,1398,7.2
"24041",24,41,2013,19162,17934,1228,6.4
"24041",24,41,2014,19148,18102,1046,5.5
"24041",24,41,2015,19328,18381,947,4.9
"24041",24,41,2016,19658,18834,824,4.2
"24041",24,41,2017,19752,18963,789,4
"24043",24,43,1990,60721,56654,4067,6.7
"24043",24,43,1991,62961,57392,5569,8.8
"24043",24,43,1992,64044,58032,6012,9.4
"24043",24,43,1993,65345,59747,5598,8.6
"24043",24,43,1994,64790,60316,4474,6.9
"24043",24,43,1995,66460,62415,4045,6.1
"24043",24,43,1996,68795,65132,3663,5.3
"24043",24,43,1997,69647,66283,3364,4.8
"24043",24,43,1998,68864,65992,2872,4.2
"24043",24,43,1999,67895,65559,2336,3.4
"24043",24,43,2000,66142,63713,2429,3.7
"24043",24,43,2001,67014,64063,2951,4.4
"24043",24,43,2002,67872,64562,3310,4.9
"24043",24,43,2003,67267,63960,3307,4.9
"24043",24,43,2004,66758,63752,3006,4.5
"24043",24,43,2005,67796,64816,2980,4.4
"24043",24,43,2006,68305,65252,3053,4.5
"24043",24,43,2007,68045,65091,2954,4.3
"24043",24,43,2008,67668,63919,3749,5.5
"24043",24,43,2009,68286,61672,6614,9.7
"24043",24,43,2010,75802,68528,7274,9.6
"24043",24,43,2011,76481,69771,6710,8.8
"24043",24,43,2012,77165,71119,6046,7.8
"24043",24,43,2013,77219,71573,5646,7.3
"24043",24,43,2014,76485,71548,4937,6.5
"24043",24,43,2015,76921,72616,4305,5.6
"24043",24,43,2016,75868,71981,3887,5.1
"24043",24,43,2017,76209,72697,3512,4.6
"24045",24,45,1990,42199,39378,2821,6.7
"24045",24,45,1991,44624,41186,3438,7.7
"24045",24,45,1992,45996,41882,4114,8.9
"24045",24,45,1993,46381,43183,3198,6.9
"24045",24,45,1994,47012,43924,3088,6.6
"24045",24,45,1995,45809,43085,2724,5.9
"24045",24,45,1996,47003,44116,2887,6.1
"24045",24,45,1997,47063,44205,2858,6.1
"24045",24,45,1998,49193,46602,2591,5.3
"24045",24,45,1999,47373,45147,2226,4.7
"24045",24,45,2000,46226,44293,1933,4.2
"24045",24,45,2001,47426,45187,2239,4.7
"24045",24,45,2002,48421,46098,2323,4.8
"24045",24,45,2003,48567,46248,2319,4.8
"24045",24,45,2004,50093,47889,2204,4.4
"24045",24,45,2005,51702,49509,2193,4.2
"24045",24,45,2006,52187,50060,2127,4.1
"24045",24,45,2007,52137,50113,2024,3.9
"24045",24,45,2008,52749,50030,2719,5.2
"24045",24,45,2009,52443,48067,4376,8.3
"24045",24,45,2010,50455,45538,4917,9.7
"24045",24,45,2011,50630,45665,4965,9.8
"24045",24,45,2012,50517,45774,4743,9.4
"24045",24,45,2013,50161,45806,4355,8.7
"24045",24,45,2014,50134,46242,3892,7.8
"24045",24,45,2015,50151,46736,3415,6.8
"24045",24,45,2016,50655,47497,3158,6.2
"24045",24,45,2017,51488,48566,2922,5.7
"24047",24,47,1990,22293,20464,1829,8.2
"24047",24,47,1991,22323,20115,2208,9.9
"24047",24,47,1992,23192,20477,2715,11.7
"24047",24,47,1993,23094,20554,2540,11
"24047",24,47,1994,23694,21415,2279,9.6
"24047",24,47,1995,24340,22017,2323,9.5
"24047",24,47,1996,24366,21962,2404,9.9
"24047",24,47,1997,24861,22211,2650,10.7
"24047",24,47,1998,25554,22998,2556,10
"24047",24,47,1999,24834,22605,2229,9
"24047",24,47,2000,25995,24396,1599,6.2
"24047",24,47,2001,26982,25228,1754,6.5
"24047",24,47,2002,28258,26485,1773,6.3
"24047",24,47,2003,27803,25995,1808,6.5
"24047",24,47,2004,27461,25596,1865,6.8
"24047",24,47,2005,27716,25885,1831,6.6
"24047",24,47,2006,28224,26524,1700,6
"24047",24,47,2007,27481,25881,1600,5.8
"24047",24,47,2008,27586,25590,1996,7.2
"24047",24,47,2009,27821,24785,3036,10.9
"24047",24,47,2010,26473,22942,3531,13.3
"24047",24,47,2011,26385,22769,3616,13.7
"24047",24,47,2012,26138,22763,3375,12.9
"24047",24,47,2013,25920,22665,3255,12.6
"24047",24,47,2014,25692,22728,2964,11.5
"24047",24,47,2015,25432,22737,2695,10.6
"24047",24,47,2016,25335,22982,2353,9.3
"24047",24,47,2017,25699,23514,2185,8.5
"24510",24,510,1990,337704,311677,26027,7.7
"24510",24,510,1991,336739,302249,34490,10.2
"24510",24,510,1992,334196,297002,37194,11.1
"24510",24,510,1993,329210,294950,34260,10.4
"24510",24,510,1994,318841,289844,28997,9.1
"24510",24,510,1995,312609,286556,26053,8.3
"24510",24,510,1996,307930,281678,26252,8.5
"24510",24,510,1997,306894,278169,28725,9.4
"24510",24,510,1998,298875,272139,26736,8.9
"24510",24,510,1999,288725,267470,21255,7.4
"24510",24,510,2000,280025,263397,16628,5.9
"24510",24,510,2001,279761,261410,18351,6.6
"24510",24,510,2002,275146,255706,19440,7.1
"24510",24,510,2003,275629,255498,20131,7.3
"24510",24,510,2004,273347,253679,19668,7.2
"24510",24,510,2005,272354,253539,18815,6.9
"24510",24,510,2006,273753,256270,17483,6.4
"24510",24,510,2007,275151,259986,15165,5.5
"24510",24,510,2008,278558,260431,18127,6.5
"24510",24,510,2009,281265,252544,28721,10.2
"24510",24,510,2010,295504,262347,33157,11.2
"24510",24,510,2011,295579,264134,31445,10.6
"24510",24,510,2012,297239,267002,30237,10.2
"24510",24,510,2013,296564,267892,28672,9.7
"24510",24,510,2014,294342,269182,25160,8.5
"24510",24,510,2015,294550,272395,22155,7.5
"24510",24,510,2016,291382,272198,19184,6.6
"24510",24,510,2017,294248,276206,18042,6.1
"25001",25,1,1990,96888,89746,7142,7.4
"25001",25,1,1991,97579,87795,9784,10
"25001",25,1,1992,97556,87507,10049,10.3
"25001",25,1,1993,99899,90855,9044,9.1
"25001",25,1,1994,101507,93071,8436,8.3
"25001",25,1,1995,102712,95566,7146,7
"25001",25,1,1996,104011,97755,6256,6
"25001",25,1,1997,105749,99756,5993,5.7
"25001",25,1,1998,107228,101993,5235,4.9
"25001",25,1,1999,109354,104711,4643,4.2
"25001",25,1,2000,112276,108455,3821,3.4
"25001",25,1,2001,114662,110183,4479,3.9
"25001",25,1,2002,118913,113334,5579,4.7
"25001",25,1,2003,122422,116079,6343,5.2
"25001",25,1,2004,123267,117149,6118,5
"25001",25,1,2005,122143,116121,6022,4.9
"25001",25,1,2006,122283,116033,6250,5.1
"25001",25,1,2007,121322,115367,5955,4.9
"25001",25,1,2008,121682,114348,7334,6
"25001",25,1,2009,122070,111852,10218,8.4
"25001",25,1,2010,111079,100049,11030,9.9
"25001",25,1,2011,109690,99735,9955,9.1
"25001",25,1,2012,108251,99077,9174,8.5
"25001",25,1,2013,108455,99337,9118,8.4
"25001",25,1,2014,111978,103982,7996,7.1
"25001",25,1,2015,111567,104763,6804,6.1
"25001",25,1,2016,111448,105960,5488,4.9
"25001",25,1,2017,112489,107254,5235,4.7
"25003",25,3,1990,69468,64560,4908,7.1
"25003",25,3,1991,69577,62188,7389,10.6
"25003",25,3,1992,68515,61510,7005,10.2
"25003",25,3,1993,67930,62380,5550,8.2
"25003",25,3,1994,67247,62222,5025,7.5
"25003",25,3,1995,66264,62212,4052,6.1
"25003",25,3,1996,66371,63009,3362,5.1
"25003",25,3,1997,66796,63642,3154,4.7
"25003",25,3,1998,66490,63915,2575,3.9
"25003",25,3,1999,66317,63843,2474,3.7
"25003",25,3,2000,69422,67406,2016,2.9
"25003",25,3,2001,70674,68170,2504,3.5
"25003",25,3,2002,72848,69539,3309,4.5
"25003",25,3,2003,73000,69344,3656,5
"25003",25,3,2004,72449,69071,3378,4.7
"25003",25,3,2005,72664,69494,3170,4.4
"25003",25,3,2006,73357,70095,3262,4.4
"25003",25,3,2007,72820,69538,3282,4.5
"25003",25,3,2008,72825,68940,3885,5.3
"25003",25,3,2009,73086,67457,5629,7.7
"25003",25,3,2010,68171,62255,5916,8.7
"25003",25,3,2011,67275,62027,5248,7.8
"25003",25,3,2012,66262,61405,4857,7.3
"25003",25,3,2013,65690,60821,4869,7.4
"25003",25,3,2014,65703,61403,4300,6.5
"25003",25,3,2015,65270,61751,3519,5.4
"25003",25,3,2016,64314,61414,2900,4.5
"25003",25,3,2017,65153,62327,2826,4.3
"25005",25,5,1990,263577,239502,24075,9.1
"25005",25,5,1991,265039,232606,32433,12.2
"25005",25,5,1992,264455,233850,30605,11.6
"25005",25,5,1993,265608,239171,26437,10
"25005",25,5,1994,267849,244436,23413,8.7
"25005",25,5,1995,266484,245193,21291,8
"25005",25,5,1996,265509,246411,19098,7.2
"25005",25,5,1997,269014,252551,16463,6.1
"25005",25,5,1998,269394,256214,13180,4.9
"25005",25,5,1999,269675,257462,12213,4.5
"25005",25,5,2000,275099,264925,10174,3.7
"25005",25,5,2001,278000,264733,13267,4.8
"25005",25,5,2002,286122,268636,17486,6.1
"25005",25,5,2003,287664,268965,18699,6.5
"25005",25,5,2004,287333,269697,17636,6.1
"25005",25,5,2005,287829,270614,17215,6
"25005",25,5,2006,290313,272487,17826,6.1
"25005",25,5,2007,290169,272931,17238,5.9
"25005",25,5,2008,290677,269445,21232,7.3
"25005",25,5,2009,292640,261465,31175,10.7
"25005",25,5,2010,286777,256436,30341,10.6
"25005",25,5,2011,284776,257904,26872,9.4
"25005",25,5,2012,285251,260399,24852,8.7
"25005",25,5,2013,286403,261464,24939,8.7
"25005",25,5,2014,288627,267447,21180,7.3
"25005",25,5,2015,288942,271227,17715,6.1
"25005",25,5,2016,289447,275144,14303,4.9
"25005",25,5,2017,292342,278472,13870,4.7
"25007",25,7,1990,7486,7107,379,5.1
"25007",25,7,1991,7851,7302,549,7
"25007",25,7,1992,7514,6945,569,7.6
"25007",25,7,1993,7762,7207,555,7.2
"25007",25,7,1994,8368,7820,548,6.5
"25007",25,7,1995,8740,8260,480,5.5
"25007",25,7,1996,9096,8624,472,5.2
"25007",25,7,1997,9314,8864,450,4.8
"25007",25,7,1998,9443,9070,373,4
"25007",25,7,1999,9531,9170,361,3.8
"25007",25,7,2000,9969,9695,274,2.7
"25007",25,7,2001,10094,9796,298,3
"25007",25,7,2002,10656,10250,406,3.8
"25007",25,7,2003,11132,10668,464,4.2
"25007",25,7,2004,11185,10741,444,4
"25007",25,7,2005,10977,10545,432,3.9
"25007",25,7,2006,11053,10611,442,4
"25007",25,7,2007,11128,10726,402,3.6
"25007",25,7,2008,11183,10703,480,4.3
"25007",25,7,2009,11334,10611,723,6.4
"25007",25,7,2010,9102,8213,889,9.8
"25007",25,7,2011,9162,8303,859,9.4
"25007",25,7,2012,9328,8503,825,8.8
"25007",25,7,2013,9403,8546,857,9.1
"25007",25,7,2014,9468,8720,748,7.9
"25007",25,7,2015,9455,8838,617,6.5
"25007",25,7,2016,9337,8852,485,5.2
"25007",25,7,2017,9468,9007,461,4.9
"25009",25,9,1990,347708,324575,23133,6.7
"25009",25,9,1991,348527,317941,30586,8.8
"25009",25,9,1992,349336,318433,30903,8.8
"25009",25,9,1993,348288,323128,25160,7.2
"25009",25,9,1994,352228,329915,22313,6.3
"25009",25,9,1995,353702,334846,18856,5.3
"25009",25,9,1996,359350,343052,16298,4.5
"25009",25,9,1997,366993,351809,15184,4.1
"25009",25,9,1998,374401,360749,13652,3.6
"25009",25,9,1999,377359,364191,13168,3.5
"25009",25,9,2000,369009,358867,10142,2.7
"25009",25,9,2001,376738,361438,15300,4.1
"25009",25,9,2002,382262,359698,22564,5.9
"25009",25,9,2003,380797,356823,23974,6.3
"25009",25,9,2004,376968,355540,21428,5.7
"25009",25,9,2005,375771,356017,19754,5.3
"25009",25,9,2006,373881,354214,19667,5.3
"25009",25,9,2007,373827,355585,18242,4.9
"25009",25,9,2008,377099,355000,22099,5.9
"25009",25,9,2009,381088,348072,33016,8.7
"25009",25,9,2010,392194,358078,34116,8.7
"25009",25,9,2011,392576,362646,29930,7.6
"25009",25,9,2012,395573,367614,27959,7.1
"25009",25,9,2013,399415,371273,28142,7
"25009",25,9,2014,404947,380765,24182,6
"25009",25,9,2015,407869,387516,20353,5
"25009",25,9,2016,410144,393781,16363,4
"25009",25,9,2017,414548,398885,15663,3.8
"25011",25,11,1990,36971,35063,1908,5.2
"25011",25,11,1991,37681,34791,2890,7.7
"25011",25,11,1992,36983,34128,2855,7.7
"25011",25,11,1993,36564,34331,2233,6.1
"25011",25,11,1994,37194,35261,1933,5.2
"25011",25,11,1995,37545,35801,1744,4.6
"25011",25,11,1996,37378,35929,1449,3.9
"25011",25,11,1997,38121,36699,1422,3.7
"25011",25,11,1998,38572,37323,1249,3.2
"25011",25,11,1999,38796,37659,1137,2.9
"25011",25,11,2000,38618,37669,949,2.5
"25011",25,11,2001,38983,37772,1211,3.1
"25011",25,11,2002,39977,38382,1595,4
"25011",25,11,2003,40280,38471,1809,4.5
"25011",25,11,2004,39772,38089,1683,4.2
"25011",25,11,2005,39577,37877,1700,4.3
"25011",25,11,2006,39639,37879,1760,4.4
"25011",25,11,2007,39104,37435,1669,4.3
"25011",25,11,2008,38937,36919,2018,5.2
"25011",25,11,2009,38913,35959,2954,7.6
"25011",25,11,2010,39956,36910,3046,7.6
"25011",25,11,2011,39526,36939,2587,6.5
"25011",25,11,2012,39587,37182,2405,6.1
"25011",25,11,2013,39296,36873,2423,6.2
"25011",25,11,2014,39489,37396,2093,5.3
"25011",25,11,2015,39433,37702,1731,4.4
"25011",25,11,2016,39485,38097,1388,3.5
"25011",25,11,2017,39904,38572,1332,3.3
"25013",25,13,1990,221488,206780,14708,6.6
"25013",25,13,1991,221488,200456,21032,9.5
"25013",25,13,1992,219797,199858,19939,9.1
"25013",25,13,1993,217268,198810,18458,8.5
"25013",25,13,1994,215563,199045,16518,7.7
"25013",25,13,1995,212517,198821,13696,6.4
"25013",25,13,1996,211623,200749,10874,5.1
"25013",25,13,1997,215237,205243,9994,4.6
"25013",25,13,1998,215204,206137,9067,4.2
"25013",25,13,1999,213998,205434,8564,4
"25013",25,13,2000,216891,209760,7131,3.3
"25013",25,13,2001,220472,211137,9335,4.2
"25013",25,13,2002,225050,212197,12853,5.7
"25013",25,13,2003,225822,211254,14568,6.5
"25013",25,13,2004,225178,211447,13731,6.1
"25013",25,13,2005,224160,211095,13065,5.8
"25013",25,13,2006,225031,211464,13567,6
"25013",25,13,2007,223699,210928,12771,5.7
"25013",25,13,2008,224883,209843,15040,6.7
"25013",25,13,2009,226900,205771,21129,9.3
"25013",25,13,2010,220724,198016,22708,10.3
"25013",25,13,2011,218969,198522,20447,9.3
"25013",25,13,2012,219020,200247,18773,8.6
"25013",25,13,2013,220022,200921,19101,8.7
"25013",25,13,2014,222012,205155,16857,7.6
"25013",25,13,2015,222565,208324,14241,6.4
"25013",25,13,2016,221675,209997,11678,5.3
"25013",25,13,2017,223137,211909,11228,5
"25015",25,15,1990,79717,75648,4069,5.1
"25015",25,15,1991,78672,73225,5447,6.9
"25015",25,15,1992,78992,73825,5167,6.5
"25015",25,15,1993,78642,74475,4167,5.3
"25015",25,15,1994,79711,75908,3803,4.8
"25015",25,15,1995,79456,76252,3204,4
"25015",25,15,1996,80090,77464,2626,3.3
"25015",25,15,1997,81666,79354,2312,2.8
"25015",25,15,1998,82785,80548,2237,2.7
"25015",25,15,1999,83077,81036,2041,2.5
"25015",25,15,2000,85106,83255,1851,2.2
"25015",25,15,2001,85973,83631,2342,2.7
"25015",25,15,2002,87352,84240,3112,3.6
"25015",25,15,2003,88172,84495,3677,4.2
"25015",25,15,2004,88200,84616,3584,4.1
"25015",25,15,2005,87822,84266,3556,4
"25015",25,15,2006,88355,84769,3586,4.1
"25015",25,15,2007,88300,84879,3421,3.9
"25015",25,15,2008,88410,84390,4020,4.5
"25015",25,15,2009,87432,81795,5637,6.4
"25015",25,15,2010,85447,79451,5996,7
"25015",25,15,2011,84907,79662,5245,6.2
"25015",25,15,2012,85198,80251,4947,5.8
"25015",25,15,2013,85354,80176,5178,6.1
"25015",25,15,2014,86935,82356,4579,5.3
"25015",25,15,2015,87311,83376,3935,4.5
"25015",25,15,2016,87906,84708,3198,3.6
"25015",25,15,2017,88508,85479,3029,3.4
"25017",25,17,1990,796639,755721,40918,5.1
"25017",25,17,1991,789377,734256,55121,7
"25017",25,17,1992,787340,730903,56437,7.2
"25017",25,17,1993,781722,736458,45264,5.8
"25017",25,17,1994,787737,748625,39112,5
"25017",25,17,1995,789520,755965,33555,4.3
"25017",25,17,1996,799884,773094,26790,3.3
"25017",25,17,1997,820662,796659,24003,2.9
"25017",25,17,1998,831440,811223,20217,2.4
"25017",25,17,1999,837580,816828,20752,2.5
"25017",25,17,2000,813222,795506,17716,2.2
"25017",25,17,2001,825602,798331,27271,3.3
"25017",25,17,2002,829752,788436,41316,5
"25017",25,17,2003,821249,778252,42997,5.2
"25017",25,17,2004,811907,775964,35943,4.4
"25017",25,17,2005,810099,777113,32986,4.1
"25017",25,17,2006,811087,778141,32946,4.1
"25017",25,17,2007,816978,786271,30707,3.8
"25017",25,17,2008,824507,787161,37346,4.5
"25017",25,17,2009,826709,769841,56868,6.9
"25017",25,17,2010,825801,768599,57202,6.9
"25017",25,17,2011,823942,775336,48606,5.9
"25017",25,17,2012,831768,786743,45025,5.4
"25017",25,17,2013,839644,793630,46014,5.5
"25017",25,17,2014,854600,814751,39849,4.7
"25017",25,17,2015,863267,829429,33838,3.9
"25017",25,17,2016,872287,844581,27706,3.2
"25017",25,17,2017,885207,858240,26967,3
"25019",25,19,1990,4729,4578,151,3.2
"25019",25,19,1991,4857,4595,262,5.4
"25019",25,19,1992,4966,4742,224,4.5
"25019",25,19,1993,5310,5113,197,3.7
"25019",25,19,1994,5592,5444,148,2.6
"25019",25,19,1995,5716,5570,146,2.6
"25019",25,19,1996,5848,5713,135,2.3
"25019",25,19,1997,6126,5990,136,2.2
"25019",25,19,1998,6509,6398,111,1.7
"25019",25,19,1999,6605,6493,112,1.7
"25019",25,19,2000,7212,7107,105,1.5
"25019",25,19,2001,7079,6962,117,1.7
"25019",25,19,2002,7486,7341,145,1.9
"25019",25,19,2003,7732,7540,192,2.5
"25019",25,19,2004,7877,7682,195,2.5
"25019",25,19,2005,8138,7940,198,2.4
"25019",25,19,2006,8396,8197,199,2.4
"25019",25,19,2007,8527,8323,204,2.4
"25019",25,19,2008,8398,8112,286,3.4
"25019",25,19,2009,7810,7283,527,6.7
"25019",25,19,2010,6166,5572,594,9.6
"25019",25,19,2011,6211,5675,536,8.6
"25019",25,19,2012,6386,5887,499,7.8
"25019",25,19,2013,6592,6111,481,7.3
"25019",25,19,2014,6959,6529,430,6.2
"25019",25,19,2015,6967,6592,375,5.4
"25019",25,19,2016,7038,6724,314,4.5
"25019",25,19,2017,7126,6810,316,4.4
"25021",25,21,1990,342414,324880,17534,5.1
"25021",25,21,1991,341739,317503,24236,7.1
"25021",25,21,1992,342195,318041,24154,7.1
"25021",25,21,1993,342204,322732,19472,5.7
"25021",25,21,1994,346908,329948,16960,4.9
"25021",25,21,1995,354064,338865,15199,4.3
"25021",25,21,1996,358407,345958,12449,3.5
"25021",25,21,1997,361976,350963,11013,3
"25021",25,21,1998,365951,356979,8972,2.5
"25021",25,21,1999,366597,357940,8657,2.4
"25021",25,21,2000,353406,345263,8143,2.3
"25021",25,21,2001,357499,346157,11342,3.2
"25021",25,21,2002,360650,343935,16715,4.6
"25021",25,21,2003,358047,339996,18051,5
"25021",25,21,2004,355848,339854,15994,4.5
"25021",25,21,2005,355887,341107,14780,4.2
"25021",25,21,2006,351993,336899,15094,4.3
"25021",25,21,2007,354533,340362,14171,4
"25021",25,21,2008,357635,340143,17492,4.9
"25021",25,21,2009,358021,331869,26152,7.3
"25021",25,21,2010,358262,331584,26678,7.4
"25021",25,21,2011,357272,334794,22478,6.3
"25021",25,21,2012,358844,338418,20426,5.7
"25021",25,21,2013,362470,341397,21073,5.8
"25021",25,21,2014,367092,348775,18317,5
"25021",25,21,2015,369035,353647,15388,4.2
"25021",25,21,2016,371974,359373,12601,3.4
"25021",25,21,2017,377844,365379,12465,3.3
"25023",25,23,1990,228461,212039,16422,7.2
"25023",25,23,1991,228779,206335,22444,9.8
"25023",25,23,1992,228026,205941,22085,9.7
"25023",25,23,1993,229810,212013,17797,7.7
"25023",25,23,1994,235971,221053,14918,6.3
"25023",25,23,1995,237329,223909,13420,5.7
"25023",25,23,1996,239814,227801,12013,5
"25023",25,23,1997,246464,235897,10567,4.3
"25023",25,23,1998,249306,240691,8615,3.5
"25023",25,23,1999,252099,243893,8206,3.3
"25023",25,23,2000,248719,242044,6675,2.7
"25023",25,23,2001,252886,244010,8876,3.5
"25023",25,23,2002,257513,244983,12530,4.9
"25023",25,23,2003,257470,243296,14174,5.5
"25023",25,23,2004,257676,244364,13312,5.2
"25023",25,23,2005,258416,245829,12587,4.9
"25023",25,23,2006,258422,245440,12982,5
"25023",25,23,2007,259937,247187,12750,4.9
"25023",25,23,2008,261448,246149,15299,5.9
"25023",25,23,2009,263807,241447,22360,8.5
"25023",25,23,2010,262176,238720,23456,8.9
"25023",25,23,2011,260735,240474,20261,7.8
"25023",25,23,2012,260295,242063,18232,7
"25023",25,23,2013,262695,244330,18365,7
"25023",25,23,2014,266779,250756,16023,6
"25023",25,23,2015,268191,254630,13561,5.1
"25023",25,23,2016,270417,259364,11053,4.1
"25023",25,23,2017,274224,263530,10694,3.9
"25025",25,25,1990,347860,326650,21210,6.1
"25025",25,25,1991,341264,312492,28772,8.4
"25025",25,25,1992,333538,306170,27368,8.2
"25025",25,25,1993,330427,307884,22543,6.8
"25025",25,25,1994,330219,310364,19855,6
"25025",25,25,1995,338386,320065,18321,5.4
"25025",25,25,1996,339641,323834,15807,4.7
"25025",25,25,1997,344549,330197,14352,4.2
"25025",25,25,1998,346274,334257,12017,3.5
"25025",25,25,1999,346429,334575,11854,3.4
"25025",25,25,2000,347381,336913,10468,3
"25025",25,25,2001,351958,337308,14650,4.2
"25025",25,25,2002,352511,331632,20879,5.9
"25025",25,25,2003,345791,323479,22312,6.5
"25025",25,25,2004,336954,317830,19124,5.7
"25025",25,25,2005,332082,314372,17710,5.3
"25025",25,25,2006,357971,339648,18323,5.1
"25025",25,25,2007,364284,347532,16752,4.6
"25025",25,25,2008,371840,351623,20217,5.4
"25025",25,25,2009,374530,345580,28950,7.7
"25025",25,25,2010,393952,363851,30101,7.6
"25025",25,25,2011,396271,369972,26299,6.6
"25025",25,25,2012,401379,376767,24612,6.1
"25025",25,25,2013,406849,381626,25223,6.2
"25025",25,25,2014,415222,393333,21889,5.3
"25025",25,25,2015,420860,402312,18548,4.4
"25025",25,25,2016,426576,411431,15145,3.6
"25025",25,25,2017,433072,418378,14694,3.4
"25027",25,27,1990,362977,337623,25354,7
"25027",25,27,1991,362529,328024,34505,9.5
"25027",25,27,1992,361815,330175,31640,8.7
"25027",25,27,1993,362863,338024,24839,6.8
"25027",25,27,1994,364738,344251,20487,5.6
"25027",25,27,1995,362218,343368,18850,5.2
"25027",25,27,1996,364351,348176,16175,4.4
"25027",25,27,1997,372987,358513,14474,3.9
"25027",25,27,1998,377631,364944,12687,3.4
"25027",25,27,1999,376442,363774,12668,3.4
"25027",25,27,2000,383858,373382,10476,2.7
"25027",25,27,2001,390669,375508,15161,3.9
"25027",25,27,2002,399985,377483,22502,5.6
"25027",25,27,2003,402837,378322,24515,6.1
"25027",25,27,2004,400898,378789,22109,5.5
"25027",25,27,2005,398556,377703,20853,5.2
"25027",25,27,2006,401558,380437,21121,5.3
"25027",25,27,2007,401374,381033,20341,5.1
"25027",25,27,2008,402921,378631,24290,6
"25027",25,27,2009,406048,370006,36042,8.9
"25027",25,27,2010,420278,383083,37195,8.9
"25027",25,27,2011,418002,385770,32232,7.7
"25027",25,27,2012,418020,387976,30044,7.2
"25027",25,27,2013,420544,390291,30253,7.2
"25027",25,27,2014,426431,400445,25986,6.1
"25027",25,27,2015,427506,405765,21741,5.1
"25027",25,27,2016,429368,411686,17682,4.1
"25027",25,27,2017,434150,417238,16912,3.9
"26001",26,1,1990,3915,3407,508,13
"26001",26,1,1991,3923,3361,562,14.3
"26001",26,1,1992,4134,3476,658,15.9
"26001",26,1,1993,4485,3870,615,13.7
"26001",26,1,1994,4836,4229,607,12.6
"26001",26,1,1995,4856,4357,499,10.3
"26001",26,1,1996,4939,4507,432,8.7
"26001",26,1,1997,5085,4675,410,8.1
"26001",26,1,1998,5008,4676,332,6.6
"26001",26,1,1999,5007,4651,356,7.1
"26001",26,1,2000,4487,4174,313,7
"26001",26,1,2001,4321,3873,448,10.4
"26001",26,1,2002,4150,3701,449,10.8
"26001",26,1,2003,4187,3683,504,12
"26001",26,1,2004,4191,3734,457,10.9
"26001",26,1,2005,4296,3848,448,10.4
"26001",26,1,2006,4461,3977,484,10.8
"26001",26,1,2007,4300,3858,442,10.3
"26001",26,1,2008,4288,3800,488,11.4
"26001",26,1,2009,4127,3351,776,18.8
"26001",26,1,2010,3880,3188,692,17.8
"26001",26,1,2011,3807,3261,546,14.3
"26001",26,1,2012,3711,3240,471,12.7
"26001",26,1,2013,3794,3288,506,13.3
"26001",26,1,2014,3821,3415,406,10.6
"26001",26,1,2015,3799,3494,305,8
"26001",26,1,2016,3825,3532,293,7.7
"26001",26,1,2017,3855,3572,283,7.3
"26003",26,3,1990,3796,3450,346,9.1
"26003",26,3,1991,3888,3477,411,10.6
"26003",26,3,1992,3957,3513,444,11.2
"26003",26,3,1993,4038,3633,405,10
"26003",26,3,1994,4130,3747,383,9.3
"26003",26,3,1995,4233,3859,374,8.8
"26003",26,3,1996,4206,3905,301,7.2
"26003",26,3,1997,4279,4006,273,6.4
"26003",26,3,1998,4314,4099,215,5
"26003",26,3,1999,4449,4215,234,5.3
"26003",26,3,2000,4391,4150,241,5.5
"26003",26,3,2001,4422,4139,283,6.4
"26003",26,3,2002,4400,4082,318,7.2
"26003",26,3,2003,4419,4071,348,7.9
"26003",26,3,2004,4393,4048,345,7.9
"26003",26,3,2005,4384,4049,335,7.6
"26003",26,3,2006,4477,4113,364,8.1
"26003",26,3,2007,4393,4022,371,8.4
"26003",26,3,2008,4281,3881,400,9.3
"26003",26,3,2009,4265,3682,583,13.7
"26003",26,3,2010,3593,3085,508,14.1
"26003",26,3,2011,3475,3035,440,12.7
"26003",26,3,2012,3433,3024,409,11.9
"26003",26,3,2013,3373,2978,395,11.7
"26003",26,3,2014,3311,2966,345,10.4
"26003",26,3,2015,3223,2949,274,8.5
"26003",26,3,2016,3261,2992,269,8.2
"26003",26,3,2017,3336,3055,281,8.4
"26005",26,5,1990,45784,43022,2762,6
"26005",26,5,1991,45258,42106,3152,7
"26005",26,5,1992,46233,43032,3201,6.9
"26005",26,5,1993,48399,45660,2739,5.7
"26005",26,5,1994,50097,47896,2201,4.4
"26005",26,5,1995,50869,48958,1911,3.8
"26005",26,5,1996,52014,50167,1847,3.6
"26005",26,5,1997,54239,52623,1616,3
"26005",26,5,1998,55523,54071,1452,2.6
"26005",26,5,1999,57823,56332,1491,2.6
"26005",26,5,2000,58011,56313,1698,2.9
"26005",26,5,2001,57521,54977,2544,4.4
"26005",26,5,2002,55028,51890,3138,5.7
"26005",26,5,2003,52965,49458,3507,6.6
"26005",26,5,2004,53450,49958,3492,6.5
"26005",26,5,2005,55028,51556,3472,6.3
"26005",26,5,2006,56445,52889,3556,6.3
"26005",26,5,2007,56007,52431,3576,6.4
"26005",26,5,2008,55201,51149,4052,7.3
"26005",26,5,2009,54382,47374,7008,12.9
"26005",26,5,2010,57023,50551,6472,11.3
"26005",26,5,2011,56816,51848,4968,8.7
"26005",26,5,2012,56649,52482,4167,7.4
"26005",26,5,2013,57933,54066,3867,6.7
"26005",26,5,2014,59631,56395,3236,5.4
"26005",26,5,2015,60372,57870,2502,4.1
"26005",26,5,2016,61243,58855,2388,3.9
"26005",26,5,2017,61320,58958,2362,3.9
"26007",26,7,1990,14261,12818,1443,10.1
"26007",26,7,1991,14398,12657,1741,12.1
"26007",26,7,1992,14845,12802,2043,13.8
"26007",26,7,1993,15006,13090,1916,12.8
"26007",26,7,1994,15443,13529,1914,12.4
"26007",26,7,1995,15288,13684,1604,10.5
"26007",26,7,1996,15531,14133,1398,9
"26007",26,7,1997,15926,14709,1217,7.6
"26007",26,7,1998,16108,15069,1039,6.5
"26007",26,7,1999,16190,15248,942,5.8
"26007",26,7,2000,15598,14715,883,5.7
"26007",26,7,2001,15681,14429,1252,8
"26007",26,7,2002,15197,13883,1314,8.6
"26007",26,7,2003,15174,13780,1394,9.2
"26007",26,7,2004,15252,13970,1282,8.4
"26007",26,7,2005,15097,13956,1141,7.6
"26007",26,7,2006,14977,13796,1181,7.9
"26007",26,7,2007,14901,13645,1256,8.4
"26007",26,7,2008,14854,13547,1307,8.8
"26007",26,7,2009,14931,12866,2065,13.8
"26007",26,7,2010,14273,12397,1876,13.1
"26007",26,7,2011,13684,12200,1484,10.8
"26007",26,7,2012,13386,12084,1302,9.7
"26007",26,7,2013,13367,12075,1292,9.7
"26007",26,7,2014,13518,12436,1082,8
"26007",26,7,2015,13593,12746,847,6.2
"26007",26,7,2016,13638,12828,810,5.9
"26007",26,7,2017,13582,12781,801,5.9
"26009",26,9,1990,8848,7964,884,10
"26009",26,9,1991,8854,7755,1099,12.4
"26009",26,9,1992,8990,7845,1145,12.7
"26009",26,9,1993,9276,8314,962,10.4
"26009",26,9,1994,9352,8427,925,9.9
"26009",26,9,1995,9369,8588,781,8.3
"26009",26,9,1996,9570,8920,650,6.8
"26009",26,9,1997,10073,9522,551,5.5
"26009",26,9,1998,10269,9682,587,5.7
"26009",26,9,1999,10649,10052,597,5.6
"26009",26,9,2000,11647,11098,549,4.7
"26009",26,9,2001,11641,10875,766,6.6
"26009",26,9,2002,11613,10773,840,7.2
"26009",26,9,2003,11649,10652,997,8.6
"26009",26,9,2004,12048,11088,960,8
"26009",26,9,2005,12103,11164,939,7.8
"26009",26,9,2006,11992,11028,964,8
"26009",26,9,2007,11860,10901,959,8.1
"26009",26,9,2008,11644,10560,1084,9.3
"26009",26,9,2009,11514,9763,1751,15.2
"26009",26,9,2010,10563,8875,1688,16
"26009",26,9,2011,10165,8817,1348,13.3
"26009",26,9,2012,10001,8848,1153,11.5
"26009",26,9,2013,9975,8835,1140,11.4
"26009",26,9,2014,10049,9094,955,9.5
"26009",26,9,2015,9972,9227,745,7.5
"26009",26,9,2016,10060,9350,710,7.1
"26009",26,9,2017,10162,9482,680,6.7
"26011",26,11,1990,6149,5601,548,8.9
"26011",26,11,1991,6125,5503,622,10.2
"26011",26,11,1992,6217,5520,697,11.2
"26011",26,11,1993,6477,5800,677,10.5
"26011",26,11,1994,6582,5814,768,11.7
"26011",26,11,1995,6638,5996,642,9.7
"26011",26,11,1996,6767,6142,625,9.2
"26011",26,11,1997,6891,6323,568,8.2
"26011",26,11,1998,6908,6430,478,6.9
"26011",26,11,1999,7039,6581,458,6.5
"26011",26,11,2000,7683,7229,454,5.9
"26011",26,11,2001,7676,7065,611,8
"26011",26,11,2002,7511,6827,684,9.1
"26011",26,11,2003,7649,6898,751,9.8
"26011",26,11,2004,7872,7103,769,9.8
"26011",26,11,2005,7824,7089,735,9.4
"26011",26,11,2006,7902,7093,809,10.2
"26011",26,11,2007,7868,7093,775,9.9
"26011",26,11,2008,7972,7154,818,10.3
"26011",26,11,2009,7916,6598,1318,16.6
"26011",26,11,2010,6958,5810,1148,16.5
"26011",26,11,2011,6688,5747,941,14.1
"26011",26,11,2012,6528,5694,834,12.8
"26011",26,11,2013,6485,5642,843,13
"26011",26,11,2014,6384,5678,706,11.1
"26011",26,11,2015,6216,5659,557,9
"26011",26,11,2016,6117,5610,507,8.3
"26011",26,11,2017,6095,5593,502,8.2
"26013",26,13,1990,3333,2987,346,10.4
"26013",26,13,1991,3244,2799,445,13.7
"26013",26,13,1992,3249,2764,485,14.9
"26013",26,13,1993,3545,3134,411,11.6
"26013",26,13,1994,3826,3429,397,10.4
"26013",26,13,1995,3974,3570,404,10.2
"26013",26,13,1996,4012,3647,365,9.1
"26013",26,13,1997,4194,3892,302,7.2
"26013",26,13,1998,4304,4028,276,6.4
"26013",26,13,1999,4404,4132,272,6.2
"26013",26,13,2000,4138,3862,276,6.7
"26013",26,13,2001,4014,3646,368,9.2
"26013",26,13,2002,3842,3466,376,9.8
"26013",26,13,2003,3885,3498,387,10
"26013",26,13,2004,4015,3556,459,11.4
"26013",26,13,2005,4131,3666,465,11.3
"26013",26,13,2006,4258,3770,488,11.5
"26013",26,13,2007,4263,3716,547,12.8
"26013",26,13,2008,4264,3691,573,13.4
"26013",26,13,2009,4497,3407,1090,24.2
"26013",26,13,2010,3906,3150,756,19.4
"26013",26,13,2011,3661,3060,601,16.4
"26013",26,13,2012,3533,3036,497,14.1
"26013",26,13,2013,3540,3028,512,14.5
"26013",26,13,2014,3459,3070,389,11.2
"26013",26,13,2015,3291,2991,300,9.1
"26013",26,13,2016,3218,2953,265,8.2
"26013",26,13,2017,3173,2919,254,8
"26015",26,15,1990,25100,23552,1548,6.2
"26015",26,15,1991,25397,23440,1957,7.7
"26015",26,15,1992,25416,23439,1977,7.8
"26015",26,15,1993,26663,24991,1672,6.3
"26015",26,15,1994,28126,26751,1375,4.9
"26015",26,15,1995,29359,28134,1225,4.2
"26015",26,15,1996,29576,28475,1101,3.7
"26015",26,15,1997,30777,29748,1029,3.3
"26015",26,15,1998,31722,30836,886,2.8
"26015",26,15,1999,33064,32183,881,2.7
"26015",26,15,2000,30548,29510,1038,3.4
"26015",26,15,2001,30503,29106,1397,4.6
"26015",26,15,2002,29836,28195,1641,5.5
"26015",26,15,2003,29633,27849,1784,6
"26015",26,15,2004,30334,28596,1738,5.7
"26015",26,15,2005,30891,29298,1593,5.2
"26015",26,15,2006,31110,29434,1676,5.4
"26015",26,15,2007,30385,28719,1666,5.5
"26015",26,15,2008,29945,28030,1915,6.4
"26015",26,15,2009,28915,25916,2999,10.4
"26015",26,15,2010,29360,26318,3042,10.4
"26015",26,15,2011,28877,26517,2360,8.2
"26015",26,15,2012,28950,26968,1982,6.8
"26015",26,15,2013,29242,27375,1867,6.4
"26015",26,15,2014,29899,28280,1619,5.4
"26015",26,15,2015,30170,28874,1296,4.3
"26015",26,15,2016,30729,29495,1234,4
"26015",26,15,2017,31125,29866,1259,4
"26017",26,17,1990,53591,49358,4233,7.9
"26017",26,17,1991,53250,48647,4603,8.6
"26017",26,17,1992,54375,49333,5042,9.3
"26017",26,17,1993,54526,50384,4142,7.6
"26017",26,17,1994,55261,51019,4242,7.7
"26017",26,17,1995,54258,50880,3378,6.2
"26017",26,17,1996,54176,51436,2740,5.1
"26017",26,17,1997,55146,52596,2550,4.6
"26017",26,17,1998,55217,52766,2451,4.4
"26017",26,17,1999,56078,53672,2406,4.3
"26017",26,17,2000,57036,54668,2368,4.2
"26017",26,17,2001,56307,53220,3087,5.5
"26017",26,17,2002,54971,51280,3691,6.7
"26017",26,17,2003,55391,51191,4200,7.6
"26017",26,17,2004,55961,51802,4159,7.4
"26017",26,17,2005,55557,51608,3949,7.1
"26017",26,17,2006,55765,51761,4004,7.2
"26017",26,17,2007,55027,51253,3774,6.9
"26017",26,17,2008,54627,50516,4111,7.5
"26017",26,17,2009,54876,48322,6554,11.9
"26017",26,17,2010,54666,48347,6319,11.6
"26017",26,17,2011,53317,48064,5253,9.9
"26017",26,17,2012,52851,48230,4621,8.7
"26017",26,17,2013,53013,48386,4627,8.7
"26017",26,17,2014,53029,49206,3823,7.2
"26017",26,17,2015,52117,49111,3006,5.8
"26017",26,17,2016,51844,49020,2824,5.4
"26017",26,17,2017,50995,48120,2875,5.6
"26019",26,19,1990,6042,5342,700,11.6
"26019",26,19,1991,6125,5304,821,13.4
"26019",26,19,1992,6320,5576,744,11.8
"26019",26,19,1993,6652,5968,684,10.3
"26019",26,19,1994,6850,6239,611,8.9
"26019",26,19,1995,7053,6412,641,9.1
"26019",26,19,1996,7143,6640,503,7
"26019",26,19,1997,7546,7075,471,6.2
"26019",26,19,1998,7684,7259,425,5.5
"26019",26,19,1999,7954,7560,394,5
"26019",26,19,2000,8420,8031,389,4.6
"26019",26,19,2001,8412,7899,513,6.1
"26019",26,19,2002,8415,7828,587,7
"26019",26,19,2003,8742,8044,698,8
"26019",26,19,2004,8897,8227,670,7.5
"26019",26,19,2005,9135,8420,715,7.8
"26019",26,19,2006,9174,8445,729,7.9
"26019",26,19,2007,8995,8271,724,8
"26019",26,19,2008,8841,8053,788,8.9
"26019",26,19,2009,8724,7523,1201,13.8
"26019",26,19,2010,8961,7755,1206,13.5
"26019",26,19,2011,8693,7646,1047,12
"26019",26,19,2012,8523,7631,892,10.5
"26019",26,19,2013,8592,7707,885,10.3
"26019",26,19,2014,8710,7956,754,8.7
"26019",26,19,2015,8660,8056,604,7
"26019",26,19,2016,8831,8250,581,6.6
"26019",26,19,2017,8919,8331,588,6.6
"26021",26,21,1990,81024,75421,5603,6.9
"26021",26,21,1991,79769,72890,6879,8.6
"26021",26,21,1992,80590,73545,7045,8.7
"26021",26,21,1993,82530,76195,6335,7.7
"26021",26,21,1994,83771,78466,5305,6.3
"26021",26,21,1995,82541,78052,4489,5.4
"26021",26,21,1996,82409,77709,4700,5.7
"26021",26,21,1997,82735,78670,4065,4.9
"26021",26,21,1998,82390,79039,3351,4.1
"26021",26,21,1999,84266,81247,3019,3.6
"26021",26,21,2000,82832,79633,3199,3.9
"26021",26,21,2001,81361,76783,4578,5.6
"26021",26,21,2002,78891,73886,5005,6.3
"26021",26,21,2003,78117,72352,5765,7.4
"26021",26,21,2004,78355,72422,5933,7.6
"26021",26,21,2005,79071,73591,5480,6.9
"26021",26,21,2006,78916,73194,5722,7.3
"26021",26,21,2007,79672,74135,5537,6.9
"26021",26,21,2008,79589,73419,6170,7.8
"26021",26,21,2009,77826,67909,9917,12.7
"26021",26,21,2010,76628,67415,9213,12
"26021",26,21,2011,74551,66972,7579,10.2
"26021",26,21,2012,73289,66664,6625,9
"26021",26,21,2013,72420,66133,6287,8.7
"26021",26,21,2014,73277,68309,4968,6.8
"26021",26,21,2015,73276,69456,3820,5.2
"26021",26,21,2016,73739,70085,3654,5
"26021",26,21,2017,73790,70122,3668,5
"26023",26,23,1990,19661,18246,1415,7.2
"26023",26,23,1991,19245,17816,1429,7.4
"26023",26,23,1992,19270,17493,1777,9.2
"26023",26,23,1993,19230,17699,1531,8
"26023",26,23,1994,19652,18568,1084,5.5
"26023",26,23,1995,19757,18839,918,4.6
"26023",26,23,1996,20238,19218,1020,5
"26023",26,23,1997,20988,20238,750,3.6
"26023",26,23,1998,21379,20642,737,3.4
"26023",26,23,1999,22910,22187,723,3.2
"26023",26,23,2000,23502,22586,916,3.9
"26023",26,23,2001,23392,22104,1288,5.5
"26023",26,23,2002,22805,21410,1395,6.1
"26023",26,23,2003,22925,21340,1585,6.9
"26023",26,23,2004,22886,21277,1609,7
"26023",26,23,2005,22721,21100,1621,7.1
"26023",26,23,2006,22658,20926,1732,7.6
"26023",26,23,2007,22254,20601,1653,7.4
"26023",26,23,2008,21828,20010,1818,8.3
"26023",26,23,2009,21605,18550,3055,14.1
"26023",26,23,2010,20042,17507,2535,12.6
"26023",26,23,2011,19173,17165,2008,10.5
"26023",26,23,2012,18642,16992,1650,8.9
"26023",26,23,2013,19007,17404,1603,8.4
"26023",26,23,2014,19253,17972,1281,6.7
"26023",26,23,2015,19116,18138,978,5.1
"26023",26,23,2016,19090,18169,921,4.8
"26023",26,23,2017,19088,18183,905,4.7
"26025",26,25,1990,64679,60025,4654,7.2
"26025",26,25,1991,63788,58994,4794,7.5
"26025",26,25,1992,64405,59690,4715,7.3
"26025",26,25,1993,66009,61756,4253,6.4
"26025",26,25,1994,67194,63345,3849,5.7
"26025",26,25,1995,66818,63203,3615,5.4
"26025",26,25,1996,66295,63257,3038,4.6
"26025",26,25,1997,67193,64419,2774,4.1
"26025",26,25,1998,68448,65969,2479,3.6
"26025",26,25,1999,70283,67655,2628,3.7
"26025",26,25,2000,70635,67638,2997,4.2
"26025",26,25,2001,70635,66806,3829,5.4
"26025",26,25,2002,70021,65736,4285,6.1
"26025",26,25,2003,71176,66083,5093,7.2
"26025",26,25,2004,71824,66888,4936,6.9
"26025",26,25,2005,71724,66925,4799,6.7
"26025",26,25,2006,70774,65679,5095,7.2
"26025",26,25,2007,69772,64905,4867,7
"26025",26,25,2008,68837,63770,5067,7.4
"26025",26,25,2009,68573,60507,8066,11.8
"26025",26,25,2010,64996,57389,7607,11.7
"26025",26,25,2011,63216,57020,6196,9.8
"26025",26,25,2012,62221,57015,5206,8.4
"26025",26,25,2013,62761,57804,4957,7.9
"26025",26,25,2014,63970,59913,4057,6.3
"26025",26,25,2015,64052,60783,3269,5.1
"26025",26,25,2016,64360,61268,3092,4.8
"26025",26,25,2017,63752,60560,3192,5
"26027",26,27,1990,24634,22861,1773,7.2
"26027",26,27,1991,24084,21894,2190,9.1
"26027",26,27,1992,24257,22429,1828,7.5
"26027",26,27,1993,24957,23497,1460,5.9
"26027",26,27,1994,25721,24499,1222,4.8
"26027",26,27,1995,25716,24489,1227,4.8
"26027",26,27,1996,25625,24309,1316,5.1
"26027",26,27,1997,25507,24340,1167,4.6
"26027",26,27,1998,26204,25337,867,3.3
"26027",26,27,1999,27097,26286,811,3
"26027",26,27,2000,27184,26303,881,3.2
"26027",26,27,2001,26944,25659,1285,4.8
"26027",26,27,2002,26152,24866,1286,4.9
"26027",26,27,2003,25918,24594,1324,5.1
"26027",26,27,2004,26863,25616,1247,4.6
"26027",26,27,2005,27659,26253,1406,5.1
"26027",26,27,2006,27464,25943,1521,5.5
"26027",26,27,2007,27196,25642,1554,5.7
"26027",26,27,2008,26515,24748,1767,6.7
"26027",26,27,2009,25313,22438,2875,11.4
"26027",26,27,2010,24583,21792,2791,11.4
"26027",26,27,2011,24419,22057,2362,9.7
"26027",26,27,2012,23748,21744,2004,8.4
"26027",26,27,2013,23514,21583,1931,8.2
"26027",26,27,2014,23792,22189,1603,6.7
"26027",26,27,2015,23979,22765,1214,5.1
"26027",26,27,2016,24326,23184,1142,4.7
"26027",26,27,2017,24431,23284,1147,4.7
"26029",26,29,1990,11243,10313,930,8.3
"26029",26,29,1991,11627,10435,1192,10.3
"26029",26,29,1992,12014,10422,1592,13.3
"26029",26,29,1993,12440,11038,1402,11.3
"26029",26,29,1994,12580,11322,1258,10
"26029",26,29,1995,12699,11633,1066,8.4
"26029",26,29,1996,13170,12318,852,6.5
"26029",26,29,1997,13698,12965,733,5.4
"26029",26,29,1998,13907,13250,657,4.7
"26029",26,29,1999,14416,13750,666,4.6
"26029",26,29,2000,13867,13231,636,4.6
"26029",26,29,2001,13826,12978,848,6.1
"26029",26,29,2002,13704,12704,1000,7.3
"26029",26,29,2003,13745,12618,1127,8.2
"26029",26,29,2004,14193,13105,1088,7.7
"26029",26,29,2005,14363,13295,1068,7.4
"26029",26,29,2006,14301,13163,1138,8
"26029",26,29,2007,14117,12877,1240,8.8
"26029",26,29,2008,14047,12700,1347,9.6
"26029",26,29,2009,13765,11734,2031,14.8
"26029",26,29,2010,13357,11483,1874,14
"26029",26,29,2011,12925,11352,1573,12.2
"26029",26,29,2012,12909,11515,1394,10.8
"26029",26,29,2013,12991,11599,1392,10.7
"26029",26,29,2014,13071,12007,1064,8.1
"26029",26,29,2015,13025,12239,786,6
"26029",26,29,2016,13043,12325,718,5.5
"26029",26,29,2017,13069,12324,745,5.7
"26031",26,31,1990,10476,9228,1248,11.9
"26031",26,31,1991,10403,8870,1533,14.7
"26031",26,31,1992,10749,9272,1477,13.7
"26031",26,31,1993,10932,9658,1274,11.7
"26031",26,31,1994,11697,10283,1414,12.1
"26031",26,31,1995,11900,10419,1481,12.4
"26031",26,31,1996,11855,10575,1280,10.8
"26031",26,31,1997,12171,10934,1237,10.2
"26031",26,31,1998,12521,11307,1214,9.7
"26031",26,31,1999,12624,11434,1190,9.4
"26031",26,31,2000,13007,11922,1085,8.3
"26031",26,31,2001,12999,11724,1275,9.8
"26031",26,31,2002,12588,11260,1328,10.5
"26031",26,31,2003,12715,11422,1293,10.2
"26031",26,31,2004,12899,11681,1218,9.4
"26031",26,31,2005,13225,12020,1205,9.1
"26031",26,31,2006,12887,11580,1307,10.1
"26031",26,31,2007,12466,11172,1294,10.4
"26031",26,31,2008,12174,10825,1349,11.1
"26031",26,31,2009,11907,10260,1647,13.8
"26031",26,31,2010,11358,9772,1586,14
"26031",26,31,2011,10839,9507,1332,12.3
"26031",26,31,2012,10499,9255,1244,11.8
"26031",26,31,2013,10497,9286,1211,11.5
"26031",26,31,2014,10654,9514,1140,10.7
"26031",26,31,2015,10664,9692,972,9.1
"26031",26,31,2016,10806,9791,1015,9.4
"26031",26,31,2017,10854,9741,1113,10.3
"26033",26,33,1990,14581,12944,1637,11.2
"26033",26,33,1991,14824,13096,1728,11.7
"26033",26,33,1992,15676,13708,1968,12.6
"26033",26,33,1993,16671,14831,1840,11
"26033",26,33,1994,17351,15407,1944,11.2
"26033",26,33,1995,17408,15711,1697,9.7
"26033",26,33,1996,17634,16180,1454,8.2
"26033",26,33,1997,17858,16454,1404,7.9
"26033",26,33,1998,17509,16192,1317,7.5
"26033",26,33,1999,17872,16710,1162,6.5
"26033",26,33,2000,17529,16388,1141,6.5
"26033",26,33,2001,17448,16106,1342,7.7
"26033",26,33,2002,17009,15632,1377,8.1
"26033",26,33,2003,17251,15721,1530,8.9
"26033",26,33,2004,17449,15906,1543,8.8
"26033",26,33,2005,17538,16024,1514,8.6
"26033",26,33,2006,17648,16091,1557,8.8
"26033",26,33,2007,17520,15965,1555,8.9
"26033",26,33,2008,17239,15601,1638,9.5
"26033",26,33,2009,17191,15010,2181,12.7
"26033",26,33,2010,17806,15682,2124,11.9
"26033",26,33,2011,17390,15503,1887,10.9
"26033",26,33,2012,17105,15386,1719,10
"26033",26,33,2013,16987,15211,1776,10.5
"26033",26,33,2014,16847,15246,1601,9.5
"26033",26,33,2015,16663,15366,1297,7.8
"26033",26,33,2016,16377,15120,1257,7.7
"26033",26,33,2017,16451,15164,1287,7.8
"26035",26,35,1990,9234,8256,978,10.6
"26035",26,35,1991,9443,8297,1146,12.1
"26035",26,35,1992,9855,8567,1288,13.1
"26035",26,35,1993,10180,9100,1080,10.6
"26035",26,35,1994,10460,9279,1181,11.3
"26035",26,35,1995,10311,9172,1139,11
"26035",26,35,1996,9882,9031,851,8.6
"26035",26,35,1997,10302,9503,799,7.8
"26035",26,35,1998,10455,9701,754,7.2
"26035",26,35,1999,10920,10162,758,6.9
"26035",26,35,2000,13080,12355,725,5.5
"26035",26,35,2001,12900,11950,950,7.4
"26035",26,35,2002,12761,11718,1043,8.2
"26035",26,35,2003,12962,11761,1201,9.3
"26035",26,35,2004,13432,12133,1299,9.7
"26035",26,35,2005,13482,12170,1312,9.7
"26035",26,35,2006,13364,11932,1432,10.7
"26035",26,35,2007,13211,11798,1413,10.7
"26035",26,35,2008,12904,11428,1476,11.4
"26035",26,35,2009,12979,10827,2152,16.6
"26035",26,35,2010,12542,10592,1950,15.5
"26035",26,35,2011,12169,10563,1606,13.2
"26035",26,35,2012,11961,10545,1416,11.8
"26035",26,35,2013,11870,10479,1391,11.7
"26035",26,35,2014,11897,10726,1171,9.8
"26035",26,35,2015,11759,10849,910,7.7
"26035",26,35,2016,11946,11072,874,7.3
"26035",26,35,2017,12093,11240,853,7.1
"26037",26,37,1990,31298,29326,1972,6.3
"26037",26,37,1991,31363,28996,2367,7.5
"26037",26,37,1992,31282,29537,1745,5.6
"26037",26,37,1993,31999,30229,1770,5.5
"26037",26,37,1994,32612,31284,1328,4.1
"26037",26,37,1995,32262,31145,1117,3.5
"26037",26,37,1996,33013,31894,1119,3.4
"26037",26,37,1997,33617,32748,869,2.6
"26037",26,37,1998,34123,33156,967,2.8
"26037",26,37,1999,34746,34054,692,2
"26037",26,37,2000,35681,34730,951,2.7
"26037",26,37,2001,35889,34664,1225,3.4
"26037",26,37,2002,35806,34384,1422,4
"26037",26,37,2003,36222,34505,1717,4.7
"26037",26,37,2004,36916,34977,1939,5.3
"26037",26,37,2005,37266,35272,1994,5.4
"26037",26,37,2006,38029,35971,2058,5.4
"26037",26,37,2007,37861,35778,2083,5.5
"26037",26,37,2008,37703,35506,2197,5.8
"26037",26,37,2009,37232,33718,3514,9.4
"26037",26,37,2010,39637,36310,3327,8.4
"26037",26,37,2011,38944,36232,2712,7
"26037",26,37,2012,38504,36153,2351,6.1
"26037",26,37,2013,39008,36649,2359,6
"26037",26,37,2014,39526,37529,1997,5.1
"26037",26,37,2015,39678,38122,1556,3.9
"26037",26,37,2016,40473,38976,1497,3.7
"26037",26,37,2017,40853,39329,1524,3.7
"26039",26,39,1990,5353,4998,355,6.6
"26039",26,39,1991,5574,5098,476,8.5
"26039",26,39,1992,5614,5069,545,9.7
"26039",26,39,1993,5571,5002,569,10.2
"26039",26,39,1994,5672,5093,579,10.2
"26039",26,39,1995,5550,5054,496,8.9
"26039",26,39,1996,5423,5037,386,7.1
"26039",26,39,1997,5584,5215,369,6.6
"26039",26,39,1998,5541,5228,313,5.6
"26039",26,39,1999,5735,5401,334,5.8
"26039",26,39,2000,6728,6410,318,4.7
"26039",26,39,2001,6741,6356,385,5.7
"26039",26,39,2002,6628,6164,464,7
"26039",26,39,2003,6659,6145,514,7.7
"26039",26,39,2004,6832,6324,508,7.4
"26039",26,39,2005,6800,6313,487,7.2
"26039",26,39,2006,6811,6274,537,7.9
"26039",26,39,2007,6655,6120,535,8
"26039",26,39,2008,6459,5864,595,9.2
"26039",26,39,2009,6390,5527,863,13.5
"26039",26,39,2010,5631,4832,799,14.2
"26039",26,39,2011,5498,4793,705,12.8
"26039",26,39,2012,5368,4736,632,11.8
"26039",26,39,2013,5375,4760,615,11.4
"26039",26,39,2014,5329,4823,506,9.5
"26039",26,39,2015,5264,4852,412,7.8
"26039",26,39,2016,5364,4957,407,7.6
"26039",26,39,2017,5451,5068,383,7
"26041",26,41,1990,16899,15342,1557,9.2
"26041",26,41,1991,17307,15252,2055,11.9
"26041",26,41,1992,17630,15222,2408,13.7
"26041",26,41,1993,17942,15904,2038,11.4
"26041",26,41,1994,18150,16216,1934,10.7
"26041",26,41,1995,18014,16267,1747,9.7
"26041",26,41,1996,18331,16879,1452,7.9
"26041",26,41,1997,18797,17461,1336,7.1
"26041",26,41,1998,18976,17834,1142,6
"26041",26,41,1999,19336,18223,1113,5.8
"26041",26,41,2000,19888,18810,1078,5.4
"26041",26,41,2001,19991,18665,1326,6.6
"26041",26,41,2002,19714,18237,1477,7.5
"26041",26,41,2003,19963,18280,1683,8.4
"26041",26,41,2004,20299,18700,1599,7.9
"26041",26,41,2005,20300,18819,1481,7.3
"26041",26,41,2006,20541,19014,1527,7.4
"26041",26,41,2007,20145,18599,1546,7.7
"26041",26,41,2008,19692,18067,1625,8.3
"26041",26,41,2009,19498,17108,2390,12.3
"26041",26,41,2010,18177,15898,2279,12.5
"26041",26,41,2011,17814,15897,1917,10.8
"26041",26,41,2012,17505,15777,1728,9.9
"26041",26,41,2013,17484,15690,1794,10.3
"26041",26,41,2014,17411,15938,1473,8.5
"26041",26,41,2015,17210,16042,1168,6.8
"26041",26,41,2016,17104,15985,1119,6.5
"26041",26,41,2017,17038,15940,1098,6.4
"26043",26,43,1990,12440,11514,926,7.4
"26043",26,43,1991,12737,11567,1170,9.2
"26043",26,43,1992,12966,11715,1251,9.6
"26043",26,43,1993,13257,12208,1049,7.9
"26043",26,43,1994,13538,12535,1003,7.4
"26043",26,43,1995,13661,12717,944,6.9
"26043",26,43,1996,13870,13100,770,5.6
"26043",26,43,1997,14069,13271,798,5.7
"26043",26,43,1998,14111,13472,639,4.5
"26043",26,43,1999,14342,13662,680,4.7
"26043",26,43,2000,14051,13455,596,4.2
"26043",26,43,2001,14172,13447,725,5.1
"26043",26,43,2002,14096,13230,866,6.1
"26043",26,43,2003,14107,13146,961,6.8
"26043",26,43,2004,14414,13496,918,6.4
"26043",26,43,2005,14474,13637,837,5.8
"26043",26,43,2006,14494,13636,858,5.9
"26043",26,43,2007,14389,13512,877,6.1
"26043",26,43,2008,14416,13443,973,6.7
"26043",26,43,2009,14291,12630,1661,11.6
"26043",26,43,2010,13213,11692,1521,11.5
"26043",26,43,2011,12810,11581,1229,9.6
"26043",26,43,2012,12633,11566,1067,8.4
"26043",26,43,2013,12611,11565,1046,8.3
"26043",26,43,2014,12831,11956,875,6.8
"26043",26,43,2015,12583,11871,712,5.7
"26043",26,43,2016,12495,11846,649,5.2
"26043",26,43,2017,12549,11940,609,4.9
"26045",26,45,1990,51227,48218,3009,5.9
"26045",26,45,1991,51227,47602,3625,7.1
"26045",26,45,1992,51311,48551,2760,5.4
"26045",26,45,1993,52238,49438,2800,5.4
"26045",26,45,1994,53055,51058,1997,3.8
"26045",26,45,1995,52853,51091,1762,3.3
"26045",26,45,1996,53926,52223,1703,3.2
"26045",26,45,1997,55036,53653,1383,2.5
"26045",26,45,1998,55751,54201,1550,2.8
"26045",26,45,1999,56617,55431,1186,2.1
"26045",26,45,2000,57995,56329,1666,2.9
"26045",26,45,2001,58161,55997,2164,3.7
"26045",26,45,2002,57481,55075,2406,4.2
"26045",26,45,2003,57844,55014,2830,4.9
"26045",26,45,2004,58267,55176,3091,5.3
"26045",26,45,2005,58653,55410,3243,5.5
"26045",26,45,2006,59180,55957,3223,5.4
"26045",26,45,2007,58968,55859,3109,5.3
"26045",26,45,2008,58738,55143,3595,6.1
"26045",26,45,2009,57934,51898,6036,10.4
"26045",26,45,2010,57180,51676,5504,9.6
"26045",26,45,2011,55660,51191,4469,8
"26045",26,45,2012,54878,51079,3799,6.9
"26045",26,45,2013,55291,51602,3689,6.7
"26045",26,45,2014,55652,52463,3189,5.7
"26045",26,45,2015,55764,53296,2468,4.4
"26045",26,45,2016,56853,54506,2347,4.1
"26045",26,45,2017,57498,55093,2405,4.2
"26047",26,47,1990,14091,12778,1313,9.3
"26047",26,47,1991,14567,12875,1692,11.6
"26047",26,47,1992,15042,13115,1927,12.8
"26047",26,47,1993,15340,13590,1750,11.4
"26047",26,47,1994,15784,13911,1873,11.9
"26047",26,47,1995,15918,14190,1728,10.9
"26047",26,47,1996,16200,14716,1484,9.2
"26047",26,47,1997,17035,15719,1316,7.7
"26047",26,47,1998,17331,16139,1192,6.9
"26047",26,47,1999,18262,17120,1142,6.3
"26047",26,47,2000,18124,17107,1017,5.6
"26047",26,47,2001,18234,17076,1158,6.4
"26047",26,47,2002,18419,17085,1334,7.2
"26047",26,47,2003,19005,17539,1466,7.7
"26047",26,47,2004,19835,18249,1586,8
"26047",26,47,2005,20154,18550,1604,8
"26047",26,47,2006,20001,18238,1763,8.8
"26047",26,47,2007,19810,18013,1797,9.1
"26047",26,47,2008,19796,17874,1922,9.7
"26047",26,47,2009,19586,16791,2795,14.3
"26047",26,47,2010,18512,15839,2673,14.4
"26047",26,47,2011,18043,15684,2359,13.1
"26047",26,47,2012,17792,15666,2126,11.9
"26047",26,47,2013,18113,15969,2144,11.8
"26047",26,47,2014,17907,16199,1708,9.5
"26047",26,47,2015,17604,16335,1269,7.2
"26047",26,47,2016,17584,16439,1145,6.5
"26047",26,47,2017,17676,16502,1174,6.6
"26049",26,49,1990,199478,180647,18831,9.4
"26049",26,49,1991,198981,175161,23820,12
"26049",26,49,1992,198509,174737,23772,12
"26049",26,49,1993,199795,179394,20401,10.2
"26049",26,49,1994,205198,187796,17402,8.5
"26049",26,49,1995,205030,191144,13886,6.8
"26049",26,49,1996,204330,192038,12292,6
"26049",26,49,1997,201444,190826,10618,5.3
"26049",26,49,1998,200147,189522,10625,5.3
"26049",26,49,1999,197034,187284,9750,4.9
"26049",26,49,2000,215846,206051,9795,4.5
"26049",26,49,2001,215652,202254,13398,6.2
"26049",26,49,2002,210306,194623,15683,7.5
"26049",26,49,2003,208776,191377,17399,8.3
"26049",26,49,2004,211528,194369,17159,8.1
"26049",26,49,2005,212686,195902,16784,7.9
"26049",26,49,2006,212294,194333,17961,8.5
"26049",26,49,2007,208354,190881,17473,8.4
"26049",26,49,2008,202220,181895,20325,10.1
"26049",26,49,2009,199418,169747,29671,14.9
"26049",26,49,2010,188190,161918,26272,14
"26049",26,49,2011,182814,161919,20895,11.4
"26049",26,49,2012,181201,163066,18135,10
"26049",26,49,2013,183792,165917,17875,9.7
"26049",26,49,2014,183700,169223,14477,7.9
"26049",26,49,2015,181426,170382,11044,6.1
"26049",26,49,2016,182403,172109,10294,5.6
"26049",26,49,2017,183109,172577,10532,5.8
"26051",26,51,1990,8068,7295,773,9.6
"26051",26,51,1991,8137,7139,998,12.3
"26051",26,51,1992,8226,7105,1121,13.6
"26051",26,51,1993,8468,7529,939,11.1
"26051",26,51,1994,8853,7921,932,10.5
"26051",26,51,1995,8850,8049,801,9.1
"26051",26,51,1996,8969,8283,686,7.6
"26051",26,51,1997,9236,8545,691,7.5
"26051",26,51,1998,9153,8485,668,7.3
"26051",26,51,1999,9129,8530,599,6.6
"26051",26,51,2000,11006,10410,596,5.4
"26051",26,51,2001,11030,10242,788,7.1
"26051",26,51,2002,10978,10067,911,8.3
"26051",26,51,2003,11141,10081,1060,9.5
"26051",26,51,2004,11140,9983,1157,10.4
"26051",26,51,2005,10902,9776,1126,10.3
"26051",26,51,2006,10958,9850,1108,10.1
"26051",26,51,2007,10686,9603,1083,10.1
"26051",26,51,2008,10451,9341,1110,10.6
"26051",26,51,2009,10422,8699,1723,16.5
"26051",26,51,2010,10413,8869,1544,14.8
"26051",26,51,2011,10115,8799,1316,13
"26051",26,51,2012,9926,8752,1174,11.8
"26051",26,51,2013,10011,8842,1169,11.7
"26051",26,51,2014,10019,9089,930,9.3
"26051",26,51,2015,9961,9236,725,7.3
"26051",26,51,2016,9880,9189,691,7
"26051",26,51,2017,9905,9244,661,6.7
"26053",26,53,1990,7243,6657,586,8.1
"26053",26,53,1991,7436,6797,639,8.6
"26053",26,53,1992,7833,7068,765,9.8
"26053",26,53,1993,8213,7432,781,9.5
"26053",26,53,1994,8362,7620,742,8.9
"26053",26,53,1995,8368,7526,842,10.1
"26053",26,53,1996,8247,7330,917,11.1
"26053",26,53,1997,8183,7441,742,9.1
"26053",26,53,1998,7975,7407,568,7.1
"26053",26,53,1999,8047,7546,501,6.2
"26053",26,53,2000,7758,7259,499,6.4
"26053",26,53,2001,7974,7388,586,7.3
"26053",26,53,2002,7849,7230,619,7.9
"26053",26,53,2003,7854,7184,670,8.5
"26053",26,53,2004,7837,7217,620,7.9
"26053",26,53,2005,7756,7144,612,7.9
"26053",26,53,2006,7782,7179,603,7.7
"26053",26,53,2007,7625,7029,596,7.8
"26053",26,53,2008,7533,6900,633,8.4
"26053",26,53,2009,7493,6525,968,12.9
"26053",26,53,2010,7226,6281,945,13.1
"26053",26,53,2011,6947,6122,825,11.9
"26053",26,53,2012,6786,6033,753,11.1
"26053",26,53,2013,6708,5981,727,10.8
"26053",26,53,2014,6684,6090,594,8.9
"26053",26,53,2015,6483,6009,474,7.3
"26053",26,53,2016,6332,5943,389,6.1
"26053",26,53,2017,6286,5900,386,6.1
"26055",26,55,1990,35901,33483,2418,6.7
"26055",26,55,1991,36351,33475,2876,7.9
"26055",26,55,1992,38539,35426,3113,8.1
"26055",26,55,1993,40167,37664,2503,6.2
"26055",26,55,1994,41366,39008,2358,5.7
"26055",26,55,1995,41734,39350,2384,5.7
"26055",26,55,1996,42685,40714,1971,4.6
"26055",26,55,1997,44551,42810,1741,3.9
"26055",26,55,1998,44980,43473,1507,3.4
"26055",26,55,1999,45900,44414,1486,3.2
"26055",26,55,2000,45707,44107,1600,3.5
"26055",26,55,2001,45647,43424,2223,4.9
"26055",26,55,2002,45544,42943,2601,5.7
"26055",26,55,2003,46486,43580,2906,6.3
"26055",26,55,2004,47586,44511,3075,6.5
"26055",26,55,2005,48348,45460,2888,6
"26055",26,55,2006,49164,46110,3054,6.2
"26055",26,55,2007,49059,45808,3251,6.6
"26055",26,55,2008,48759,45204,3555,7.3
"26055",26,55,2009,48509,42776,5733,11.8
"26055",26,55,2010,47553,42015,5538,11.6
"26055",26,55,2011,46656,42083,4573,9.8
"26055",26,55,2012,46358,42529,3829,8.3
"26055",26,55,2013,47035,43446,3589,7.6
"26055",26,55,2014,47855,44968,2887,6
"26055",26,55,2015,48367,46111,2256,4.7
"26055",26,55,2016,49346,47227,2119,4.3
"26055",26,55,2017,49856,47732,2124,4.3
"26057",26,57,1990,18421,16801,1620,8.8
"26057",26,57,1991,18303,16329,1974,10.8
"26057",26,57,1992,18210,16487,1723,9.5
"26057",26,57,1993,19459,17900,1559,8
"26057",26,57,1994,19309,17827,1482,7.7
"26057",26,57,1995,18887,17532,1355,7.2
"26057",26,57,1996,18716,17495,1221,6.5
"26057",26,57,1997,18983,17944,1039,5.5
"26057",26,57,1998,19152,18254,898,4.7
"26057",26,57,1999,19818,19021,797,4
"26057",26,57,2000,19609,18697,912,4.7
"26057",26,57,2001,19486,18378,1108,5.7
"26057",26,57,2002,19325,18133,1192,6.2
"26057",26,57,2003,19602,18186,1416,7.2
"26057",26,57,2004,20268,18680,1588,7.8
"26057",26,57,2005,20309,18614,1695,8.3
"26057",26,57,2006,20342,18541,1801,8.9
"26057",26,57,2007,19857,18125,1732,8.7
"26057",26,57,2008,19368,17591,1777,9.2
"26057",26,57,2009,19605,16866,2739,14
"26057",26,57,2010,19544,17233,2311,11.8
"26057",26,57,2011,19075,17162,1913,10
"26057",26,57,2012,18575,16905,1670,9
"26057",26,57,2013,18419,16780,1639,8.9
"26057",26,57,2014,18439,17138,1301,7.1
"26057",26,57,2015,18260,17224,1036,5.7
"26057",26,57,2016,18154,17214,940,5.2
"26057",26,57,2017,18068,17075,993,5.5
"26059",26,59,1990,21008,19221,1787,8.5
"26059",26,59,1991,20310,18207,2103,10.4
"26059",26,59,1992,20978,19209,1769,8.4
"26059",26,59,1993,21750,20271,1479,6.8
"26059",26,59,1994,22198,20938,1260,5.7
"26059",26,59,1995,21937,20883,1054,4.8
"26059",26,59,1996,22020,21055,965,4.4
"26059",26,59,1997,22648,21808,840,3.7
"26059",26,59,1998,23512,22773,739,3.1
"26059",26,59,1999,24664,23940,724,2.9
"26059",26,59,2000,24256,23341,915,3.8
"26059",26,59,2001,23978,22505,1473,6.1
"26059",26,59,2002,23093,21637,1456,6.3
"26059",26,59,2003,22879,21127,1752,7.7
"26059",26,59,2004,22536,20675,1861,8.3
"26059",26,59,2005,22353,20645,1708,7.6
"26059",26,59,2006,22385,20589,1796,8
"26059",26,59,2007,21781,19866,1915,8.8
"26059",26,59,2008,20879,18754,2125,10.2
"26059",26,59,2009,20987,17345,3642,17.4
"26059",26,59,2010,21487,18577,2910,13.5
"26059",26,59,2011,20651,18454,2197,10.6
"26059",26,59,2012,20458,18586,1872,9.2
"26059",26,59,2013,20505,18680,1825,8.9
"26059",26,59,2014,20467,19034,1433,7
"26059",26,59,2015,20990,19889,1101,5.2
"26059",26,59,2016,21158,20089,1069,5.1
"26059",26,59,2017,21084,20040,1044,5
"26061",26,61,1990,14542,13472,1070,7.4
"26061",26,61,1991,14592,13360,1232,8.4
"26061",26,61,1992,15186,13714,1472,9.7
"26061",26,61,1993,15858,14509,1349,8.5
"26061",26,61,1994,16402,15095,1307,8
"26061",26,61,1995,16304,15038,1266,7.8
"26061",26,61,1996,16499,15427,1072,6.5
"26061",26,61,1997,17023,16083,940,5.5
"26061",26,61,1998,17307,16449,858,5
"26061",26,61,1999,17497,16767,730,4.2
"26061",26,61,2000,17186,16325,861,5
"26061",26,61,2001,17033,15974,1059,6.2
"26061",26,61,2002,16873,15701,1172,6.9
"26061",26,61,2003,17013,15811,1202,7.1
"26061",26,61,2004,17239,16137,1102,6.4
"26061",26,61,2005,17571,16423,1148,6.5
"26061",26,61,2006,17820,16555,1265,7.1
"26061",26,61,2007,17657,16379,1278,7.2
"26061",26,61,2008,17402,16064,1338,7.7
"26061",26,61,2009,17689,15776,1913,10.8
"26061",26,61,2010,17939,16010,1929,10.8
"26061",26,61,2011,17322,15662,1660,9.6
"26061",26,61,2012,16904,15390,1514,9
"26061",26,61,2013,16824,15333,1491,8.9
"26061",26,61,2014,16913,15616,1297,7.7
"26061",26,61,2015,16537,15487,1050,6.3
"26061",26,61,2016,16552,15538,1014,6.1
"26061",26,61,2017,16542,15539,1003,6.1
"26063",26,63,1990,15873,14249,1624,10.2
"26063",26,63,1991,15805,13861,1944,12.3
"26063",26,63,1992,15768,13830,1938,12.3
"26063",26,63,1993,16640,14941,1699,10.2
"26063",26,63,1994,17546,15947,1599,9.1
"26063",26,63,1995,17206,15770,1436,8.3
"26063",26,63,1996,17144,16096,1048,6.1
"26063",26,63,1997,17878,17002,876,4.9
"26063",26,63,1998,18093,17392,701,3.9
"26063",26,63,1999,18053,17258,795,4.4
"26063",26,63,2000,17668,16842,826,4.7
"26063",26,63,2001,17363,16062,1301,7.5
"26063",26,63,2002,16880,15387,1493,8.8
"26063",26,63,2003,17124,15499,1625,9.5
"26063",26,63,2004,17119,15636,1483,8.7
"26063",26,63,2005,17061,15750,1311,7.7
"26063",26,63,2006,17332,15882,1450,8.4
"26063",26,63,2007,16714,15377,1337,8
"26063",26,63,2008,16260,14826,1434,8.8
"26063",26,63,2009,16186,13821,2365,14.6
"26063",26,63,2010,16642,14567,2075,12.5
"26063",26,63,2011,16412,14815,1597,9.7
"26063",26,63,2012,16389,15069,1320,8.1
"26063",26,63,2013,16323,14958,1365,8.4
"26063",26,63,2014,16515,15380,1135,6.9
"26063",26,63,2015,16336,15455,881,5.4
"26063",26,63,2016,15985,15158,827,5.2
"26063",26,63,2017,15737,14906,831,5.3
"26065",26,65,1990,150555,141367,9188,6.1
"26065",26,65,1991,147815,137481,10334,7
"26065",26,65,1992,147441,138795,8646,5.9
"26065",26,65,1993,147699,139594,8105,5.5
"26065",26,65,1994,148853,142002,6851,4.6
"26065",26,65,1995,149083,143381,5702,3.8
"26065",26,65,1996,150198,144664,5534,3.7
"26065",26,65,1997,152864,148252,4612,3
"26065",26,65,1998,152983,148418,4565,3
"26065",26,65,1999,154279,150508,3771,2.4
"26065",26,65,2000,154743,150077,4666,3
"26065",26,65,2001,154468,148267,6201,4
"26065",26,65,2002,152030,144855,7175,4.7
"26065",26,65,2003,151665,143052,8613,5.7
"26065",26,65,2004,152828,143327,9501,6.2
"26065",26,65,2005,152166,142407,9759,6.4
"26065",26,65,2006,153139,143147,9992,6.5
"26065",26,65,2007,153495,143929,9566,6.2
"26065",26,65,2008,152552,141990,10562,6.9
"26065",26,65,2009,151927,134570,17357,11.4
"26065",26,65,2010,148442,133197,15245,10.3
"26065",26,65,2011,145123,132289,12834,8.8
"26065",26,65,2012,143174,131953,11221,7.8
"26065",26,65,2013,144121,133094,11027,7.7
"26065",26,65,2014,145186,136185,9001,6.2
"26065",26,65,2015,145587,138778,6809,4.7
"26065",26,65,2016,148824,142425,6399,4.3
"26065",26,65,2017,150600,143970,6630,4.4
"26067",26,67,1990,26949,24299,2650,9.8
"26067",26,67,1991,26663,23717,2946,11
"26067",26,67,1992,26178,23714,2464,9.4
"26067",26,67,1993,26770,24406,2364,8.8
"26067",26,67,1994,27034,24925,2109,7.8
"26067",26,67,1995,26472,24843,1629,6.2
"26067",26,67,1996,26618,25057,1561,5.9
"26067",26,67,1997,26890,25564,1326,4.9
"26067",26,67,1998,27357,26192,1165,4.3
"26067",26,67,1999,27828,26742,1086,3.9
"26067",26,67,2000,30120,28992,1128,3.7
"26067",26,67,2001,30044,28478,1566,5.2
"26067",26,67,2002,29655,27764,1891,6.4
"26067",26,67,2003,29418,27317,2101,7.1
"26067",26,67,2004,30515,28133,2382,7.8
"26067",26,67,2005,30924,28656,2268,7.3
"26067",26,67,2006,31552,28883,2669,8.5
"26067",26,67,2007,30484,28179,2305,7.6
"26067",26,67,2008,30027,27549,2478,8.3
"26067",26,67,2009,29284,25163,4121,14.1
"26067",26,67,2010,29931,26363,3568,11.9
"26067",26,67,2011,29106,26261,2845,9.8
"26067",26,67,2012,28620,26190,2430,8.5
"26067",26,67,2013,28765,26474,2291,8
"26067",26,67,2014,29191,27381,1810,6.2
"26067",26,67,2015,29309,27968,1341,4.6
"26067",26,67,2016,29636,28382,1254,4.2
"26067",26,67,2017,29898,28689,1209,4
"26069",26,69,1990,11122,10192,930,8.4
"26069",26,69,1991,11229,10137,1092,9.7
"26069",26,69,1992,11486,10203,1283,11.2
"26069",26,69,1993,10834,9447,1387,12.8
"26069",26,69,1994,10924,9689,1235,11.3
"26069",26,69,1995,11110,10074,1036,9.3
"26069",26,69,1996,11261,10351,910,8.1
"26069",26,69,1997,11621,10715,906,7.8
"26069",26,69,1998,11673,10907,766,6.6
"26069",26,69,1999,11704,10852,852,7.3
"26069",26,69,2000,11661,10888,773,6.6
"26069",26,69,2001,11085,10027,1058,9.5
"26069",26,69,2002,10729,9639,1090,10.2
"26069",26,69,2003,10564,9480,1084,10.3
"26069",26,69,2004,10644,9617,1027,9.6
"26069",26,69,2005,10958,9953,1005,9.2
"26069",26,69,2006,11184,10135,1049,9.4
"26069",26,69,2007,10895,9802,1093,10
"26069",26,69,2008,10665,9522,1143,10.7
"26069",26,69,2009,10589,8712,1877,17.7
"26069",26,69,2010,10377,8737,1640,15.8
"26069",26,69,2011,10130,8830,1300,12.8
"26069",26,69,2012,10148,9010,1138,11.2
"26069",26,69,2013,10188,9023,1165,11.4
"26069",26,69,2014,10282,9282,1000,9.7
"26069",26,69,2015,10077,9318,759,7.5
"26069",26,69,2016,10103,9367,736,7.3
"26069",26,69,2017,10173,9406,767,7.5
"26071",26,71,1990,5272,4809,463,8.8
"26071",26,71,1991,5287,4726,561,10.6
"26071",26,71,1992,5407,4792,615,11.4
"26071",26,71,1993,5573,4970,603,10.8
"26071",26,71,1994,5595,4947,648,11.6
"26071",26,71,1995,5499,4982,517,9.4
"26071",26,71,1996,5522,5075,447,8.1
"26071",26,71,1997,5645,5253,392,6.9
"26071",26,71,1998,5557,5229,328,5.9
"26071",26,71,1999,5623,5280,343,6.1
"26071",26,71,2000,5684,5345,339,6
"26071",26,71,2001,5738,5355,383,6.7
"26071",26,71,2002,5690,5278,412,7.2
"26071",26,71,2003,5816,5383,433,7.4
"26071",26,71,2004,5923,5480,443,7.5
"26071",26,71,2005,5874,5438,436,7.4
"26071",26,71,2006,6008,5560,448,7.5
"26071",26,71,2007,5938,5496,442,7.4
"26071",26,71,2008,5838,5357,481,8.2
"26071",26,71,2009,5779,5081,698,12.1
"26071",26,71,2010,5296,4661,635,12
"26071",26,71,2011,5170,4634,536,10.4
"26071",26,71,2012,5079,4594,485,9.5
"26071",26,71,2013,5068,4553,515,10.2
"26071",26,71,2014,5195,4743,452,8.7
"26071",26,71,2015,5197,4831,366,7
"26071",26,71,2016,5212,4876,336,6.4
"26071",26,71,2017,5213,4873,340,6.5
"26073",26,73,1990,25846,24280,1566,6.1
"26073",26,73,1991,25444,23600,1844,7.2
"26073",26,73,1992,25608,23729,1879,7.3
"26073",26,73,1993,26309,24799,1510,5.7
"26073",26,73,1994,27605,26218,1387,5
"26073",26,73,1995,28267,26915,1352,4.8
"26073",26,73,1996,28198,27153,1045,3.7
"26073",26,73,1997,29773,28793,980,3.3
"26073",26,73,1998,31797,30905,892,2.8
"26073",26,73,1999,33122,32202,920,2.8
"26073",26,73,2000,34909,33725,1184,3.4
"26073",26,73,2001,35222,33812,1410,4
"26073",26,73,2002,34953,33403,1550,4.4
"26073",26,73,2003,34960,33152,1808,5.2
"26073",26,73,2004,36830,35007,1823,4.9
"26073",26,73,2005,37989,36097,1892,5
"26073",26,73,2006,38165,36125,2040,5.3
"26073",26,73,2007,38743,36705,2038,5.3
"26073",26,73,2008,38645,36364,2281,5.9
"26073",26,73,2009,38315,34911,3404,8.9
"26073",26,73,2010,35522,32046,3476,9.8
"26073",26,73,2011,34911,31986,2925,8.4
"26073",26,73,2012,34701,32136,2565,7.4
"26073",26,73,2013,34863,32344,2519,7.2
"26073",26,73,2014,35426,33326,2100,5.9
"26073",26,73,2015,35245,33551,1694,4.8
"26073",26,73,2016,35328,33666,1662,4.7
"26073",26,73,2017,35483,33858,1625,4.6
"26075",26,75,1990,71169,66155,5014,7
"26075",26,75,1991,69967,63784,6183,8.8
"26075",26,75,1992,71334,64522,6812,9.5
"26075",26,75,1993,73546,67667,5879,8
"26075",26,75,1994,74662,69653,5009,6.7
"26075",26,75,1995,74197,70229,3968,5.3
"26075",26,75,1996,74915,71280,3635,4.9
"26075",26,75,1997,75871,72609,3262,4.3
"26075",26,75,1998,76046,73471,2575,3.4
"26075",26,75,1999,78112,75751,2361,3
"26075",26,75,2000,79369,76596,2773,3.5
"26075",26,75,2001,79659,75349,4310,5.4
"26075",26,75,2002,78003,72768,5235,6.7
"26075",26,75,2003,77256,71054,6202,8
"26075",26,75,2004,78092,72274,5818,7.5
"26075",26,75,2005,78307,72944,5363,6.8
"26075",26,75,2006,78168,72349,5819,7.4
"26075",26,75,2007,77563,71629,5934,7.7
"26075",26,75,2008,76407,70110,6297,8.2
"26075",26,75,2009,76509,66125,10384,13.6
"26075",26,75,2010,74673,65564,9109,12.2
"26075",26,75,2011,72614,65424,7190,9.9
"26075",26,75,2012,71562,65453,6109,8.5
"26075",26,75,2013,72095,66139,5956,8.3
"26075",26,75,2014,72888,68034,4854,6.7
"26075",26,75,2015,72913,69056,3857,5.3
"26075",26,75,2016,74356,70750,3606,4.8
"26075",26,75,2017,74314,70799,3515,4.7
"26077",26,77,1990,119722,113536,6186,5.2
"26077",26,77,1991,117990,110965,7025,6
"26077",26,77,1992,118859,112332,6527,5.5
"26077",26,77,1993,122076,116519,5557,4.6
"26077",26,77,1994,123720,118650,5070,4.1
"26077",26,77,1995,122863,118612,4251,3.5
"26077",26,77,1996,123242,119109,4133,3.4
"26077",26,77,1997,125762,121923,3839,3.1
"26077",26,77,1998,127089,123960,3129,2.5
"26077",26,77,1999,130114,126745,3369,2.6
"26077",26,77,2000,133298,129235,4063,3
"26077",26,77,2001,131690,126075,5615,4.3
"26077",26,77,2002,129610,123404,6206,4.8
"26077",26,77,2003,129785,122658,7127,5.5
"26077",26,77,2004,131183,123752,7431,5.7
"26077",26,77,2005,132576,125622,6954,5.2
"26077",26,77,2006,133847,126658,7189,5.4
"26077",26,77,2007,134661,127431,7230,5.4
"26077",26,77,2008,133981,125812,8169,6.1
"26077",26,77,2009,133516,119922,13594,10.2
"26077",26,77,2010,129632,116657,12975,10
"26077",26,77,2011,126186,115549,10637,8.4
"26077",26,77,2012,124591,115564,9027,7.2
"26077",26,77,2013,124901,116335,8566,6.9
"26077",26,77,2014,127872,120691,7181,5.6
"26077",26,77,2015,128930,123323,5607,4.3
"26077",26,77,2016,131920,126566,5354,4.1
"26077",26,77,2017,132438,126982,5456,4.1
"26079",26,79,1990,6118,5522,596,9.7
"26079",26,79,1991,6329,5578,751,11.9
"26079",26,79,1992,6587,5814,773,11.7
"26079",26,79,1993,6990,6188,802,11.5
"26079",26,79,1994,7113,6428,685,9.6
"26079",26,79,1995,7155,6535,620,8.7
"26079",26,79,1996,7417,6848,569,7.7
"26079",26,79,1997,7619,7138,481,6.3
"26079",26,79,1998,7646,7177,469,6.1
"26079",26,79,1999,7771,7342,429,5.5
"26079",26,79,2000,8580,8170,410,4.8
"26079",26,79,2001,8592,7949,643,7.5
"26079",26,79,2002,8478,7816,662,7.8
"26079",26,79,2003,8642,7932,710,8.2
"26079",26,79,2004,8711,8036,675,7.7
"26079",26,79,2005,8774,8110,664,7.6
"26079",26,79,2006,8886,8173,713,8
"26079",26,79,2007,8709,8004,705,8.1
"26079",26,79,2008,8522,7788,734,8.6
"26079",26,79,2009,8496,7272,1224,14.4
"26079",26,79,2010,7918,6680,1238,15.6
"26079",26,79,2011,7595,6606,989,13
"26079",26,79,2012,7429,6588,841,11.3
"26079",26,79,2013,7557,6713,844,11.2
"26079",26,79,2014,7700,6974,726,9.4
"26079",26,79,2015,7612,7028,584,7.7
"26079",26,79,2016,7713,7160,553,7.2
"26079",26,79,2017,7793,7238,555,7.1
"26081",26,81,1990,269082,254097,14985,5.6
"26081",26,81,1991,268293,248780,19513,7.3
"26081",26,81,1992,273206,252839,20367,7.5
"26081",26,81,1993,282251,266240,16011,5.7
"26081",26,81,1994,290218,277090,13128,4.5
"26081",26,81,1995,296377,285253,11124,3.8
"26081",26,81,1996,301823,290281,11542,3.8
"26081",26,81,1997,312865,303218,9647,3.1
"26081",26,81,1998,318244,309793,8451,2.7
"26081",26,81,1999,329758,320624,9134,2.8
"26081",26,81,2000,320150,310020,10130,3.2
"26081",26,81,2001,320943,305541,15402,4.8
"26081",26,81,2002,314301,294931,19370,6.2
"26081",26,81,2003,312867,289940,22927,7.3
"26081",26,81,2004,318011,297020,20991,6.6
"26081",26,81,2005,321655,302857,18798,5.8
"26081",26,81,2006,324689,305699,18990,5.8
"26081",26,81,2007,323454,304257,19197,5.9
"26081",26,81,2008,320177,298902,21275,6.6
"26081",26,81,2009,314423,279938,34485,11
"26081",26,81,2010,316233,284168,32065,10.1
"26081",26,81,2011,315111,289297,25814,8.2
"26081",26,81,2012,319697,297920,21777,6.8
"26081",26,81,2013,326607,306212,20395,6.2
"26081",26,81,2014,335664,319053,16611,4.9
"26081",26,81,2015,341904,329042,12862,3.8
"26081",26,81,2016,350111,337766,12345,3.5
"26081",26,81,2017,355111,342568,12543,3.5
"26083",26,83,1990,603,514,89,14.8
"26083",26,83,1991,620,508,112,18.1
"26083",26,83,1992,640,532,108,16.9
"26083",26,83,1993,693,588,105,15.2
"26083",26,83,1994,729,631,98,13.4
"26083",26,83,1995,745,651,94,12.6
"26083",26,83,1996,785,692,93,11.8
"26083",26,83,1997,817,737,80,9.8
"26083",26,83,1998,851,776,75,8.8
"26083",26,83,1999,879,811,68,7.7
"26083",26,83,2000,1054,987,67,6.4
"26083",26,83,2001,1058,971,87,8.2
"26083",26,83,2002,1027,934,93,9.1
"26083",26,83,2003,1048,939,109,10.4
"26083",26,83,2004,1066,944,122,11.4
"26083",26,83,2005,1064,951,113,10.6
"26083",26,83,2006,1075,964,111,10.3
"26083",26,83,2007,1059,943,116,11
"26083",26,83,2008,1062,948,114,10.7
"26083",26,83,2009,1130,970,160,14.2
"26083",26,83,2010,1015,862,153,15.1
"26083",26,83,2011,1017,877,140,13.8
"26083",26,83,2012,984,859,125,12.7
"26083",26,83,2013,986,852,134,13.6
"26083",26,83,2014,982,873,109,11.1
"26083",26,83,2015,938,851,87,9.3
"26083",26,83,2016,941,860,81,8.6
"26083",26,83,2017,940,858,82,8.7
"26085",26,85,1990,2719,2397,322,11.8
"26085",26,85,1991,2787,2422,365,13.1
"26085",26,85,1992,3070,2646,424,13.8
"26085",26,85,1993,3268,2825,443,13.6
"26085",26,85,1994,3276,2858,418,12.8
"26085",26,85,1995,3143,2732,411,13.1
"26085",26,85,1996,3094,2763,331,10.7
"26085",26,85,1997,3091,2826,265,8.6
"26085",26,85,1998,3243,3002,241,7.4
"26085",26,85,1999,3476,3223,253,7.3
"26085",26,85,2000,4476,4215,261,5.8
"26085",26,85,2001,4473,4123,350,7.8
"26085",26,85,2002,4463,4078,385,8.6
"26085",26,85,2003,4488,4037,451,10
"26085",26,85,2004,4474,3998,476,10.6
"26085",26,85,2005,4388,3930,458,10.4
"26085",26,85,2006,4222,3768,454,10.8
"26085",26,85,2007,4074,3646,428,10.5
"26085",26,85,2008,3940,3501,439,11.1
"26085",26,85,2009,4080,3400,680,16.7
"26085",26,85,2010,3890,3258,632,16.2
"26085",26,85,2011,3858,3331,527,13.7
"26085",26,85,2012,3661,3183,478,13.1
"26085",26,85,2013,3619,3139,480,13.3
"26085",26,85,2014,3611,3207,404,11.2
"26085",26,85,2015,3672,3357,315,8.6
"26085",26,85,2016,3750,3469,281,7.5
"26085",26,85,2017,3772,3465,307,8.1
"26087",26,87,1990,37499,33672,3827,10.2
"26087",26,87,1991,38406,33439,4967,12.9
"26087",26,87,1992,39143,34480,4663,11.9
"26087",26,87,1993,39396,35872,3524,8.9
"26087",26,87,1994,39479,37040,2439,6.2
"26087",26,87,1995,40360,38052,2308,5.7
"26087",26,87,1996,41734,39499,2235,5.4
"26087",26,87,1997,42576,40504,2072,4.9
"26087",26,87,1998,43981,41779,2202,5
"26087",26,87,1999,44859,42862,1997,4.5
"26087",26,87,2000,46069,44252,1817,3.9
"26087",26,87,2001,45633,42837,2796,6.1
"26087",26,87,2002,45325,41930,3395,7.5
"26087",26,87,2003,45545,41827,3718,8.2
"26087",26,87,2004,45470,41905,3565,7.8
"26087",26,87,2005,45788,42344,3444,7.5
"26087",26,87,2006,45400,41920,3480,7.7
"26087",26,87,2007,44306,40778,3528,8
"26087",26,87,2008,43084,39013,4071,9.4
"26087",26,87,2009,43238,35718,7520,17.4
"26087",26,87,2010,41335,34587,6748,16.3
"26087",26,87,2011,39862,34587,5275,13.2
"26087",26,87,2012,39714,35095,4619,11.6
"26087",26,87,2013,40283,35679,4604,11.4
"26087",26,87,2014,39882,36056,3826,9.6
"26087",26,87,2015,39712,36846,2866,7.2
"26087",26,87,2016,40649,38032,2617,6.4
"26087",26,87,2017,41114,38906,2208,5.4
"26089",26,89,1990,8741,8200,541,6.2
"26089",26,89,1991,8857,8180,677,7.6
"26089",26,89,1992,9460,8734,726,7.7
"26089",26,89,1993,10012,9373,639,6.4
"26089",26,89,1994,10322,9739,583,5.6
"26089",26,89,1995,10257,9685,572,5.6
"26089",26,89,1996,10391,9921,470,4.5
"26089",26,89,1997,10993,10567,426,3.9
"26089",26,89,1998,11062,10716,346,3.1
"26089",26,89,1999,11244,10913,331,2.9
"26089",26,89,2000,11358,11002,356,3.1
"26089",26,89,2001,11117,10691,426,3.8
"26089",26,89,2002,10984,10451,533,4.9
"26089",26,89,2003,11313,10672,641,5.7
"26089",26,89,2004,11491,10874,617,5.4
"26089",26,89,2005,11576,10976,600,5.2
"26089",26,89,2006,11588,10982,606,5.2
"26089",26,89,2007,11362,10738,624,5.5
"26089",26,89,2008,11142,10468,674,6
"26089",26,89,2009,10943,9928,1015,9.3
"26089",26,89,2010,10588,9490,1098,10.4
"26089",26,89,2011,10324,9378,946,9.2
"26089",26,89,2012,10163,9347,816,8
"26089",26,89,2013,10259,9472,787,7.7
"26089",26,89,2014,10510,9810,700,6.7
"26089",26,89,2015,10566,10009,557,5.3
"26089",26,89,2016,10567,10053,514,4.9
"26089",26,89,2017,10655,10133,522,4.9
"26091",26,91,1990,43690,40425,3265,7.5
"26091",26,91,1991,44243,40077,4166,9.4
"26091",26,91,1992,45105,41564,3541,7.9
"26091",26,91,1993,45033,42410,2623,5.8
"26091",26,91,1994,45283,42979,2304,5.1
"26091",26,91,1995,45417,43091,2326,5.1
"26091",26,91,1996,45513,43551,1962,4.3
"26091",26,91,1997,46261,44545,1716,3.7
"26091",26,91,1998,46975,45611,1364,2.9
"26091",26,91,1999,48650,47096,1554,3.2
"26091",26,91,2000,51888,49901,1987,3.8
"26091",26,91,2001,52109,49251,2858,5.5
"26091",26,91,2002,50606,47409,3197,6.3
"26091",26,91,2003,50072,46417,3655,7.3
"26091",26,91,2004,49341,45730,3611,7.3
"26091",26,91,2005,49734,46189,3545,7.1
"26091",26,91,2006,50177,46363,3814,7.6
"26091",26,91,2007,49663,45710,3953,8
"26091",26,91,2008,48629,43910,4719,9.7
"26091",26,91,2009,48487,40951,7536,15.5
"26091",26,91,2010,49811,43318,6493,13
"26091",26,91,2011,48269,43261,5008,10.4
"26091",26,91,2012,47498,43522,3976,8.4
"26091",26,91,2013,47581,43858,3723,7.8
"26091",26,91,2014,47915,44841,3074,6.4
"26091",26,91,2015,47393,45018,2375,5
"26091",26,91,2016,47317,45142,2175,4.6
"26091",26,91,2017,47363,45089,2274,4.8
"26093",26,93,1990,61739,58218,3521,5.7
"26093",26,93,1991,63633,59039,4594,7.2
"26093",26,93,1992,67420,63268,4152,6.2
"26093",26,93,1993,67953,65045,2908,4.3
"26093",26,93,1994,70073,67474,2599,3.7
"26093",26,93,1995,71145,68712,2433,3.4
"26093",26,93,1996,73819,71337,2482,3.4
"26093",26,93,1997,75722,73502,2220,2.9
"26093",26,93,1998,78823,76793,2030,2.6
"26093",26,93,1999,81645,79658,1987,2.4
"26093",26,93,2000,90099,87936,2163,2.4
"26093",26,93,2001,89973,86826,3147,3.5
"26093",26,93,2002,90513,86477,4036,4.5
"26093",26,93,2003,92225,87545,4680,5.1
"26093",26,93,2004,93749,89055,4694,5
"26093",26,93,2005,96140,91165,4975,5.2
"26093",26,93,2006,96337,91350,4987,5.2
"26093",26,93,2007,94930,89902,5028,5.3
"26093",26,93,2008,92641,86794,5847,6.3
"26093",26,93,2009,91418,80499,10919,11.9
"26093",26,93,2010,94112,83600,10512,11.2
"26093",26,93,2011,92626,84286,8340,9
"26093",26,93,2012,93153,85806,7347,7.9
"26093",26,93,2013,94808,87770,7038,7.4
"26093",26,93,2014,95436,89367,6069,6.4
"26093",26,93,2015,96400,91931,4469,4.6
"26093",26,93,2016,99864,95768,4096,4.1
"26093",26,93,2017,101400,98038,3362,3.3
"26095",26,95,1990,2410,2192,218,9
"26095",26,95,1991,2433,2112,321,13.2
"26095",26,95,1992,2376,1999,377,15.9
"26095",26,95,1993,2387,2021,366,15.3
"26095",26,95,1994,2460,2113,347,14.1
"26095",26,95,1995,2587,2314,273,10.6
"26095",26,95,1996,2714,2508,206,7.6
"26095",26,95,1997,2819,2574,245,8.7
"26095",26,95,1998,2719,2519,200,7.4
"26095",26,95,1999,2646,2450,196,7.4
"26095",26,95,2000,2765,2594,171,6.2
"26095",26,95,2001,2852,2657,195,6.8
"26095",26,95,2002,2894,2678,216,7.5
"26095",26,95,2003,2884,2660,224,7.8
"26095",26,95,2004,2868,2654,214,7.5
"26095",26,95,2005,2834,2615,219,7.7
"26095",26,95,2006,2859,2635,224,7.8
"26095",26,95,2007,2773,2520,253,9.1
"26095",26,95,2008,2739,2489,250,9.1
"26095",26,95,2009,2723,2362,361,13.3
"26095",26,95,2010,2498,2163,335,13.4
"26095",26,95,2011,2412,2117,295,12.2
"26095",26,95,2012,2366,2107,259,10.9
"26095",26,95,2013,2397,2149,248,10.3
"26095",26,95,2014,2479,2268,211,8.5
"26095",26,95,2015,2455,2284,171,7
"26095",26,95,2016,2401,2239,162,6.7
"26095",26,95,2017,2431,2263,168,6.9
"26097",26,97,1990,6207,5327,880,14.2
"26097",26,97,1991,6328,5379,949,15
"26097",26,97,1992,6443,5411,1032,16
"26097",26,97,1993,6703,5875,828,12.4
"26097",26,97,1994,7061,6181,880,12.5
"26097",26,97,1995,7259,6390,869,12
"26097",26,97,1996,7223,6486,737,10.2
"26097",26,97,1997,7344,6627,717,9.8
"26097",26,97,1998,7341,6683,658,9
"26097",26,97,1999,7475,6830,645,8.6
"26097",26,97,2000,6909,6375,534,7.7
"26097",26,97,2001,6873,6251,622,9
"26097",26,97,2002,6623,5996,627,9.5
"26097",26,97,2003,6534,5912,622,9.5
"26097",26,97,2004,6525,5885,640,9.8
"26097",26,97,2005,6509,5849,660,10.1
"26097",26,97,2006,6546,5898,648,9.9
"26097",26,97,2007,6430,5779,651,10.1
"26097",26,97,2008,6298,5573,725,11.5
"26097",26,97,2009,6185,5319,866,14
"26097",26,97,2010,5560,4746,814,14.6
"26097",26,97,2011,5289,4595,694,13.1
"26097",26,97,2012,5187,4560,627,12.1
"26097",26,97,2013,5238,4597,641,12.2
"26097",26,97,2014,5283,4693,590,11.2
"26097",26,97,2015,5113,4616,497,9.7
"26097",26,97,2016,5185,4674,511,9.9
"26097",26,97,2017,5282,4741,541,10.2
"26099",26,99,1990,392960,362426,30534,7.8
"26099",26,99,1991,395267,357475,37792,9.6
"26099",26,99,1992,402350,366791,35559,8.8
"26099",26,99,1993,404971,378249,26722,6.6
"26099",26,99,1994,409688,387672,22016,5.4
"26099",26,99,1995,411891,393063,18828,4.6
"26099",26,99,1996,423406,404798,18608,4.4
"26099",26,99,1997,427639,411206,16433,3.8
"26099",26,99,1998,435607,419569,16038,3.7
"26099",26,99,1999,443626,427668,15958,3.6
"26099",26,99,2000,435533,421151,14382,3.3
"26099",26,99,2001,428355,407043,21312,5
"26099",26,99,2002,422480,396836,25644,6.1
"26099",26,99,2003,425040,396080,28960,6.8
"26099",26,99,2004,425762,396780,28982,6.8
"26099",26,99,2005,428038,399805,28233,6.6
"26099",26,99,2006,425611,395735,29876,7
"26099",26,99,2007,421017,391423,29594,7
"26099",26,99,2008,412613,378988,33625,8.1
"26099",26,99,2009,416697,350776,65921,15.8
"26099",26,99,2010,420803,362380,58423,13.9
"26099",26,99,2011,409065,363484,45581,11.1
"26099",26,99,2012,411719,371286,40433,9.8
"26099",26,99,2013,420290,380495,39795,9.5
"26099",26,99,2014,420858,387545,33313,7.9
"26099",26,99,2015,421322,397009,24313,5.8
"26099",26,99,2016,435141,412449,22692,5.2
"26099",26,99,2017,441491,422560,18931,4.3
"26101",26,101,1990,9354,8369,985,10.5
"26101",26,101,1991,9361,8203,1158,12.4
"26101",26,101,1992,9753,8390,1363,14
"26101",26,101,1993,9967,8700,1267,12.7
"26101",26,101,1994,10201,8980,1221,12
"26101",26,101,1995,10191,8996,1195,11.7
"26101",26,101,1996,10061,9048,1013,10.1
"26101",26,101,1997,10271,9467,804,7.8
"26101",26,101,1998,10322,9674,648,6.3
"26101",26,101,1999,11020,10427,593,5.4
"26101",26,101,2000,11877,11228,649,5.5
"26101",26,101,2001,12034,11238,796,6.6
"26101",26,101,2002,11914,11000,914,7.7
"26101",26,101,2003,11846,10798,1048,8.8
"26101",26,101,2004,11805,10779,1026,8.7
"26101",26,101,2005,12157,11188,969,8
"26101",26,101,2006,12299,11230,1069,8.7
"26101",26,101,2007,11982,10963,1019,8.5
"26101",26,101,2008,11714,10695,1019,8.7
"26101",26,101,2009,11606,10102,1504,13
"26101",26,101,2010,11051,9605,1446,13.1
"26101",26,101,2011,10684,9406,1278,12
"26101",26,101,2012,10494,9359,1135,10.8
"26101",26,101,2013,10484,9371,1113,10.6
"26101",26,101,2014,10340,9461,879,8.5
"26101",26,101,2015,10388,9697,691,6.7
"26101",26,101,2016,10526,9836,690,6.6
"26101",26,101,2017,10448,9754,694,6.6
"26103",26,103,1990,31984,29445,2539,7.9
"26103",26,103,1991,32165,29609,2556,7.9
"26103",26,103,1992,33068,30344,2724,8.2
"26103",26,103,1993,33447,30956,2491,7.4
"26103",26,103,1994,33676,31131,2545,7.6
"26103",26,103,1995,32438,29842,2596,8
"26103",26,103,1996,31478,29571,1907,6.1
"26103",26,103,1997,31974,30129,1845,5.8
"26103",26,103,1998,31895,30409,1486,4.7
"26103",26,103,1999,32839,31188,1651,5
"26103",26,103,2000,34294,32766,1528,4.5
"26103",26,103,2001,34444,32497,1947,5.7
"26103",26,103,2002,33653,31306,2347,7
"26103",26,103,2003,34032,31774,2258,6.6
"26103",26,103,2004,34674,32565,2109,6.1
"26103",26,103,2005,35566,33490,2076,5.8
"26103",26,103,2006,35952,33704,2248,6.3
"26103",26,103,2007,35891,33633,2258,6.3
"26103",26,103,2008,35904,33455,2449,6.8
"26103",26,103,2009,36329,32554,3775,10.4
"26103",26,103,2010,34937,31502,3435,9.8
"26103",26,103,2011,33939,30923,3016,8.9
"26103",26,103,2012,33986,31240,2746,8.1
"26103",26,103,2013,33926,31153,2773,8.2
"26103",26,103,2014,33734,31369,2365,7
"26103",26,103,2015,33323,31325,1998,6
"26103",26,103,2016,33294,31395,1899,5.7
"26103",26,103,2017,32799,30931,1868,5.7
"26105",26,105,1990,12145,11146,999,8.2
"26105",26,105,1991,12621,11327,1294,10.3
"26105",26,105,1992,13463,11819,1644,12.2
"26105",26,105,1993,14044,12548,1496,10.7
"26105",26,105,1994,14412,12902,1510,10.5
"26105",26,105,1995,14124,12721,1403,9.9
"26105",26,105,1996,13668,12499,1169,8.6
"26105",26,105,1997,14034,13040,994,7.1
"26105",26,105,1998,13965,13134,831,6
"26105",26,105,1999,14372,13582,790,5.5
"26105",26,105,2000,14786,14052,734,5
"26105",26,105,2001,15433,13966,1467,9.5
"26105",26,105,2002,15363,13628,1735,11.3
"26105",26,105,2003,15273,13559,1714,11.2
"26105",26,105,2004,15190,13773,1417,9.3
"26105",26,105,2005,15205,14013,1192,7.8
"26105",26,105,2006,15089,13854,1235,8.2
"26105",26,105,2007,14924,13756,1168,7.8
"26105",26,105,2008,14814,13582,1232,8.3
"26105",26,105,2009,14812,12843,1969,13.3
"26105",26,105,2010,14567,12733,1834,12.6
"26105",26,105,2011,14263,12694,1569,11
"26105",26,105,2012,14338,12952,1386,9.7
"26105",26,105,2013,14467,13139,1328,9.2
"26105",26,105,2014,14658,13555,1103,7.5
"26105",26,105,2015,14389,13510,879,6.1
"26105",26,105,2016,14266,13435,831,5.8
"26105",26,105,2017,14163,13340,823,5.8
"26107",26,107,1990,16394,15091,1303,7.9
"26107",26,107,1991,16426,14952,1474,9
"26107",26,107,1992,16346,14960,1386,8.5
"26107",26,107,1993,17247,16004,1243,7.2
"26107",26,107,1994,17317,16163,1154,6.7
"26107",26,107,1995,17101,16181,920,5.4
"26107",26,107,1996,17265,16389,876,5.1
"26107",26,107,1997,17594,16807,787,4.5
"26107",26,107,1998,17840,17176,664,3.7
"26107",26,107,1999,18135,17464,671,3.7
"26107",26,107,2000,18987,18159,828,4.4
"26107",26,107,2001,19086,18011,1075,5.6
"26107",26,107,2002,19079,17904,1175,6.2
"26107",26,107,2003,19750,18403,1347,6.8
"26107",26,107,2004,19956,18531,1425,7.1
"26107",26,107,2005,20188,18705,1483,7.3
"26107",26,107,2006,20391,18827,1564,7.7
"26107",26,107,2007,20058,18535,1523,7.6
"26107",26,107,2008,19706,18042,1664,8.4
"26107",26,107,2009,20321,17706,2615,12.9
"26107",26,107,2010,19304,16872,2432,12.6
"26107",26,107,2011,19137,16974,2163,11.3
"26107",26,107,2012,18822,16916,1906,10.1
"26107",26,107,2013,18704,16831,1873,10
"26107",26,107,2014,19146,17627,1519,7.9
"26107",26,107,2015,19108,17932,1176,6.2
"26107",26,107,2016,19090,18017,1073,5.6
"26107",26,107,2017,18905,17808,1097,5.8
"26109",26,109,1990,11982,11173,809,6.8
"26109",26,109,1991,12042,11036,1006,8.4
"26109",26,109,1992,12536,11482,1054,8.4
"26109",26,109,1993,12814,11839,975,7.6
"26109",26,109,1994,13036,12117,919,7
"26109",26,109,1995,13055,12194,861,6.6
"26109",26,109,1996,13015,12268,747,5.7
"26109",26,109,1997,13023,12313,710,5.5
"26109",26,109,1998,12807,12162,645,5
"26109",26,109,1999,13026,12462,564,4.3
"26109",26,109,2000,13319,12752,567,4.3
"26109",26,109,2001,13356,12598,758,5.7
"26109",26,109,2002,13083,12260,823,6.3
"26109",26,109,2003,13269,12445,824,6.2
"26109",26,109,2004,13370,12597,773,5.8
"26109",26,109,2005,13293,12583,710,5.3
"26109",26,109,2006,13142,12276,866,6.6
"26109",26,109,2007,13207,12439,768,5.8
"26109",26,109,2008,13069,12260,809,6.2
"26109",26,109,2009,13156,11594,1562,11.9
"26109",26,109,2010,11958,10566,1392,11.6
"26109",26,109,2011,11815,10736,1079,9.1
"26109",26,109,2012,11755,10809,946,8
"26109",26,109,2013,11748,10834,914,7.8
"26109",26,109,2014,11708,10902,806,6.9
"26109",26,109,2015,11507,10887,620,5.4
"26109",26,109,2016,11243,10661,582,5.2
"26109",26,109,2017,11018,10464,554,5
"26111",26,111,1990,37628,35583,2045,5.4
"26111",26,111,1991,37755,35405,2350,6.2
"26111",26,111,1992,39091,36306,2785,7.1
"26111",26,111,1993,40228,37364,2864,7.1
"26111",26,111,1994,40872,38346,2526,6.2
"26111",26,111,1995,40669,38611,2058,5.1
"26111",26,111,1996,41255,39695,1560,3.8
"26111",26,111,1997,42393,41068,1325,3.1
"26111",26,111,1998,42705,41500,1205,2.8
"26111",26,111,1999,43753,42617,1136,2.6
"26111",26,111,2000,42694,41272,1422,3.3
"26111",26,111,2001,42711,40842,1869,4.4
"26111",26,111,2002,41753,39455,2298,5.5
"26111",26,111,2003,41210,38581,2629,6.4
"26111",26,111,2004,41348,38738,2610,6.3
"26111",26,111,2005,41907,39428,2479,5.9
"26111",26,111,2006,42326,39865,2461,5.8
"26111",26,111,2007,43003,40609,2394,5.6
"26111",26,111,2008,43191,40565,2626,6.1
"26111",26,111,2009,42860,38692,4168,9.7
"26111",26,111,2010,41219,37196,4023,9.8
"26111",26,111,2011,40869,37450,3419,8.4
"26111",26,111,2012,40668,37507,3161,7.8
"26111",26,111,2013,40777,37630,3147,7.7
"26111",26,111,2014,41546,39015,2531,6.1
"26111",26,111,2015,41360,39345,2015,4.9
"26111",26,111,2016,40997,39062,1935,4.7
"26111",26,111,2017,40489,38565,1924,4.8
"26113",26,113,1990,5362,4803,559,10.4
"26113",26,113,1991,5379,4787,592,11
"26113",26,113,1992,5547,5008,539,9.7
"26113",26,113,1993,5855,5346,509,8.7
"26113",26,113,1994,6243,5746,497,8
"26113",26,113,1995,6173,5647,526,8.5
"26113",26,113,1996,6170,5760,410,6.6
"26113",26,113,1997,6251,5861,390,6.2
"26113",26,113,1998,6442,6074,368,5.7
"26113",26,113,1999,7017,6654,363,5.2
"26113",26,113,2000,7025,6704,321,4.6
"26113",26,113,2001,6748,6272,476,7.1
"26113",26,113,2002,6716,6220,496,7.4
"26113",26,113,2003,6617,6088,529,8
"26113",26,113,2004,6733,6201,532,7.9
"26113",26,113,2005,6720,6217,503,7.5
"26113",26,113,2006,6715,6180,535,8
"26113",26,113,2007,6526,5968,558,8.6
"26113",26,113,2008,6409,5753,656,10.2
"26113",26,113,2009,6322,5338,984,15.6
"26113",26,113,2010,7146,6241,905,12.7
"26113",26,113,2011,7037,6272,765,10.9
"26113",26,113,2012,6910,6242,668,9.7
"26113",26,113,2013,6937,6296,641,9.2
"26113",26,113,2014,7050,6503,547,7.8
"26113",26,113,2015,6975,6518,457,6.6
"26113",26,113,2016,7020,6602,418,6
"26113",26,113,2017,7033,6613,420,6
"26115",26,115,1990,67443,62360,5083,7.5
"26115",26,115,1991,66759,59995,6764,10.1
"26115",26,115,1992,66399,60139,6260,9.4
"26115",26,115,1993,67201,61856,5345,8
"26115",26,115,1994,67400,63451,3949,5.9
"26115",26,115,1995,68251,64724,3527,5.2
"26115",26,115,1996,68928,66252,2676,3.9
"26115",26,115,1997,71172,68613,2559,3.6
"26115",26,115,1998,72565,70493,2072,2.9
"26115",26,115,1999,75607,73492,2115,2.8
"26115",26,115,2000,77465,74954,2511,3.2
"26115",26,115,2001,77290,73737,3553,4.6
"26115",26,115,2002,76747,72714,4033,5.3
"26115",26,115,2003,76923,72219,4704,6.1
"26115",26,115,2004,77222,72474,4748,6.1
"26115",26,115,2005,77855,73029,4826,6.2
"26115",26,115,2006,78710,73405,5305,6.7
"26115",26,115,2007,77356,72129,5227,6.8
"26115",26,115,2008,75916,69463,6453,8.5
"26115",26,115,2009,74736,63861,10875,14.6
"26115",26,115,2010,75640,66771,8869,11.7
"26115",26,115,2011,73660,66681,6979,9.5
"26115",26,115,2012,73606,67904,5702,7.7
"26115",26,115,2013,74365,68874,5491,7.4
"26115",26,115,2014,75927,71292,4635,6.1
"26115",26,115,2015,76092,72628,3464,4.6
"26115",26,115,2016,76357,73056,3301,4.3
"26115",26,115,2017,76449,72736,3713,4.9
"26117",26,117,1990,23667,20292,3375,14.3
"26117",26,117,1991,22700,19592,3108,13.7
"26117",26,117,1992,23394,20468,2926,12.5
"26117",26,117,1993,24408,21969,2439,10
"26117",26,117,1994,24952,22588,2364,9.5
"26117",26,117,1995,24680,22820,1860,7.5
"26117",26,117,1996,24419,22420,1999,8.2
"26117",26,117,1997,24633,22916,1717,7
"26117",26,117,1998,25588,24195,1393,5.4
"26117",26,117,1999,25560,24213,1347,5.3
"26117",26,117,2000,29514,28263,1251,4.2
"26117",26,117,2001,30245,28333,1912,6.3
"26117",26,117,2002,29244,27030,2214,7.6
"26117",26,117,2003,29232,26889,2343,8
"26117",26,117,2004,29649,27319,2330,7.9
"26117",26,117,2005,29471,26895,2576,8.7
"26117",26,117,2006,28428,24656,3772,13.3
"26117",26,117,2007,26870,23726,3144,11.7
"26117",26,117,2008,26322,23353,2969,11.3
"26117",26,117,2009,26724,22280,4444,16.6
"26117",26,117,2010,27809,23888,3921,14.1
"26117",26,117,2011,27300,24140,3160,11.6
"26117",26,117,2012,27253,24473,2780,10.2
"26117",26,117,2013,27452,24819,2633,9.6
"26117",26,117,2014,27608,25518,2090,7.6
"26117",26,117,2015,27634,26053,1581,5.7
"26117",26,117,2016,27893,26421,1472,5.3
"26117",26,117,2017,28183,26753,1430,5.1
"26119",26,119,1990,3228,2744,484,15
"26119",26,119,1991,3175,2616,559,17.6
"26119",26,119,1992,3541,2868,673,19
"26119",26,119,1993,3543,2976,567,16
"26119",26,119,1994,3563,2951,612,17.2
"26119",26,119,1995,3456,2914,542,15.7
"26119",26,119,1996,3332,2919,413,12.4
"26119",26,119,1997,3468,3075,393,11.3
"26119",26,119,1998,3533,3150,383,10.8
"26119",26,119,1999,3579,3208,371,10.4
"26119",26,119,2000,4106,3766,340,8.3
"26119",26,119,2001,4162,3727,435,10.5
"26119",26,119,2002,4241,3781,460,10.8
"26119",26,119,2003,4276,3768,508,11.9
"26119",26,119,2004,4344,3817,527,12.1
"26119",26,119,2005,4301,3780,521,12.1
"26119",26,119,2006,4353,3817,536,12.3
"26119",26,119,2007,4176,3623,553,13.2
"26119",26,119,2008,4010,3461,549,13.7
"26119",26,119,2009,4008,3178,830,20.7
"26119",26,119,2010,3552,2836,716,20.2
"26119",26,119,2011,3346,2742,604,18.1
"26119",26,119,2012,3234,2709,525,16.2
"26119",26,119,2013,3198,2685,513,16
"26119",26,119,2014,3151,2743,408,12.9
"26119",26,119,2015,3060,2755,305,10
"26119",26,119,2016,3058,2747,311,10.2
"26119",26,119,2017,3037,2709,328,10.8
"26121",26,121,1990,73125,67024,6101,8.3
"26121",26,121,1991,73195,65462,7733,10.6
"26121",26,121,1992,74671,66506,8165,10.9
"26121",26,121,1993,76573,69890,6683,8.7
"26121",26,121,1994,78280,72462,5818,7.4
"26121",26,121,1995,78119,73089,5030,6.4
"26121",26,121,1996,78859,74257,4602,5.8
"26121",26,121,1997,81109,77258,3851,4.7
"26121",26,121,1998,82220,78910,3310,4
"26121",26,121,1999,84961,81413,3548,4.2
"26121",26,121,2000,85904,82305,3599,4.2
"26121",26,121,2001,85594,80267,5327,6.2
"26121",26,121,2002,85594,78772,6822,8
"26121",26,121,2003,87933,80001,7932,9
"26121",26,121,2004,89570,82728,6842,7.6
"26121",26,121,2005,90054,83745,6309,7
"26121",26,121,2006,90509,84055,6454,7.1
"26121",26,121,2007,89458,82943,6515,7.3
"26121",26,121,2008,88699,81253,7446,8.4
"26121",26,121,2009,88315,75137,13178,14.9
"26121",26,121,2010,77712,66420,11292,14.5
"26121",26,121,2011,75669,67008,8661,11.4
"26121",26,121,2012,75633,68034,7599,10
"26121",26,121,2013,76165,68623,7542,9.9
"26121",26,121,2014,77067,71144,5923,7.7
"26121",26,121,2015,77170,72677,4493,5.8
"26121",26,121,2016,77385,73162,4223,5.5
"26121",26,121,2017,78193,73961,4232,5.4
"26123",26,123,1990,17215,15571,1644,9.5
"26123",26,123,1991,17814,15737,2077,11.7
"26123",26,123,1992,18540,16312,2228,12
"26123",26,123,1993,19720,17715,2005,10.2
"26123",26,123,1994,20293,18151,2142,10.6
"26123",26,123,1995,19919,17931,1988,10
"26123",26,123,1996,20063,18173,1890,9.4
"26123",26,123,1997,20250,18680,1570,7.8
"26123",26,123,1998,20577,19229,1348,6.6
"26123",26,123,1999,20852,19543,1309,6.3
"26123",26,123,2000,23132,22046,1086,4.7
"26123",26,123,2001,23334,21843,1491,6.4
"26123",26,123,2002,22830,20992,1838,8.1
"26123",26,123,2003,22719,20715,2004,8.8
"26123",26,123,2004,23038,21238,1800,7.8
"26123",26,123,2005,23425,21667,1758,7.5
"26123",26,123,2006,23429,21688,1741,7.4
"26123",26,123,2007,22955,21126,1829,8
"26123",26,123,2008,22609,20609,2000,8.8
"26123",26,123,2009,22210,19120,3090,13.9
"26123",26,123,2010,22988,20078,2910,12.7
"26123",26,123,2011,22463,20074,2389,10.6
"26123",26,123,2012,22013,19993,2020,9.2
"26123",26,123,2013,22019,20067,1952,8.9
"26123",26,123,2014,22589,20959,1630,7.2
"26123",26,123,2015,23041,21779,1262,5.5
"26123",26,123,2016,23308,22172,1136,4.9
"26123",26,123,2017,23456,22282,1174,5
"26125",26,125,1990,604705,568400,36305,6
"26125",26,125,1991,604232,559027,45205,7.5
"26125",26,125,1992,619725,573564,46161,7.4
"26125",26,125,1993,627307,590400,36907,5.9
"26125",26,125,1994,632398,605463,26935,4.3
"26125",26,125,1995,634257,611547,22710,3.6
"26125",26,125,1996,647958,624984,22974,3.5
"26125",26,125,1997,657264,637112,20152,3.1
"26125",26,125,1998,669232,649774,19458,2.9
"26125",26,125,1999,679850,660710,19140,2.8
"26125",26,125,2000,678896,661139,17757,2.6
"26125",26,125,2001,661465,634356,27109,4.1
"26125",26,125,2002,646548,613059,33489,5.2
"26125",26,125,2003,644959,608748,36211,5.6
"26125",26,125,2004,642874,606421,36453,5.7
"26125",26,125,2005,642576,607355,35221,5.5
"26125",26,125,2006,634540,598658,35882,5.7
"26125",26,125,2007,625693,589416,36277,5.8
"26125",26,125,2008,609423,569123,40300,6.6
"26125",26,125,2009,606548,527731,78817,13
"26125",26,125,2010,621876,548699,73177,11.8
"26125",26,125,2011,610881,552660,58221,9.5
"26125",26,125,2012,616205,565454,50751,8.2
"26125",26,125,2013,628635,579614,49021,7.8
"26125",26,125,2014,630196,589208,40988,6.5
"26125",26,125,2015,632577,602606,29971,4.7
"26125",26,125,2016,651937,624840,27097,4.2
"26125",26,125,2017,662752,639968,22784,3.4
"26127",26,127,1990,11248,10030,1218,10.8
"26127",26,127,1991,11132,9786,1346,12.1
"26127",26,127,1992,11530,9903,1627,14.1
"26127",26,127,1993,12046,10497,1549,12.9
"26127",26,127,1994,13271,11539,1732,13.1
"26127",26,127,1995,12962,11479,1483,11.4
"26127",26,127,1996,13319,11950,1369,10.3
"26127",26,127,1997,13875,12820,1055,7.6
"26127",26,127,1998,13916,12965,951,6.8
"26127",26,127,1999,14357,13413,944,6.6
"26127",26,127,2000,13272,12474,798,6
"26127",26,127,2001,13457,12467,990,7.4
"26127",26,127,2002,13422,12255,1167,8.7
"26127",26,127,2003,13485,12207,1278,9.5
"26127",26,127,2004,13910,12741,1169,8.4
"26127",26,127,2005,14393,13221,1172,8.1
"26127",26,127,2006,14760,13470,1290,8.7
"26127",26,127,2007,14400,13185,1215,8.4
"26127",26,127,2008,14064,12626,1438,10.2
"26127",26,127,2009,14212,11923,2289,16.1
"26127",26,127,2010,13380,11217,2163,16.2
"26127",26,127,2011,12988,11165,1823,14
"26127",26,127,2012,12824,11202,1622,12.6
"26127",26,127,2013,12719,11145,1574,12.4
"26127",26,127,2014,12815,11529,1286,10
"26127",26,127,2015,12465,11469,996,8
"26127",26,127,2016,12314,11411,903,7.3
"26127",26,127,2017,12397,11510,887,7.2
"26129",26,129,1990,7188,6487,701,9.8
"26129",26,129,1991,7180,6385,795,11.1
"26129",26,129,1992,7497,6571,926,12.4
"26129",26,129,1993,7880,7037,843,10.7
"26129",26,129,1994,8331,7391,940,11.3
"26129",26,129,1995,8306,7449,857,10.3
"26129",26,129,1996,8396,7611,785,9.3
"26129",26,129,1997,8587,7916,671,7.8
"26129",26,129,1998,8550,7979,571,6.7
"26129",26,129,1999,8904,8349,555,6.2
"26129",26,129,2000,9640,9105,535,5.5
"26129",26,129,2001,9690,8953,737,7.6
"26129",26,129,2002,9665,8852,813,8.4
"26129",26,129,2003,9639,8746,893,9.3
"26129",26,129,2004,9830,8987,843,8.6
"26129",26,129,2005,9884,9126,758,7.7
"26129",26,129,2006,9842,9012,830,8.4
"26129",26,129,2007,9651,8832,819,8.5
"26129",26,129,2008,9536,8665,871,9.1
"26129",26,129,2009,9627,8325,1302,13.5
"26129",26,129,2010,9082,7767,1315,14.5
"26129",26,129,2011,8786,7663,1123,12.8
"26129",26,129,2012,8623,7639,984,11.4
"26129",26,129,2013,8599,7586,1013,11.8
"26129",26,129,2014,8580,7739,841,9.8
"26129",26,129,2015,8392,7732,660,7.9
"26129",26,129,2016,8231,7589,642,7.8
"26129",26,129,2017,8238,7592,646,7.8
"26131",26,131,1990,3864,3654,210,5.4
"26131",26,131,1991,3918,3661,257,6.6
"26131",26,131,1992,4020,3612,408,10.1
"26131",26,131,1993,3941,3596,345,8.8
"26131",26,131,1994,3896,3602,294,7.5
"26131",26,131,1995,3863,3480,383,9.9
"26131",26,131,1996,3557,2981,576,16.2
"26131",26,131,1997,3253,2851,402,12.4
"26131",26,131,1998,3070,2827,243,7.9
"26131",26,131,1999,3039,2795,244,8
"26131",26,131,2000,3665,3426,239,6.5
"26131",26,131,2001,3555,3280,275,7.7
"26131",26,131,2002,3499,3234,265,7.6
"26131",26,131,2003,3503,3225,278,7.9
"26131",26,131,2004,3572,3300,272,7.6
"26131",26,131,2005,3578,3313,265,7.4
"26131",26,131,2006,3531,3243,288,8.2
"26131",26,131,2007,3417,3129,288,8.4
"26131",26,131,2008,3274,2977,297,9.1
"26131",26,131,2009,3211,2705,506,15.8
"26131",26,131,2010,3075,2560,515,16.7
"26131",26,131,2011,2777,2326,451,16.2
"26131",26,131,2012,2578,2233,345,13.4
"26131",26,131,2013,2445,2107,338,13.8
"26131",26,131,2014,2377,2106,271,11.4
"26131",26,131,2015,2290,2075,215,9.4
"26131",26,131,2016,2201,2013,188,8.5
"26131",26,131,2017,2166,1969,197,9.1
"26133",26,133,1990,8757,7777,980,11.2
"26133",26,133,1991,8925,7842,1083,12.1
"26133",26,133,1992,9484,8513,971,10.2
"26133",26,133,1993,10324,9343,981,9.5
"26133",26,133,1994,10626,9709,917,8.6
"26133",26,133,1995,10571,9668,903,8.5
"26133",26,133,1996,10668,9970,698,6.5
"26133",26,133,1997,10969,10274,695,6.3
"26133",26,133,1998,10833,10225,608,5.6
"26133",26,133,1999,10831,10282,549,5.1
"26133",26,133,2000,11214,10694,520,4.6
"26133",26,133,2001,11141,10368,773,6.9
"26133",26,133,2002,10945,10174,771,7
"26133",26,133,2003,10814,9938,876,8.1
"26133",26,133,2004,10474,9575,899,8.6
"26133",26,133,2005,10242,9459,783,7.6
"26133",26,133,2006,10243,9468,775,7.6
"26133",26,133,2007,9895,9098,797,8.1
"26133",26,133,2008,9441,8564,877,9.3
"26133",26,133,2009,9546,8090,1456,15.3
"26133",26,133,2010,10383,8970,1413,13.6
"26133",26,133,2011,10170,9012,1158,11.4
"26133",26,133,2012,9968,8975,993,10
"26133",26,133,2013,10015,9017,998,10
"26133",26,133,2014,10196,9326,870,8.5
"26133",26,133,2015,10142,9482,660,6.5
"26133",26,133,2016,10424,9829,595,5.7
"26133",26,133,2017,10624,9978,646,6.1
"26135",26,135,1990,2914,2679,235,8.1
"26135",26,135,1991,2988,2692,296,9.9
"26135",26,135,1992,3168,2855,313,9.9
"26135",26,135,1993,3415,3084,331,9.7
"26135",26,135,1994,3597,3222,375,10.4
"26135",26,135,1995,3629,3273,356,9.8
"26135",26,135,1996,3419,3088,331,9.7
"26135",26,135,1997,3414,3131,283,8.3
"26135",26,135,1998,3422,3172,250,7.3
"26135",26,135,1999,3675,3414,261,7.1
"26135",26,135,2000,3912,3667,245,6.3
"26135",26,135,2001,3875,3525,350,9
"26135",26,135,2002,3766,3350,416,11
"26135",26,135,2003,3785,3350,435,11.5
"26135",26,135,2004,3869,3442,427,11
"26135",26,135,2005,3957,3537,420,10.6
"26135",26,135,2006,4085,3643,442,10.8
"26135",26,135,2007,4013,3589,424,10.6
"26135",26,135,2008,3878,3391,487,12.6
"26135",26,135,2009,3757,2958,799,21.3
"26135",26,135,2010,3316,2667,649,19.6
"26135",26,135,2011,3149,2589,560,17.8
"26135",26,135,2012,2985,2518,467,15.6
"26135",26,135,2013,2959,2498,461,15.6
"26135",26,135,2014,2973,2622,351,11.8
"26135",26,135,2015,2905,2653,252,8.7
"26135",26,135,2016,2905,2692,213,7.3
"26135",26,135,2017,2941,2721,220,7.5
"26137",26,137,1990,9329,8757,572,6.1
"26137",26,137,1991,9680,8821,859,8.9
"26137",26,137,1992,10283,9327,956,9.3
"26137",26,137,1993,11040,10198,842,7.6
"26137",26,137,1994,11818,11005,813,6.9
"26137",26,137,1995,12101,11343,758,6.3
"26137",26,137,1996,12268,11648,620,5.1
"26137",26,137,1997,12878,12315,563,4.4
"26137",26,137,1998,13122,12587,535,4.1
"26137",26,137,1999,13482,12917,565,4.2
"26137",26,137,2000,12394,11868,526,4.2
"26137",26,137,2001,12341,11590,751,6.1
"26137",26,137,2002,12229,11317,912,7.5
"26137",26,137,2003,12263,11250,1013,8.3
"26137",26,137,2004,12679,11720,959,7.6
"26137",26,137,2005,12957,12041,916,7.1
"26137",26,137,2006,12625,11549,1076,8.5
"26137",26,137,2007,12333,11188,1145,9.3
"26137",26,137,2008,12024,10833,1191,9.9
"26137",26,137,2009,11993,10235,1758,14.7
"26137",26,137,2010,11870,10180,1690,14.2
"26137",26,137,2011,11452,10058,1394,12.2
"26137",26,137,2012,11187,9989,1198,10.7
"26137",26,137,2013,11213,10045,1168,10.4
"26137",26,137,2014,11190,10282,908,8.1
"26137",26,137,2015,11387,10689,698,6.1
"26137",26,137,2016,11679,10983,696,6
"26137",26,137,2017,11668,10954,714,6.1
"26139",26,139,1990,104454,98998,5456,5.2
"26139",26,139,1991,104462,98042,6420,6.1
"26139",26,139,1992,107368,100823,6545,6.1
"26139",26,139,1993,112800,107437,5363,4.8
"26139",26,139,1994,117834,113325,4509,3.8
"26139",26,139,1995,120644,116805,3839,3.2
"26139",26,139,1996,124703,120920,3783,3
"26139",26,139,1997,130992,127504,3488,2.7
"26139",26,139,1998,135832,132694,3138,2.3
"26139",26,139,1999,142221,138860,3361,2.4
"26139",26,139,2000,136514,132803,3711,2.7
"26139",26,139,2001,134622,128891,5731,4.3
"26139",26,139,2002,130590,123438,7152,5.5
"26139",26,139,2003,131705,123836,7869,6
"26139",26,139,2004,134092,126705,7387,5.5
"26139",26,139,2005,136228,129095,7133,5.2
"26139",26,139,2006,137253,129698,7555,5.5
"26139",26,139,2007,135826,128067,7759,5.7
"26139",26,139,2008,134168,125097,9071,6.8
"26139",26,139,2009,131050,114716,16334,12.5
"26139",26,139,2010,140585,126112,14473,10.3
"26139",26,139,2011,139598,128452,11146,8
"26139",26,139,2012,141570,132241,9329,6.6
"26139",26,139,2013,144633,135820,8813,6.1
"26139",26,139,2014,149009,141869,7140,4.8
"26139",26,139,2015,152151,146621,5530,3.6
"26139",26,139,2016,155279,150038,5241,3.4
"26139",26,139,2017,157285,152022,5263,3.3
"26141",26,141,1990,6034,5334,700,11.6
"26141",26,141,1991,6174,5266,908,14.7
"26141",26,141,1992,6267,5243,1024,16.3
"26141",26,141,1993,6404,5349,1055,16.5
"26141",26,141,1994,6474,5313,1161,17.9
"26141",26,141,1995,6264,5251,1013,16.2
"26141",26,141,1996,6172,5357,815,13.2
"26141",26,141,1997,6265,5547,718,11.5
"26141",26,141,1998,6156,5522,634,10.3
"26141",26,141,1999,6284,5678,606,9.6
"26141",26,141,2000,6532,5977,555,8.5
"26141",26,141,2001,6618,5976,642,9.7
"26141",26,141,2002,6465,5783,682,10.5
"26141",26,141,2003,6524,5786,738,11.3
"26141",26,141,2004,6370,5647,723,11.4
"26141",26,141,2005,6222,5520,702,11.3
"26141",26,141,2006,6233,5459,774,12.4
"26141",26,141,2007,6106,5331,775,12.7
"26141",26,141,2008,6013,5205,808,13.4
"26141",26,141,2009,6043,4911,1132,18.7
"26141",26,141,2010,5755,4751,1004,17.4
"26141",26,141,2011,5569,4673,896,16.1
"26141",26,141,2012,5536,4734,802,14.5
"26141",26,141,2013,5459,4656,803,14.7
"26141",26,141,2014,5438,4743,695,12.8
"26141",26,141,2015,5348,4803,545,10.2
"26141",26,141,2016,5283,4778,505,9.6
"26141",26,141,2017,5190,4697,493,9.5
"26143",26,143,1990,7123,6483,640,9
"26143",26,143,1991,6961,6239,722,10.4
"26143",26,143,1992,7436,6578,858,11.5
"26143",26,143,1993,7837,7031,806,10.3
"26143",26,143,1994,8018,7129,889,11.1
"26143",26,143,1995,8169,7319,850,10.4
"26143",26,143,1996,7973,7236,737,9.2
"26143",26,143,1997,8143,7484,659,8.1
"26143",26,143,1998,8009,7450,559,7
"26143",26,143,1999,8223,7666,557,6.8
"26143",26,143,2000,10422,9836,586,5.6
"26143",26,143,2001,10444,9735,709,6.8
"26143",26,143,2002,10452,9630,822,7.9
"26143",26,143,2003,10651,9726,925,8.7
"26143",26,143,2004,11262,10306,956,8.5
"26143",26,143,2005,11205,10253,952,8.5
"26143",26,143,2006,10950,9907,1043,9.5
"26143",26,143,2007,10473,9444,1029,9.8
"26143",26,143,2008,10206,9096,1110,10.9
"26143",26,143,2009,10053,8536,1517,15.1
"26143",26,143,2010,8652,7212,1440,16.6
"26143",26,143,2011,8383,7143,1240,14.8
"26143",26,143,2012,8101,7012,1089,13.4
"26143",26,143,2013,8077,6957,1120,13.9
"26143",26,143,2014,7942,7032,910,11.5
"26143",26,143,2015,7794,7090,704,9
"26143",26,143,2016,7864,7197,667,8.5
"26143",26,143,2017,7957,7248,709,8.9
"26145",26,145,1990,97106,89686,7420,7.6
"26145",26,145,1991,96555,88551,8004,8.3
"26145",26,145,1992,97781,89546,8235,8.4
"26145",26,145,1993,98601,91307,7294,7.4
"26145",26,145,1994,99331,92772,6559,6.6
"26145",26,145,1995,98675,92743,5932,6
"26145",26,145,1996,99072,94246,4826,4.9
"26145",26,145,1997,100568,96164,4404,4.4
"26145",26,145,1998,100799,96527,4272,4.2
"26145",26,145,1999,102292,98233,4059,4
"26145",26,145,2000,100589,96385,4204,4.2
"26145",26,145,2001,99608,93696,5912,5.9
"26145",26,145,2002,97718,90666,7052,7.2
"26145",26,145,2003,99280,90388,8892,9
"26145",26,145,2004,99041,90548,8493,8.6
"26145",26,145,2005,98365,90520,7845,8
"26145",26,145,2006,98712,91076,7636,7.7
"26145",26,145,2007,96947,89941,7006,7.2
"26145",26,145,2008,94273,86456,7817,8.3
"26145",26,145,2009,94536,82693,11843,12.5
"26145",26,145,2010,90722,79625,11097,12.2
"26145",26,145,2011,89803,80647,9156,10.2
"26145",26,145,2012,88770,80580,8190,9.2
"26145",26,145,2013,88844,80811,8033,9
"26145",26,145,2014,88977,82324,6653,7.5
"26145",26,145,2015,88253,83223,5030,5.7
"26145",26,145,2016,88524,83808,4716,5.3
"26145",26,145,2017,87662,82820,4842,5.5
"26147",26,147,1990,72462,65611,6851,9.5
"26147",26,147,1991,73248,64718,8530,11.6
"26147",26,147,1992,74340,66091,8249,11.1
"26147",26,147,1993,74089,67933,6156,8.3
"26147",26,147,1994,74895,69588,5307,7.1
"26147",26,147,1995,75037,70326,4711,6.3
"26147",26,147,1996,76384,71959,4425,5.8
"26147",26,147,1997,77921,73547,4374,5.6
"26147",26,147,1998,79706,75594,4112,5.2
"26147",26,147,1999,81576,77645,3931,4.8
"26147",26,147,2000,87339,83977,3362,3.8
"26147",26,147,2001,86032,80850,5182,6
"26147",26,147,2002,84944,78702,6242,7.3
"26147",26,147,2003,86110,78823,7287,8.5
"26147",26,147,2004,85628,78920,6708,7.8
"26147",26,147,2005,85725,79111,6614,7.7
"26147",26,147,2006,84801,78121,6680,7.9
"26147",26,147,2007,83783,76711,7072,8.4
"26147",26,147,2008,81735,73777,7958,9.7
"26147",26,147,2009,82253,67684,14569,17.7
"26147",26,147,2010,77675,64934,12741,16.4
"26147",26,147,2011,74208,64509,9699,13.1
"26147",26,147,2012,73736,65066,8670,11.8
"26147",26,147,2013,74581,65988,8593,11.5
"26147",26,147,2014,73701,66621,7080,9.6
"26147",26,147,2015,72795,67818,4977,6.8
"26147",26,147,2016,74568,70017,4551,6.1
"26147",26,147,2017,75420,71672,3748,5
"26149",26,149,1990,29598,27065,2533,8.6
"26149",26,149,1991,28703,25712,2991,10.4
"26149",26,149,1992,29662,26965,2697,9.1
"26149",26,149,1993,30893,28999,1894,6.1
"26149",26,149,1994,32392,30920,1472,4.5
"26149",26,149,1995,32716,31321,1395,4.3
"26149",26,149,1996,32534,31064,1470,4.5
"26149",26,149,1997,32903,31752,1151,3.5
"26149",26,149,1998,32284,31281,1003,3.1
"26149",26,149,1999,33179,32229,950,2.9
"26149",26,149,2000,32684,31557,1127,3.4
"26149",26,149,2001,32093,30085,2008,6.3
"26149",26,149,2002,30516,28518,1998,6.5
"26149",26,149,2003,30474,28255,2219,7.3
"26149",26,149,2004,30963,28932,2031,6.6
"26149",26,149,2005,30942,28946,1996,6.5
"26149",26,149,2006,31549,29424,2125,6.7
"26149",26,149,2007,31678,29652,2026,6.4
"26149",26,149,2008,30595,27988,2607,8.5
"26149",26,149,2009,28889,24635,4254,14.7
"26149",26,149,2010,28110,24585,3525,12.5
"26149",26,149,2011,27609,24606,3003,10.9
"26149",26,149,2012,27438,24989,2449,8.9
"26149",26,149,2013,28150,25963,2187,7.8
"26149",26,149,2014,28818,27142,1676,5.8
"26149",26,149,2015,28997,27687,1310,4.5
"26149",26,149,2016,29104,27900,1204,4.1
"26149",26,149,2017,28855,27615,1240,4.3
"26151",26,151,1990,18949,16918,2031,10.7
"26151",26,151,1991,18283,15860,2423,13.3
"26151",26,151,1992,18775,16389,2386,12.7
"26151",26,151,1993,20008,17992,2016,10.1
"26151",26,151,1994,20521,18563,1958,9.5
"26151",26,151,1995,20632,18965,1667,8.1
"26151",26,151,1996,20458,19075,1383,6.8
"26151",26,151,1997,20802,19595,1207,5.8
"26151",26,151,1998,20977,19930,1047,5
"26151",26,151,1999,21051,19845,1206,5.7
"26151",26,151,2000,22018,20979,1039,4.7
"26151",26,151,2001,22004,20479,1525,6.9
"26151",26,151,2002,21614,19843,1771,8.2
"26151",26,151,2003,21530,19452,2078,9.7
"26151",26,151,2004,21895,19894,2001,9.1
"26151",26,151,2005,22187,20371,1816,8.2
"26151",26,151,2006,22618,20623,1995,8.8
"26151",26,151,2007,21820,19836,1984,9.1
"26151",26,151,2008,21151,18856,2295,10.9
"26151",26,151,2009,21027,17345,3682,17.5
"26151",26,151,2010,20006,16923,3083,15.4
"26151",26,151,2011,19505,17119,2386,12.2
"26151",26,151,2012,19300,17274,2026,10.5
"26151",26,151,2013,19369,17336,2033,10.5
"26151",26,151,2014,19602,17933,1669,8.5
"26151",26,151,2015,19471,18203,1268,6.5
"26151",26,151,2016,19400,18191,1209,6.2
"26151",26,151,2017,19457,18287,1170,6
"26153",26,153,1990,3796,3187,609,16
"26153",26,153,1991,3748,3231,517,13.8
"26153",26,153,1992,3911,3327,584,14.9
"26153",26,153,1993,3964,3430,534,13.5
"26153",26,153,1994,4110,3528,582,14.2
"26153",26,153,1995,4099,3534,565,13.8
"26153",26,153,1996,4092,3630,462,11.3
"26153",26,153,1997,4251,3816,435,10.2
"26153",26,153,1998,4259,3880,379,8.9
"26153",26,153,1999,4343,3977,366,8.4
"26153",26,153,2000,3943,3616,327,8.3
"26153",26,153,2001,3906,3544,362,9.3
"26153",26,153,2002,3837,3448,389,10.1
"26153",26,153,2003,3901,3472,429,11
"26153",26,153,2004,4028,3588,440,10.9
"26153",26,153,2005,4070,3633,437,10.7
"26153",26,153,2006,4076,3633,443,10.9
"26153",26,153,2007,3957,3524,433,10.9
"26153",26,153,2008,3893,3461,432,11.1
"26153",26,153,2009,3929,3357,572,14.6
"26153",26,153,2010,3798,3280,518,13.6
"26153",26,153,2011,3678,3189,489,13.3
"26153",26,153,2012,3534,3090,444,12.6
"26153",26,153,2013,3558,3102,456,12.8
"26153",26,153,2014,3527,3140,387,11
"26153",26,153,2015,3452,3078,374,10.8
"26153",26,153,2016,3386,3077,309,9.1
"26153",26,153,2017,3370,3082,288,8.5
"26155",26,155,1990,35023,31648,3375,9.6
"26155",26,155,1991,34237,29994,4243,12.4
"26155",26,155,1992,34941,30898,4043,11.6
"26155",26,155,1993,35462,32048,3414,9.6
"26155",26,155,1994,35503,32698,2805,7.9
"26155",26,155,1995,34757,32220,2537,7.3
"26155",26,155,1996,34971,32746,2225,6.4
"26155",26,155,1997,35496,33700,1796,5.1
"26155",26,155,1998,36400,34685,1715,4.7
"26155",26,155,1999,36856,35390,1466,4
"26155",26,155,2000,37531,36044,1487,4
"26155",26,155,2001,36588,34518,2070,5.7
"26155",26,155,2002,35554,33207,2347,6.6
"26155",26,155,2003,35710,33042,2668,7.5
"26155",26,155,2004,36774,33900,2874,7.8
"26155",26,155,2005,36739,33817,2922,8
"26155",26,155,2006,36785,33700,3085,8.4
"26155",26,155,2007,36158,33169,2989,8.3
"26155",26,155,2008,35335,31927,3408,9.6
"26155",26,155,2009,35395,30129,5266,14.9
"26155",26,155,2010,34707,30234,4473,12.9
"26155",26,155,2011,33632,30023,3609,10.7
"26155",26,155,2012,33156,29986,3170,9.6
"26155",26,155,2013,33046,29948,3098,9.4
"26155",26,155,2014,33199,30698,2501,7.5
"26155",26,155,2015,33021,31155,1866,5.7
"26155",26,155,2016,33461,31700,1761,5.3
"26155",26,155,2017,33525,31762,1763,5.3
"26157",26,157,1990,26002,23508,2494,9.6
"26157",26,157,1991,25622,22592,3030,11.8
"26157",26,157,1992,26364,23471,2893,11
"26157",26,157,1993,26734,24242,2492,9.3
"26157",26,157,1994,27613,25300,2313,8.4
"26157",26,157,1995,27149,25050,2099,7.7
"26157",26,157,1996,26927,25234,1693,6.3
"26157",26,157,1997,27600,26209,1391,5
"26157",26,157,1998,27947,26596,1351,4.8
"26157",26,157,1999,28057,26674,1383,4.9
"26157",26,157,2000,28835,27487,1348,4.7
"26157",26,157,2001,29085,27117,1968,6.8
"26157",26,157,2002,28867,26543,2324,8.1
"26157",26,157,2003,29151,26517,2634,9
"26157",26,157,2004,29425,26833,2592,8.8
"26157",26,157,2005,29259,26868,2391,8.2
"26157",26,157,2006,29306,26738,2568,8.8
"26157",26,157,2007,28600,26167,2433,8.5
"26157",26,157,2008,27872,25098,2774,10
"26157",26,157,2009,28025,23575,4450,15.9
"26157",26,157,2010,26057,22214,3843,14.7
"26157",26,157,2011,25165,22145,3020,12
"26157",26,157,2012,24683,22078,2605,10.6
"26157",26,157,2013,25033,22398,2635,10.5
"26157",26,157,2014,25094,22942,2152,8.6
"26157",26,157,2015,24482,22841,1641,6.7
"26157",26,157,2016,24202,22684,1518,6.3
"26157",26,157,2017,24039,22504,1535,6.4
"26159",26,159,1990,33643,30754,2889,8.6
"26159",26,159,1991,33719,30381,3338,9.9
"26159",26,159,1992,34259,30992,3267,9.5
"26159",26,159,1993,35147,32316,2831,8.1
"26159",26,159,1994,35871,33279,2592,7.2
"26159",26,159,1995,35729,33372,2357,6.6
"26159",26,159,1996,35998,33725,2273,6.3
"26159",26,159,1997,36461,34517,1944,5.3
"26159",26,159,1998,36715,35210,1505,4.1
"26159",26,159,1999,37539,36097,1442,3.8
"26159",26,159,2000,39775,38140,1635,4.1
"26159",26,159,2001,39595,37401,2194,5.5
"26159",26,159,2002,39170,36707,2463,6.3
"26159",26,159,2003,39364,36571,2793,7.1
"26159",26,159,2004,40294,37417,2877,7.1
"26159",26,159,2005,40873,37996,2877,7
"26159",26,159,2006,41245,38381,2864,6.9
"26159",26,159,2007,40190,37367,2823,7
"26159",26,159,2008,39934,36744,3190,8
"26159",26,159,2009,39965,34862,5103,12.8
"26159",26,159,2010,37784,32687,5097,13.5
"26159",26,159,2011,36445,32241,4204,11.5
"26159",26,159,2012,35208,31496,3712,10.5
"26159",26,159,2013,34980,31454,3526,10.1
"26159",26,159,2014,35296,32454,2842,8.1
"26159",26,159,2015,35175,32964,2211,6.3
"26159",26,159,2016,35442,33401,2041,5.8
"26159",26,159,2017,35459,33395,2064,5.8
"26161",26,161,1990,158174,150634,7540,4.8
"26161",26,161,1991,156657,147723,8934,5.7
"26161",26,161,1992,161343,153354,7989,5
"26161",26,161,1993,162309,155560,6749,4.2
"26161",26,161,1994,162358,156937,5421,3.3
"26161",26,161,1995,161595,157187,4408,2.7
"26161",26,161,1996,163470,159818,3652,2.2
"26161",26,161,1997,167635,164254,3381,2
"26161",26,161,1998,171763,168825,2938,1.7
"26161",26,161,1999,177007,174146,2861,1.6
"26161",26,161,2000,185811,181382,4429,2.4
"26161",26,161,2001,190909,185111,5798,3
"26161",26,161,2002,185034,178274,6760,3.7
"26161",26,161,2003,184030,176442,7588,4.1
"26161",26,161,2004,187648,179602,8046,4.3
"26161",26,161,2005,189926,181459,8467,4.5
"26161",26,161,2006,190167,181037,9130,4.8
"26161",26,161,2007,188362,179146,9216,4.9
"26161",26,161,2008,186421,175940,10481,5.6
"26161",26,161,2009,185329,169338,15991,8.6
"26161",26,161,2010,182801,167969,14832,8.1
"26161",26,161,2011,180797,168467,12330,6.8
"26161",26,161,2012,181611,170803,10808,6
"26161",26,161,2013,183727,173018,10709,5.8
"26161",26,161,2014,186899,177797,9102,4.9
"26161",26,161,2015,188111,181123,6988,3.7
"26161",26,161,2016,191376,184359,7017,3.7
"26161",26,161,2017,193566,186598,6968,3.6
"26163",26,163,1990,944393,857281,87112,9.2
"26163",26,163,1991,939619,836228,103391,11
"26163",26,163,1992,951152,849122,102030,10.7
"26163",26,163,1993,942688,866617,76071,8.1
"26163",26,163,1994,939612,879764,59848,6.4
"26163",26,163,1995,935634,881149,54485,5.8
"26163",26,163,1996,950567,895399,55168,5.8
"26163",26,163,1997,949909,900545,49364,5.2
"26163",26,163,1998,956875,909516,47359,4.9
"26163",26,163,1999,961764,916598,45166,4.7
"26163",26,163,2000,955276,917566,37710,3.9
"26163",26,163,2001,942230,888352,53878,5.7
"26163",26,163,2002,917251,851213,66038,7.2
"26163",26,163,2003,920061,840332,79729,8.7
"26163",26,163,2004,916559,837179,79380,8.7
"26163",26,163,2005,910762,835251,75511,8.3
"26163",26,163,2006,901905,827726,74179,8.2
"26163",26,163,2007,883501,810552,72949,8.3
"26163",26,163,2008,863865,783771,80094,9.3
"26163",26,163,2009,869996,728832,141164,16.2
"26163",26,163,2010,802754,678426,124328,15.5
"26163",26,163,2011,774443,674177,100266,12.9
"26163",26,163,2012,771845,681453,90392,11.7
"26163",26,163,2013,776560,687300,89260,11.5
"26163",26,163,2014,768439,694244,74195,9.7
"26163",26,163,2015,758684,706075,52609,6.9
"26163",26,163,2016,778434,729654,48780,6.3
"26163",26,163,2017,789088,746415,42673,5.4
"26165",26,165,1990,12368,10862,1506,12.2
"26165",26,165,1991,12306,10741,1565,12.7
"26165",26,165,1992,12855,11128,1727,13.4
"26165",26,165,1993,13359,11908,1451,10.9
"26165",26,165,1994,14124,12726,1398,9.9
"26165",26,165,1995,14099,12550,1549,11
"26165",26,165,1996,13928,12722,1206,8.7
"26165",26,165,1997,14341,13117,1224,8.5
"26165",26,165,1998,14423,13341,1082,7.5
"26165",26,165,1999,15475,14560,915,5.9
"26165",26,165,2000,15654,14795,859,5.5
"26165",26,165,2001,15031,13735,1296,8.6
"26165",26,165,2002,14595,13447,1148,7.9
"26165",26,165,2003,14542,13212,1330,9.1
"26165",26,165,2004,14686,13468,1218,8.3
"26165",26,165,2005,14753,13622,1131,7.7
"26165",26,165,2006,14939,13684,1255,8.4
"26165",26,165,2007,14590,13325,1265,8.7
"26165",26,165,2008,14319,12775,1544,10.8
"26165",26,165,2009,14482,11938,2544,17.6
"26165",26,165,2010,15218,13023,2195,14.4
"26165",26,165,2011,14656,12870,1786,12.2
"26165",26,165,2012,14469,12876,1593,11
"26165",26,165,2013,14622,13000,1622,11.1
"26165",26,165,2014,14666,13412,1254,8.6
"26165",26,165,2015,14550,13568,982,6.7
"26165",26,165,2016,14687,13826,861,5.9
"26165",26,165,2017,14776,13936,840,5.7
"27001",27,1,1990,5214,4666,548,10.5
"27001",27,1,1991,5308,4712,596,11.2
"27001",27,1,1992,5363,4725,638,11.9
"27001",27,1,1993,5597,4926,671,12
"27001",27,1,1994,5692,5091,601,10.6
"27001",27,1,1995,5749,5202,547,9.5
"27001",27,1,1996,6011,5430,581,9.7
"27001",27,1,1997,6185,5663,522,8.4
"27001",27,1,1998,6029,5548,481,8
"27001",27,1,1999,6085,5632,453,7.4
"27001",27,1,2000,7200,6757,443,6.2
"27001",27,1,2001,7330,6864,466,6.4
"27001",27,1,2002,7475,6986,489,6.5
"27001",27,1,2003,7540,7010,530,7
"27001",27,1,2004,7801,7261,540,6.9
"27001",27,1,2005,7741,7276,465,6
"27001",27,1,2006,7755,7297,458,5.9
"27001",27,1,2007,7718,7193,525,6.8
"27001",27,1,2008,7681,7061,620,8.1
"27001",27,1,2009,7718,6926,792,10.3
"27001",27,1,2010,7310,6550,760,10.4
"27001",27,1,2011,7112,6431,681,9.6
"27001",27,1,2012,6904,6345,559,8.1
"27001",27,1,2013,6802,6295,507,7.5
"27001",27,1,2014,6772,6321,451,6.7
"27001",27,1,2015,6871,6423,448,6.5
"27001",27,1,2016,7054,6560,494,7
"27001",27,1,2017,7195,6747,448,6.2
"27003",27,3,1990,145162,138604,6558,4.5
"27003",27,3,1991,148739,141336,7403,5
"27003",27,3,1992,152933,145630,7303,4.8
"27003",27,3,1993,156619,149276,7343,4.7
"27003",27,3,1994,161571,155903,5668,3.5
"27003",27,3,1995,166431,161267,5164,3.1
"27003",27,3,1996,170593,165070,5523,3.2
"27003",27,3,1997,173865,169303,4562,2.6
"27003",27,3,1998,177898,174257,3641,2
"27003",27,3,1999,183240,179233,4007,2.2
"27003",27,3,2000,179312,174416,4896,2.7
"27003",27,3,2001,181995,175577,6418,3.5
"27003",27,3,2002,183612,175519,8093,4.4
"27003",27,3,2003,185945,177029,8916,4.8
"27003",27,3,2004,188296,179770,8526,4.5
"27003",27,3,2005,189702,182389,7313,3.9
"27003",27,3,2006,190346,182942,7404,3.9
"27003",27,3,2007,189600,180992,8608,4.5
"27003",27,3,2008,189874,179506,10368,5.5
"27003",27,3,2009,190905,174945,15960,8.4
"27003",27,3,2010,187355,172342,15013,8
"27003",27,3,2011,187000,174217,12783,6.8
"27003",27,3,2012,187260,176226,11034,5.9
"27003",27,3,2013,188370,178904,9466,5
"27003",27,3,2014,189030,181194,7836,4.1
"27003",27,3,2015,189854,183013,6841,3.6
"27003",27,3,2016,192622,185451,7171,3.7
"27003",27,3,2017,195328,188808,6520,3.3
"27005",27,5,1990,12652,11712,940,7.4
"27005",27,5,1991,12758,11782,976,7.7
"27005",27,5,1992,12689,11263,1426,11.2
"27005",27,5,1993,12892,11480,1412,11
"27005",27,5,1994,12843,11812,1031,8
"27005",27,5,1995,13008,12006,1002,7.7
"27005",27,5,1996,13514,12427,1087,8
"27005",27,5,1997,13654,12645,1009,7.4
"27005",27,5,1998,13830,13016,814,5.9
"27005",27,5,1999,14234,13449,785,5.5
"27005",27,5,2000,15652,14871,781,5
"27005",27,5,2001,16268,15413,855,5.3
"27005",27,5,2002,16370,15478,892,5.4
"27005",27,5,2003,16451,15461,990,6
"27005",27,5,2004,16536,15579,957,5.8
"27005",27,5,2005,16642,15751,891,5.4
"27005",27,5,2006,16807,15951,856,5.1
"27005",27,5,2007,16852,15889,963,5.7
"27005",27,5,2008,16808,15672,1136,6.8
"27005",27,5,2009,17277,15798,1479,8.6
"27005",27,5,2010,17602,16210,1392,7.9
"27005",27,5,2011,17715,16451,1264,7.1
"27005",27,5,2012,17873,16836,1037,5.8
"27005",27,5,2013,17969,16985,984,5.5
"27005",27,5,2014,17975,17119,856,4.8
"27005",27,5,2015,18399,17597,802,4.4
"27005",27,5,2016,18627,17777,850,4.6
"27005",27,5,2017,18589,17817,772,4.2
"27007",27,7,1990,15670,14495,1175,7.5
"27007",27,7,1991,16265,14979,1286,7.9
"27007",27,7,1992,16604,15293,1311,7.9
"27007",27,7,1993,17117,15823,1294,7.6
"27007",27,7,1994,17883,16686,1197,6.7
"27007",27,7,1995,18656,17421,1235,6.6
"27007",27,7,1996,18943,17573,1370,7.2
"27007",27,7,1997,19822,18601,1221,6.2
"27007",27,7,1998,19760,18818,942,4.8
"27007",27,7,1999,20022,19008,1014,5.1
"27007",27,7,2000,20356,19402,954,4.7
"27007",27,7,2001,20868,19909,959,4.6
"27007",27,7,2002,21326,20292,1034,4.8
"27007",27,7,2003,21267,20106,1161,5.5
"27007",27,7,2004,21240,20017,1223,5.8
"27007",27,7,2005,21185,20062,1123,5.3
"27007",27,7,2006,21093,20001,1092,5.2
"27007",27,7,2007,21174,19897,1277,6
"27007",27,7,2008,21196,19732,1464,6.9
"27007",27,7,2009,21699,19826,1873,8.6
"27007",27,7,2010,22591,20737,1854,8.2
"27007",27,7,2011,22491,20650,1841,8.2
"27007",27,7,2012,22840,21245,1595,7
"27007",27,7,2013,23024,21588,1436,6.2
"27007",27,7,2014,23310,22069,1241,5.3
"27007",27,7,2015,23502,22353,1149,4.9
"27007",27,7,2016,23765,22526,1239,5.2
"27007",27,7,2017,23722,22567,1155,4.9
"27009",27,9,1990,16926,15853,1073,6.3
"27009",27,9,1991,17577,16510,1067,6.1
"27009",27,9,1992,17998,17005,993,5.5
"27009",27,9,1993,18567,17539,1028,5.5
"27009",27,9,1994,18772,17945,827,4.4
"27009",27,9,1995,19354,18493,861,4.4
"27009",27,9,1996,19849,18832,1017,5.1
"27009",27,9,1997,19802,18955,847,4.3
"27009",27,9,1998,20017,19344,673,3.4
"27009",27,9,1999,21089,20448,641,3
"27009",27,9,2000,20607,19887,720,3.5
"27009",27,9,2001,21269,20349,920,4.3
"27009",27,9,2002,21600,20512,1088,5
"27009",27,9,2003,21817,20640,1177,5.4
"27009",27,9,2004,22056,20897,1159,5.3
"27009",27,9,2005,22165,21129,1036,4.7
"27009",27,9,2006,22332,21341,991,4.4
"27009",27,9,2007,22936,21792,1144,5
"27009",27,9,2008,23093,21694,1399,6.1
"27009",27,9,2009,23241,21277,1964,8.5
"27009",27,9,2010,21100,19263,1837,8.7
"27009",27,9,2011,21250,19645,1605,7.6
"27009",27,9,2012,21197,19844,1353,6.4
"27009",27,9,2013,21437,20167,1270,5.9
"27009",27,9,2014,21710,20613,1097,5.1
"27009",27,9,2015,21589,20633,956,4.4
"27009",27,9,2016,21858,20895,963,4.4
"27009",27,9,2017,22088,21202,886,4
"27011",27,11,1990,2928,2804,124,4.2
"27011",27,11,1991,2869,2724,145,5.1
"27011",27,11,1992,2824,2681,143,5.1
"27011",27,11,1993,2853,2679,174,6.1
"27011",27,11,1994,2799,2652,147,5.3
"27011",27,11,1995,2793,2655,138,4.9
"27011",27,11,1996,2831,2703,128,4.5
"27011",27,11,1997,2863,2754,109,3.8
"27011",27,11,1998,2819,2715,104,3.7
"27011",27,11,1999,2741,2638,103,3.8
"27011",27,11,2000,2782,2662,120,4.3
"27011",27,11,2001,2848,2725,123,4.3
"27011",27,11,2002,2879,2757,122,4.2
"27011",27,11,2003,2833,2700,133,4.7
"27011",27,11,2004,2807,2670,137,4.9
"27011",27,11,2005,2759,2633,126,4.6
"27011",27,11,2006,2808,2686,122,4.3
"27011",27,11,2007,2801,2668,133,4.7
"27011",27,11,2008,2803,2648,155,5.5
"27011",27,11,2009,2944,2775,169,5.7
"27011",27,11,2010,2911,2722,189,6.5
"27011",27,11,2011,2902,2715,187,6.4
"27011",27,11,2012,2830,2682,148,5.2
"27011",27,11,2013,2557,2419,138,5.4
"27011",27,11,2014,2593,2478,115,4.4
"27011",27,11,2015,2682,2563,119,4.4
"27011",27,11,2016,2714,2584,130,4.8
"27011",27,11,2017,2599,2485,114,4.4
"27013",27,13,1990,29863,28744,1119,3.7
"27013",27,13,1991,30325,29182,1143,3.8
"27013",27,13,1992,30856,29721,1135,3.7
"27013",27,13,1993,31105,30018,1087,3.5
"27013",27,13,1994,32160,31248,912,2.8
"27013",27,13,1995,32573,31510,1063,3.3
"27013",27,13,1996,32730,31619,1111,3.4
"27013",27,13,1997,32562,31677,885,2.7
"27013",27,13,1998,33516,32806,710,2.1
"27013",27,13,1999,33725,32949,776,2.3
"27013",27,13,2000,33930,32975,955,2.8
"27013",27,13,2001,34428,33402,1026,3
"27013",27,13,2002,35086,33840,1246,3.6
"27013",27,13,2003,35160,33775,1385,3.9
"27013",27,13,2004,34976,33612,1364,3.9
"27013",27,13,2005,35479,34296,1183,3.3
"27013",27,13,2006,35989,34813,1176,3.3
"27013",27,13,2007,36387,35023,1364,3.7
"27013",27,13,2008,37418,35772,1646,4.4
"27013",27,13,2009,37819,35390,2429,6.4
"27013",27,13,2010,38114,35687,2427,6.4
"27013",27,13,2011,38315,36245,2070,5.4
"27013",27,13,2012,38316,36479,1837,4.8
"27013",27,13,2013,38620,37017,1603,4.2
"27013",27,13,2014,38538,37213,1325,3.4
"27013",27,13,2015,39381,38224,1157,2.9
"27013",27,13,2016,39767,38492,1275,3.2
"27013",27,13,2017,40188,39019,1169,2.9
"27015",27,15,1990,14303,13699,604,4.2
"27015",27,15,1991,14313,13680,633,4.4
"27015",27,15,1992,14236,13520,716,5
"27015",27,15,1993,14555,13854,701,4.8
"27015",27,15,1994,14734,14156,578,3.9
"27015",27,15,1995,14961,14394,567,3.8
"27015",27,15,1996,15326,14630,696,4.5
"27015",27,15,1997,15422,14713,709,4.6
"27015",27,15,1998,15090,14505,585,3.9
"27015",27,15,1999,15064,14531,533,3.5
"27015",27,15,2000,15439,14855,584,3.8
"27015",27,15,2001,15561,14929,632,4.1
"27015",27,15,2002,15379,14675,704,4.6
"27015",27,15,2003,15232,14402,830,5.4
"27015",27,15,2004,15058,14321,737,4.9
"27015",27,15,2005,14822,14187,635,4.3
"27015",27,15,2006,14874,14223,651,4.4
"27015",27,15,2007,14676,13966,710,4.8
"27015",27,15,2008,14903,14009,894,6
"27015",27,15,2009,15063,13964,1099,7.3
"27015",27,15,2010,15102,14064,1038,6.9
"27015",27,15,2011,15042,14157,885,5.9
"27015",27,15,2012,14817,13982,835,5.6
"27015",27,15,2013,14524,13769,755,5.2
"27015",27,15,2014,14193,13545,648,4.6
"27015",27,15,2015,14620,14024,596,4.1
"27015",27,15,2016,14575,13965,610,4.2
"27015",27,15,2017,14473,13935,538,3.7
"27017",27,17,1990,13364,12378,986,7.4
"27017",27,17,1991,13766,12648,1118,8.1
"27017",27,17,1992,14481,13230,1251,8.6
"27017",27,17,1993,15054,13827,1227,8.2
"27017",27,17,1994,15112,13922,1190,7.9
"27017",27,17,1995,15150,14096,1054,7
"27017",27,17,1996,15384,14280,1104,7.2
"27017",27,17,1997,15436,14477,959,6.2
"27017",27,17,1998,15839,15077,762,4.8
"27017",27,17,1999,16088,15412,676,4.2
"27017",27,17,2000,15905,15121,784,4.9
"27017",27,17,2001,15938,15026,912,5.7
"27017",27,17,2002,16322,15313,1009,6.2
"27017",27,17,2003,16583,15529,1054,6.4
"27017",27,17,2004,16866,15792,1074,6.4
"27017",27,17,2005,17021,16036,985,5.8
"27017",27,17,2006,17143,16248,895,5.2
"27017",27,17,2007,17208,16232,976,5.7
"27017",27,17,2008,17438,16277,1161,6.7
"27017",27,17,2009,17566,16079,1487,8.5
"27017",27,17,2010,17794,16304,1490,8.4
"27017",27,17,2011,17630,16286,1344,7.6
"27017",27,17,2012,17472,16272,1200,6.9
"27017",27,17,2013,17509,16462,1047,6
"27017",27,17,2014,17588,16666,922,5.2
"27017",27,17,2015,17570,16709,861,4.9
"27017",27,17,2016,17805,16864,941,5.3
"27017",27,17,2017,17854,16997,857,4.8
"27019",27,19,1990,28264,27235,1029,3.6
"27019",27,19,1991,29170,28004,1166,4
"27019",27,19,1992,30318,29136,1182,3.9
"27019",27,19,1993,31662,30551,1111,3.5
"27019",27,19,1994,33488,32555,933,2.8
"27019",27,19,1995,35224,34371,853,2.4
"27019",27,19,1996,36839,35941,898,2.4
"27019",27,19,1997,37914,37135,779,2.1
"27019",27,19,1998,39259,38506,753,1.9
"27019",27,19,1999,40897,40043,854,2.1
"27019",27,19,2000,41076,40076,1000,2.4
"27019",27,19,2001,42307,40938,1369,3.2
"27019",27,19,2002,43612,41845,1767,4.1
"27019",27,19,2003,45259,43306,1953,4.3
"27019",27,19,2004,46602,44759,1843,4
"27019",27,19,2005,48068,46435,1633,3.4
"27019",27,19,2006,49222,47605,1617,3.3
"27019",27,19,2007,49658,47699,1959,3.9
"27019",27,19,2008,50504,48031,2473,4.9
"27019",27,19,2009,50924,47236,3688,7.2
"27019",27,19,2010,51621,48148,3473,6.7
"27019",27,19,2011,52129,49252,2877,5.5
"27019",27,19,2012,52427,49897,2530,4.8
"27019",27,19,2013,53318,51020,2298,4.3
"27019",27,19,2014,54280,52313,1967,3.6
"27019",27,19,2015,55179,53436,1743,3.2
"27019",27,19,2016,56537,54674,1863,3.3
"27019",27,19,2017,57261,55589,1672,2.9
"27021",27,21,1990,9133,8243,890,9.7
"27021",27,21,1991,9531,8623,908,9.5
"27021",27,21,1992,9848,8856,992,10.1
"27021",27,21,1993,10444,9402,1042,10
"27021",27,21,1994,10634,9712,922,8.7
"27021",27,21,1995,11179,10250,929,8.3
"27021",27,21,1996,11631,10570,1061,9.1
"27021",27,21,1997,11880,11005,875,7.4
"27021",27,21,1998,12114,11403,711,5.9
"27021",27,21,1999,12587,11844,743,5.9
"27021",27,21,2000,13419,12682,737,5.5
"27021",27,21,2001,13734,12949,785,5.7
"27021",27,21,2002,13986,13141,845,6
"27021",27,21,2003,14140,13147,993,7
"27021",27,21,2004,14363,13331,1032,7.2
"27021",27,21,2005,14438,13549,889,6.2
"27021",27,21,2006,14365,13454,911,6.3
"27021",27,21,2007,14260,13244,1016,7.1
"27021",27,21,2008,14173,12954,1219,8.6
"27021",27,21,2009,14136,12636,1500,10.6
"27021",27,21,2010,14383,12864,1519,10.6
"27021",27,21,2011,14149,12730,1419,10
"27021",27,21,2012,13852,12623,1229,8.9
"27021",27,21,2013,13991,12842,1149,8.2
"27021",27,21,2014,13993,12995,998,7.1
"27021",27,21,2015,14031,13095,936,6.7
"27021",27,21,2016,14207,13241,966,6.8
"27021",27,21,2017,14554,13702,852,5.9
"27023",27,23,1990,6429,6115,314,4.9
"27023",27,23,1991,6335,5977,358,5.7
"27023",27,23,1992,6152,5741,411,6.7
"27023",27,23,1993,6475,6117,358,5.5
"27023",27,23,1994,6428,6055,373,5.8
"27023",27,23,1995,6709,6354,355,5.3
"27023",27,23,1996,7062,6713,349,4.9
"27023",27,23,1997,7182,6869,313,4.4
"27023",27,23,1998,7004,6710,294,4.2
"27023",27,23,1999,6984,6643,341,4.9
"27023",27,23,2000,7131,6773,358,5
"27023",27,23,2001,7433,7070,363,4.9
"27023",27,23,2002,7410,7065,345,4.7
"27023",27,23,2003,7218,6845,373,5.2
"27023",27,23,2004,7231,6871,360,5
"27023",27,23,2005,7170,6875,295,4.1
"27023",27,23,2006,7136,6864,272,3.8
"27023",27,23,2007,7071,6768,303,4.3
"27023",27,23,2008,7136,6765,371,5.2
"27023",27,23,2009,7298,6733,565,7.7
"27023",27,23,2010,7153,6628,525,7.3
"27023",27,23,2011,7183,6730,453,6.3
"27023",27,23,2012,7058,6685,373,5.3
"27023",27,23,2013,6945,6588,357,5.1
"27023",27,23,2014,6897,6584,313,4.5
"27023",27,23,2015,6945,6642,303,4.4
"27023",27,23,2016,6992,6677,315,4.5
"27023",27,23,2017,6969,6688,281,4
"27025",27,25,1990,15663,14578,1085,6.9
"27025",27,25,1991,15949,14807,1142,7.2
"27025",27,25,1992,16473,15352,1121,6.8
"27025",27,25,1993,17260,16110,1150,6.7
"27025",27,25,1994,18113,17178,935,5.2
"27025",27,25,1995,19000,18133,867,4.6
"27025",27,25,1996,19737,18771,966,4.9
"27025",27,25,1997,20454,19634,820,4
"27025",27,25,1998,21153,20506,647,3.1
"27025",27,25,1999,22003,21306,697,3.2
"27025",27,25,2000,23250,22394,856,3.7
"27025",27,25,2001,24097,23013,1084,4.5
"27025",27,25,2002,24887,23558,1329,5.3
"27025",27,25,2003,25897,24390,1507,5.8
"27025",27,25,2004,26570,25142,1428,5.4
"27025",27,25,2005,27047,25756,1291,4.8
"27025",27,25,2006,27408,26085,1323,4.8
"27025",27,25,2007,27346,25756,1590,5.8
"27025",27,25,2008,27414,25545,1869,6.8
"27025",27,25,2009,27459,24739,2720,9.9
"27025",27,25,2010,29314,26707,2607,8.9
"27025",27,25,2011,28983,26777,2206,7.6
"27025",27,25,2012,28561,26684,1877,6.6
"27025",27,25,2013,28523,26932,1591,5.6
"27025",27,25,2014,28584,27237,1347,4.7
"27025",27,25,2015,28734,27539,1195,4.2
"27025",27,25,2016,29255,27992,1263,4.3
"27025",27,25,2017,29638,28467,1171,4
"27027",27,27,1990,27583,26115,1468,5.3
"27027",27,27,1991,27386,26107,1279,4.7
"27027",27,27,1992,27859,26756,1103,4
"27027",27,27,1993,28253,27143,1110,3.9
"27027",27,27,1994,29479,28400,1079,3.7
"27027",27,27,1995,29169,28074,1095,3.8
"27027",27,27,1996,29627,28385,1242,4.2
"27027",27,27,1997,29928,29056,872,2.9
"27027",27,27,1998,30087,29435,652,2.2
"27027",27,27,1999,30363,29621,742,2.4
"27027",27,27,2000,28082,27174,908,3.2
"27027",27,27,2001,28358,27417,941,3.3
"27027",27,27,2002,28843,27827,1016,3.5
"27027",27,27,2003,29468,28399,1069,3.6
"27027",27,27,2004,30207,29094,1113,3.7
"27027",27,27,2005,30853,29791,1062,3.4
"27027",27,27,2006,31273,30273,1000,3.2
"27027",27,27,2007,31280,30201,1079,3.4
"27027",27,27,2008,32244,31052,1192,3.7
"27027",27,27,2009,32769,31199,1570,4.8
"27027",27,27,2010,33883,32009,1874,5.5
"27027",27,27,2011,34623,32703,1920,5.5
"27027",27,27,2012,35023,33334,1689,4.8
"27027",27,27,2013,34830,33337,1493,4.3
"27027",27,27,2014,35235,34035,1200,3.4
"27027",27,27,2015,35546,34446,1100,3.1
"27027",27,27,2016,35746,34519,1227,3.4
"27027",27,27,2017,35875,34723,1152,3.2
"27029",27,29,1990,3530,2947,583,16.5
"27029",27,29,1991,3675,3035,640,17.4
"27029",27,29,1992,3711,3044,667,18
"27029",27,29,1993,3991,3260,731,18.3
"27029",27,29,1994,3986,3377,609,15.3
"27029",27,29,1995,3951,3345,606,15.3
"27029",27,29,1996,4070,3455,615,15.1
"27029",27,29,1997,4092,3558,534,13
"27029",27,29,1998,4047,3587,460,11.4
"27029",27,29,1999,4165,3695,470,11.3
"27029",27,29,2000,4210,3812,398,9.5
"27029",27,29,2001,4388,3960,428,9.8
"27029",27,29,2002,4303,3857,446,10.4
"27029",27,29,2003,4028,3575,453,11.2
"27029",27,29,2004,4016,3574,442,11
"27029",27,29,2005,3869,3478,391,10.1
"27029",27,29,2006,3794,3424,370,9.8
"27029",27,29,2007,3872,3475,397,10.3
"27029",27,29,2008,4045,3582,463,11.4
"27029",27,29,2009,4223,3604,619,14.7
"27029",27,29,2010,4589,3988,601,13.1
"27029",27,29,2011,4573,4030,543,11.9
"27029",27,29,2012,4409,3944,465,10.5
"27029",27,29,2013,4474,3998,476,10.6
"27029",27,29,2014,4545,4070,475,10.5
"27029",27,29,2015,4627,4208,419,9.1
"27029",27,29,2016,4732,4279,453,9.6
"27029",27,29,2017,4631,4229,402,8.7
"27031",27,31,1990,2260,2060,200,8.8
"27031",27,31,1991,2395,2233,162,6.8
"27031",27,31,1992,2671,2501,170,6.4
"27031",27,31,1993,2737,2584,153,5.6
"27031",27,31,1994,2832,2670,162,5.7
"27031",27,31,1995,2966,2795,171,5.8
"27031",27,31,1996,2966,2803,163,5.5
"27031",27,31,1997,2952,2813,139,4.7
"27031",27,31,1998,2968,2849,119,4
"27031",27,31,1999,3085,2973,112,3.6
"27031",27,31,2000,3139,3011,128,4.1
"27031",27,31,2001,3219,3069,150,4.7
"27031",27,31,2002,3182,3029,153,4.8
"27031",27,31,2003,3156,3002,154,4.9
"27031",27,31,2004,3218,3064,154,4.8
"27031",27,31,2005,3241,3100,141,4.4
"27031",27,31,2006,3171,3031,140,4.4
"27031",27,31,2007,3133,2982,151,4.8
"27031",27,31,2008,3121,2947,174,5.6
"27031",27,31,2009,3116,2898,218,7
"27031",27,31,2010,3056,2837,219,7.2
"27031",27,31,2011,3051,2842,209,6.9
"27031",27,31,2012,3048,2858,190,6.2
"27031",27,31,2013,3055,2878,177,5.8
"27031",27,31,2014,3056,2884,172,5.6
"27031",27,31,2015,3154,3016,138,4.4
"27031",27,31,2016,3105,2965,140,4.5
"27031",27,31,2017,3194,3075,119,3.7
"27033",27,33,1990,5912,5542,370,6.3
"27033",27,33,1991,5802,5445,357,6.2
"27033",27,33,1992,5899,5452,447,7.6
"27033",27,33,1993,6176,5810,366,5.9
"27033",27,33,1994,6288,5948,340,5.4
"27033",27,33,1995,6174,5739,435,7
"27033",27,33,1996,6243,5793,450,7.2
"27033",27,33,1997,6114,5828,286,4.7
"27033",27,33,1998,5590,5295,295,5.3
"27033",27,33,1999,5717,5465,252,4.4
"27033",27,33,2000,6278,5976,302,4.8
"27033",27,33,2001,6471,6228,243,3.8
"27033",27,33,2002,6458,6188,270,4.2
"27033",27,33,2003,6684,6375,309,4.6
"27033",27,33,2004,6390,6089,301,4.7
"27033",27,33,2005,6311,6038,273,4.3
"27033",27,33,2006,6402,6119,283,4.4
"27033",27,33,2007,6261,6009,252,4
"27033",27,33,2008,6290,5959,331,5.3
"27033",27,33,2009,6477,6070,407,6.3
"27033",27,33,2010,6227,5822,405,6.5
"27033",27,33,2011,6139,5762,377,6.1
"27033",27,33,2012,5947,5561,386,6.5
"27033",27,33,2013,5756,5422,334,5.8
"27033",27,33,2014,5580,5288,292,5.2
"27033",27,33,2015,5788,5513,275,4.8
"27033",27,33,2016,5556,5156,400,7.2
"27033",27,33,2017,5636,5335,301,5.3
"27035",27,35,1990,20999,19511,1488,7.1
"27035",27,35,1991,22176,20576,1600,7.2
"27035",27,35,1992,22806,21025,1781,7.8
"27035",27,35,1993,24180,22292,1888,7.8
"27035",27,35,1994,24838,23161,1677,6.8
"27035",27,35,1995,25605,23985,1620,6.3
"27035",27,35,1996,26523,24725,1798,6.8
"27035",27,35,1997,26861,25289,1572,5.9
"27035",27,35,1998,27448,26139,1309,4.8
"27035",27,35,1999,28091,26856,1235,4.4
"27035",27,35,2000,29129,27935,1194,4.1
"27035",27,35,2001,29936,28613,1323,4.4
"27035",27,35,2002,30945,29322,1623,5.2
"27035",27,35,2003,31442,29634,1808,5.8
"27035",27,35,2004,31850,30136,1714,5.4
"27035",27,35,2005,32080,30515,1565,4.9
"27035",27,35,2006,32307,30720,1587,4.9
"27035",27,35,2007,32719,30893,1826,5.6
"27035",27,35,2008,32735,30464,2271,6.9
"27035",27,35,2009,33408,30187,3221,9.6
"27035",27,35,2010,32033,28983,3050,9.5
"27035",27,35,2011,31556,28798,2758,8.7
"27035",27,35,2012,30912,28538,2374,7.7
"27035",27,35,2013,31432,29255,2177,6.9
"27035",27,35,2014,31475,29629,1846,5.9
"27035",27,35,2015,31498,29879,1619,5.1
"27035",27,35,2016,31956,30331,1625,5.1
"27035",27,35,2017,32486,31036,1450,4.5
"27037",27,37,1990,166461,160414,6047,3.6
"27037",27,37,1991,171206,164034,7172,4.2
"27037",27,37,1992,177435,170271,7164,4
"27037",27,37,1993,182861,176218,6643,3.6
"27037",27,37,1994,187312,181855,5457,2.9
"27037",27,37,1995,194030,189118,4912,2.5
"27037",27,37,1996,201275,196079,5196,2.6
"27037",27,37,1997,206298,202191,4107,2
"27037",27,37,1998,212447,208436,4011,1.9
"27037",27,37,1999,217949,213972,3977,1.8
"27037",27,37,2000,217183,211870,5313,2.4
"27037",27,37,2001,219504,212745,6759,3.1
"27037",27,37,2002,221067,212363,8704,3.9
"27037",27,37,2003,223604,214057,9547,4.3
"27037",27,37,2004,225803,216611,9192,4.1
"27037",27,37,2005,227941,219756,8185,3.6
"27037",27,37,2006,228974,220905,8069,3.5
"27037",27,37,2007,229769,220453,9316,4.1
"27037",27,37,2008,230661,219354,11307,4.9
"27037",27,37,2009,229412,212895,16517,7.2
"27037",27,37,2010,227259,211414,15845,7
"27037",27,37,2011,227975,214174,13801,6.1
"27037",27,37,2012,228036,216129,11907,5.2
"27037",27,37,2013,229724,219309,10415,4.5
"27037",27,37,2014,231511,222769,8742,3.8
"27037",27,37,2015,232285,224645,7640,3.3
"27037",27,37,2016,235971,227974,7997,3.4
"27037",27,37,2017,239345,232117,7228,3
"27039",27,39,1990,8033,7609,424,5.3
"27039",27,39,1991,8023,7533,490,6.1
"27039",27,39,1992,8363,7872,491,5.9
"27039",27,39,1993,8648,8097,551,6.4
"27039",27,39,1994,8996,8466,530,5.9
"27039",27,39,1995,9035,8542,493,5.5
"27039",27,39,1996,8915,8413,502,5.6
"27039",27,39,1997,8938,8556,382,4.3
"27039",27,39,1998,8967,8659,308,3.4
"27039",27,39,1999,9110,8820,290,3.2
"27039",27,39,2000,10238,9928,310,3
"27039",27,39,2001,10481,10123,358,3.4
"27039",27,39,2002,10736,10312,424,3.9
"27039",27,39,2003,10861,10384,477,4.4
"27039",27,39,2004,11122,10639,483,4.3
"27039",27,39,2005,11172,10741,431,3.9
"27039",27,39,2006,11106,10695,411,3.7
"27039",27,39,2007,11028,10552,476,4.3
"27039",27,39,2008,11041,10467,574,5.2
"27039",27,39,2009,11131,10310,821,7.4
"27039",27,39,2010,11307,10525,782,6.9
"27039",27,39,2011,11235,10559,676,6
"27039",27,39,2012,11339,10768,571,5
"27039",27,39,2013,11330,10794,536,4.7
"27039",27,39,2014,11250,10781,469,4.2
"27039",27,39,2015,11454,11028,426,3.7
"27039",27,39,2016,11599,11169,430,3.7
"27039",27,39,2017,11657,11261,396,3.4
"27041",27,41,1990,14342,13521,821,5.7
"27041",27,41,1991,14492,13704,788,5.4
"27041",27,41,1992,14655,13795,860,5.9
"27041",27,41,1993,15209,14334,875,5.8
"27041",27,41,1994,15702,15045,657,4.2
"27041",27,41,1995,16019,15314,705,4.4
"27041",27,41,1996,16594,15830,764,4.6
"27041",27,41,1997,16716,16084,632,3.8
"27041",27,41,1998,16861,16322,539,3.2
"27041",27,41,1999,16850,16282,568,3.4
"27041",27,41,2000,18231,17620,611,3.4
"27041",27,41,2001,18684,18006,678,3.6
"27041",27,41,2002,19327,18615,712,3.7
"27041",27,41,2003,19861,19095,766,3.9
"27041",27,41,2004,20055,19282,773,3.9
"27041",27,41,2005,20027,19266,761,3.8
"27041",27,41,2006,20004,19237,767,3.8
"27041",27,41,2007,20039,19154,885,4.4
"27041",27,41,2008,20363,19352,1011,5
"27041",27,41,2009,20767,19387,1380,6.6
"27041",27,41,2010,19817,18471,1346,6.8
"27041",27,41,2011,19780,18584,1196,6
"27041",27,41,2012,19810,18812,998,5
"27041",27,41,2013,19873,18991,882,4.4
"27041",27,41,2014,19875,19134,741,3.7
"27041",27,41,2015,20138,19452,686,3.4
"27041",27,41,2016,20308,19599,709,3.5
"27041",27,41,2017,20653,19995,658,3.2
"27043",27,43,1990,8318,7905,413,5
"27043",27,43,1991,8188,7680,508,6.2
"27043",27,43,1992,8134,7664,470,5.8
"27043",27,43,1993,8168,7633,535,6.5
"27043",27,43,1994,8312,7898,414,5
"27043",27,43,1995,8264,7830,434,5.3
"27043",27,43,1996,8392,7960,432,5.1
"27043",27,43,1997,8265,7906,359,4.3
"27043",27,43,1998,8047,7749,298,3.7
"27043",27,43,1999,8169,7861,308,3.8
"27043",27,43,2000,8622,8296,326,3.8
"27043",27,43,2001,8529,8165,364,4.3
"27043",27,43,2002,8841,8463,378,4.3
"27043",27,43,2003,8572,8127,445,5.2
"27043",27,43,2004,8269,7797,472,5.7
"27043",27,43,2005,8048,7661,387,4.8
"27043",27,43,2006,7842,7493,349,4.5
"27043",27,43,2007,7777,7370,407,5.2
"27043",27,43,2008,7750,7267,483,6.2
"27043",27,43,2009,7712,7005,707,9.2
"27043",27,43,2010,7831,7207,624,8
"27043",27,43,2011,7794,7242,552,7.1
"27043",27,43,2012,7771,7318,453,5.8
"27043",27,43,2013,7494,7090,404,5.4
"27043",27,43,2014,7374,6989,385,5.2
"27043",27,43,2015,7503,7176,327,4.4
"27043",27,43,2016,7348,7026,322,4.4
"27043",27,43,2017,7235,6930,305,4.2
"27045",27,45,1990,10359,9880,479,4.6
"27045",27,45,1991,10140,9589,551,5.4
"27045",27,45,1992,10065,9515,550,5.5
"27045",27,45,1993,10256,9659,597,5.8
"27045",27,45,1994,10134,9616,518,5.1
"27045",27,45,1995,10117,9641,476,4.7
"27045",27,45,1996,10249,9725,524,5.1
"27045",27,45,1997,10045,9665,380,3.8
"27045",27,45,1998,10074,9751,323,3.2
"27045",27,45,1999,10043,9715,328,3.3
"27045",27,45,2000,11760,11386,374,3.2
"27045",27,45,2001,11992,11560,432,3.6
"27045",27,45,2002,11889,11389,500,4.2
"27045",27,45,2003,11740,11154,586,5
"27045",27,45,2004,11564,10983,581,5
"27045",27,45,2005,11274,10798,476,4.2
"27045",27,45,2006,11207,10746,461,4.1
"27045",27,45,2007,11157,10590,567,5.1
"27045",27,45,2008,10970,10302,668,6.1
"27045",27,45,2009,11270,10359,911,8.1
"27045",27,45,2010,11246,10402,844,7.5
"27045",27,45,2011,11224,10479,745,6.6
"27045",27,45,2012,11274,10650,624,5.5
"27045",27,45,2013,11107,10549,558,5
"27045",27,45,2014,11025,10540,485,4.4
"27045",27,45,2015,11405,10941,464,4.1
"27045",27,45,2016,11541,11076,465,4
"27045",27,45,2017,11521,11119,402,3.5
"27047",27,47,1990,17375,15388,1987,11.4
"27047",27,47,1991,16956,15966,990,5.8
"27047",27,47,1992,17125,16378,747,4.4
"27047",27,47,1993,17454,16489,965,5.5
"27047",27,47,1994,16666,15538,1128,6.8
"27047",27,47,1995,16253,15487,766,4.7
"27047",27,47,1996,16496,15766,730,4.4
"27047",27,47,1997,16514,15933,581,3.5
"27047",27,47,1998,16612,16190,422,2.5
"27047",27,47,1999,16687,16243,444,2.7
"27047",27,47,2000,17452,16834,618,3.5
"27047",27,47,2001,17397,16600,797,4.6
"27047",27,47,2002,17180,16342,838,4.9
"27047",27,47,2003,16866,15962,904,5.4
"27047",27,47,2004,16551,15668,883,5.3
"27047",27,47,2005,16243,15485,758,4.7
"27047",27,47,2006,16310,15591,719,4.4
"27047",27,47,2007,16336,15530,806,4.9
"27047",27,47,2008,16347,15417,930,5.7
"27047",27,47,2009,16527,15136,1391,8.4
"27047",27,47,2010,17087,15767,1320,7.7
"27047",27,47,2011,17051,15919,1132,6.6
"27047",27,47,2012,16675,15707,968,5.8
"27047",27,47,2013,16459,15640,819,5
"27047",27,47,2014,16246,15542,704,4.3
"27047",27,47,2015,16345,15730,615,3.8
"27047",27,47,2016,16346,15722,624,3.8
"27047",27,47,2017,16182,15589,593,3.7
"27049",27,49,1990,20870,20119,751,3.6
"27049",27,49,1991,21912,21030,882,4
"27049",27,49,1992,23028,22132,896,3.9
"27049",27,49,1993,23527,22492,1035,4.4
"27049",27,49,1994,23286,22320,966,4.1
"27049",27,49,1995,23550,22660,890,3.8
"27049",27,49,1996,23708,22687,1021,4.3
"27049",27,49,1997,23637,22885,752,3.2
"27049",27,49,1998,23800,23176,624,2.6
"27049",27,49,1999,23455,22772,683,2.9
"27049",27,49,2000,25165,24385,780,3.1
"27049",27,49,2001,25755,24883,872,3.4
"27049",27,49,2002,25665,24519,1146,4.5
"27049",27,49,2003,25618,24392,1226,4.8
"27049",27,49,2004,25410,24177,1233,4.9
"27049",27,49,2005,24721,23627,1094,4.4
"27049",27,49,2006,24806,23750,1056,4.3
"27049",27,49,2007,25003,23768,1235,4.9
"27049",27,49,2008,25137,23710,1427,5.7
"27049",27,49,2009,25723,23763,1960,7.6
"27049",27,49,2010,26734,24853,1881,7
"27049",27,49,2011,26931,25318,1613,6
"27049",27,49,2012,26709,25333,1376,5.2
"27049",27,49,2013,26821,25565,1256,4.7
"27049",27,49,2014,26728,25675,1053,3.9
"27049",27,49,2015,26881,25938,943,3.5
"27049",27,49,2016,26948,25946,1002,3.7
"27049",27,49,2017,26916,26042,874,3.2
"27051",27,51,1990,2843,2656,187,6.6
"27051",27,51,1991,2841,2657,184,6.5
"27051",27,51,1992,2811,2625,186,6.6
"27051",27,51,1993,3002,2819,183,6.1
"27051",27,51,1994,3022,2874,148,4.9
"27051",27,51,1995,3013,2865,148,4.9
"27051",27,51,1996,3057,2881,176,5.8
"27051",27,51,1997,2938,2787,151,5.1
"27051",27,51,1998,2822,2682,140,5
"27051",27,51,1999,2861,2707,154,5.4
"27051",27,51,2000,3301,3136,165,5
"27051",27,51,2001,3316,3135,181,5.5
"27051",27,51,2002,3313,3108,205,6.2
"27051",27,51,2003,3225,3024,201,6.2
"27051",27,51,2004,3155,2969,186,5.9
"27051",27,51,2005,3052,2880,172,5.6
"27051",27,51,2006,3039,2880,159,5.2
"27051",27,51,2007,3018,2840,178,5.9
"27051",27,51,2008,3053,2838,215,7
"27051",27,51,2009,3174,2909,265,8.3
"27051",27,51,2010,3399,3129,270,7.9
"27051",27,51,2011,3375,3142,233,6.9
"27051",27,51,2012,3337,3133,204,6.1
"27051",27,51,2013,3282,3094,188,5.7
"27051",27,51,2014,3282,3118,164,5
"27051",27,51,2015,3347,3190,157,4.7
"27051",27,51,2016,3299,3145,154,4.7
"27051",27,51,2017,3281,3146,135,4.1
"27053",27,53,1990,616943,592350,24593,4
"27053",27,53,1991,616600,589750,26850,4.4
"27053",27,53,1992,621237,594348,26889,4.3
"27053",27,53,1993,626538,600577,25961,4.1
"27053",27,53,1994,634288,613804,20484,3.2
"27053",27,53,1995,642932,624592,18340,2.9
"27053",27,53,1996,645525,626446,19079,3
"27053",27,53,1997,648027,632488,15539,2.4
"27053",27,53,1998,653431,640208,13223,2
"27053",27,53,1999,661528,647231,14297,2.2
"27053",27,53,2000,666621,648571,18050,2.7
"27053",27,53,2001,666946,643865,23081,3.5
"27053",27,53,2002,661528,632374,29154,4.4
"27053",27,53,2003,660470,629699,30771,4.7
"27053",27,53,2004,657468,628479,28989,4.4
"27053",27,53,2005,652568,628595,23973,3.7
"27053",27,53,2006,649356,626223,23133,3.6
"27053",27,53,2007,655691,629005,26686,4.1
"27053",27,53,2008,656957,624644,32313,4.9
"27053",27,53,2009,656192,608540,47652,7.3
"27053",27,53,2010,650891,605294,45597,7
"27053",27,53,2011,656063,616331,39732,6.1
"27053",27,53,2012,659812,625310,34502,5.2
"27053",27,53,2013,666831,636298,30533,4.6
"27053",27,53,2014,672435,647004,25431,3.8
"27053",27,53,2015,676859,654708,22151,3.3
"27053",27,53,2016,688117,665204,22913,3.3
"27053",27,53,2017,698457,677339,21118,3
"27055",27,55,1990,9765,9426,339,3.5
"27055",27,55,1991,9971,9548,423,4.2
"27055",27,55,1992,10173,9770,403,4
"27055",27,55,1993,10483,10000,483,4.6
"27055",27,55,1994,10663,10332,331,3.1
"27055",27,55,1995,10850,10462,388,3.6
"27055",27,55,1996,10929,10503,426,3.9
"27055",27,55,1997,10974,10642,332,3
"27055",27,55,1998,11086,10783,303,2.7
"27055",27,55,1999,11389,10996,393,3.5
"27055",27,55,2000,10960,10513,447,4.1
"27055",27,55,2001,11126,10640,486,4.4
"27055",27,55,2002,11210,10668,542,4.8
"27055",27,55,2003,11149,10554,595,5.3
"27055",27,55,2004,11196,10613,583,5.2
"27055",27,55,2005,11082,10580,502,4.5
"27055",27,55,2006,11233,10754,479,4.3
"27055",27,55,2007,10980,10424,556,5.1
"27055",27,55,2008,10910,10282,628,5.8
"27055",27,55,2009,11009,10134,875,7.9
"27055",27,55,2010,10830,9999,831,7.7
"27055",27,55,2011,10665,9930,735,6.9
"27055",27,55,2012,10571,9957,614,5.8
"27055",27,55,2013,10478,9953,525,5
"27055",27,55,2014,10357,9898,459,4.4
"27055",27,55,2015,10484,10086,398,3.8
"27055",27,55,2016,10640,10224,416,3.9
"27055",27,55,2017,10613,10254,359,3.4
"27057",27,57,1990,6711,6090,621,9.3
"27057",27,57,1991,6888,6268,620,9
"27057",27,57,1992,7059,6391,668,9.5
"27057",27,57,1993,7237,6576,661,9.1
"27057",27,57,1994,7482,6885,597,8
"27057",27,57,1995,7733,7198,535,6.9
"27057",27,57,1996,7992,7329,663,8.3
"27057",27,57,1997,8340,7790,550,6.6
"27057",27,57,1998,8418,7980,438,5.2
"27057",27,57,1999,8415,8006,409,4.9
"27057",27,57,2000,9166,8710,456,5
"27057",27,57,2001,9345,8870,475,5.1
"27057",27,57,2002,9753,9245,508,5.2
"27057",27,57,2003,9718,9139,579,6
"27057",27,57,2004,9762,9182,580,5.9
"27057",27,57,2005,9656,9131,525,5.4
"27057",27,57,2006,9552,9024,528,5.5
"27057",27,57,2007,9188,8603,585,6.4
"27057",27,57,2008,9562,8839,723,7.6
"27057",27,57,2009,9570,8618,952,9.9
"27057",27,57,2010,9751,8784,967,9.9
"27057",27,57,2011,9512,8638,874,9.2
"27057",27,57,2012,9540,8773,767,8
"27057",27,57,2013,9534,8846,688,7.2
"27057",27,57,2014,9434,8833,601,6.4
"27057",27,57,2015,9553,8971,582,6.1
"27057",27,57,2016,9834,9194,640,6.5
"27057",27,57,2017,9924,9372,552,5.6
"27059",27,59,1990,13225,12445,780,5.9
"27059",27,59,1991,13489,12537,952,7.1
"27059",27,59,1992,13657,12743,914,6.7
"27059",27,59,1993,14153,13213,940,6.6
"27059",27,59,1994,14253,13569,684,4.8
"27059",27,59,1995,14666,13993,673,4.6
"27059",27,59,1996,15132,14373,759,5
"27059",27,59,1997,15417,14785,632,4.1
"27059",27,59,1998,15680,15172,508,3.2
"27059",27,59,1999,16254,15692,562,3.5
"27059",27,59,2000,17944,17329,615,3.4
"27059",27,59,2001,18506,17721,785,4.2
"27059",27,59,2002,19113,18121,992,5.2
"27059",27,59,2003,20027,18882,1145,5.7
"27059",27,59,2004,20494,19411,1083,5.3
"27059",27,59,2005,21044,20029,1015,4.8
"27059",27,59,2006,21431,20387,1044,4.9
"27059",27,59,2007,21689,20397,1292,6
"27059",27,59,2008,21777,20273,1504,6.9
"27059",27,59,2009,21853,19658,2195,10
"27059",27,59,2010,20561,18583,1978,9.6
"27059",27,59,2011,20589,18874,1715,8.3
"27059",27,59,2012,20351,18929,1422,7
"27059",27,59,2013,20202,18989,1213,6
"27059",27,59,2014,20238,19215,1023,5.1
"27059",27,59,2015,20197,19331,866,4.3
"27059",27,59,2016,20751,19784,967,4.7
"27059",27,59,2017,21034,20124,910,4.3
"27061",27,61,1990,17626,15781,1845,10.5
"27061",27,61,1991,18527,16648,1879,10.1
"27061",27,61,1992,19052,16853,2199,11.5
"27061",27,61,1993,19721,17318,2403,12.2
"27061",27,61,1994,19812,17484,2328,11.8
"27061",27,61,1995,19900,17991,1909,9.6
"27061",27,61,1996,19823,17911,1912,9.6
"27061",27,61,1997,19867,18154,1713,8.6
"27061",27,61,1998,19678,18323,1355,6.9
"27061",27,61,1999,20126,18689,1437,7.1
"27061",27,61,2000,21704,20444,1260,5.8
"27061",27,61,2001,22210,20825,1385,6.2
"27061",27,61,2002,22623,21215,1408,6.2
"27061",27,61,2003,22454,20775,1679,7.5
"27061",27,61,2004,22535,20864,1671,7.4
"27061",27,61,2005,22419,21092,1327,5.9
"27061",27,61,2006,22224,20887,1337,6
"27061",27,61,2007,22250,20637,1613,7.2
"27061",27,61,2008,22229,20478,1751,7.9
"27061",27,61,2009,22885,20422,2463,10.8
"27061",27,61,2010,22499,20214,2285,10.2
"27061",27,61,2011,22519,20478,2041,9.1
"27061",27,61,2012,22248,20502,1746,7.8
"27061",27,61,2013,21916,20238,1678,7.7
"27061",27,61,2014,21952,20501,1451,6.6
"27061",27,61,2015,22297,20856,1441,6.5
"27061",27,61,2016,22110,20220,1890,8.5
"27061",27,61,2017,21781,20254,1527,7
"27063",27,63,1990,5510,5268,242,4.4
"27063",27,63,1991,5438,5177,261,4.8
"27063",27,63,1992,5345,5064,281,5.3
"27063",27,63,1993,5623,5345,278,4.9
"27063",27,63,1994,5715,5428,287,5
"27063",27,63,1995,5940,5655,285,4.8
"27063",27,63,1996,6144,5836,308,5
"27063",27,63,1997,6022,5812,210,3.5
"27063",27,63,1998,6369,6164,205,3.2
"27063",27,63,1999,6134,5940,194,3.2
"27063",27,63,2000,6157,5964,193,3.1
"27063",27,63,2001,6429,6219,210,3.3
"27063",27,63,2002,6507,6270,237,3.6
"27063",27,63,2003,6505,6235,270,4.2
"27063",27,63,2004,6574,6330,244,3.7
"27063",27,63,2005,6670,6444,226,3.4
"27063",27,63,2006,6663,6405,258,3.9
"27063",27,63,2007,6532,6280,252,3.9
"27063",27,63,2008,6621,6343,278,4.2
"27063",27,63,2009,6976,6598,378,5.4
"27063",27,63,2010,6026,5674,352,5.8
"27063",27,63,2011,6090,5760,330,5.4
"27063",27,63,2012,6206,5924,282,4.5
"27063",27,63,2013,6229,5971,258,4.1
"27063",27,63,2014,6302,6039,263,4.2
"27063",27,63,2015,6288,6035,253,4
"27063",27,63,2016,6121,5845,276,4.5
"27063",27,63,2017,5779,5568,211,3.7
"27065",27,65,1990,6554,5871,683,10.4
"27065",27,65,1991,6710,6025,685,10.2
"27065",27,65,1992,6772,6091,681,10.1
"27065",27,65,1993,7092,6332,760,10.7
"27065",27,65,1994,7151,6542,609,8.5
"27065",27,65,1995,7414,6817,597,8.1
"27065",27,65,1996,7471,6758,713,9.5
"27065",27,65,1997,7372,6806,566,7.7
"27065",27,65,1998,7159,6711,448,6.3
"27065",27,65,1999,6960,6508,452,6.5
"27065",27,65,2000,7932,7550,382,4.8
"27065",27,65,2001,8040,7529,511,6.4
"27065",27,65,2002,7988,7400,588,7.4
"27065",27,65,2003,7900,7257,643,8.1
"27065",27,65,2004,7901,7303,598,7.6
"27065",27,65,2005,7778,7256,522,6.7
"27065",27,65,2006,7779,7238,541,7
"27065",27,65,2007,7917,7263,654,8.3
"27065",27,65,2008,8014,7192,822,10.3
"27065",27,65,2009,8115,7056,1059,13
"27065",27,65,2010,8784,7800,984,11.2
"27065",27,65,2011,8709,7834,875,10
"27065",27,65,2012,8732,7947,785,9
"27065",27,65,2013,8793,8077,716,8.1
"27065",27,65,2014,8850,8192,658,7.4
"27065",27,65,2015,8834,8254,580,6.6
"27065",27,65,2016,9025,8439,586,6.5
"27065",27,65,2017,9022,8474,548,6.1
"27067",27,67,1990,19207,18316,891,4.6
"27067",27,67,1991,19448,18478,970,5
"27067",27,67,1992,19322,18349,973,5
"27067",27,67,1993,19704,18802,902,4.6
"27067",27,67,1994,20132,19320,812,4
"27067",27,67,1995,20845,20103,742,3.6
"27067",27,67,1996,21366,20463,903,4.2
"27067",27,67,1997,21470,20727,743,3.5
"27067",27,67,1998,21744,21090,654,3
"27067",27,67,1999,21654,20908,746,3.4
"27067",27,67,2000,22956,22206,750,3.3
"27067",27,67,2001,23223,22399,824,3.5
"27067",27,67,2002,23388,22433,955,4.1
"27067",27,67,2003,23557,22515,1042,4.4
"27067",27,67,2004,23162,22111,1051,4.5
"27067",27,67,2005,23214,22252,962,4.1
"27067",27,67,2006,23206,22302,904,3.9
"27067",27,67,2007,23434,22430,1004,4.3
"27067",27,67,2008,23576,22408,1168,5
"27067",27,67,2009,23968,22368,1600,6.7
"27067",27,67,2010,23568,21997,1571,6.7
"27067",27,67,2011,23643,22229,1414,6
"27067",27,67,2012,23494,22267,1227,5.2
"27067",27,67,2013,23472,22357,1115,4.8
"27067",27,67,2014,23675,22670,1005,4.2
"27067",27,67,2015,24062,23166,896,3.7
"27067",27,67,2016,24279,23358,921,3.8
"27067",27,67,2017,24834,24023,811,3.3
"27069",27,69,1990,2597,2392,205,7.9
"27069",27,69,1991,2544,2344,200,7.9
"27069",27,69,1992,2511,2312,199,7.9
"27069",27,69,1993,2524,2346,178,7.1
"27069",27,69,1994,2500,2343,157,6.3
"27069",27,69,1995,2453,2294,159,6.5
"27069",27,69,1996,2452,2281,171,7
"27069",27,69,1997,2399,2253,146,6.1
"27069",27,69,1998,2305,2172,133,5.8
"27069",27,69,1999,2350,2203,147,6.3
"27069",27,69,2000,2584,2440,144,5.6
"27069",27,69,2001,2647,2510,137,5.2
"27069",27,69,2002,2625,2470,155,5.9
"27069",27,69,2003,2537,2347,190,7.5
"27069",27,69,2004,2690,2510,180,6.7
"27069",27,69,2005,2575,2440,135,5.2
"27069",27,69,2006,2582,2442,140,5.4
"27069",27,69,2007,2486,2344,142,5.7
"27069",27,69,2008,2477,2337,140,5.7
"27069",27,69,2009,2523,2342,181,7.2
"27069",27,69,2010,2576,2382,194,7.5
"27069",27,69,2011,2604,2426,178,6.8
"27069",27,69,2012,2563,2414,149,5.8
"27069",27,69,2013,2419,2274,145,6
"27069",27,69,2014,2390,2273,117,4.9
"27069",27,69,2015,2473,2359,114,4.6
"27069",27,69,2016,2413,2303,110,4.6
"27069",27,69,2017,2381,2291,90,3.8
"27071",27,71,1990,7951,7395,556,7
"27071",27,71,1991,6787,5921,866,12.8
"27071",27,71,1992,6703,6004,699,10.4
"27071",27,71,1993,6619,5844,775,11.7
"27071",27,71,1994,6420,5792,628,9.8
"27071",27,71,1995,6326,5785,541,8.6
"27071",27,71,1996,6684,6153,531,7.9
"27071",27,71,1997,6754,6276,478,7.1
"27071",27,71,1998,6577,6111,466,7.1
"27071",27,71,1999,6538,6104,434,6.6
"27071",27,71,2000,7263,6881,382,5.3
"27071",27,71,2001,7246,6837,409,5.6
"27071",27,71,2002,7251,6815,436,6
"27071",27,71,2003,7188,6719,469,6.5
"27071",27,71,2004,7069,6627,442,6.3
"27071",27,71,2005,6953,6530,423,6.1
"27071",27,71,2006,6648,6210,438,6.6
"27071",27,71,2007,6517,6063,454,7
"27071",27,71,2008,6533,6030,503,7.7
"27071",27,71,2009,6679,6050,629,9.4
"27071",27,71,2010,6938,6336,602,8.7
"27071",27,71,2011,6811,6242,569,8.4
"27071",27,71,2012,6702,6167,535,8
"27071",27,71,2013,6725,6168,557,8.3
"27071",27,71,2014,6433,5889,544,8.5
"27071",27,71,2015,6253,5747,506,8.1
"27071",27,71,2016,6185,5661,524,8.5
"27071",27,71,2017,6026,5602,424,7
"27073",27,73,1990,4049,3910,139,3.4
"27073",27,73,1991,3944,3804,140,3.5
"27073",27,73,1992,3911,3731,180,4.6
"27073",27,73,1993,3943,3775,168,4.3
"27073",27,73,1994,3970,3820,150,3.8
"27073",27,73,1995,3972,3831,141,3.5
"27073",27,73,1996,3990,3852,138,3.5
"27073",27,73,1997,3902,3761,141,3.6
"27073",27,73,1998,3860,3748,112,2.9
"27073",27,73,1999,3775,3649,126,3.3
"27073",27,73,2000,4132,3989,143,3.5
"27073",27,73,2001,4241,4070,171,4
"27073",27,73,2002,4174,4019,155,3.7
"27073",27,73,2003,4080,3902,178,4.4
"27073",27,73,2004,4058,3878,180,4.4
"27073",27,73,2005,4099,3939,160,3.9
"27073",27,73,2006,4092,3939,153,3.7
"27073",27,73,2007,4055,3887,168,4.1
"27073",27,73,2008,4113,3915,198,4.8
"27073",27,73,2009,4333,4069,264,6.1
"27073",27,73,2010,4082,3810,272,6.7
"27073",27,73,2011,3974,3733,241,6.1
"27073",27,73,2012,3856,3662,194,5
"27073",27,73,2013,3667,3462,205,5.6
"27073",27,73,2014,3651,3477,174,4.8
"27073",27,73,2015,3764,3610,154,4.1
"27073",27,73,2016,3632,3477,155,4.3
"27073",27,73,2017,3528,3404,124,3.5
"27075",27,75,1990,5082,4744,338,6.7
"27075",27,75,1991,5293,4829,464,8.8
"27075",27,75,1992,5559,5013,546,9.8
"27075",27,75,1993,5509,5074,435,7.9
"27075",27,75,1994,5555,5210,345,6.2
"27075",27,75,1995,5564,5270,294,5.3
"27075",27,75,1996,5852,5516,336,5.7
"27075",27,75,1997,5829,5529,300,5.1
"27075",27,75,1998,5632,5397,235,4.2
"27075",27,75,1999,5683,5474,209,3.7
"27075",27,75,2000,5932,5680,252,4.2
"27075",27,75,2001,6279,5954,325,5.2
"27075",27,75,2002,6114,5820,294,4.8
"27075",27,75,2003,6068,5781,287,4.7
"27075",27,75,2004,6057,5768,289,4.8
"27075",27,75,2005,6089,5829,260,4.3
"27075",27,75,2006,6078,5829,249,4.1
"27075",27,75,2007,6131,5856,275,4.5
"27075",27,75,2008,6169,5843,326,5.3
"27075",27,75,2009,6195,5634,561,9.1
"27075",27,75,2010,5798,5316,482,8.3
"27075",27,75,2011,5814,5414,400,6.9
"27075",27,75,2012,5828,5478,350,6
"27075",27,75,2013,5775,5417,358,6.2
"27075",27,75,2014,5681,5421,260,4.6
"27075",27,75,2015,5610,5342,268,4.8
"27075",27,75,2016,5438,5092,346,6.4
"27075",27,75,2017,5591,5373,218,3.9
"27077",27,77,1990,2092,2025,67,3.2
"27077",27,77,1991,2159,2082,77,3.6
"27077",27,77,1992,2223,2100,123,5.5
"27077",27,77,1993,2185,2092,93,4.3
"27077",27,77,1994,2326,2225,101,4.3
"27077",27,77,1995,2425,2324,101,4.2
"27077",27,77,1996,2530,2404,126,5
"27077",27,77,1997,2507,2395,112,4.5
"27077",27,77,1998,2514,2412,102,4.1
"27077",27,77,1999,2540,2421,119,4.7
"27077",27,77,2000,2352,2256,96,4.1
"27077",27,77,2001,2343,2238,105,4.5
"27077",27,77,2002,2355,2246,109,4.6
"27077",27,77,2003,2471,2357,114,4.6
"27077",27,77,2004,2469,2350,119,4.8
"27077",27,77,2005,2447,2338,109,4.5
"27077",27,77,2006,2390,2280,110,4.6
"27077",27,77,2007,2298,2182,116,5
"27077",27,77,2008,2272,2135,137,6
"27077",27,77,2009,2273,2101,172,7.6
"27077",27,77,2010,2282,2134,148,6.5
"27077",27,77,2011,2339,2194,145,6.2
"27077",27,77,2012,2347,2204,143,6.1
"27077",27,77,2013,2374,2240,134,5.6
"27077",27,77,2014,2388,2274,114,4.8
"27077",27,77,2015,2422,2315,107,4.4
"27077",27,77,2016,2392,2277,115,4.8
"27077",27,77,2017,2387,2275,112,4.7
"27079",27,79,1990,12040,11336,704,5.8
"27079",27,79,1991,12365,11549,816,6.6
"27079",27,79,1992,12683,11907,776,6.1
"27079",27,79,1993,13002,12239,763,5.9
"27079",27,79,1994,13492,12858,634,4.7
"27079",27,79,1995,13648,13034,614,4.5
"27079",27,79,1996,13897,13214,683,4.9
"27079",27,79,1997,14060,13490,570,4.1
"27079",27,79,1998,14682,14194,488,3.3
"27079",27,79,1999,14789,14297,492,3.3
"27079",27,79,2000,14959,14380,579,3.9
"27079",27,79,2001,15015,14267,748,5
"27079",27,79,2002,15035,14145,890,5.9
"27079",27,79,2003,14788,13850,938,6.3
"27079",27,79,2004,14489,13656,833,5.7
"27079",27,79,2005,14186,13416,770,5.4
"27079",27,79,2006,14165,13403,762,5.4
"27079",27,79,2007,14183,13311,872,6.1
"27079",27,79,2008,14362,13306,1056,7.4
"27079",27,79,2009,14427,12899,1528,10.6
"27079",27,79,2010,15715,14324,1391,8.9
"27079",27,79,2011,15684,14494,1190,7.6
"27079",27,79,2012,15488,14482,1006,6.5
"27079",27,79,2013,15497,14553,944,6.1
"27079",27,79,2014,15484,14649,835,5.4
"27079",27,79,2015,15537,14790,747,4.8
"27079",27,79,2016,15615,14854,761,4.9
"27079",27,79,2017,15803,15066,737,4.7
"27081",27,81,1990,3234,3097,137,4.2
"27081",27,81,1991,3156,3029,127,4
"27081",27,81,1992,3050,2920,130,4.3
"27081",27,81,1993,3173,3019,154,4.9
"27081",27,81,1994,3176,3021,155,4.9
"27081",27,81,1995,3099,2939,160,5.2
"27081",27,81,1996,3097,2939,158,5.1
"27081",27,81,1997,3099,2961,138,4.5
"27081",27,81,1998,3152,3049,103,3.3
"27081",27,81,1999,3043,2930,113,3.7
"27081",27,81,2000,3473,3345,128,3.7
"27081",27,81,2001,3539,3414,125,3.5
"27081",27,81,2002,3425,3298,127,3.7
"27081",27,81,2003,3360,3225,135,4
"27081",27,81,2004,3382,3242,140,4.1
"27081",27,81,2005,3394,3271,123,3.6
"27081",27,81,2006,3315,3195,120,3.6
"27081",27,81,2007,3210,3064,146,4.5
"27081",27,81,2008,3259,3094,165,5.1
"27081",27,81,2009,3376,3180,196,5.8
"27081",27,81,2010,3445,3255,190,5.5
"27081",27,81,2011,3448,3270,178,5.2
"27081",27,81,2012,3422,3260,162,4.7
"27081",27,81,2013,3311,3158,153,4.6
"27081",27,81,2014,3280,3138,142,4.3
"27081",27,81,2015,3392,3273,119,3.5
"27081",27,81,2016,3396,3272,124,3.7
"27081",27,81,2017,3321,3210,111,3.3
"27083",27,83,1990,13139,12570,569,4.3
"27083",27,83,1991,13557,13041,516,3.8
"27083",27,83,1992,14058,13546,512,3.6
"27083",27,83,1993,14740,14226,514,3.5
"27083",27,83,1994,14606,14113,493,3.4
"27083",27,83,1995,14882,14367,515,3.5
"27083",27,83,1996,15152,14613,539,3.6
"27083",27,83,1997,15026,14539,487,3.2
"27083",27,83,1998,15152,14750,402,2.7
"27083",27,83,1999,15058,14662,396,2.6
"27083",27,83,2000,14683,14252,431,2.9
"27083",27,83,2001,14934,14386,548,3.7
"27083",27,83,2002,14507,13942,565,3.9
"27083",27,83,2003,14433,13818,615,4.3
"27083",27,83,2004,14331,13782,549,3.8
"27083",27,83,2005,14619,14139,480,3.3
"27083",27,83,2006,14598,14119,479,3.3
"27083",27,83,2007,14454,13902,552,3.8
"27083",27,83,2008,14557,13913,644,4.4
"27083",27,83,2009,14762,13907,855,5.8
"27083",27,83,2010,15226,14375,851,5.6
"27083",27,83,2011,15396,14586,810,5.3
"27083",27,83,2012,15230,14558,672,4.4
"27083",27,83,2013,15280,14649,631,4.1
"27083",27,83,2014,15284,14732,552,3.6
"27083",27,83,2015,15286,14796,490,3.2
"27083",27,83,2016,15243,14702,541,3.5
"27083",27,83,2017,14987,14506,481,3.2
"27085",27,85,1990,17976,17212,764,4.3
"27085",27,85,1991,18466,17629,837,4.5
"27085",27,85,1992,18941,17959,982,5.2
"27085",27,85,1993,19540,18548,992,5.1
"27085",27,85,1994,19882,19098,784,3.9
"27085",27,85,1995,20089,19373,716,3.6
"27085",27,85,1996,21105,20295,810,3.8
"27085",27,85,1997,21258,20574,684,3.2
"27085",27,85,1998,21169,20546,623,2.9
"27085",27,85,1999,21081,20409,672,3.2
"27085",27,85,2000,20301,19628,673,3.3
"27085",27,85,2001,20234,19496,738,3.6
"27085",27,85,2002,20160,19296,864,4.3
"27085",27,85,2003,20114,19192,922,4.6
"27085",27,85,2004,19858,18938,920,4.6
"27085",27,85,2005,20040,19222,818,4.1
"27085",27,85,2006,20469,19648,821,4
"27085",27,85,2007,20388,19365,1023,5
"27085",27,85,2008,20505,19266,1239,6
"27085",27,85,2009,20157,18242,1915,9.5
"27085",27,85,2010,20307,18487,1820,9
"27085",27,85,2011,20344,18789,1555,7.6
"27085",27,85,2012,19931,18580,1351,6.8
"27085",27,85,2013,20019,18899,1120,5.6
"27085",27,85,2014,19822,18907,915,4.6
"27085",27,85,2015,20203,19411,792,3.9
"27085",27,85,2016,19850,18975,875,4.4
"27085",27,85,2017,19578,18831,747,3.8
"27087",27,87,1990,1850,1637,213,11.5
"27087",27,87,1991,1897,1679,218,11.5
"27087",27,87,1992,2649,2419,230,8.7
"27087",27,87,1993,2788,2524,264,9.5
"27087",27,87,1994,2567,2362,205,8
"27087",27,87,1995,2490,2313,177,7.1
"27087",27,87,1996,2466,2232,234,9.5
"27087",27,87,1997,2417,2183,234,9.7
"27087",27,87,1998,2244,2046,198,8.8
"27087",27,87,1999,2237,2072,165,7.4
"27087",27,87,2000,2479,2335,144,5.8
"27087",27,87,2001,2661,2511,150,5.6
"27087",27,87,2002,2771,2608,163,5.9
"27087",27,87,2003,2717,2572,145,5.3
"27087",27,87,2004,2636,2482,154,5.8
"27087",27,87,2005,2552,2412,140,5.5
"27087",27,87,2006,2493,2355,138,5.5
"27087",27,87,2007,2430,2266,164,6.7
"27087",27,87,2008,2413,2239,174,7.2
"27087",27,87,2009,2437,2248,189,7.8
"27087",27,87,2010,2503,2296,207,8.3
"27087",27,87,2011,2493,2304,189,7.6
"27087",27,87,2012,2478,2306,172,6.9
"27087",27,87,2013,2397,2259,138,5.8
"27087",27,87,2014,2361,2228,133,5.6
"27087",27,87,2015,2405,2267,138,5.7
"27087",27,87,2016,2397,2259,138,5.8
"27087",27,87,2017,2367,2250,117,4.9
"27089",27,89,1990,4968,4347,621,12.5
"27089",27,89,1991,4833,4172,661,13.7
"27089",27,89,1992,4770,4133,637,13.4
"27089",27,89,1993,4856,4245,611,12.6
"27089",27,89,1994,4827,4302,525,10.9
"27089",27,89,1995,4747,4273,474,10
"27089",27,89,1996,4838,4261,577,11.9
"27089",27,89,1997,4813,4276,537,11.2
"27089",27,89,1998,4602,4171,431,9.4
"27089",27,89,1999,4620,4169,451,9.8
"27089",27,89,2000,5211,4796,415,8
"27089",27,89,2001,5238,4872,366,7
"27089",27,89,2002,5275,4868,407,7.7
"27089",27,89,2003,5239,4806,433,8.3
"27089",27,89,2004,5400,4985,415,7.7
"27089",27,89,2005,5289,4915,374,7.1
"27089",27,89,2006,5296,4934,362,6.8
"27089",27,89,2007,5172,4759,413,8
"27089",27,89,2008,5168,4762,406,7.9
"27089",27,89,2009,5350,4827,523,9.8
"27089",27,89,2010,5698,5170,528,9.3
"27089",27,89,2011,5787,5304,483,8.3
"27089",27,89,2012,5746,5306,440,7.7
"27089",27,89,2013,5567,5142,425,7.6
"27089",27,89,2014,5591,5213,378,6.8
"27089",27,89,2015,5743,5348,395,6.9
"27089",27,89,2016,5638,5227,411,7.3
"27089",27,89,2017,5498,5111,387,7
"27091",27,91,1990,11630,11111,519,4.5
"27091",27,91,1991,11822,11080,742,6.3
"27091",27,91,1992,11662,10979,683,5.9
"27091",27,91,1993,11656,10778,878,7.5
"27091",27,91,1994,11700,11129,571,4.9
"27091",27,91,1995,11628,11103,525,4.5
"27091",27,91,1996,11389,10817,572,5
"27091",27,91,1997,11428,11019,409,3.6
"27091",27,91,1998,11306,10929,377,3.3
"27091",27,91,1999,11077,10697,380,3.4
"27091",27,91,2000,11736,11321,415,3.5
"27091",27,91,2001,11998,11530,468,3.9
"27091",27,91,2002,12066,11585,481,4
"27091",27,91,2003,11780,11228,552,4.7
"27091",27,91,2004,11454,10894,560,4.9
"27091",27,91,2005,11241,10776,465,4.1
"27091",27,91,2006,11196,10723,473,4.2
"27091",27,91,2007,11257,10762,495,4.4
"27091",27,91,2008,11492,10930,562,4.9
"27091",27,91,2009,11690,10816,874,7.5
"27091",27,91,2010,11506,10664,842,7.3
"27091",27,91,2011,11212,10468,744,6.6
"27091",27,91,2012,10873,10263,610,5.6
"27091",27,91,2013,10335,9791,544,5.3
"27091",27,91,2014,10220,9739,481,4.7
"27091",27,91,2015,10447,10024,423,4
"27091",27,91,2016,10500,10069,431,4.1
"27091",27,91,2017,10424,10057,367,3.5
"27093",27,93,1990,10192,9530,662,6.5
"27093",27,93,1991,10155,9259,896,8.8
"27093",27,93,1992,9631,8798,833,8.6
"27093",27,93,1993,9608,8829,779,8.1
"27093",27,93,1994,9428,8815,613,6.5
"27093",27,93,1995,9380,8798,582,6.2
"27093",27,93,1996,9606,8966,640,6.7
"27093",27,93,1997,9613,9097,516,5.4
"27093",27,93,1998,9531,9047,484,5.1
"27093",27,93,1999,9497,8993,504,5.3
"27093",27,93,2000,12343,11808,535,4.3
"27093",27,93,2001,12581,11974,607,4.8
"27093",27,93,2002,12622,11972,650,5.1
"27093",27,93,2003,12635,11909,726,5.7
"27093",27,93,2004,12387,11695,692,5.6
"27093",27,93,2005,12352,11725,627,5.1
"27093",27,93,2006,12388,11762,626,5.1
"27093",27,93,2007,12380,11646,734,5.9
"27093",27,93,2008,12498,11673,825,6.6
"27093",27,93,2009,12551,11354,1197,9.5
"27093",27,93,2010,12811,11684,1127,8.8
"27093",27,93,2011,12844,11853,991,7.7
"27093",27,93,2012,12736,11897,839,6.6
"27093",27,93,2013,12741,12036,705,5.5
"27093",27,93,2014,12859,12268,591,4.6
"27093",27,93,2015,13339,12782,557,4.2
"27093",27,93,2016,13311,12714,597,4.5
"27093",27,93,2017,13301,12761,540,4.1
"27095",27,95,1990,8989,8319,670,7.5
"27095",27,95,1991,9013,8200,813,9
"27095",27,95,1992,9983,9197,786,7.9
"27095",27,95,1993,9934,9124,810,8.2
"27095",27,95,1994,9585,8889,696,7.3
"27095",27,95,1995,8962,8234,728,8.1
"27095",27,95,1996,9411,8562,849,9
"27095",27,95,1997,9282,8586,696,7.5
"27095",27,95,1998,9265,8666,599,6.5
"27095",27,95,1999,9465,8881,584,6.2
"27095",27,95,2000,11885,11348,537,4.5
"27095",27,95,2001,11953,11308,645,5.4
"27095",27,95,2002,12006,11240,766,6.4
"27095",27,95,2003,12163,11266,897,7.4
"27095",27,95,2004,12133,11257,876,7.2
"27095",27,95,2005,11974,11174,800,6.7
"27095",27,95,2006,12117,11301,816,6.7
"27095",27,95,2007,12282,11343,939,7.6
"27095",27,95,2008,12317,11203,1114,9
"27095",27,95,2009,12423,10866,1557,12.5
"27095",27,95,2010,13152,11695,1457,11.1
"27095",27,95,2011,12924,11683,1241,9.6
"27095",27,95,2012,12693,11634,1059,8.3
"27095",27,95,2013,12678,11727,951,7.5
"27095",27,95,2014,12681,11831,850,6.7
"27095",27,95,2015,12612,11884,728,5.8
"27095",27,95,2016,12770,12010,760,6
"27095",27,95,2017,12918,12205,713,5.5
"27097",27,97,1990,13913,12589,1324,9.5
"27097",27,97,1991,13963,12572,1391,10
"27097",27,97,1992,14268,12927,1341,9.4
"27097",27,97,1993,14826,13430,1396,9.4
"27097",27,97,1994,14863,13711,1152,7.8
"27097",27,97,1995,14923,13779,1144,7.7
"27097",27,97,1996,15397,14074,1323,8.6
"27097",27,97,1997,15026,13917,1109,7.4
"27097",27,97,1998,15293,14402,891,5.8
"27097",27,97,1999,14915,14009,906,6.1
"27097",27,97,2000,16720,15936,784,4.7
"27097",27,97,2001,17162,16241,921,5.4
"27097",27,97,2002,17320,16329,991,5.7
"27097",27,97,2003,17588,16491,1097,6.2
"27097",27,97,2004,17434,16416,1018,5.8
"27097",27,97,2005,17370,16425,945,5.4
"27097",27,97,2006,17246,16295,951,5.5
"27097",27,97,2007,17315,16250,1065,6.2
"27097",27,97,2008,17683,16346,1337,7.6
"27097",27,97,2009,18341,16321,2020,11
"27097",27,97,2010,18617,16849,1768,9.5
"27097",27,97,2011,18752,17210,1542,8.2
"27097",27,97,2012,17936,16670,1266,7.1
"27097",27,97,2013,17677,16486,1191,6.7
"27097",27,97,2014,17395,16308,1087,6.2
"27097",27,97,2015,17796,16838,958,5.4
"27097",27,97,2016,17931,16927,1004,5.6
"27097",27,97,2017,17713,16765,948,5.4
"27099",27,99,1990,17511,16757,754,4.3
"27099",27,99,1991,18049,17362,687,3.8
"27099",27,99,1992,18283,17615,668,3.7
"27099",27,99,1993,18524,17817,707,3.8
"27099",27,99,1994,18537,17813,724,3.9
"27099",27,99,1995,18577,17981,596,3.2
"27099",27,99,1996,18790,18145,645,3.4
"27099",27,99,1997,19075,18553,522,2.7
"27099",27,99,1998,19037,18629,408,2.1
"27099",27,99,1999,19105,18702,403,2.1
"27099",27,99,2000,19995,19409,586,2.9
"27099",27,99,2001,20266,19570,696,3.4
"27099",27,99,2002,20412,19601,811,4
"27099",27,99,2003,20376,19449,927,4.5
"27099",27,99,2004,20330,19420,910,4.5
"27099",27,99,2005,20333,19559,774,3.8
"27099",27,99,2006,20159,19390,769,3.8
"27099",27,99,2007,20346,19523,823,4
"27099",27,99,2008,20449,19510,939,4.6
"27099",27,99,2009,21020,19709,1311,6.2
"27099",27,99,2010,20908,19634,1274,6.1
"27099",27,99,2011,20818,19641,1177,5.7
"27099",27,99,2012,20661,19630,1031,5
"27099",27,99,2013,20474,19557,917,4.5
"27099",27,99,2014,20280,19505,775,3.8
"27099",27,99,2015,20363,19711,652,3.2
"27099",27,99,2016,20595,19944,651,3.2
"27099",27,99,2017,20575,19991,584,2.8
"27101",27,101,1990,4550,4325,225,4.9
"27101",27,101,1991,4408,4201,207,4.7
"27101",27,101,1992,4496,4229,267,5.9
"27101",27,101,1993,4532,4271,261,5.8
"27101",27,101,1994,4511,4274,237,5.3
"27101",27,101,1995,4411,4160,251,5.7
"27101",27,101,1996,4454,4196,258,5.8
"27101",27,101,1997,4479,4257,222,5
"27101",27,101,1998,4380,4188,192,4.4
"27101",27,101,1999,4372,4194,178,4.1
"27101",27,101,2000,5200,5001,199,3.8
"27101",27,101,2001,5673,5462,211,3.7
"27101",27,101,2002,5499,5290,209,3.8
"27101",27,101,2003,5503,5259,244,4.4
"27101",27,101,2004,5529,5288,241,4.4
"27101",27,101,2005,5395,5176,219,4.1
"27101",27,101,2006,5465,5252,213,3.9
"27101",27,101,2007,5382,5152,230,4.3
"27101",27,101,2008,5431,5155,276,5.1
"27101",27,101,2009,5755,5429,326,5.7
"27101",27,101,2010,5022,4678,344,6.8
"27101",27,101,2011,5039,4725,314,6.2
"27101",27,101,2012,4995,4735,260,5.2
"27101",27,101,2013,4837,4579,258,5.3
"27101",27,101,2014,4859,4622,237,4.9
"27101",27,101,2015,5063,4839,224,4.4
"27101",27,101,2016,4975,4740,235,4.7
"27101",27,101,2017,4898,4686,212,4.3
"27103",27,103,1990,15764,15157,607,3.9
"27103",27,103,1991,16047,15483,564,3.5
"27103",27,103,1992,16564,16007,557,3.4
"27103",27,103,1993,17272,16703,569,3.3
"27103",27,103,1994,17813,17335,478,2.7
"27103",27,103,1995,18037,17509,528,2.9
"27103",27,103,1996,18222,17675,547,3
"27103",27,103,1997,18307,17873,434,2.4
"27103",27,103,1998,18609,18284,325,1.7
"27103",27,103,1999,18532,18183,349,1.9
"27103",27,103,2000,18146,17647,499,2.7
"27103",27,103,2001,18492,17937,555,3
"27103",27,103,2002,18862,18191,671,3.6
"27103",27,103,2003,18811,18091,720,3.8
"27103",27,103,2004,18767,18080,687,3.7
"27103",27,103,2005,18843,18242,601,3.2
"27103",27,103,2006,19331,18725,606,3.1
"27103",27,103,2007,19264,18565,699,3.6
"27103",27,103,2008,19842,18979,863,4.3
"27103",27,103,2009,19951,18704,1247,6.3
"27103",27,103,2010,19782,18575,1207,6.1
"27103",27,103,2011,19939,18924,1015,5.1
"27103",27,103,2012,19739,18839,900,4.6
"27103",27,103,2013,19715,18978,737,3.7
"27103",27,103,2014,19770,19166,604,3.1
"27103",27,103,2015,20308,19774,534,2.6
"27103",27,103,2016,20431,19853,578,2.8
"27103",27,103,2017,20625,20101,524,2.5
"27105",27,105,1990,9973,9622,351,3.5
"27105",27,105,1991,9847,9505,342,3.5
"27105",27,105,1992,9965,9571,394,4
"27105",27,105,1993,10273,9863,410,4
"27105",27,105,1994,10069,9737,332,3.3
"27105",27,105,1995,10122,9717,405,4
"27105",27,105,1996,10314,9932,382,3.7
"27105",27,105,1997,10172,9774,398,3.9
"27105",27,105,1998,9693,9281,412,4.3
"27105",27,105,1999,9694,9390,304,3.1
"27105",27,105,2000,11117,10777,340,3.1
"27105",27,105,2001,11415,11031,384,3.4
"27105",27,105,2002,11285,10912,373,3.3
"27105",27,105,2003,11278,10844,434,3.8
"27105",27,105,2004,11188,10753,435,3.9
"27105",27,105,2005,11095,10730,365,3.3
"27105",27,105,2006,11194,10846,348,3.1
"27105",27,105,2007,11134,10748,386,3.5
"27105",27,105,2008,11144,10681,463,4.2
"27105",27,105,2009,11615,11009,606,5.2
"27105",27,105,2010,11522,10876,646,5.6
"27105",27,105,2011,11485,10880,605,5.3
"27105",27,105,2012,11289,10799,490,4.3
"27105",27,105,2013,11061,10615,446,4
"27105",27,105,2014,11232,10848,384,3.4
"27105",27,105,2015,11526,11158,368,3.2
"27105",27,105,2016,11499,11066,433,3.8
"27105",27,105,2017,11344,10981,363,3.2
"27107",27,107,1990,3515,3306,209,5.9
"27107",27,107,1991,3524,3279,245,7
"27107",27,107,1992,3479,3219,260,7.5
"27107",27,107,1993,3594,3348,246,6.8
"27107",27,107,1994,3584,3379,205,5.7
"27107",27,107,1995,3662,3463,199,5.4
"27107",27,107,1996,3674,3453,221,6
"27107",27,107,1997,3602,3327,275,7.6
"27107",27,107,1998,3423,3242,181,5.3
"27107",27,107,1999,3383,3210,173,5.1
"27107",27,107,2000,3731,3562,169,4.5
"27107",27,107,2001,3787,3625,162,4.3
"27107",27,107,2002,3767,3587,180,4.8
"27107",27,107,2003,3693,3495,198,5.4
"27107",27,107,2004,3746,3557,189,5
"27107",27,107,2005,3619,3451,168,4.6
"27107",27,107,2006,3601,3422,179,5
"27107",27,107,2007,3551,3370,181,5.1
"27107",27,107,2008,3536,3337,199,5.6
"27107",27,107,2009,3596,3366,230,6.4
"27107",27,107,2010,3603,3355,248,6.9
"27107",27,107,2011,3649,3405,244,6.7
"27107",27,107,2012,3522,3314,208,5.9
"27107",27,107,2013,3312,3122,190,5.7
"27107",27,107,2014,3315,3149,166,5
"27107",27,107,2015,3441,3281,160,4.6
"27107",27,107,2016,3455,3290,165,4.8
"27107",27,107,2017,3408,3246,162,4.8
"27109",27,109,1990,62072,60334,1738,2.8
"27109",27,109,1991,63842,62028,1814,2.8
"27109",27,109,1992,64346,62473,1873,2.9
"27109",27,109,1993,65419,63362,2057,3.1
"27109",27,109,1994,64540,62276,2264,3.5
"27109",27,109,1995,64374,62484,1890,2.9
"27109",27,109,1996,65493,63516,1977,3
"27109",27,109,1997,67923,66454,1469,2.2
"27109",27,109,1998,71231,70042,1189,1.7
"27109",27,109,1999,74143,72670,1473,2
"27109",27,109,2000,72757,70797,1960,2.7
"27109",27,109,2001,74134,72033,2101,2.8
"27109",27,109,2002,75905,72983,2922,3.8
"27109",27,109,2003,76609,73293,3316,4.3
"27109",27,109,2004,77837,74710,3127,4
"27109",27,109,2005,78290,75583,2707,3.5
"27109",27,109,2006,78568,75882,2686,3.4
"27109",27,109,2007,79951,76931,3020,3.8
"27109",27,109,2008,79968,76415,3553,4.4
"27109",27,109,2009,81545,76566,4979,6.1
"27109",27,109,2010,81197,76368,4829,5.9
"27109",27,109,2011,81313,77037,4276,5.3
"27109",27,109,2012,82541,78892,3649,4.4
"27109",27,109,2013,83374,80035,3339,4
"27109",27,109,2014,83053,80187,2866,3.5
"27109",27,109,2015,83903,81462,2441,2.9
"27109",27,109,2016,85535,82990,2545,3
"27109",27,109,2017,86420,84085,2335,2.7
"27111",27,111,1990,24577,23073,1504,6.1
"27111",27,111,1991,24709,23115,1594,6.5
"27111",27,111,1992,25088,23361,1727,6.9
"27111",27,111,1993,25669,23794,1875,7.3
"27111",27,111,1994,25938,24493,1445,5.6
"27111",27,111,1995,26615,25135,1480,5.6
"27111",27,111,1996,27818,26154,1664,6
"27111",27,111,1997,27753,26334,1419,5.1
"27111",27,111,1998,27417,26273,1144,4.2
"27111",27,111,1999,27678,26503,1175,4.2
"27111",27,111,2000,29381,28152,1229,4.2
"27111",27,111,2001,29620,28306,1314,4.4
"27111",27,111,2002,29785,28288,1497,5
"27111",27,111,2003,30016,28371,1645,5.5
"27111",27,111,2004,29806,28245,1561,5.2
"27111",27,111,2005,29550,28123,1427,4.8
"27111",27,111,2006,29160,27742,1418,4.9
"27111",27,111,2007,29322,27773,1549,5.3
"27111",27,111,2008,29643,27837,1806,6.1
"27111",27,111,2009,30228,27822,2406,8
"27111",27,111,2010,30869,28657,2212,7.2
"27111",27,111,2011,30890,28916,1974,6.4
"27111",27,111,2012,30777,29067,1710,5.6
"27111",27,111,2013,30867,29246,1621,5.3
"27111",27,111,2014,30884,29481,1403,4.5
"27111",27,111,2015,31118,29815,1303,4.2
"27111",27,111,2016,31411,30045,1366,4.3
"27111",27,111,2017,31757,30498,1259,4
"27113",27,113,1990,6756,6131,625,9.3
"27113",27,113,1991,6936,6201,735,10.6
"27113",27,113,1992,6968,6308,660,9.5
"27113",27,113,1993,7206,6627,579,8
"27113",27,113,1994,7477,7010,467,6.2
"27113",27,113,1995,7657,7185,472,6.2
"27113",27,113,1996,7997,7482,515,6.4
"27113",27,113,1997,8071,7627,444,5.5
"27113",27,113,1998,8124,7741,383,4.7
"27113",27,113,1999,8123,7652,471,5.8
"27113",27,113,2000,7692,7229,463,6
"27113",27,113,2001,7875,7475,400,5.1
"27113",27,113,2002,7902,7441,461,5.8
"27113",27,113,2003,7995,7508,487,6.1
"27113",27,113,2004,8131,7601,530,6.5
"27113",27,113,2005,8194,7742,452,5.5
"27113",27,113,2006,8358,7897,461,5.5
"27113",27,113,2007,8550,7961,589,6.9
"27113",27,113,2008,8718,8100,618,7.1
"27113",27,113,2009,8975,8184,791,8.8
"27113",27,113,2010,8398,7639,759,9
"27113",27,113,2011,8559,7903,656,7.7
"27113",27,113,2012,8589,8022,567,6.6
"27113",27,113,2013,8656,8109,547,6.3
"27113",27,113,2014,8844,8388,456,5.2
"27113",27,113,2015,9078,8614,464,5.1
"27113",27,113,2016,9076,8555,521,5.7
"27113",27,113,2017,8831,8326,505,5.7
"27115",27,115,1990,9231,8247,984,10.7
"27115",27,115,1991,9384,8316,1068,11.4
"27115",27,115,1992,10532,9457,1075,10.2
"27115",27,115,1993,11364,10278,1086,9.6
"27115",27,115,1994,10982,9989,993,9
"27115",27,115,1995,11256,10344,912,8.1
"27115",27,115,1996,11378,10374,1004,8.8
"27115",27,115,1997,11403,10537,866,7.6
"27115",27,115,1998,11285,10577,708,6.3
"27115",27,115,1999,11304,10597,707,6.3
"27115",27,115,2000,13456,12744,712,5.3
"27115",27,115,2001,13942,13074,868,6.2
"27115",27,115,2002,14551,13615,936,6.4
"27115",27,115,2003,14718,13701,1017,6.9
"27115",27,115,2004,14776,13777,999,6.8
"27115",27,115,2005,13666,12768,898,6.6
"27115",27,115,2006,13593,12711,882,6.5
"27115",27,115,2007,13713,12664,1049,7.6
"27115",27,115,2008,14161,12950,1211,8.6
"27115",27,115,2009,14543,12919,1624,11.2
"27115",27,115,2010,15355,13848,1507,9.8
"27115",27,115,2011,15150,13817,1333,8.8
"27115",27,115,2012,14881,13761,1120,7.5
"27115",27,115,2013,14831,13805,1026,6.9
"27115",27,115,2014,14605,13709,896,6.1
"27115",27,115,2015,14784,13964,820,5.5
"27115",27,115,2016,14892,14025,867,5.8
"27115",27,115,2017,15044,14198,846,5.6
"27117",27,117,1990,4866,4556,310,6.4
"27117",27,117,1991,4832,4598,234,4.8
"27117",27,117,1992,4855,4626,229,4.7
"27117",27,117,1993,4989,4720,269,5.4
"27117",27,117,1994,4996,4812,184,3.7
"27117",27,117,1995,5042,4869,173,3.4
"27117",27,117,1996,5237,5047,190,3.6
"27117",27,117,1997,5168,4994,174,3.4
"27117",27,117,1998,5108,4969,139,2.7
"27117",27,117,1999,4976,4835,141,2.8
"27117",27,117,2000,5421,5235,186,3.4
"27117",27,117,2001,5569,5381,188,3.4
"27117",27,117,2002,5483,5307,176,3.2
"27117",27,117,2003,5478,5266,212,3.9
"27117",27,117,2004,5157,4937,220,4.3
"27117",27,117,2005,5049,4866,183,3.6
"27117",27,117,2006,5097,4927,170,3.3
"27117",27,117,2007,5292,5094,198,3.7
"27117",27,117,2008,5615,5366,249,4.4
"27117",27,117,2009,5578,5225,353,6.3
"27117",27,117,2010,5148,4809,339,6.6
"27117",27,117,2011,5031,4704,327,6.5
"27117",27,117,2012,4906,4662,244,5
"27117",27,117,2013,4689,4473,216,4.6
"27117",27,117,2014,4783,4602,181,3.8
"27117",27,117,2015,4977,4811,166,3.3
"27117",27,117,2016,4919,4732,187,3.8
"27117",27,117,2017,4909,4741,168,3.4
"27119",27,119,1990,15182,14108,1074,7.1
"27119",27,119,1991,15561,14615,946,6.1
"27119",27,119,1992,15902,14937,965,6.1
"27119",27,119,1993,16385,15449,936,5.7
"27119",27,119,1994,16842,15888,954,5.7
"27119",27,119,1995,16958,16094,864,5.1
"27119",27,119,1996,17156,16177,979,5.7
"27119",27,119,1997,16867,15922,945,5.6
"27119",27,119,1998,16843,16232,611,3.6
"27119",27,119,1999,17116,16488,628,3.7
"27119",27,119,2000,15846,15080,766,4.8
"27119",27,119,2001,15941,15167,774,4.9
"27119",27,119,2002,16231,15322,909,5.6
"27119",27,119,2003,16562,15711,851,5.1
"27119",27,119,2004,16634,15754,880,5.3
"27119",27,119,2005,16899,16140,759,4.5
"27119",27,119,2006,17063,16271,792,4.6
"27119",27,119,2007,16675,15910,765,4.6
"27119",27,119,2008,16893,16044,849,5
"27119",27,119,2009,17149,16141,1008,5.9
"27119",27,119,2010,17156,16019,1137,6.6
"27119",27,119,2011,17420,16196,1224,7
"27119",27,119,2012,17506,16418,1088,6.2
"27119",27,119,2013,17100,16180,920,5.4
"27119",27,119,2014,17088,16300,788,4.6
"27119",27,119,2015,17165,16443,722,4.2
"27119",27,119,2016,17210,16464,746,4.3
"27119",27,119,2017,17043,16321,722,4.2
"27121",27,121,1990,4935,4660,275,5.6
"27121",27,121,1991,4878,4597,281,5.8
"27121",27,121,1992,5160,4872,288,5.6
"27121",27,121,1993,5209,4901,308,5.9
"27121",27,121,1994,5254,4999,255,4.9
"27121",27,121,1995,5303,5081,222,4.2
"27121",27,121,1996,5478,5214,264,4.8
"27121",27,121,1997,5562,5353,209,3.8
"27121",27,121,1998,5577,5396,181,3.2
"27121",27,121,1999,5485,5318,167,3
"27121",27,121,2000,5879,5700,179,3
"27121",27,121,2001,6056,5835,221,3.6
"27121",27,121,2002,6053,5818,235,3.9
"27121",27,121,2003,6204,5950,254,4.1
"27121",27,121,2004,6132,5878,254,4.1
"27121",27,121,2005,6093,5858,235,3.9
"27121",27,121,2006,6180,5940,240,3.9
"27121",27,121,2007,6101,5830,271,4.4
"27121",27,121,2008,6093,5769,324,5.3
"27121",27,121,2009,6249,5805,444,7.1
"27121",27,121,2010,5880,5461,419,7.1
"27121",27,121,2011,5860,5515,345,5.9
"27121",27,121,2012,5944,5667,277,4.7
"27121",27,121,2013,5964,5710,254,4.3
"27121",27,121,2014,6224,5997,227,3.6
"27121",27,121,2015,6389,6167,222,3.5
"27121",27,121,2016,6326,6102,224,3.5
"27121",27,121,2017,6371,6176,195,3.1
"27123",27,123,1990,271999,261185,10814,4
"27123",27,123,1991,270739,258819,11920,4.4
"27123",27,123,1992,272507,260625,11882,4.4
"27123",27,123,1993,272280,261265,11015,4
"27123",27,123,1994,273792,264783,9009,3.3
"27123",27,123,1995,277271,269077,8194,3
"27123",27,123,1996,278373,269496,8877,3.2
"27123",27,123,1997,279897,272466,7431,2.7
"27123",27,123,1998,281652,275526,6126,2.2
"27123",27,123,1999,283934,277426,6508,2.3
"27123",27,123,2000,286658,278404,8254,2.9
"27123",27,123,2001,285372,275427,9945,3.5
"27123",27,123,2002,282104,269783,12321,4.4
"27123",27,123,2003,279615,266120,13495,4.8
"27123",27,123,2004,275725,262848,12877,4.7
"27123",27,123,2005,271356,260757,10599,3.9
"27123",27,123,2006,268666,258249,10417,3.9
"27123",27,123,2007,271469,259552,11917,4.4
"27123",27,123,2008,271843,257550,14293,5.3
"27123",27,123,2009,270603,250001,20602,7.6
"27123",27,123,2010,270063,249935,20128,7.5
"27123",27,123,2011,272394,254310,18084,6.6
"27123",27,123,2012,272944,257259,15685,5.7
"27123",27,123,2013,275220,261715,13505,4.9
"27123",27,123,2014,277378,266200,11178,4
"27123",27,123,2015,279593,269768,9825,3.5
"27123",27,123,2016,283461,273252,10209,3.6
"27123",27,123,2017,287472,278210,9262,3.2
"27125",27,125,1990,2079,1759,320,15.4
"27125",27,125,1991,2063,1755,308,14.9
"27125",27,125,1992,2069,1733,336,16.2
"27125",27,125,1993,2076,1793,283,13.6
"27125",27,125,1994,2048,1811,237,11.6
"27125",27,125,1995,2010,1799,211,10.5
"27125",27,125,1996,2036,1785,251,12.3
"27125",27,125,1997,1998,1789,209,10.5
"27125",27,125,1998,1899,1736,163,8.6
"27125",27,125,1999,1897,1721,176,9.3
"27125",27,125,2000,2212,2047,165,7.5
"27125",27,125,2001,2238,2079,159,7.1
"27125",27,125,2002,2213,2028,185,8.4
"27125",27,125,2003,2189,2016,173,7.9
"27125",27,125,2004,2250,2075,175,7.8
"27125",27,125,2005,2235,2082,153,6.8
"27125",27,125,2006,2223,2074,149,6.7
"27125",27,125,2007,2297,2111,186,8.1
"27125",27,125,2008,2361,2174,187,7.9
"27125",27,125,2009,2432,2187,245,10.1
"27125",27,125,2010,2419,2187,232,9.6
"27125",27,125,2011,2424,2228,196,8.1
"27125",27,125,2012,2340,2171,169,7.2
"27125",27,125,2013,2255,2103,152,6.7
"27125",27,125,2014,2259,2128,131,5.8
"27125",27,125,2015,2329,2193,136,5.8
"27125",27,125,2016,2298,2130,168,7.3
"27125",27,125,2017,2255,2107,148,6.6
"27127",27,127,1990,8404,8139,265,3.2
"27127",27,127,1991,9333,9066,267,2.9
"27127",27,127,1992,9574,9222,352,3.7
"27127",27,127,1993,8456,8076,380,4.5
"27127",27,127,1994,9109,8821,288,3.2
"27127",27,127,1995,8859,8587,272,3.1
"27127",27,127,1996,9203,8845,358,3.9
"27127",27,127,1997,9079,8787,292,3.2
"27127",27,127,1998,9149,8890,259,2.8
"27127",27,127,1999,8954,8702,252,2.8
"27127",27,127,2000,8915,8629,286,3.2
"27127",27,127,2001,8989,8626,363,4
"27127",27,127,2002,8834,8478,356,4
"27127",27,127,2003,8614,8223,391,4.5
"27127",27,127,2004,8425,8046,379,4.5
"27127",27,127,2005,8201,7884,317,3.9
"27127",27,127,2006,8088,7760,328,4.1
"27127",27,127,2007,8272,7882,390,4.7
"27127",27,127,2008,8089,7651,438,5.4
"27127",27,127,2009,8438,7870,568,6.7
"27127",27,127,2010,8580,8002,578,6.7
"27127",27,127,2011,8385,7878,507,6
"27127",27,127,2012,8205,7752,453,5.5
"27127",27,127,2013,8051,7610,441,5.5
"27127",27,127,2014,8002,7649,353,4.4
"27127",27,127,2015,8269,7946,323,3.9
"27127",27,127,2016,8351,8009,342,4.1
"27127",27,127,2017,7702,7385,317,4.1
"27129",27,129,1990,8257,7751,506,6.1
"27129",27,129,1991,8283,7819,464,5.6
"27129",27,129,1992,8052,7514,538,6.7
"27129",27,129,1993,9251,8657,594,6.4
"27129",27,129,1994,8371,7858,513,6.1
"27129",27,129,1995,8287,7871,416,5
"27129",27,129,1996,8470,7996,474,5.6
"27129",27,129,1997,8288,7916,372,4.5
"27129",27,129,1998,8303,7929,374,4.5
"27129",27,129,1999,8174,7791,383,4.7
"27129",27,129,2000,9182,8813,369,4
"27129",27,129,2001,9250,8785,465,5
"27129",27,129,2002,9070,8627,443,4.9
"27129",27,129,2003,8953,8473,480,5.4
"27129",27,129,2004,8807,8307,500,5.7
"27129",27,129,2005,8437,8024,413,4.9
"27129",27,129,2006,8284,7882,402,4.9
"27129",27,129,2007,8482,8037,445,5.2
"27129",27,129,2008,8682,8181,501,5.8
"27129",27,129,2009,8771,8083,688,7.8
"27129",27,129,2010,8993,8269,724,8.1
"27129",27,129,2011,8545,7919,626,7.3
"27129",27,129,2012,8426,7855,571,6.8
"27129",27,129,2013,8238,7702,536,6.5
"27129",27,129,2014,8204,7754,450,5.5
"27129",27,129,2015,8592,8181,411,4.8
"27129",27,129,2016,8447,8003,444,5.3
"27129",27,129,2017,8900,8500,400,4.5
"27131",27,131,1990,27341,26127,1214,4.4
"27131",27,131,1991,27884,26411,1473,5.3
"27131",27,131,1992,28000,26431,1569,5.6
"27131",27,131,1993,27918,26462,1456,5.2
"27131",27,131,1994,27911,26582,1329,4.8
"27131",27,131,1995,28202,27046,1156,4.1
"27131",27,131,1996,28774,27608,1166,4.1
"27131",27,131,1997,28936,27981,955,3.3
"27131",27,131,1998,28812,27982,830,2.9
"27131",27,131,1999,28512,27686,826,2.9
"27131",27,131,2000,31616,30628,988,3.1
"27131",27,131,2001,32330,31174,1156,3.6
"27131",27,131,2002,32960,31478,1482,4.5
"27131",27,131,2003,33086,31492,1594,4.8
"27131",27,131,2004,32383,30829,1554,4.8
"27131",27,131,2005,31538,30121,1417,4.5
"27131",27,131,2006,31709,30340,1369,4.3
"27131",27,131,2007,32138,30545,1593,5
"27131",27,131,2008,32732,30805,1927,5.9
"27131",27,131,2009,33630,30775,2855,8.5
"27131",27,131,2010,34985,32264,2721,7.8
"27131",27,131,2011,34771,32464,2307,6.6
"27131",27,131,2012,34862,32836,2026,5.8
"27131",27,131,2013,34992,33260,1732,4.9
"27131",27,131,2014,35108,33663,1445,4.1
"27131",27,131,2015,35425,34175,1250,3.5
"27131",27,131,2016,36241,34971,1270,3.5
"27131",27,131,2017,36629,35466,1163,3.2
"27133",27,133,1990,4816,4690,126,2.6
"27133",27,133,1991,4737,4609,128,2.7
"27133",27,133,1992,4668,4531,137,2.9
"27133",27,133,1993,4765,4632,133,2.8
"27133",27,133,1994,4976,4838,138,2.8
"27133",27,133,1995,5037,4912,125,2.5
"27133",27,133,1996,5108,4966,142,2.8
"27133",27,133,1997,5104,4979,125,2.4
"27133",27,133,1998,4740,4566,174,3.7
"27133",27,133,1999,4744,4611,133,2.8
"27133",27,133,2000,5250,5106,144,2.7
"27133",27,133,2001,5324,5187,137,2.6
"27133",27,133,2002,5357,5194,163,3
"27133",27,133,2003,5237,5055,182,3.5
"27133",27,133,2004,5055,4883,172,3.4
"27133",27,133,2005,5184,5027,157,3
"27133",27,133,2006,4964,4825,139,2.8
"27133",27,133,2007,4925,4769,156,3.2
"27133",27,133,2008,4945,4754,191,3.9
"27133",27,133,2009,5052,4784,268,5.3
"27133",27,133,2010,5377,5105,272,5.1
"27133",27,133,2011,5617,5380,237,4.2
"27133",27,133,2012,5546,5344,202,3.6
"27133",27,133,2013,5626,5446,180,3.2
"27133",27,133,2014,5673,5529,144,2.5
"27133",27,133,2015,5909,5784,125,2.1
"27133",27,133,2016,5932,5795,137,2.3
"27133",27,133,2017,5912,5790,122,2.1
"27135",27,135,1990,8058,7686,372,4.6
"27135",27,135,1991,8343,7760,583,7
"27135",27,135,1992,8126,7756,370,4.6
"27135",27,135,1993,8213,7787,426,5.2
"27135",27,135,1994,8475,8152,323,3.8
"27135",27,135,1995,8871,8540,331,3.7
"27135",27,135,1996,9271,8743,528,5.7
"27135",27,135,1997,9351,8848,503,5.4
"27135",27,135,1998,9097,8742,355,3.9
"27135",27,135,1999,9026,8662,364,4
"27135",27,135,2000,9309,8967,342,3.7
"27135",27,135,2001,9498,9163,335,3.5
"27135",27,135,2002,9843,9326,517,5.3
"27135",27,135,2003,10194,9449,745,7.3
"27135",27,135,2004,10127,9667,460,4.5
"27135",27,135,2005,10185,9672,513,5
"27135",27,135,2006,10127,9487,640,6.3
"27135",27,135,2007,9755,9140,615,6.3
"27135",27,135,2008,9562,9089,473,4.9
"27135",27,135,2009,9533,8809,724,7.6
"27135",27,135,2010,8685,8130,555,6.4
"27135",27,135,2011,8528,8072,456,5.3
"27135",27,135,2012,8537,8134,403,4.7
"27135",27,135,2013,8614,8235,379,4.4
"27135",27,135,2014,8813,8489,324,3.7
"27135",27,135,2015,8602,8262,340,4
"27135",27,135,2016,8279,7856,423,5.1
"27135",27,135,2017,8157,7758,399,4.9
"27137",27,137,1990,93710,87687,6023,6.4
"27137",27,137,1991,96730,89963,6767,7
"27137",27,137,1992,98520,91030,7490,7.6
"27137",27,137,1993,98600,91185,7415,7.5
"27137",27,137,1994,99324,92842,6482,6.5
"27137",27,137,1995,100966,95194,5772,5.7
"27137",27,137,1996,101784,96001,5783,5.7
"27137",27,137,1997,102947,97857,5090,4.9
"27137",27,137,1998,103756,99546,4210,4.1
"27137",27,137,1999,103980,99832,4148,4
"27137",27,137,2000,103527,98964,4563,4.4
"27137",27,137,2001,103362,97442,5920,5.7
"27137",27,137,2002,103270,97438,5832,5.6
"27137",27,137,2003,103199,96753,6446,6.2
"27137",27,137,2004,102426,96444,5982,5.8
"27137",27,137,2005,101353,96270,5083,5
"27137",27,137,2006,101848,96738,5110,5
"27137",27,137,2007,103338,97591,5747,5.6
"27137",27,137,2008,104443,97825,6618,6.3
"27137",27,137,2009,105614,95965,9649,9.1
"27137",27,137,2010,103374,94990,8384,8.1
"27137",27,137,2011,102271,94758,7513,7.3
"27137",27,137,2012,101564,94964,6600,6.5
"27137",27,137,2013,102216,96029,6187,6.1
"27137",27,137,2014,102285,97080,5205,5.1
"27137",27,137,2015,101926,96884,5042,4.9
"27137",27,137,2016,102995,97111,5884,5.7
"27137",27,137,2017,102698,97937,4761,4.6
"27139",27,139,1990,33552,32046,1506,4.5
"27139",27,139,1991,34579,32831,1748,5.1
"27139",27,139,1992,35821,34145,1676,4.7
"27139",27,139,1993,37427,35799,1628,4.3
"27139",27,139,1994,39220,37956,1264,3.2
"27139",27,139,1995,41133,39874,1259,3.1
"27139",27,139,1996,42817,41509,1308,3.1
"27139",27,139,1997,45018,43914,1104,2.5
"27139",27,139,1998,46978,45939,1039,2.2
"27139",27,139,1999,49569,48469,1100,2.2
"27139",27,139,2000,54351,52918,1433,2.6
"27139",27,139,2001,57894,55967,1927,3.3
"27139",27,139,2002,61168,58653,2515,4.1
"27139",27,139,2003,64052,61279,2773,4.3
"27139",27,139,2004,67139,64460,2679,4
"27139",27,139,2005,69821,67345,2476,3.5
"27139",27,139,2006,71811,69311,2500,3.5
"27139",27,139,2007,73099,70143,2956,4
"27139",27,139,2008,74340,70646,3694,5
"27139",27,139,2009,74949,69500,5449,7.3
"27139",27,139,2010,74150,69064,5086,6.9
"27139",27,139,2011,74896,70578,4318,5.8
"27139",27,139,2012,75799,72024,3775,5
"27139",27,139,2013,76971,73598,3373,4.4
"27139",27,139,2014,78168,75351,2817,3.6
"27139",27,139,2015,79160,76693,2467,3.1
"27139",27,139,2016,81013,78411,2602,3.2
"27139",27,139,2017,82194,79824,2370,2.9
"27141",27,141,1990,22580,21330,1250,5.5
"27141",27,141,1991,23338,21934,1404,6
"27141",27,141,1992,24416,23018,1398,5.7
"27141",27,141,1993,25809,24337,1472,5.7
"27141",27,141,1994,27016,25904,1112,4.1
"27141",27,141,1995,28658,27517,1141,4
"27141",27,141,1996,30142,28901,1241,4.1
"27141",27,141,1997,31601,30544,1057,3.3
"27141",27,141,1998,32948,32071,877,2.7
"27141",27,141,1999,34768,33868,900,2.6
"27141",27,141,2000,37904,36748,1156,3
"27141",27,141,2001,39496,38001,1495,3.8
"27141",27,141,2002,41524,39552,1972,4.7
"27141",27,141,2003,43310,41090,2220,5.1
"27141",27,141,2004,45025,42780,2245,5
"27141",27,141,2005,46529,44513,2016,4.3
"27141",27,141,2006,48064,45991,2073,4.3
"27141",27,141,2007,48738,46299,2439,5
"27141",27,141,2008,49592,46531,3061,6.2
"27141",27,141,2009,49293,44821,4472,9.1
"27141",27,141,2010,48989,44866,4123,8.4
"27141",27,141,2011,48872,45383,3489,7.1
"27141",27,141,2012,48620,45611,3009,6.2
"27141",27,141,2013,48786,46184,2602,5.3
"27141",27,141,2014,49205,46971,2234,4.5
"27141",27,141,2015,49472,47496,1976,4
"27141",27,141,2016,50884,48816,2068,4.1
"27141",27,141,2017,51601,49675,1926,3.7
"27143",27,143,1990,6911,6563,348,5
"27143",27,143,1991,6832,6450,382,5.6
"27143",27,143,1992,6741,6298,443,6.6
"27143",27,143,1993,6817,6318,499,7.3
"27143",27,143,1994,6877,6486,391,5.7
"27143",27,143,1995,6856,6494,362,5.3
"27143",27,143,1996,6912,6532,380,5.5
"27143",27,143,1997,6788,6472,316,4.7
"27143",27,143,1998,6667,6393,274,4.1
"27143",27,143,1999,6589,6325,264,4
"27143",27,143,2000,8801,8512,289,3.3
"27143",27,143,2001,9007,8658,349,3.9
"27143",27,143,2002,9038,8643,395,4.4
"27143",27,143,2003,9028,8589,439,4.9
"27143",27,143,2004,8899,8455,444,5
"27143",27,143,2005,8874,8504,370,4.2
"27143",27,143,2006,8731,8365,366,4.2
"27143",27,143,2007,8694,8256,438,5
"27143",27,143,2008,8650,8109,541,6.3
"27143",27,143,2009,8892,8193,699,7.9
"27143",27,143,2010,8506,7836,670,7.9
"27143",27,143,2011,8500,7915,585,6.9
"27143",27,143,2012,8418,7915,503,6
"27143",27,143,2013,8320,7863,457,5.5
"27143",27,143,2014,8268,7886,382,4.6
"27143",27,143,2015,8510,8158,352,4.1
"27143",27,143,2016,8525,8161,364,4.3
"27143",27,143,2017,8513,8208,305,3.6
"27145",27,145,1990,65911,62252,3659,5.6
"27145",27,145,1991,67793,63940,3853,5.7
"27145",27,145,1992,68686,65220,3466,5
"27145",27,145,1993,70351,66925,3426,4.9
"27145",27,145,1994,71459,68497,2962,4.1
"27145",27,145,1995,73550,70503,3047,4.1
"27145",27,145,1996,75102,71401,3701,4.9
"27145",27,145,1997,74531,71492,3039,4.1
"27145",27,145,1998,75116,72796,2320,3.1
"27145",27,145,1999,78428,76149,2279,2.9
"27145",27,145,2000,78375,75921,2454,3.1
"27145",27,145,2001,79619,76602,3017,3.8
"27145",27,145,2002,79745,76257,3488,4.4
"27145",27,145,2003,79727,75928,3799,4.8
"27145",27,145,2004,79928,76262,3666,4.6
"27145",27,145,2005,80640,77165,3475,4.3
"27145",27,145,2006,81617,78355,3262,4
"27145",27,145,2007,83223,79426,3797,4.6
"27145",27,145,2008,83513,78874,4639,5.6
"27145",27,145,2009,84273,77734,6539,7.8
"27145",27,145,2010,85674,79494,6180,7.2
"27145",27,145,2011,85989,80611,5378,6.3
"27145",27,145,2012,86268,81613,4655,5.4
"27145",27,145,2013,86690,82446,4244,4.9
"27145",27,145,2014,87725,84143,3582,4.1
"27145",27,145,2015,88137,84962,3175,3.6
"27145",27,145,2016,89277,85917,3360,3.8
"27145",27,145,2017,90157,87116,3041,3.4
"27147",27,147,1990,16800,16206,594,3.5
"27147",27,147,1991,16848,16029,819,4.9
"27147",27,147,1992,16991,16196,795,4.7
"27147",27,147,1993,17516,16800,716,4.1
"27147",27,147,1994,17904,17239,665,3.7
"27147",27,147,1995,18213,17508,705,3.9
"27147",27,147,1996,18875,18189,686,3.6
"27147",27,147,1997,19082,18489,593,3.1
"27147",27,147,1998,19674,19213,461,2.3
"27147",27,147,1999,19635,19145,490,2.5
"27147",27,147,2000,19513,18943,570,2.9
"27147",27,147,2001,19658,18910,748,3.8
"27147",27,147,2002,19534,18659,875,4.5
"27147",27,147,2003,19429,18469,960,4.9
"27147",27,147,2004,19612,18705,907,4.6
"27147",27,147,2005,19668,18858,810,4.1
"27147",27,147,2006,20014,19222,792,4
"27147",27,147,2007,20401,19523,878,4.3
"27147",27,147,2008,20797,19742,1055,5.1
"27147",27,147,2009,20813,19025,1788,8.6
"27147",27,147,2010,21063,19426,1637,7.8
"27147",27,147,2011,21118,19753,1365,6.5
"27147",27,147,2012,21570,20400,1170,5.4
"27147",27,147,2013,21395,20419,976,4.6
"27147",27,147,2014,21303,20498,805,3.8
"27147",27,147,2015,21203,20498,705,3.3
"27147",27,147,2016,21269,20512,757,3.6
"27147",27,147,2017,20561,19867,694,3.4
"27149",27,149,1990,5252,4958,294,5.6
"27149",27,149,1991,5115,4890,225,4.4
"27149",27,149,1992,5125,4911,214,4.2
"27149",27,149,1993,5259,5042,217,4.1
"27149",27,149,1994,5342,5139,203,3.8
"27149",27,149,1995,5358,5173,185,3.5
"27149",27,149,1996,5597,5399,198,3.5
"27149",27,149,1997,5569,5403,166,3
"27149",27,149,1998,5591,5447,144,2.6
"27149",27,149,1999,5594,5435,159,2.8
"27149",27,149,2000,5706,5509,197,3.5
"27149",27,149,2001,5763,5565,198,3.4
"27149",27,149,2002,5793,5580,213,3.7
"27149",27,149,2003,5718,5494,224,3.9
"27149",27,149,2004,5655,5436,219,3.9
"27149",27,149,2005,5528,5328,200,3.6
"27149",27,149,2006,5665,5473,192,3.4
"27149",27,149,2007,5640,5430,210,3.7
"27149",27,149,2008,5626,5364,262,4.7
"27149",27,149,2009,5630,5329,301,5.3
"27149",27,149,2010,5547,5238,309,5.6
"27149",27,149,2011,5587,5315,272,4.9
"27149",27,149,2012,5606,5369,237,4.2
"27149",27,149,2013,5510,5303,207,3.8
"27149",27,149,2014,5569,5388,181,3.3
"27149",27,149,2015,5709,5549,160,2.8
"27149",27,149,2016,5672,5502,170,3
"27149",27,149,2017,5526,5379,147,2.7
"27151",27,151,1990,4640,4423,217,4.7
"27151",27,151,1991,4682,4413,269,5.7
"27151",27,151,1992,4756,4447,309,6.5
"27151",27,151,1993,5006,4733,273,5.5
"27151",27,151,1994,5134,4894,240,4.7
"27151",27,151,1995,5305,5058,247,4.7
"27151",27,151,1996,5545,5254,291,5.2
"27151",27,151,1997,5670,5438,232,4.1
"27151",27,151,1998,5645,5469,176,3.1
"27151",27,151,1999,5566,5349,217,3.9
"27151",27,151,2000,5683,5462,221,3.9
"27151",27,151,2001,5753,5495,258,4.5
"27151",27,151,2002,5617,5344,273,4.9
"27151",27,151,2003,5493,5220,273,5
"27151",27,151,2004,5417,5143,274,5.1
"27151",27,151,2005,5281,5041,240,4.5
"27151",27,151,2006,5298,5068,230,4.3
"27151",27,151,2007,5313,5036,277,5.2
"27151",27,151,2008,5223,4905,318,6.1
"27151",27,151,2009,5507,5113,394,7.2
"27151",27,151,2010,5239,4815,424,8.1
"27151",27,151,2011,5194,4823,371,7.1
"27151",27,151,2012,5084,4771,313,6.2
"27151",27,151,2013,4894,4609,285,5.8
"27151",27,151,2014,4869,4633,236,4.8
"27151",27,151,2015,5170,4860,310,6
"27151",27,151,2016,5066,4794,272,5.4
"27151",27,151,2017,5045,4838,207,4.1
"27153",27,153,1990,10340,9531,809,7.8
"27153",27,153,1991,10256,9400,856,8.3
"27153",27,153,1992,10202,9357,845,8.3
"27153",27,153,1993,10555,9746,809,7.7
"27153",27,153,1994,10377,9658,719,6.9
"27153",27,153,1995,10259,9540,719,7
"27153",27,153,1996,10436,9620,816,7.8
"27153",27,153,1997,9838,9156,682,6.9
"27153",27,153,1998,9351,8839,512,5.5
"27153",27,153,1999,9332,8851,481,5.2
"27153",27,153,2000,12395,11909,486,3.9
"27153",27,153,2001,12721,12151,570,4.5
"27153",27,153,2002,12849,12222,627,4.9
"27153",27,153,2003,12840,12192,648,5
"27153",27,153,2004,12756,12095,661,5.2
"27153",27,153,2005,12448,11819,629,5.1
"27153",27,153,2006,12351,11713,638,5.2
"27153",27,153,2007,12228,11565,663,5.4
"27153",27,153,2008,12194,11396,798,6.5
"27153",27,153,2009,12534,11417,1117,8.9
"27153",27,153,2010,13519,12471,1048,7.8
"27153",27,153,2011,13296,12393,903,6.8
"27153",27,153,2012,13033,12277,756,5.8
"27153",27,153,2013,12851,12166,685,5.3
"27153",27,153,2014,12818,12221,597,4.7
"27153",27,153,2015,13008,12440,568,4.4
"27153",27,153,2016,12956,12346,610,4.7
"27153",27,153,2017,13476,12938,538,4
"27155",27,155,1990,1889,1793,96,5.1
"27155",27,155,1991,1812,1721,91,5
"27155",27,155,1992,1764,1669,95,5.4
"27155",27,155,1993,1789,1695,94,5.3
"27155",27,155,1994,1904,1824,80,4.2
"27155",27,155,1995,1850,1760,90,4.9
"27155",27,155,1996,1909,1810,99,5.2
"27155",27,155,1997,1855,1771,84,4.5
"27155",27,155,1998,1854,1778,76,4.1
"27155",27,155,1999,1754,1656,98,5.6
"27155",27,155,2000,1818,1730,88,4.8
"27155",27,155,2001,1869,1783,86,4.6
"27155",27,155,2002,1931,1847,84,4.4
"27155",27,155,2003,1903,1816,87,4.6
"27155",27,155,2004,1952,1866,86,4.4
"27155",27,155,2005,1850,1780,70,3.8
"27155",27,155,2006,1900,1819,81,4.3
"27155",27,155,2007,1839,1744,95,5.2
"27155",27,155,2008,1758,1662,96,5.5
"27155",27,155,2009,1791,1672,119,6.6
"27155",27,155,2010,1881,1764,117,6.2
"27155",27,155,2011,1843,1733,110,6
"27155",27,155,2012,1775,1686,89,5
"27155",27,155,2013,1660,1576,84,5.1
"27155",27,155,2014,1712,1633,79,4.6
"27155",27,155,2015,1835,1759,76,4.1
"27155",27,155,2016,1714,1647,67,3.9
"27155",27,155,2017,1789,1726,63,3.5
"27157",27,157,1990,10264,9814,450,4.4
"27157",27,157,1991,10426,9887,539,5.2
"27157",27,157,1992,10900,10379,521,4.8
"27157",27,157,1993,11013,10509,504,4.6
"27157",27,157,1994,11769,11266,503,4.3
"27157",27,157,1995,11896,11404,492,4.1
"27157",27,157,1996,12223,11657,566,4.6
"27157",27,157,1997,12243,11836,407,3.3
"27157",27,157,1998,12429,12106,323,2.6
"27157",27,157,1999,12727,12426,301,2.4
"27157",27,157,2000,12323,11961,362,2.9
"27157",27,157,2001,12514,12096,418,3.3
"27157",27,157,2002,12571,12094,477,3.8
"27157",27,157,2003,12606,12055,551,4.4
"27157",27,157,2004,12669,12111,558,4.4
"27157",27,157,2005,12593,12080,513,4.1
"27157",27,157,2006,12469,11967,502,4
"27157",27,157,2007,12215,11672,543,4.4
"27157",27,157,2008,12085,11476,609,5
"27157",27,157,2009,12261,11329,932,7.6
"27157",27,157,2010,12107,11242,865,7.1
"27157",27,157,2011,11954,11217,737,6.2
"27157",27,157,2012,11959,11340,619,5.2
"27157",27,157,2013,11829,11284,545,4.6
"27157",27,157,2014,11727,11254,473,4
"27157",27,157,2015,11993,11541,452,3.8
"27157",27,157,2016,12059,11615,444,3.7
"27157",27,157,2017,12078,11674,404,3.3
"27159",27,159,1990,5874,5462,412,7
"27159",27,159,1991,5823,5389,434,7.5
"27159",27,159,1992,5819,5408,411,7.1
"27159",27,159,1993,5922,5543,379,6.4
"27159",27,159,1994,6078,5728,350,5.8
"27159",27,159,1995,6262,5926,336,5.4
"27159",27,159,1996,6400,5964,436,6.8
"27159",27,159,1997,6774,6382,392,5.8
"27159",27,159,1998,7012,6664,348,5
"27159",27,159,1999,7208,6824,384,5.3
"27159",27,159,2000,6697,6349,348,5.2
"27159",27,159,2001,6673,6279,394,5.9
"27159",27,159,2002,6674,6265,409,6.1
"27159",27,159,2003,6684,6242,442,6.6
"27159",27,159,2004,6671,6239,432,6.5
"27159",27,159,2005,6424,5993,431,6.7
"27159",27,159,2006,6293,5865,428,6.8
"27159",27,159,2007,6271,5805,466,7.4
"27159",27,159,2008,6506,5975,531,8.2
"27159",27,159,2009,6559,5845,714,10.9
"27159",27,159,2010,6483,5822,661,10.2
"27159",27,159,2011,6319,5750,569,9
"27159",27,159,2012,6229,5743,486,7.8
"27159",27,159,2013,6166,5735,431,7
"27159",27,159,2014,6142,5760,382,6.2
"27159",27,159,2015,6328,5955,373,5.9
"27159",27,159,2016,6271,5900,371,5.9
"27159",27,159,2017,5831,5502,329,5.6
"27161",27,161,1990,9558,9195,363,3.8
"27161",27,161,1991,9304,8870,434,4.7
"27161",27,161,1992,9170,8707,463,5
"27161",27,161,1993,8968,8455,513,5.7
"27161",27,161,1994,8926,8539,387,4.3
"27161",27,161,1995,9445,9105,340,3.6
"27161",27,161,1996,9621,9210,411,4.3
"27161",27,161,1997,9763,9460,303,3.1
"27161",27,161,1998,9685,9404,281,2.9
"27161",27,161,1999,9700,9393,307,3.2
"27161",27,161,2000,10615,10294,321,3
"27161",27,161,2001,10699,10302,397,3.7
"27161",27,161,2002,10674,10182,492,4.6
"27161",27,161,2003,10671,10165,506,4.7
"27161",27,161,2004,10610,10123,487,4.6
"27161",27,161,2005,10446,9990,456,4.4
"27161",27,161,2006,10501,10073,428,4.1
"27161",27,161,2007,10257,9770,487,4.7
"27161",27,161,2008,10494,9928,566,5.4
"27161",27,161,2009,10492,9633,859,8.2
"27161",27,161,2010,10577,9786,791,7.5
"27161",27,161,2011,10582,9916,666,6.3
"27161",27,161,2012,10213,9625,588,5.8
"27161",27,161,2013,9926,9380,546,5.5
"27161",27,161,2014,9672,9206,466,4.8
"27161",27,161,2015,9752,9350,402,4.1
"27161",27,161,2016,9502,9095,407,4.3
"27161",27,161,2017,9392,9025,367,3.9
"27163",27,163,1990,83089,79983,3106,3.7
"27163",27,163,1991,85782,82127,3655,4.3
"27163",27,163,1992,89385,85714,3671,4.1
"27163",27,163,1993,94115,90548,3567,3.8
"27163",27,163,1994,99334,96496,2838,2.9
"27163",27,163,1995,103726,100986,2740,2.6
"27163",27,163,1996,108351,105472,2879,2.7
"27163",27,163,1997,111434,109111,2323,2.1
"27163",27,163,1998,114926,112900,2026,1.8
"27163",27,163,1999,119117,116975,2142,1.8
"27163",27,163,2000,118092,115159,2933,2.5
"27163",27,163,2001,119974,116379,3595,3
"27163",27,163,2002,120946,116297,4649,3.8
"27163",27,163,2003,122962,117815,5147,4.2
"27163",27,163,2004,123805,118788,5017,4.1
"27163",27,163,2005,125591,121213,4378,3.5
"27163",27,163,2006,127484,122962,4522,3.5
"27163",27,163,2007,127837,122731,5106,4
"27163",27,163,2008,129322,122858,6464,5
"27163",27,163,2009,128886,119550,9336,7.2
"27163",27,163,2010,132046,123188,8858,6.7
"27163",27,163,2011,133063,125221,7842,5.9
"27163",27,163,2012,133686,126811,6875,5.1
"27163",27,163,2013,134883,128912,5971,4.4
"27163",27,163,2014,136056,131103,4953,3.6
"27163",27,163,2015,137160,132839,4321,3.2
"27163",27,163,2016,139341,134693,4648,3.3
"27163",27,163,2017,141336,137106,4230,3
"27165",27,165,1990,5693,5496,197,3.5
"27165",27,165,1991,5747,5472,275,4.8
"27165",27,165,1992,5856,5588,268,4.6
"27165",27,165,1993,5889,5646,243,4.1
"27165",27,165,1994,5808,5605,203,3.5
"27165",27,165,1995,5787,5538,249,4.3
"27165",27,165,1996,5902,5659,243,4.1
"27165",27,165,1997,5883,5684,199,3.4
"27165",27,165,1998,5694,5527,167,2.9
"27165",27,165,1999,5794,5575,219,3.8
"27165",27,165,2000,6059,5856,203,3.4
"27165",27,165,2001,6117,5904,213,3.5
"27165",27,165,2002,6058,5816,242,4
"27165",27,165,2003,5963,5671,292,4.9
"27165",27,165,2004,5878,5607,271,4.6
"27165",27,165,2005,5749,5512,237,4.1
"27165",27,165,2006,5632,5386,246,4.4
"27165",27,165,2007,5487,5211,276,5
"27165",27,165,2008,5470,5113,357,6.5
"27165",27,165,2009,5585,5092,493,8.8
"27165",27,165,2010,6311,5850,461,7.3
"27165",27,165,2011,6267,5871,396,6.3
"27165",27,165,2012,6285,5932,353,5.6
"27165",27,165,2013,6179,5853,326,5.3
"27165",27,165,2014,6160,5857,303,4.9
"27165",27,165,2015,6251,5960,291,4.7
"27165",27,165,2016,6602,6281,321,4.9
"27165",27,165,2017,6491,6205,286,4.4
"27167",27,167,1990,3661,3485,176,4.8
"27167",27,167,1991,3570,3389,181,5.1
"27167",27,167,1992,3602,3461,141,3.9
"27167",27,167,1993,3503,3365,138,3.9
"27167",27,167,1994,4027,3871,156,3.9
"27167",27,167,1995,3847,3691,156,4.1
"27167",27,167,1996,4008,3856,152,3.8
"27167",27,167,1997,3997,3896,101,2.5
"27167",27,167,1998,3974,3889,85,2.1
"27167",27,167,1999,4048,3958,90,2.2
"27167",27,167,2000,3698,3585,113,3.1
"27167",27,167,2001,3577,3436,141,3.9
"27167",27,167,2002,3761,3616,145,3.9
"27167",27,167,2003,3769,3621,148,3.9
"27167",27,167,2004,3674,3534,140,3.8
"27167",27,167,2005,3604,3472,132,3.7
"27167",27,167,2006,3558,3425,133,3.7
"27167",27,167,2007,3484,3352,132,3.8
"27167",27,167,2008,3490,3337,153,4.4
"27167",27,167,2009,3544,3354,190,5.4
"27167",27,167,2010,3822,3613,209,5.5
"27167",27,167,2011,3818,3605,213,5.6
"27167",27,167,2012,3781,3603,178,4.7
"27167",27,167,2013,3625,3474,151,4.2
"27167",27,167,2014,3593,3471,122,3.4
"27167",27,167,2015,3690,3568,122,3.3
"27167",27,167,2016,3734,3613,121,3.2
"27167",27,167,2017,3574,3462,112,3.1
"27169",27,169,1990,26694,25184,1510,5.7
"27169",27,169,1991,26661,25084,1577,5.9
"27169",27,169,1992,26564,25240,1324,5
"27169",27,169,1993,27848,26542,1306,4.7
"27169",27,169,1994,27996,26974,1022,3.7
"27169",27,169,1995,28090,27050,1040,3.7
"27169",27,169,1996,28455,27349,1106,3.9
"27169",27,169,1997,28461,27559,902,3.2
"27169",27,169,1998,28418,27764,654,2.3
"27169",27,169,1999,28213,27471,742,2.6
"27169",27,169,2000,28956,28055,901,3.1
"27169",27,169,2001,28846,27785,1061,3.7
"27169",27,169,2002,28712,27543,1169,4.1
"27169",27,169,2003,28170,26832,1338,4.7
"27169",27,169,2004,27973,26744,1229,4.4
"27169",27,169,2005,28262,27240,1022,3.6
"27169",27,169,2006,28500,27488,1012,3.6
"27169",27,169,2007,28603,27411,1192,4.2
"27169",27,169,2008,28929,27547,1382,4.8
"27169",27,169,2009,28884,26673,2211,7.7
"27169",27,169,2010,29217,27196,2021,6.9
"27169",27,169,2011,29435,27721,1714,5.8
"27169",27,169,2012,29823,28363,1460,4.9
"27169",27,169,2013,29580,28287,1293,4.4
"27169",27,169,2014,29347,28252,1095,3.7
"27169",27,169,2015,29474,28500,974,3.3
"27169",27,169,2016,29375,28335,1040,3.5
"27169",27,169,2017,29057,28152,905,3.1
"27171",27,171,1990,37538,35441,2097,5.6
"27171",27,171,1991,38418,36015,2403,6.3
"27171",27,171,1992,39404,37064,2340,5.9
"27171",27,171,1993,40592,38264,2328,5.7
"27171",27,171,1994,41795,39999,1796,4.3
"27171",27,171,1995,43327,41580,1747,4
"27171",27,171,1996,44941,43101,1840,4.1
"27171",27,171,1997,46151,44585,1566,3.4
"27171",27,171,1998,47366,46024,1342,2.8
"27171",27,171,1999,49226,47836,1390,2.8
"27171",27,171,2000,52598,50909,1689,3.2
"27171",27,171,2001,54097,52035,2062,3.8
"27171",27,171,2002,56431,53694,2737,4.9
"27171",27,171,2003,58927,55893,3034,5.1
"27171",27,171,2004,61075,58061,3014,4.9
"27171",27,171,2005,62757,60088,2669,4.3
"27171",27,171,2006,64671,61904,2767,4.3
"27171",27,171,2007,66107,62767,3340,5.1
"27171",27,171,2008,67440,63324,4116,6.1
"27171",27,171,2009,68094,62001,6093,8.9
"27171",27,171,2010,70095,64461,5634,8
"27171",27,171,2011,70299,65495,4804,6.8
"27171",27,171,2012,70288,66174,4114,5.9
"27171",27,171,2013,70559,66999,3560,5
"27171",27,171,2014,71193,68190,3003,4.2
"27171",27,171,2015,71983,69347,2636,3.7
"27171",27,171,2016,73378,70551,2827,3.9
"27171",27,171,2017,74355,71749,2606,3.5
"27173",27,173,1990,5370,5137,233,4.3
"27173",27,173,1991,5375,5116,259,4.8
"27173",27,173,1992,5489,5190,299,5.4
"27173",27,173,1993,5892,5594,298,5.1
"27173",27,173,1994,5449,5155,294,5.4
"27173",27,173,1995,5417,5141,276,5.1
"27173",27,173,1996,5455,5154,301,5.5
"27173",27,173,1997,5359,5110,249,4.6
"27173",27,173,1998,5373,5178,195,3.6
"27173",27,173,1999,5328,5100,228,4.3
"27173",27,173,2000,5738,5493,245,4.3
"27173",27,173,2001,5804,5498,306,5.3
"27173",27,173,2002,5690,5422,268,4.7
"27173",27,173,2003,5682,5362,320,5.6
"27173",27,173,2004,5519,5235,284,5.1
"27173",27,173,2005,5513,5281,232,4.2
"27173",27,173,2006,5572,5344,228,4.1
"27173",27,173,2007,5687,5444,243,4.3
"27173",27,173,2008,5847,5550,297,5.1
"27173",27,173,2009,5874,5497,377,6.4
"27173",27,173,2010,5878,5508,370,6.3
"27173",27,173,2011,5743,5415,328,5.7
"27173",27,173,2012,5679,5394,285,5
"27173",27,173,2013,5541,5269,272,4.9
"27173",27,173,2014,5488,5260,228,4.2
"27173",27,173,2015,5576,5372,204,3.7
"27173",27,173,2016,5498,5288,210,3.8
"27173",27,173,2017,5345,5156,189,3.5
"28001",28,1,1990,15095,13887,1208,8
"28001",28,1,1991,15065,13487,1578,10.5
"28001",28,1,1992,14671,13491,1180,8
"28001",28,1,1993,14928,13817,1111,7.4
"28001",28,1,1994,15105,13926,1179,7.8
"28001",28,1,1995,14703,13614,1089,7.4
"28001",28,1,1996,14263,13286,977,6.8
"28001",28,1,1997,15007,13673,1334,8.9
"28001",28,1,1998,14746,13541,1205,8.2
"28001",28,1,1999,14599,13326,1273,8.7
"28001",28,1,2000,14574,13663,911,6.3
"28001",28,1,2001,14048,13115,933,6.6
"28001",28,1,2002,13887,12869,1018,7.3
"28001",28,1,2003,13622,12469,1153,8.5
"28001",28,1,2004,13344,12339,1005,7.5
"28001",28,1,2005,13403,12187,1216,9.1
"28001",28,1,2006,13227,12329,898,6.8
"28001",28,1,2007,13391,12539,852,6.4
"28001",28,1,2008,13488,12614,874,6.5
"28001",28,1,2009,12807,11637,1170,9.1
"28001",28,1,2010,12608,11162,1446,11.5
"28001",28,1,2011,12915,11523,1392,10.8
"28001",28,1,2012,12366,11141,1225,9.9
"28001",28,1,2013,11835,10732,1103,9.3
"28001",28,1,2014,11603,10636,967,8.3
"28001",28,1,2015,11414,10503,911,8
"28001",28,1,2016,11264,10332,932,8.3
"28001",28,1,2017,11205,10388,817,7.3
"28003",28,3,1990,15629,14123,1506,9.6
"28003",28,3,1991,15653,13994,1659,10.6
"28003",28,3,1992,15551,14152,1399,9
"28003",28,3,1993,15600,14489,1111,7.1
"28003",28,3,1994,15948,14611,1337,8.4
"28003",28,3,1995,15573,14223,1350,8.7
"28003",28,3,1996,15174,13669,1505,9.9
"28003",28,3,1997,15570,14321,1249,8
"28003",28,3,1998,14676,13697,979,6.7
"28003",28,3,1999,15127,14340,787,5.2
"28003",28,3,2000,16751,15938,813,4.9
"28003",28,3,2001,16339,15422,917,5.6
"28003",28,3,2002,15970,14709,1261,7.9
"28003",28,3,2003,15860,14688,1172,7.4
"28003",28,3,2004,15910,14852,1058,6.6
"28003",28,3,2005,15986,14873,1113,7
"28003",28,3,2006,15434,14319,1115,7.2
"28003",28,3,2007,15416,14359,1057,6.9
"28003",28,3,2008,15249,14091,1158,7.6
"28003",28,3,2009,14874,13110,1764,11.9
"28003",28,3,2010,15721,13906,1815,11.5
"28003",28,3,2011,16192,14435,1757,10.9
"28003",28,3,2012,16001,14608,1393,8.7
"28003",28,3,2013,15378,14183,1195,7.8
"28003",28,3,2014,15136,14130,1006,6.6
"28003",28,3,2015,15724,14837,887,5.6
"28003",28,3,2016,15837,15014,823,5.2
"28003",28,3,2017,16095,15387,708,4.4
"28005",28,5,1990,5026,4718,308,6.1
"28005",28,5,1991,5039,4695,344,6.8
"28005",28,5,1992,5048,4693,355,7
"28005",28,5,1993,5192,4819,373,7.2
"28005",28,5,1994,5079,4770,309,6.1
"28005",28,5,1995,5256,4978,278,5.3
"28005",28,5,1996,5412,5142,270,5
"28005",28,5,1997,5461,5235,226,4.1
"28005",28,5,1998,5610,5377,233,4.2
"28005",28,5,1999,5746,5463,283,4.9
"28005",28,5,2000,5569,5274,295,5.3
"28005",28,5,2001,5317,5042,275,5.2
"28005",28,5,2002,5233,4879,354,6.8
"28005",28,5,2003,5364,4904,460,8.6
"28005",28,5,2004,5215,4872,343,6.6
"28005",28,5,2005,5267,4830,437,8.3
"28005",28,5,2006,5152,4840,312,6.1
"28005",28,5,2007,5157,4833,324,6.3
"28005",28,5,2008,5211,4848,363,7
"28005",28,5,2009,4950,4423,527,10.6
"28005",28,5,2010,4979,4385,594,11.9
"28005",28,5,2011,4993,4421,572,11.5
"28005",28,5,2012,4762,4284,478,10
"28005",28,5,2013,4549,4134,415,9.1
"28005",28,5,2014,4449,4093,356,8
"28005",28,5,2015,4515,4173,342,7.6
"28005",28,5,2016,4514,4182,332,7.4
"28005",28,5,2017,4509,4209,300,6.7
"28007",28,7,1990,8008,7185,823,10.3
"28007",28,7,1991,8015,7003,1012,12.6
"28007",28,7,1992,7696,6789,907,11.8
"28007",28,7,1993,7743,6891,852,11
"28007",28,7,1994,7942,7278,664,8.4
"28007",28,7,1995,7982,7374,608,7.6
"28007",28,7,1996,7819,6989,830,10.6
"28007",28,7,1997,7579,6856,723,9.5
"28007",28,7,1998,7678,6993,685,8.9
"28007",28,7,1999,7760,7103,657,8.5
"28007",28,7,2000,8377,7786,591,7.1
"28007",28,7,2001,7995,7426,569,7.1
"28007",28,7,2002,8759,8120,639,7.3
"28007",28,7,2003,8486,7824,662,7.8
"28007",28,7,2004,7841,7223,618,7.9
"28007",28,7,2005,7659,7034,625,8.2
"28007",28,7,2006,7452,6880,572,7.7
"28007",28,7,2007,7349,6795,554,7.5
"28007",28,7,2008,7304,6655,649,8.9
"28007",28,7,2009,6937,6011,926,13.3
"28007",28,7,2010,7955,6957,998,12.5
"28007",28,7,2011,7982,7090,892,11.2
"28007",28,7,2012,7585,6841,744,9.8
"28007",28,7,2013,7251,6572,679,9.4
"28007",28,7,2014,7044,6430,614,8.7
"28007",28,7,2015,6985,6453,532,7.6
"28007",28,7,2016,7022,6551,471,6.7
"28007",28,7,2017,6938,6512,426,6.1
"28009",28,9,1990,3333,2996,337,10.1
"28009",28,9,1991,3183,2811,372,11.7
"28009",28,9,1992,3124,2850,274,8.8
"28009",28,9,1993,3111,2907,204,6.6
"28009",28,9,1994,3186,2963,223,7
"28009",28,9,1995,3219,2890,329,10.2
"28009",28,9,1996,3153,2875,278,8.8
"28009",28,9,1997,3206,3047,159,5
"28009",28,9,1998,3293,3100,193,5.9
"28009",28,9,1999,3208,3005,203,6.3
"28009",28,9,2000,3214,3006,208,6.5
"28009",28,9,2001,2930,2729,201,6.9
"28009",28,9,2002,2987,2654,333,11.1
"28009",28,9,2003,2955,2640,315,10.7
"28009",28,9,2004,2897,2631,266,9.2
"28009",28,9,2005,2987,2691,296,9.9
"28009",28,9,2006,2936,2675,261,8.9
"28009",28,9,2007,2913,2641,272,9.3
"28009",28,9,2008,2883,2565,318,11
"28009",28,9,2009,2788,2393,395,14.2
"28009",28,9,2010,3273,2865,408,12.5
"28009",28,9,2011,3388,2969,419,12.4
"28009",28,9,2012,3290,2941,349,10.6
"28009",28,9,2013,3136,2808,328,10.5
"28009",28,9,2014,2979,2701,278,9.3
"28009",28,9,2015,2984,2746,238,8
"28009",28,9,2016,3051,2846,205,6.7
"28009",28,9,2017,3054,2885,169,5.5
"28011",28,11,1990,16829,15346,1483,8.8
"28011",28,11,1991,17389,15860,1529,8.8
"28011",28,11,1992,17803,16208,1595,9
"28011",28,11,1993,18429,16598,1831,9.9
"28011",28,11,1994,18549,16855,1694,9.1
"28011",28,11,1995,17980,16395,1585,8.8
"28011",28,11,1996,17580,15941,1639,9.3
"28011",28,11,1997,17073,15419,1654,9.7
"28011",28,11,1998,16815,15364,1451,8.6
"28011",28,11,1999,16761,15514,1247,7.4
"28011",28,11,2000,16316,15149,1167,7.2
"28011",28,11,2001,15864,14747,1117,7
"28011",28,11,2002,15839,14272,1567,9.9
"28011",28,11,2003,15761,14499,1262,8
"28011",28,11,2004,15619,14335,1284,8.2
"28011",28,11,2005,15524,14105,1419,9.1
"28011",28,11,2006,15642,14362,1280,8.2
"28011",28,11,2007,15573,14323,1250,8
"28011",28,11,2008,15271,13982,1289,8.4
"28011",28,11,2009,14740,13176,1564,10.6
"28011",28,11,2010,14909,13212,1697,11.4
"28011",28,11,2011,15023,13348,1675,11.1
"28011",28,11,2012,14400,12871,1529,10.6
"28011",28,11,2013,13795,12321,1474,10.7
"28011",28,11,2014,13310,12039,1271,9.5
"28011",28,11,2015,13389,12338,1051,7.8
"28011",28,11,2016,13416,12445,971,7.2
"28011",28,11,2017,12985,12147,838,6.5
"28013",28,13,1990,7213,6584,629,8.7
"28013",28,13,1991,7016,6473,543,7.7
"28013",28,13,1992,7255,6787,468,6.5
"28013",28,13,1993,7298,6955,343,4.7
"28013",28,13,1994,7264,6922,342,4.7
"28013",28,13,1995,7124,6814,310,4.4
"28013",28,13,1996,6896,6525,371,5.4
"28013",28,13,1997,6576,6154,422,6.4
"28013",28,13,1998,6368,5980,388,6.1
"28013",28,13,1999,6231,5971,260,4.2
"28013",28,13,2000,6963,6568,395,5.7
"28013",28,13,2001,6699,6149,550,8.2
"28013",28,13,2002,6577,6073,504,7.7
"28013",28,13,2003,6564,6078,486,7.4
"28013",28,13,2004,6432,5995,437,6.8
"28013",28,13,2005,6324,5878,446,7.1
"28013",28,13,2006,6216,5744,472,7.6
"28013",28,13,2007,6072,5582,490,8.1
"28013",28,13,2008,5986,5458,528,8.8
"28013",28,13,2009,5864,5214,650,11.1
"28013",28,13,2010,7025,6376,649,9.2
"28013",28,13,2011,7115,6495,620,8.7
"28013",28,13,2012,6746,6185,561,8.3
"28013",28,13,2013,6403,5865,538,8.4
"28013",28,13,2014,6240,5775,465,7.5
"28013",28,13,2015,6138,5760,378,6.2
"28013",28,13,2016,6191,5859,332,5.4
"28013",28,13,2017,6130,5866,264,4.3
"28015",28,15,1990,4080,3770,310,7.6
"28015",28,15,1991,4081,3674,407,10
"28015",28,15,1992,4094,3810,284,6.9
"28015",28,15,1993,4250,4001,249,5.9
"28015",28,15,1994,4430,4164,266,6
"28015",28,15,1995,4432,4186,246,5.6
"28015",28,15,1996,4475,4223,252,5.6
"28015",28,15,1997,4479,4206,273,6.1
"28015",28,15,1998,4321,4088,233,5.4
"28015",28,15,1999,4453,4222,231,5.2
"28015",28,15,2000,5051,4764,287,5.7
"28015",28,15,2001,4964,4674,290,5.8
"28015",28,15,2002,5021,4670,351,7
"28015",28,15,2003,5043,4741,302,6
"28015",28,15,2004,4810,4524,286,5.9
"28015",28,15,2005,4811,4480,331,6.9
"28015",28,15,2006,4846,4565,281,5.8
"28015",28,15,2007,4996,4680,316,6.3
"28015",28,15,2008,4895,4552,343,7
"28015",28,15,2009,4740,4231,509,10.7
"28015",28,15,2010,3834,3330,504,13.1
"28015",28,15,2011,3804,3341,463,12.2
"28015",28,15,2012,3676,3271,405,11
"28015",28,15,2013,3473,3106,367,10.6
"28015",28,15,2014,3412,3089,323,9.5
"28015",28,15,2015,3460,3177,283,8.2
"28015",28,15,2016,3568,3308,260,7.3
"28015",28,15,2017,3597,3388,209,5.8
"28017",28,17,1990,9608,8256,1352,14.1
"28017",28,17,1991,9323,8193,1130,12.1
"28017",28,17,1992,9059,8162,897,9.9
"28017",28,17,1993,8987,8249,738,8.2
"28017",28,17,1994,8871,8170,701,7.9
"28017",28,17,1995,8491,7550,941,11.1
"28017",28,17,1996,8639,7784,855,9.9
"28017",28,17,1997,8312,7498,814,9.8
"28017",28,17,1998,7871,7173,698,8.9
"28017",28,17,1999,7703,7218,485,6.3
"28017",28,17,2000,8826,8355,471,5.3
"28017",28,17,2001,8373,7526,847,10.1
"28017",28,17,2002,8014,7235,779,9.7
"28017",28,17,2003,7907,7217,690,8.7
"28017",28,17,2004,7862,7224,638,8.1
"28017",28,17,2005,7768,7063,705,9.1
"28017",28,17,2006,7629,6965,664,8.7
"28017",28,17,2007,7427,6688,739,10
"28017",28,17,2008,7254,6478,776,10.7
"28017",28,17,2009,7103,6161,942,13.3
"28017",28,17,2010,7944,6989,955,12
"28017",28,17,2011,8255,7312,943,11.4
"28017",28,17,2012,7992,7174,818,10.2
"28017",28,17,2013,7609,6797,812,10.7
"28017",28,17,2014,7206,6507,699,9.7
"28017",28,17,2015,7151,6602,549,7.7
"28017",28,17,2016,7100,6633,467,6.6
"28017",28,17,2017,7075,6704,371,5.2
"28019",28,19,1990,3766,3417,349,9.3
"28019",28,19,1991,3577,3157,420,11.7
"28019",28,19,1992,3409,2997,412,12.1
"28019",28,19,1993,3399,3076,323,9.5
"28019",28,19,1994,3312,3056,256,7.7
"28019",28,19,1995,3554,3217,337,9.5
"28019",28,19,1996,3319,3014,305,9.2
"28019",28,19,1997,3176,2905,271,8.5
"28019",28,19,1998,2959,2764,195,6.6
"28019",28,19,1999,3102,2863,239,7.7
"28019",28,19,2000,4050,3748,302,7.5
"28019",28,19,2001,3850,3501,349,9.1
"28019",28,19,2002,3666,3225,441,12
"28019",28,19,2003,3619,3226,393,10.9
"28019",28,19,2004,3663,3366,297,8.1
"28019",28,19,2005,3609,3336,273,7.6
"28019",28,19,2006,3462,3205,257,7.4
"28019",28,19,2007,3480,3219,261,7.5
"28019",28,19,2008,3427,3157,270,7.9
"28019",28,19,2009,3329,2923,406,12.2
"28019",28,19,2010,3766,3322,444,11.8
"28019",28,19,2011,3807,3419,388,10.2
"28019",28,19,2012,3724,3386,338,9.1
"28019",28,19,2013,3746,3427,319,8.5
"28019",28,19,2014,3578,3287,291,8.1
"28019",28,19,2015,3711,3479,232,6.3
"28019",28,19,2016,3731,3520,211,5.7
"28019",28,19,2017,3677,3498,179,4.9
"28021",28,21,1990,4121,3495,626,15.2
"28021",28,21,1991,3770,3058,712,18.9
"28021",28,21,1992,4021,3408,613,15.2
"28021",28,21,1993,3894,3451,443,11.4
"28021",28,21,1994,3773,3326,447,11.8
"28021",28,21,1995,3812,3431,381,10
"28021",28,21,1996,3557,3189,368,10.3
"28021",28,21,1997,3236,2918,318,9.8
"28021",28,21,1998,3495,3128,367,10.5
"28021",28,21,1999,3416,3063,353,10.3
"28021",28,21,2000,4298,3909,389,9.1
"28021",28,21,2001,4136,3809,327,7.9
"28021",28,21,2002,4083,3685,398,9.7
"28021",28,21,2003,3965,3545,420,10.6
"28021",28,21,2004,3868,3465,403,10.4
"28021",28,21,2005,3759,3321,438,11.7
"28021",28,21,2006,3564,3183,381,10.7
"28021",28,21,2007,3573,3182,391,10.9
"28021",28,21,2008,3628,3240,388,10.7
"28021",28,21,2009,3673,3100,573,15.6
"28021",28,21,2010,3580,2982,598,16.7
"28021",28,21,2011,3690,3102,588,15.9
"28021",28,21,2012,3530,2986,544,15.4
"28021",28,21,2013,3299,2739,560,17
"28021",28,21,2014,3110,2656,454,14.6
"28021",28,21,2015,3119,2728,391,12.5
"28021",28,21,2016,3095,2743,352,11.4
"28021",28,21,2017,3034,2737,297,9.8
"28023",28,23,1990,8232,7645,587,7.1
"28023",28,23,1991,8270,7649,621,7.5
"28023",28,23,1992,8175,7480,695,8.5
"28023",28,23,1993,8155,7695,460,5.6
"28023",28,23,1994,8337,7839,498,6
"28023",28,23,1995,8500,8042,458,5.4
"28023",28,23,1996,8608,8015,593,6.9
"28023",28,23,1997,8667,8123,544,6.3
"28023",28,23,1998,8652,8171,481,5.6
"28023",28,23,1999,8875,8233,642,7.2
"28023",28,23,2000,7653,7027,626,8.2
"28023",28,23,2001,7501,6805,696,9.3
"28023",28,23,2002,7641,6596,1045,13.7
"28023",28,23,2003,7313,6633,680,9.3
"28023",28,23,2004,7272,6718,554,7.6
"28023",28,23,2005,7215,6670,545,7.6
"28023",28,23,2006,7068,6638,430,6.1
"28023",28,23,2007,7083,6565,518,7.3
"28023",28,23,2008,7024,6491,533,7.6
"28023",28,23,2009,6687,5944,743,11.1
"28023",28,23,2010,6606,5776,830,12.6
"28023",28,23,2011,6755,5958,797,11.8
"28023",28,23,2012,6729,6005,724,10.8
"28023",28,23,2013,6657,5993,664,10
"28023",28,23,2014,6270,5706,564,9
"28023",28,23,2015,6076,5600,476,7.8
"28023",28,23,2016,6081,5670,411,6.8
"28023",28,23,2017,6033,5661,372,6.2
"28025",28,25,1990,9844,8777,1067,10.8
"28025",28,25,1991,9815,8788,1027,10.5
"28025",28,25,1992,9771,8754,1017,10.4
"28025",28,25,1993,9380,8488,892,9.5
"28025",28,25,1994,8944,7969,975,10.9
"28025",28,25,1995,8976,8056,920,10.2
"28025",28,25,1996,9295,8330,965,10.4
"28025",28,25,1997,9096,8084,1012,11.1
"28025",28,25,1998,8931,8133,798,8.9
"28025",28,25,1999,8958,8298,660,7.4
"28025",28,25,2000,9804,9203,601,6.1
"28025",28,25,2001,9736,8951,785,8.1
"28025",28,25,2002,9525,8643,882,9.3
"28025",28,25,2003,8954,8083,871,9.7
"28025",28,25,2004,8858,8039,819,9.2
"28025",28,25,2005,8547,7646,901,10.5
"28025",28,25,2006,8180,7306,874,10.7
"28025",28,25,2007,7924,6749,1175,14.8
"28025",28,25,2008,7319,6380,939,12.8
"28025",28,25,2009,7146,5878,1268,17.7
"28025",28,25,2010,8682,7257,1425,16.4
"28025",28,25,2011,8696,7401,1295,14.9
"28025",28,25,2012,8587,7379,1208,14.1
"28025",28,25,2013,8387,7094,1293,15.4
"28025",28,25,2014,7981,6923,1058,13.3
"28025",28,25,2015,8019,7251,768,9.6
"28025",28,25,2016,8028,7376,652,8.1
"28025",28,25,2017,7852,7322,530,6.7
"28027",28,27,1990,11988,10612,1376,11.5
"28027",28,27,1991,11816,10453,1363,11.5
"28027",28,27,1992,11808,10501,1307,11.1
"28027",28,27,1993,11970,10629,1341,11.2
"28027",28,27,1994,12567,11223,1344,10.7
"28027",28,27,1995,12821,11478,1343,10.5
"28027",28,27,1996,12462,11241,1221,9.8
"28027",28,27,1997,12255,10975,1280,10.4
"28027",28,27,1998,11719,10527,1192,10.2
"28027",28,27,1999,11707,10643,1064,9.1
"28027",28,27,2000,11819,10915,904,7.6
"28027",28,27,2001,11498,10654,844,7.3
"28027",28,27,2002,11546,10533,1013,8.8
"28027",28,27,2003,11618,10648,970,8.3
"28027",28,27,2004,11247,10230,1017,9
"28027",28,27,2005,11127,9979,1148,10.3
"28027",28,27,2006,10678,9687,991,9.3
"28027",28,27,2007,10415,9487,928,8.9
"28027",28,27,2008,10173,9258,915,9
"28027",28,27,2009,9915,8715,1200,12.1
"28027",28,27,2010,10480,9044,1436,13.7
"28027",28,27,2011,10686,9206,1480,13.8
"28027",28,27,2012,10217,8931,1286,12.6
"28027",28,27,2013,9813,8548,1265,12.9
"28027",28,27,2014,9558,8434,1124,11.8
"28027",28,27,2015,9451,8500,951,10.1
"28027",28,27,2016,9228,8425,803,8.7
"28027",28,27,2017,8923,8269,654,7.3
"28029",28,29,1990,11635,10547,1088,9.4
"28029",28,29,1991,11302,10009,1293,11.4
"28029",28,29,1992,11207,10039,1168,10.4
"28029",28,29,1993,11206,10320,886,7.9
"28029",28,29,1994,11307,10471,836,7.4
"28029",28,29,1995,11502,10661,841,7.3
"28029",28,29,1996,11028,10177,851,7.7
"28029",28,29,1997,11129,10259,870,7.8
"28029",28,29,1998,11140,10283,857,7.7
"28029",28,29,1999,11132,10159,973,8.7
"28029",28,29,2000,12296,11535,761,6.2
"28029",28,29,2001,12305,11598,707,5.7
"28029",28,29,2002,12100,11245,855,7.1
"28029",28,29,2003,12296,11524,772,6.3
"28029",28,29,2004,12609,11753,856,6.8
"28029",28,29,2005,12489,11494,995,8
"28029",28,29,2006,12102,11274,828,6.8
"28029",28,29,2007,12173,11278,895,7.4
"28029",28,29,2008,12049,11192,857,7.1
"28029",28,29,2009,11726,10531,1195,10.2
"28029",28,29,2010,11991,10622,1369,11.4
"28029",28,29,2011,12254,10840,1414,11.5
"28029",28,29,2012,11873,10562,1311,11
"28029",28,29,2013,11475,10269,1206,10.5
"28029",28,29,2014,11169,10178,991,8.9
"28029",28,29,2015,11260,10447,813,7.2
"28029",28,29,2016,11290,10554,736,6.5
"28029",28,29,2017,11310,10670,640,5.7
"28031",28,31,1990,7337,6674,663,9
"28031",28,31,1991,7551,6729,822,10.9
"28031",28,31,1992,7381,6749,632,8.6
"28031",28,31,1993,7755,7225,530,6.8
"28031",28,31,1994,8635,8160,475,5.5
"28031",28,31,1995,8831,8381,450,5.1
"28031",28,31,1996,8613,8071,542,6.3
"28031",28,31,1997,8283,7836,447,5.4
"28031",28,31,1998,8339,7857,482,5.8
"28031",28,31,1999,8305,7839,466,5.6
"28031",28,31,2000,8438,7975,463,5.5
"28031",28,31,2001,8200,7784,416,5.1
"28031",28,31,2002,8387,7894,493,5.9
"28031",28,31,2003,8675,8197,478,5.5
"28031",28,31,2004,8886,8398,488,5.5
"28031",28,31,2005,8793,8205,588,6.7
"28031",28,31,2006,8591,8106,485,5.6
"28031",28,31,2007,8815,8345,470,5.3
"28031",28,31,2008,8812,8292,520,5.9
"28031",28,31,2009,8589,7882,707,8.2
"28031",28,31,2010,8235,7402,833,10.1
"28031",28,31,2011,8535,7738,797,9.3
"28031",28,31,2012,8359,7651,708,8.5
"28031",28,31,2013,7955,7329,626,7.9
"28031",28,31,2014,7840,7322,518,6.6
"28031",28,31,2015,7967,7501,466,5.8
"28031",28,31,2016,8164,7719,445,5.5
"28031",28,31,2017,8261,7863,398,4.8
"28033",28,33,1990,37384,35387,1997,5.3
"28033",28,33,1991,38026,35680,2346,6.2
"28033",28,33,1992,38555,36302,2253,5.8
"28033",28,33,1993,39691,37758,1933,4.9
"28033",28,33,1994,41973,40000,1973,4.7
"28033",28,33,1995,44864,42971,1893,4.2
"28033",28,33,1996,47173,45578,1595,3.4
"28033",28,33,1997,50097,48547,1550,3.1
"28033",28,33,1998,52957,51485,1472,2.8
"28033",28,33,1999,55007,53639,1368,2.5
"28033",28,33,2000,59225,57810,1415,2.4
"28033",28,33,2001,60820,59105,1715,2.8
"28033",28,33,2002,62029,59762,2267,3.7
"28033",28,33,2003,65522,63103,2419,3.7
"28033",28,33,2004,68683,66201,2482,3.6
"28033",28,33,2005,71502,68547,2955,4.1
"28033",28,33,2006,73926,70983,2943,4
"28033",28,33,2007,76812,73815,2997,3.9
"28033",28,33,2008,78606,74957,3649,4.6
"28033",28,33,2009,76330,70891,5439,7.1
"28033",28,33,2010,79619,73681,5938,7.5
"28033",28,33,2011,83144,77164,5980,7.2
"28033",28,33,2012,83109,77739,5370,6.5
"28033",28,33,2013,81100,76308,4792,5.9
"28033",28,33,2014,81350,77005,4345,5.3
"28033",28,33,2015,84566,80508,4058,4.8
"28033",28,33,2016,87373,83687,3686,4.2
"28033",28,33,2017,88199,84855,3344,3.8
"28035",28,35,1990,31900,29683,2217,6.9
"28035",28,35,1991,31197,29066,2131,6.8
"28035",28,35,1992,31147,28868,2279,7.3
"28035",28,35,1993,31301,29475,1826,5.8
"28035",28,35,1994,32387,30827,1560,4.8
"28035",28,35,1995,33229,31739,1490,4.5
"28035",28,35,1996,33416,31981,1435,4.3
"28035",28,35,1997,33938,32769,1169,3.4
"28035",28,35,1998,33688,32497,1191,3.5
"28035",28,35,1999,33488,32353,1135,3.4
"28035",28,35,2000,35256,33562,1694,4.8
"28035",28,35,2001,34883,33366,1517,4.3
"28035",28,35,2002,34761,32801,1960,5.6
"28035",28,35,2003,35169,33319,1850,5.3
"28035",28,35,2004,35416,33475,1941,5.5
"28035",28,35,2005,35646,33425,2221,6.2
"28035",28,35,2006,36412,34542,1870,5.1
"28035",28,35,2007,37064,35224,1840,5
"28035",28,35,2008,36878,34810,2068,5.6
"28035",28,35,2009,36321,33475,2846,7.8
"28035",28,35,2010,34083,30756,3327,9.8
"28035",28,35,2011,35065,31522,3543,10.1
"28035",28,35,2012,34419,31315,3104,9
"28035",28,35,2013,33102,30310,2792,8.4
"28035",28,35,2014,32288,29893,2395,7.4
"28035",28,35,2015,32842,30778,2064,6.3
"28035",28,35,2016,33419,31504,1915,5.7
"28035",28,35,2017,33967,32337,1630,4.8
"28037",28,37,1990,3048,2825,223,7.3
"28037",28,37,1991,3182,2821,361,11.3
"28037",28,37,1992,3196,2923,273,8.5
"28037",28,37,1993,3286,3056,230,7
"28037",28,37,1994,3252,3021,231,7.1
"28037",28,37,1995,3238,3025,213,6.6
"28037",28,37,1996,3272,3107,165,5
"28037",28,37,1997,3384,3174,210,6.2
"28037",28,37,1998,3306,3062,244,7.4
"28037",28,37,1999,3444,3165,279,8.1
"28037",28,37,2000,3459,3234,225,6.5
"28037",28,37,2001,3262,3032,230,7.1
"28037",28,37,2002,3279,3003,276,8.4
"28037",28,37,2003,3141,2871,270,8.6
"28037",28,37,2004,3085,2841,244,7.9
"28037",28,37,2005,3119,2849,270,8.7
"28037",28,37,2006,3153,2944,209,6.6
"28037",28,37,2007,3137,2920,217,6.9
"28037",28,37,2008,3083,2853,230,7.5
"28037",28,37,2009,2996,2663,333,11.1
"28037",28,37,2010,3234,2866,368,11.4
"28037",28,37,2011,3218,2870,348,10.8
"28037",28,37,2012,3071,2771,300,9.8
"28037",28,37,2013,2953,2681,272,9.2
"28037",28,37,2014,2907,2664,243,8.4
"28037",28,37,2015,2938,2713,225,7.7
"28037",28,37,2016,2856,2651,205,7.2
"28037",28,37,2017,2833,2641,192,6.8
"28039",28,39,1990,7239,6458,781,10.8
"28039",28,39,1991,7284,6379,905,12.4
"28039",28,39,1992,7556,6499,1057,14
"28039",28,39,1993,7776,6805,971,12.5
"28039",28,39,1994,7955,7020,935,11.8
"28039",28,39,1995,8158,7357,801,9.8
"28039",28,39,1996,8484,7684,800,9.4
"28039",28,39,1997,8419,7717,702,8.3
"28039",28,39,1998,8218,7606,612,7.4
"28039",28,39,1999,8593,7982,611,7.1
"28039",28,39,2000,8429,7793,636,7.5
"28039",28,39,2001,8129,7461,668,8.2
"28039",28,39,2002,8192,7441,751,9.2
"28039",28,39,2003,8507,7648,859,10.1
"28039",28,39,2004,8502,7743,759,8.9
"28039",28,39,2005,8562,7805,757,8.8
"28039",28,39,2006,8817,8020,797,9
"28039",28,39,2007,9107,8463,644,7.1
"28039",28,39,2008,9565,8860,705,7.4
"28039",28,39,2009,9384,8443,941,10
"28039",28,39,2010,8759,7753,1006,11.5
"28039",28,39,2011,9052,7954,1098,12.1
"28039",28,39,2012,8823,7919,904,10.2
"28039",28,39,2013,8564,7757,807,9.4
"28039",28,39,2014,8919,8184,735,8.2
"28039",28,39,2015,8857,8193,664,7.5
"28039",28,39,2016,8822,8169,653,7.4
"28039",28,39,2017,8914,8285,629,7.1
"28041",28,41,1990,3963,3510,453,11.4
"28041",28,41,1991,4583,4046,537,11.7
"28041",28,41,1992,4560,4007,553,12.1
"28041",28,41,1993,4452,3941,511,11.5
"28041",28,41,1994,4636,4109,527,11.4
"28041",28,41,1995,4741,4318,423,8.9
"28041",28,41,1996,5264,4834,430,8.2
"28041",28,41,1997,5587,5145,442,7.9
"28041",28,41,1998,5376,4991,385,7.2
"28041",28,41,1999,5312,4936,376,7.1
"28041",28,41,2000,4810,4402,408,8.5
"28041",28,41,2001,4686,4336,350,7.5
"28041",28,41,2002,4835,4398,437,9
"28041",28,41,2003,4946,4484,462,9.3
"28041",28,41,2004,4794,4353,441,9.2
"28041",28,41,2005,4769,4330,439,9.2
"28041",28,41,2006,4924,4560,364,7.4
"28041",28,41,2007,4934,4562,372,7.5
"28041",28,41,2008,4959,4512,447,9
"28041",28,41,2009,4829,4270,559,11.6
"28041",28,41,2010,4580,4034,546,11.9
"28041",28,41,2011,4692,4125,567,12.1
"28041",28,41,2012,4568,4055,513,11.2
"28041",28,41,2013,4435,3984,451,10.2
"28041",28,41,2014,4394,4004,390,8.9
"28041",28,41,2015,4329,4003,326,7.5
"28041",28,41,2016,4291,3978,313,7.3
"28041",28,41,2017,4372,4044,328,7.5
"28043",28,43,1990,10171,9092,1079,10.6
"28043",28,43,1991,9823,8890,933,9.5
"28043",28,43,1992,9905,9062,843,8.5
"28043",28,43,1993,10005,9231,774,7.7
"28043",28,43,1994,10187,9507,680,6.7
"28043",28,43,1995,10155,9438,717,7.1
"28043",28,43,1996,10123,9463,660,6.5
"28043",28,43,1997,10252,9537,715,7
"28043",28,43,1998,10040,9463,577,5.7
"28043",28,43,1999,10128,9585,543,5.4
"28043",28,43,2000,10589,10006,583,5.5
"28043",28,43,2001,10182,9544,638,6.3
"28043",28,43,2002,9854,9191,663,6.7
"28043",28,43,2003,9946,9337,609,6.1
"28043",28,43,2004,10123,9484,639,6.3
"28043",28,43,2005,10186,9443,743,7.3
"28043",28,43,2006,9803,9185,618,6.3
"28043",28,43,2007,9651,8958,693,7.2
"28043",28,43,2008,9595,8894,701,7.3
"28043",28,43,2009,8948,7850,1098,12.3
"28043",28,43,2010,9433,8342,1091,11.6
"28043",28,43,2011,9709,8715,994,10.2
"28043",28,43,2012,9612,8726,886,9.2
"28043",28,43,2013,9334,8510,824,8.8
"28043",28,43,2014,9296,8627,669,7.2
"28043",28,43,2015,9481,8917,564,5.9
"28043",28,43,2016,9618,9125,493,5.1
"28043",28,43,2017,9653,9209,444,4.6
"28045",28,45,1990,12887,11960,927,7.2
"28045",28,45,1991,13035,12134,901,6.9
"28045",28,45,1992,13593,12574,1019,7.5
"28045",28,45,1993,15001,14063,938,6.3
"28045",28,45,1994,16109,15115,994,6.2
"28045",28,45,1995,16046,14966,1080,6.7
"28045",28,45,1996,16359,15439,920,5.6
"28045",28,45,1997,16778,16026,752,4.5
"28045",28,45,1998,17334,16715,619,3.6
"28045",28,45,1999,18516,17783,733,4
"28045",28,45,2000,19599,18691,908,4.6
"28045",28,45,2001,19707,18894,813,4.1
"28045",28,45,2002,19765,18705,1060,5.4
"28045",28,45,2003,20420,19388,1032,5.1
"28045",28,45,2004,20713,19673,1040,5
"28045",28,45,2005,21028,18754,2274,10.8
"28045",28,45,2006,18207,16455,1752,9.6
"28045",28,45,2007,18300,17349,951,5.2
"28045",28,45,2008,18398,17379,1019,5.5
"28045",28,45,2009,18096,16651,1445,8
"28045",28,45,2010,19653,17887,1766,9
"28045",28,45,2011,20060,18157,1903,9.5
"28045",28,45,2012,19597,17941,1656,8.5
"28045",28,45,2013,18932,17446,1486,7.8
"28045",28,45,2014,18476,17141,1335,7.2
"28045",28,45,2015,18676,17466,1210,6.5
"28045",28,45,2016,18893,17742,1151,6.1
"28045",28,45,2017,18911,17886,1025,5.4
"28047",28,47,1990,72257,67426,4831,6.7
"28047",28,47,1991,72619,67599,5020,6.9
"28047",28,47,1992,75234,69726,5508,7.3
"28047",28,47,1993,79627,75425,4202,5.3
"28047",28,47,1994,82882,78603,4279,5.2
"28047",28,47,1995,81742,76428,5314,6.5
"28047",28,47,1996,81380,77472,3908,4.8
"28047",28,47,1997,81837,78103,3734,4.6
"28047",28,47,1998,83216,80037,3179,3.8
"28047",28,47,1999,86229,83240,2989,3.5
"28047",28,47,2000,91244,87056,4188,4.6
"28047",28,47,2001,90562,86648,3914,4.3
"28047",28,47,2002,89472,84673,4799,5.4
"28047",28,47,2003,90776,86329,4447,4.9
"28047",28,47,2004,92320,87670,4650,5
"28047",28,47,2005,92740,82699,10041,10.8
"28047",28,47,2006,82643,74359,8284,10
"28047",28,47,2007,86384,81818,4566,5.3
"28047",28,47,2008,86814,82117,4697,5.4
"28047",28,47,2009,84779,78275,6504,7.7
"28047",28,47,2010,88745,80951,7794,8.8
"28047",28,47,2011,90572,82496,8076,8.9
"28047",28,47,2012,88960,81688,7272,8.2
"28047",28,47,2013,86617,80121,6496,7.5
"28047",28,47,2014,84780,79082,5698,6.7
"28047",28,47,2015,85654,80568,5086,5.9
"28047",28,47,2016,86823,82029,4794,5.5
"28047",28,47,2017,86789,82636,4153,4.8
"28049",28,49,1990,128614,121424,7190,5.6
"28049",28,49,1991,127246,119298,7948,6.2
"28049",28,49,1992,126324,118558,7766,6.1
"28049",28,49,1993,126941,119995,6946,5.5
"28049",28,49,1994,128152,122036,6116,4.8
"28049",28,49,1995,127953,122262,5691,4.4
"28049",28,49,1996,128744,123635,5109,4
"28049",28,49,1997,127993,122806,5187,4.1
"28049",28,49,1998,128700,123543,5157,4
"28049",28,49,1999,126563,121311,5252,4.1
"28049",28,49,2000,122940,116785,6155,5
"28049",28,49,2001,122510,116587,5923,4.8
"28049",28,49,2002,119845,112967,6878,5.7
"28049",28,49,2003,121448,114758,6690,5.5
"28049",28,49,2004,124079,117206,6873,5.5
"28049",28,49,2005,122092,114214,7878,6.5
"28049",28,49,2006,118328,111647,6681,5.6
"28049",28,49,2007,117887,111407,6480,5.5
"28049",28,49,2008,116684,109822,6862,5.9
"28049",28,49,2009,113528,104170,9358,8.2
"28049",28,49,2010,113892,102705,11187,9.8
"28049",28,49,2011,118305,107045,11260,9.5
"28049",28,49,2012,115704,105543,10161,8.8
"28049",28,49,2013,110759,101375,9384,8.5
"28049",28,49,2014,108127,100282,7845,7.3
"28049",28,49,2015,109216,102641,6575,6
"28049",28,49,2016,110103,104114,5989,5.4
"28049",28,49,2017,110762,105429,5333,4.8
"28051",28,51,1990,6871,5958,913,13.3
"28051",28,51,1991,6884,5939,945,13.7
"28051",28,51,1992,6889,6024,865,12.6
"28051",28,51,1993,7124,6345,779,10.9
"28051",28,51,1994,7630,6792,838,11
"28051",28,51,1995,7451,6525,926,12.4
"28051",28,51,1996,7516,6634,882,11.7
"28051",28,51,1997,7469,6635,834,11.2
"28051",28,51,1998,7134,6343,791,11.1
"28051",28,51,1999,7020,5805,1215,17.3
"28051",28,51,2000,7626,6627,999,13.1
"28051",28,51,2001,7181,6282,899,12.5
"28051",28,51,2002,6900,6086,814,11.8
"28051",28,51,2003,6837,6067,770,11.3
"28051",28,51,2004,6858,6107,751,11
"28051",28,51,2005,7045,6222,823,11.7
"28051",28,51,2006,7157,6424,733,10.2
"28051",28,51,2007,7162,6393,769,10.7
"28051",28,51,2008,7143,6223,920,12.9
"28051",28,51,2009,6956,5621,1335,19.2
"28051",28,51,2010,6848,5506,1342,19.6
"28051",28,51,2011,6895,5661,1234,17.9
"28051",28,51,2012,6618,5524,1094,16.5
"28051",28,51,2013,6301,5247,1054,16.7
"28051",28,51,2014,6140,5220,920,15
"28051",28,51,2015,6116,5381,735,12
"28051",28,51,2016,5984,5326,658,11
"28051",28,51,2017,5789,5237,552,9.5
"28053",28,53,1990,5165,4749,416,8.1
"28053",28,53,1991,5298,4788,510,9.6
"28053",28,53,1992,5326,4852,474,8.9
"28053",28,53,1993,5301,4730,571,10.8
"28053",28,53,1994,5374,4468,906,16.9
"28053",28,53,1995,4993,4399,594,11.9
"28053",28,53,1996,4901,4395,506,10.3
"28053",28,53,1997,4972,4436,536,10.8
"28053",28,53,1998,4803,4282,521,10.8
"28053",28,53,1999,4825,4346,479,9.9
"28053",28,53,2000,4263,3866,397,9.3
"28053",28,53,2001,4157,3710,447,10.8
"28053",28,53,2002,4452,4005,447,10
"28053",28,53,2003,4593,4204,389,8.5
"28053",28,53,2004,4393,4008,385,8.8
"28053",28,53,2005,4301,3874,427,9.9
"28053",28,53,2006,4249,3869,380,8.9
"28053",28,53,2007,4357,3975,382,8.8
"28053",28,53,2008,4337,3919,418,9.6
"28053",28,53,2009,4155,3632,523,12.6
"28053",28,53,2010,3482,2882,600,17.2
"28053",28,53,2011,3422,2789,633,18.5
"28053",28,53,2012,3171,2567,604,19
"28053",28,53,2013,3053,2529,524,17.2
"28053",28,53,2014,2562,2156,406,15.8
"28053",28,53,2015,2467,2155,312,12.6
"28053",28,53,2016,2376,2105,271,11.4
"28053",28,53,2017,2308,2098,210,9.1
"28055",28,55,1990,850,748,102,12
"28055",28,55,1991,865,746,119,13.8
"28055",28,55,1992,882,767,115,13
"28055",28,55,1993,881,763,118,13.4
"28055",28,55,1994,852,726,126,14.8
"28055",28,55,1995,779,653,126,16.2
"28055",28,55,1996,721,590,131,18.2
"28055",28,55,1997,693,592,101,14.6
"28055",28,55,1998,674,585,89,13.2
"28055",28,55,1999,648,551,97,15
"28055",28,55,2000,850,764,86,10.1
"28055",28,55,2001,853,754,99,11.6
"28055",28,55,2002,836,739,97,11.6
"28055",28,55,2003,844,753,91,10.8
"28055",28,55,2004,801,719,82,10.2
"28055",28,55,2005,765,676,89,11.6
"28055",28,55,2006,729,659,70,9.6
"28055",28,55,2007,706,652,54,7.6
"28055",28,55,2008,687,628,59,8.6
"28055",28,55,2009,662,586,76,11.5
"28055",28,55,2010,525,440,85,16.2
"28055",28,55,2011,516,412,104,20.2
"28055",28,55,2012,471,388,83,17.6
"28055",28,55,2013,446,355,91,20.4
"28055",28,55,2014,426,352,74,17.4
"28055",28,55,2015,419,347,72,17.2
"28055",28,55,2016,401,345,56,14
"28055",28,55,2017,396,350,46,11.6
"28057",28,57,1990,10685,9946,739,6.9
"28057",28,57,1991,10613,9602,1011,9.5
"28057",28,57,1992,10590,9933,657,6.2
"28057",28,57,1993,10790,10284,506,4.7
"28057",28,57,1994,11189,10742,447,4
"28057",28,57,1995,11319,10753,566,5
"28057",28,57,1996,11487,10737,750,6.5
"28057",28,57,1997,11266,10591,675,6
"28057",28,57,1998,11146,10550,596,5.3
"28057",28,57,1999,11331,10841,490,4.3
"28057",28,57,2000,11174,10591,583,5.2
"28057",28,57,2001,10723,10154,569,5.3
"28057",28,57,2002,10511,9865,646,6.1
"28057",28,57,2003,10396,9741,655,6.3
"28057",28,57,2004,10478,9866,612,5.8
"28057",28,57,2005,10531,9859,672,6.4
"28057",28,57,2006,10220,9580,640,6.3
"28057",28,57,2007,10036,9325,711,7.1
"28057",28,57,2008,10069,9263,806,8
"28057",28,57,2009,9596,8490,1106,11.5
"28057",28,57,2010,10355,9188,1167,11.3
"28057",28,57,2011,10572,9516,1056,10
"28057",28,57,2012,10415,9540,875,8.4
"28057",28,57,2013,10027,9223,804,8
"28057",28,57,2014,9898,9190,708,7.2
"28057",28,57,2015,10210,9626,584,5.7
"28057",28,57,2016,10413,9885,528,5.1
"28057",28,57,2017,10385,9942,443,4.3
"28059",28,59,1990,55330,51351,3979,7.2
"28059",28,59,1991,56166,52304,3862,6.9
"28059",28,59,1992,58420,54325,4095,7
"28059",28,59,1993,62911,59240,3671,5.8
"28059",28,59,1994,65655,61983,3672,5.6
"28059",28,59,1995,64770,60961,3809,5.9
"28059",28,59,1996,65048,61493,3555,5.5
"28059",28,59,1997,65741,62312,3429,5.2
"28059",28,59,1998,67151,64573,2578,3.8
"28059",28,59,1999,70521,67821,2700,3.8
"28059",28,59,2000,63739,60106,3633,5.7
"28059",28,59,2001,60487,57061,3426,5.7
"28059",28,59,2002,59517,55452,4065,6.8
"28059",28,59,2003,59685,55958,3727,6.2
"28059",28,59,2004,60112,56627,3485,5.8
"28059",28,59,2005,62240,56060,6180,9.9
"28059",28,59,2006,58419,53890,4529,7.8
"28059",28,59,2007,59623,56377,3246,5.4
"28059",28,59,2008,61569,58051,3518,5.7
"28059",28,59,2009,60589,55581,5008,8.3
"28059",28,59,2010,64425,58293,6132,9.5
"28059",28,59,2011,65563,58738,6825,10.4
"28059",28,59,2012,63232,57255,5977,9.5
"28059",28,59,2013,60944,55537,5407,8.9
"28059",28,59,2014,59094,54377,4717,8
"28059",28,59,2015,58978,54826,4152,7
"28059",28,59,2016,59171,55276,3895,6.6
"28059",28,59,2017,59121,55670,3451,5.8
"28061",28,61,1990,7140,6481,659,9.2
"28061",28,61,1991,7088,6347,741,10.5
"28061",28,61,1992,7425,6526,899,12.1
"28061",28,61,1993,7292,6779,513,7
"28061",28,61,1994,7555,7026,529,7
"28061",28,61,1995,7649,7156,493,6.4
"28061",28,61,1996,7670,7216,454,5.9
"28061",28,61,1997,7843,7344,499,6.4
"28061",28,61,1998,7892,7500,392,5
"28061",28,61,1999,8236,7836,400,4.9
"28061",28,61,2000,7470,7037,433,5.8
"28061",28,61,2001,7284,6855,429,5.9
"28061",28,61,2002,7190,6614,576,8
"28061",28,61,2003,7167,6636,531,7.4
"28061",28,61,2004,7325,6743,582,7.9
"28061",28,61,2005,7410,6836,574,7.7
"28061",28,61,2006,7518,7079,439,5.8
"28061",28,61,2007,7557,7102,455,6
"28061",28,61,2008,7514,6990,524,7
"28061",28,61,2009,7102,6347,755,10.6
"28061",28,61,2010,7013,6154,859,12.2
"28061",28,61,2011,7184,6359,825,11.5
"28061",28,61,2012,6893,6193,700,10.2
"28061",28,61,2013,6514,5867,647,9.9
"28061",28,61,2014,6433,5886,547,8.5
"28061",28,61,2015,6364,5866,498,7.8
"28061",28,61,2016,6198,5723,475,7.7
"28061",28,61,2017,6100,5699,401,6.6
"28063",28,63,1990,2984,2299,685,23
"28063",28,63,1991,2823,2009,814,28.8
"28063",28,63,1992,2469,1950,519,21
"28063",28,63,1993,2431,2004,427,17.6
"28063",28,63,1994,2533,2084,449,17.7
"28063",28,63,1995,2502,2113,389,15.5
"28063",28,63,1996,2483,2102,381,15.3
"28063",28,63,1997,2464,2076,388,15.7
"28063",28,63,1998,2455,2052,403,16.4
"28063",28,63,1999,2680,2202,478,17.8
"28063",28,63,2000,3180,2800,380,11.9
"28063",28,63,2001,2970,2619,351,11.8
"28063",28,63,2002,2922,2570,352,12
"28063",28,63,2003,2912,2534,378,13
"28063",28,63,2004,2871,2492,379,13.2
"28063",28,63,2005,2813,2399,414,14.7
"28063",28,63,2006,2723,2387,336,12.3
"28063",28,63,2007,2779,2415,364,13.1
"28063",28,63,2008,2801,2435,366,13.1
"28063",28,63,2009,2802,2335,467,16.7
"28063",28,63,2010,2472,2007,465,18.8
"28063",28,63,2011,2539,2067,472,18.6
"28063",28,63,2012,2517,2080,437,17.4
"28063",28,63,2013,2480,2003,477,19.2
"28063",28,63,2014,2405,2018,387,16.1
"28063",28,63,2015,2277,1938,339,14.9
"28063",28,63,2016,2229,1897,332,14.9
"28063",28,63,2017,2093,1785,308,14.7
"28065",28,65,1990,5674,4904,770,13.6
"28065",28,65,1991,5493,4587,906,16.5
"28065",28,65,1992,5169,4378,791,15.3
"28065",28,65,1993,4992,4474,518,10.4
"28065",28,65,1994,5303,4816,487,9.2
"28065",28,65,1995,5276,4587,689,13.1
"28065",28,65,1996,4913,4254,659,13.4
"28065",28,65,1997,4824,4414,410,8.5
"28065",28,65,1998,4801,4300,501,10.4
"28065",28,65,1999,4800,4006,794,16.5
"28065",28,65,2000,5455,4923,532,9.8
"28065",28,65,2001,5285,4875,410,7.8
"28065",28,65,2002,5229,4824,405,7.7
"28065",28,65,2003,5333,4925,408,7.7
"28065",28,65,2004,5367,4953,414,7.7
"28065",28,65,2005,5429,4944,485,8.9
"28065",28,65,2006,5226,4840,386,7.4
"28065",28,65,2007,5252,4885,367,7
"28065",28,65,2008,5623,5238,385,6.8
"28065",28,65,2009,5133,4597,536,10.4
"28065",28,65,2010,4609,3961,648,14.1
"28065",28,65,2011,4636,3991,645,13.9
"28065",28,65,2012,4459,3883,576,12.9
"28065",28,65,2013,4218,3686,532,12.6
"28065",28,65,2014,4119,3698,421,10.2
"28065",28,65,2015,4129,3769,360,8.7
"28065",28,65,2016,4186,3841,345,8.2
"28065",28,65,2017,4217,3927,290,6.9
"28067",28,67,1990,27812,26028,1784,6.4
"28067",28,67,1991,27987,25737,2250,8
"28067",28,67,1992,28252,26115,2137,7.6
"28067",28,67,1993,28958,27297,1661,5.7
"28067",28,67,1994,29752,28347,1405,4.7
"28067",28,67,1995,29910,28691,1219,4.1
"28067",28,67,1996,30216,29161,1055,3.5
"28067",28,67,1997,30440,29363,1077,3.5
"28067",28,67,1998,30963,29947,1016,3.3
"28067",28,67,1999,31307,30251,1056,3.4
"28067",28,67,2000,30061,28739,1322,4.4
"28067",28,67,2001,29035,27726,1309,4.5
"28067",28,67,2002,28419,26858,1561,5.5
"28067",28,67,2003,28691,27147,1544,5.4
"28067",28,67,2004,29306,27790,1516,5.2
"28067",28,67,2005,30093,28366,1727,5.7
"28067",28,67,2006,30999,29561,1438,4.6
"28067",28,67,2007,31314,29886,1428,4.6
"28067",28,67,2008,30914,29315,1599,5.2
"28067",28,67,2009,29509,27313,2196,7.4
"28067",28,67,2010,27932,25384,2548,9.1
"28067",28,67,2011,29123,26630,2493,8.6
"28067",28,67,2012,28735,26560,2175,7.6
"28067",28,67,2013,27346,25417,1929,7.1
"28067",28,67,2014,26671,25024,1647,6.2
"28067",28,67,2015,26552,24960,1592,6
"28067",28,67,2016,25821,24241,1580,6.1
"28067",28,67,2017,25476,24165,1311,5.1
"28069",28,69,1990,4294,3859,435,10.1
"28069",28,69,1991,4282,3853,429,10
"28069",28,69,1992,4167,3707,460,11
"28069",28,69,1993,4180,3834,346,8.3
"28069",28,69,1994,4232,3898,334,7.9
"28069",28,69,1995,4345,3993,352,8.1
"28069",28,69,1996,4277,3939,338,7.9
"28069",28,69,1997,4315,3970,345,8
"28069",28,69,1998,4410,4005,405,9.2
"28069",28,69,1999,4510,3959,551,12.2
"28069",28,69,2000,4419,4055,364,8.2
"28069",28,69,2001,4387,4045,342,7.8
"28069",28,69,2002,4274,3870,404,9.5
"28069",28,69,2003,4288,3901,387,9
"28069",28,69,2004,4279,3914,365,8.5
"28069",28,69,2005,4236,3846,390,9.2
"28069",28,69,2006,4120,3784,336,8.2
"28069",28,69,2007,4108,3789,319,7.8
"28069",28,69,2008,4028,3702,326,8.1
"28069",28,69,2009,3863,3377,486,12.6
"28069",28,69,2010,3906,3330,576,14.7
"28069",28,69,2011,3916,3358,558,14.2
"28069",28,69,2012,3971,3450,521,13.1
"28069",28,69,2013,3956,3447,509,12.9
"28069",28,69,2014,3751,3273,478,12.7
"28069",28,69,2015,3577,3207,370,10.3
"28069",28,69,2016,3557,3247,310,8.7
"28069",28,69,2017,3511,3233,278,7.9
"28071",28,71,1990,15251,14430,821,5.4
"28071",28,71,1991,15319,14560,759,5
"28071",28,71,1992,15391,14473,918,6
"28071",28,71,1993,15161,14774,387,2.6
"28071",28,71,1994,15740,15400,340,2.2
"28071",28,71,1995,16140,15722,418,2.6
"28071",28,71,1996,16587,16145,442,2.7
"28071",28,71,1997,16835,16443,392,2.3
"28071",28,71,1998,17160,16835,325,1.9
"28071",28,71,1999,17693,17375,318,1.8
"28071",28,71,2000,19834,18976,858,4.3
"28071",28,71,2001,19218,18494,724,3.8
"28071",28,71,2002,19957,18985,972,4.9
"28071",28,71,2003,20256,19126,1130,5.6
"28071",28,71,2004,20593,19530,1063,5.2
"28071",28,71,2005,21324,20230,1094,5.1
"28071",28,71,2006,21677,20692,985,4.5
"28071",28,71,2007,22115,21072,1043,4.7
"28071",28,71,2008,22246,21088,1158,5.2
"28071",28,71,2009,21475,19763,1712,8
"28071",28,71,2010,21649,19630,2019,9.3
"28071",28,71,2011,22931,20961,1970,8.6
"28071",28,71,2012,23351,21550,1801,7.7
"28071",28,71,2013,23038,21391,1647,7.1
"28071",28,71,2014,23279,21790,1489,6.4
"28071",28,71,2015,24447,23112,1335,5.5
"28071",28,71,2016,26019,24749,1270,4.9
"28071",28,71,2017,26766,25631,1135,4.2
"28073",28,73,1990,14596,13866,730,5
"28073",28,73,1991,14321,13586,735,5.1
"28073",28,73,1992,14373,13503,870,6.1
"28073",28,73,1993,14722,14113,609,4.1
"28073",28,73,1994,15448,14842,606,3.9
"28073",28,73,1995,16005,15479,526,3.3
"28073",28,73,1996,16511,15971,540,3.3
"28073",28,73,1997,17102,16666,436,2.5
"28073",28,73,1998,17391,16921,470,2.7
"28073",28,73,1999,17760,17239,521,2.9
"28073",28,73,2000,20116,19320,796,4
"28073",28,73,2001,20229,19520,709,3.5
"28073",28,73,2002,20489,19581,908,4.4
"28073",28,73,2003,20909,20037,872,4.2
"28073",28,73,2004,21613,20696,917,4.2
"28073",28,73,2005,22323,21140,1183,5.3
"28073",28,73,2006,23222,22264,958,4.1
"28073",28,73,2007,23865,22860,1005,4.2
"28073",28,73,2008,24035,22919,1116,4.6
"28073",28,73,2009,23539,21967,1572,6.7
"28073",28,73,2010,27659,25673,1986,7.2
"28073",28,73,2011,28508,26473,2035,7.1
"28073",28,73,2012,28145,26328,1817,6.5
"28073",28,73,2013,27531,25904,1627,5.9
"28073",28,73,2014,27777,26356,1421,5.1
"28073",28,73,2015,28902,27511,1391,4.8
"28073",28,73,2016,29638,28291,1347,4.5
"28073",28,73,2017,30205,29049,1156,3.8
"28075",28,75,1990,34741,32278,2463,7.1
"28075",28,75,1991,35125,32346,2779,7.9
"28075",28,75,1992,34233,31761,2472,7.2
"28075",28,75,1993,34666,32681,1985,5.7
"28075",28,75,1994,34981,33078,1903,5.4
"28075",28,75,1995,35726,33764,1962,5.5
"28075",28,75,1996,35289,33421,1868,5.3
"28075",28,75,1997,35289,33478,1811,5.1
"28075",28,75,1998,34943,32980,1963,5.6
"28075",28,75,1999,34790,32809,1981,5.7
"28075",28,75,2000,34698,32743,1955,5.6
"28075",28,75,2001,33576,31742,1834,5.5
"28075",28,75,2002,32954,30801,2153,6.5
"28075",28,75,2003,33550,31250,2300,6.9
"28075",28,75,2004,33758,31534,2224,6.6
"28075",28,75,2005,33605,31249,2356,7
"28075",28,75,2006,33025,30971,2054,6.2
"28075",28,75,2007,33274,31163,2111,6.3
"28075",28,75,2008,33549,31308,2241,6.7
"28075",28,75,2009,32362,29297,3065,9.5
"28075",28,75,2010,33063,29541,3522,10.7
"28075",28,75,2011,34382,30858,3524,10.2
"28075",28,75,2012,34574,31447,3127,9
"28075",28,75,2013,34590,31701,2889,8.4
"28075",28,75,2014,32578,30130,2448,7.5
"28075",28,75,2015,31661,29585,2076,6.6
"28075",28,75,2016,31816,29945,1871,5.9
"28075",28,75,2017,31618,29897,1721,5.4
"28077",28,77,1990,5208,4734,474,9.1
"28077",28,77,1991,5304,4741,563,10.6
"28077",28,77,1992,5499,4941,558,10.1
"28077",28,77,1993,5280,4812,468,8.9
"28077",28,77,1994,5231,4802,429,8.2
"28077",28,77,1995,5302,4903,399,7.5
"28077",28,77,1996,5583,5209,374,6.7
"28077",28,77,1997,5532,5224,308,5.6
"28077",28,77,1998,5321,5022,299,5.6
"28077",28,77,1999,5282,4889,393,7.4
"28077",28,77,2000,5948,5494,454,7.6
"28077",28,77,2001,5470,5062,408,7.5
"28077",28,77,2002,5278,4905,373,7.1
"28077",28,77,2003,5396,5037,359,6.7
"28077",28,77,2004,5268,4910,358,6.8
"28077",28,77,2005,5128,4711,417,8.1
"28077",28,77,2006,5071,4696,375,7.4
"28077",28,77,2007,5150,4765,385,7.5
"28077",28,77,2008,5324,4914,410,7.7
"28077",28,77,2009,5127,4556,571,11.1
"28077",28,77,2010,5147,4534,613,11.9
"28077",28,77,2011,5076,4487,589,11.6
"28077",28,77,2012,4941,4433,508,10.3
"28077",28,77,2013,4717,4281,436,9.2
"28077",28,77,2014,4521,4146,375,8.3
"28077",28,77,2015,4745,4403,342,7.2
"28077",28,77,2016,4680,4347,333,7.1
"28077",28,77,2017,4643,4339,304,6.5
"28079",28,79,1990,8001,7419,582,7.3
"28079",28,79,1991,8362,7609,753,9
"28079",28,79,1992,8344,7696,648,7.8
"28079",28,79,1993,8384,7787,597,7.1
"28079",28,79,1994,8642,8067,575,6.7
"28079",28,79,1995,8841,8331,510,5.8
"28079",28,79,1996,9230,8770,460,5
"28079",28,79,1997,9907,9389,518,5.2
"28079",28,79,1998,9796,9321,475,4.8
"28079",28,79,1999,9465,8889,576,6.1
"28079",28,79,2000,8937,8378,559,6.3
"28079",28,79,2001,9162,8634,528,5.8
"28079",28,79,2002,9982,9363,619,6.2
"28079",28,79,2003,9505,8952,553,5.8
"28079",28,79,2004,8836,8257,579,6.6
"28079",28,79,2005,8557,7936,621,7.3
"28079",28,79,2006,8220,7670,550,6.7
"28079",28,79,2007,8152,7636,516,6.3
"28079",28,79,2008,8448,7883,565,6.7
"28079",28,79,2009,8438,7660,778,9.2
"28079",28,79,2010,9177,8289,888,9.7
"28079",28,79,2011,8871,8007,864,9.7
"28079",28,79,2012,8405,7629,776,9.2
"28079",28,79,2013,8108,7415,693,8.5
"28079",28,79,2014,7831,7275,556,7.1
"28079",28,79,2015,7890,7405,485,6.1
"28079",28,79,2016,7762,7292,470,6.1
"28079",28,79,2017,7683,7251,432,5.6
"28081",28,81,1990,35356,33033,2323,6.6
"28081",28,81,1991,35343,32553,2790,7.9
"28081",28,81,1992,36405,34140,2265,6.2
"28081",28,81,1993,37652,35920,1732,4.6
"28081",28,81,1994,38733,37091,1642,4.2
"28081",28,81,1995,39475,37832,1643,4.2
"28081",28,81,1996,39625,37797,1828,4.6
"28081",28,81,1997,39465,37611,1854,4.7
"28081",28,81,1998,39352,37750,1602,4.1
"28081",28,81,1999,40660,39112,1548,3.8
"28081",28,81,2000,40018,38265,1753,4.4
"28081",28,81,2001,38834,36932,1902,4.9
"28081",28,81,2002,38235,35943,2292,6
"28081",28,81,2003,37732,35463,2269,6
"28081",28,81,2004,38296,36143,2153,5.6
"28081",28,81,2005,38532,36145,2387,6.2
"28081",28,81,2006,37754,35542,2212,5.9
"28081",28,81,2007,37650,35357,2293,6.1
"28081",28,81,2008,37843,35249,2594,6.9
"28081",28,81,2009,36729,32864,3865,10.5
"28081",28,81,2010,39180,35112,4068,10.4
"28081",28,81,2011,41068,37105,3963,9.6
"28081",28,81,2012,41050,37628,3422,8.3
"28081",28,81,2013,39557,36395,3162,8
"28081",28,81,2014,38830,36039,2791,7.2
"28081",28,81,2015,39860,37648,2212,5.5
"28081",28,81,2016,40851,38864,1987,4.9
"28081",28,81,2017,40783,39130,1653,4.1
"28083",28,83,1990,15481,13895,1586,10.2
"28083",28,83,1991,15528,13554,1974,12.7
"28083",28,83,1992,15547,14006,1541,9.9
"28083",28,83,1993,15948,14369,1579,9.9
"28083",28,83,1994,16059,14542,1517,9.4
"28083",28,83,1995,15873,14351,1522,9.6
"28083",28,83,1996,15672,14223,1449,9.2
"28083",28,83,1997,15693,14236,1457,9.3
"28083",28,83,1998,15280,13923,1357,8.9
"28083",28,83,1999,15547,14245,1302,8.4
"28083",28,83,2000,14659,13372,1287,8.8
"28083",28,83,2001,14279,12996,1283,9
"28083",28,83,2002,14330,12936,1394,9.7
"28083",28,83,2003,14519,13020,1499,10.3
"28083",28,83,2004,13805,12532,1273,9.2
"28083",28,83,2005,13873,12540,1333,9.6
"28083",28,83,2006,13792,12627,1165,8.4
"28083",28,83,2007,13829,12731,1098,7.9
"28083",28,83,2008,13525,12340,1185,8.8
"28083",28,83,2009,12997,11366,1631,12.5
"28083",28,83,2010,11604,9825,1779,15.3
"28083",28,83,2011,11626,9895,1731,14.9
"28083",28,83,2012,11210,9637,1573,14
"28083",28,83,2013,10738,9207,1531,14.3
"28083",28,83,2014,10555,9224,1331,12.6
"28083",28,83,2015,10491,9362,1129,10.8
"28083",28,83,2016,10347,9407,940,9.1
"28083",28,83,2017,10414,9648,766,7.4
"28085",28,85,1990,13135,12132,1003,7.6
"28085",28,85,1991,13128,11729,1399,10.7
"28085",28,85,1992,13071,11757,1314,10.1
"28085",28,85,1993,12900,11728,1172,9.1
"28085",28,85,1994,13006,12010,996,7.7
"28085",28,85,1995,13452,12645,807,6
"28085",28,85,1996,13466,12740,726,5.4
"28085",28,85,1997,13409,12665,744,5.5
"28085",28,85,1998,13649,12976,673,4.9
"28085",28,85,1999,14026,13352,674,4.8
"28085",28,85,2000,14776,13981,795,5.4
"28085",28,85,2001,14464,13684,780,5.4
"28085",28,85,2002,14198,13187,1011,7.1
"28085",28,85,2003,14405,13508,897,6.2
"28085",28,85,2004,14406,13508,898,6.2
"28085",28,85,2005,14552,13487,1065,7.3
"28085",28,85,2006,14311,13465,846,5.9
"28085",28,85,2007,14222,13312,910,6.4
"28085",28,85,2008,14126,13113,1013,7.2
"28085",28,85,2009,13590,12196,1394,10.3
"28085",28,85,2010,14459,12940,1519,10.5
"28085",28,85,2011,14829,13383,1446,9.8
"28085",28,85,2012,14412,13168,1244,8.6
"28085",28,85,2013,13920,12848,1072,7.7
"28085",28,85,2014,13743,12836,907,6.6
"28085",28,85,2015,14225,13363,862,6.1
"28085",28,85,2016,14438,13617,821,5.7
"28085",28,85,2017,14579,13819,760,5.2
"28087",28,87,1990,28388,26544,1844,6.5
"28087",28,87,1991,27731,25369,2362,8.5
"28087",28,87,1992,26738,24604,2134,8
"28087",28,87,1993,26867,25228,1639,6.1
"28087",28,87,1994,27429,25738,1691,6.2
"28087",28,87,1995,27770,26231,1539,5.5
"28087",28,87,1996,27845,26030,1815,6.5
"28087",28,87,1997,27965,25931,2034,7.3
"28087",28,87,1998,27605,25522,2083,7.5
"28087",28,87,1999,26971,25399,1572,5.8
"28087",28,87,2000,27766,26231,1535,5.5
"28087",28,87,2001,27186,25455,1731,6.4
"28087",28,87,2002,26152,23995,2157,8.2
"28087",28,87,2003,25717,23845,1872,7.3
"28087",28,87,2004,25713,23998,1715,6.7
"28087",28,87,2005,25498,23594,1904,7.5
"28087",28,87,2006,25572,23877,1695,6.6
"28087",28,87,2007,26208,24262,1946,7.4
"28087",28,87,2008,25896,23939,1957,7.6
"28087",28,87,2009,24998,22351,2647,10.6
"28087",28,87,2010,26144,23046,3098,11.8
"28087",28,87,2011,27321,24446,2875,10.5
"28087",28,87,2012,27522,25005,2517,9.1
"28087",28,87,2013,26976,24470,2506,9.3
"28087",28,87,2014,25266,23064,2202,8.7
"28087",28,87,2015,25122,23358,1764,7
"28087",28,87,2016,25547,23978,1569,6.1
"28087",28,87,2017,25384,24016,1368,5.4
"28089",28,89,1990,26901,25477,1424,5.3
"28089",28,89,1991,27522,25735,1787,6.5
"28089",28,89,1992,28228,26719,1509,5.3
"28089",28,89,1993,29903,28537,1366,4.6
"28089",28,89,1994,31621,30318,1303,4.1
"28089",28,89,1995,33053,31843,1210,3.7
"28089",28,89,1996,34339,33148,1191,3.5
"28089",28,89,1997,35823,34571,1252,3.5
"28089",28,89,1998,36938,35805,1133,3.1
"28089",28,89,1999,37346,36192,1154,3.1
"28089",28,89,2000,39495,37869,1626,4.1
"28089",28,89,2001,40194,38660,1534,3.8
"28089",28,89,2002,40177,38252,1925,4.8
"28089",28,89,2003,41741,39846,1895,4.5
"28089",28,89,2004,43698,41612,2086,4.8
"28089",28,89,2005,44044,41794,2250,5.1
"28089",28,89,2006,44449,42430,2019,4.5
"28089",28,89,2007,45385,43266,2119,4.7
"28089",28,89,2008,46205,43861,2344,5.1
"28089",28,89,2009,45519,42394,3125,6.9
"28089",28,89,2010,48712,45114,3598,7.4
"28089",28,89,2011,50716,47222,3494,6.9
"28089",28,89,2012,50411,47262,3149,6.2
"28089",28,89,2013,49764,46853,2911,5.8
"28089",28,89,2014,49769,47154,2615,5.3
"28089",28,89,2015,51644,49283,2361,4.6
"28089",28,89,2016,53420,51118,2302,4.3
"28089",28,89,2017,53841,51767,2074,3.9
"28091",28,91,1990,10275,9283,992,9.7
"28091",28,91,1991,10094,9037,1057,10.5
"28091",28,91,1992,10259,9083,1176,11.5
"28091",28,91,1993,10262,9242,1020,9.9
"28091",28,91,1994,10252,9357,895,8.7
"28091",28,91,1995,9830,9091,739,7.5
"28091",28,91,1996,10265,9584,681,6.6
"28091",28,91,1997,10474,9845,629,6
"28091",28,91,1998,10674,10047,627,5.9
"28091",28,91,1999,10690,9997,693,6.5
"28091",28,91,2000,10680,10046,634,5.9
"28091",28,91,2001,10314,9733,581,5.6
"28091",28,91,2002,10238,9631,607,5.9
"28091",28,91,2003,10578,9947,631,6
"28091",28,91,2004,10483,9781,702,6.7
"28091",28,91,2005,10325,9480,845,8.2
"28091",28,91,2006,10318,9666,652,6.3
"28091",28,91,2007,10329,9683,646,6.3
"28091",28,91,2008,10408,9685,723,6.9
"28091",28,91,2009,10288,9241,1047,10.2
"28091",28,91,2010,10544,9259,1285,12.2
"28091",28,91,2011,10922,9756,1166,10.7
"28091",28,91,2012,10334,9276,1058,10.2
"28091",28,91,2013,9936,9000,936,9.4
"28091",28,91,2014,9893,9081,812,8.2
"28091",28,91,2015,10008,9278,730,7.3
"28091",28,91,2016,10276,9602,674,6.6
"28091",28,91,2017,10233,9667,566,5.5
"28093",28,93,1990,13638,12232,1406,10.3
"28093",28,93,1991,13623,11866,1757,12.9
"28093",28,93,1992,13577,11996,1581,11.6
"28093",28,93,1993,13791,12497,1294,9.4
"28093",28,93,1994,13886,12687,1199,8.6
"28093",28,93,1995,13886,12496,1390,10
"28093",28,93,1996,13481,12429,1052,7.8
"28093",28,93,1997,14039,13135,904,6.4
"28093",28,93,1998,14073,13277,796,5.7
"28093",28,93,1999,13759,12918,841,6.1
"28093",28,93,2000,15329,14692,637,4.2
"28093",28,93,2001,15321,14356,965,6.3
"28093",28,93,2002,15178,13964,1214,8
"28093",28,93,2003,15424,14184,1240,8
"28093",28,93,2004,15294,14119,1175,7.7
"28093",28,93,2005,15345,14042,1303,8.5
"28093",28,93,2006,14986,13842,1144,7.6
"28093",28,93,2007,15413,14270,1143,7.4
"28093",28,93,2008,15378,14145,1233,8
"28093",28,93,2009,14707,12972,1735,11.8
"28093",28,93,2010,15497,13626,1871,12.1
"28093",28,93,2011,15773,13927,1846,11.7
"28093",28,93,2012,15396,13725,1671,10.9
"28093",28,93,2013,14805,13303,1502,10.1
"28093",28,93,2014,14360,13114,1246,8.7
"28093",28,93,2015,14446,13403,1043,7.2
"28093",28,93,2016,14571,13693,878,6
"28093",28,93,2017,14624,13881,743,5.1
"28095",28,95,1990,18094,16683,1411,7.8
"28095",28,95,1991,17286,15594,1692,9.8
"28095",28,95,1992,16664,15228,1436,8.6
"28095",28,95,1993,16907,15771,1136,6.7
"28095",28,95,1994,17135,16116,1019,5.9
"28095",28,95,1995,17131,15527,1604,9.4
"28095",28,95,1996,16074,14283,1791,11.1
"28095",28,95,1997,15748,14104,1644,10.4
"28095",28,95,1998,15305,13747,1558,10.2
"28095",28,95,1999,15256,14143,1113,7.3
"28095",28,95,2000,17766,16523,1243,7
"28095",28,95,2001,17058,15705,1353,7.9
"28095",28,95,2002,16640,15277,1363,8.2
"28095",28,95,2003,16865,15511,1354,8
"28095",28,95,2004,17221,15921,1300,7.5
"28095",28,95,2005,17190,15817,1373,8
"28095",28,95,2006,16639,15213,1426,8.6
"28095",28,95,2007,16536,15021,1515,9.2
"28095",28,95,2008,15864,14341,1523,9.6
"28095",28,95,2009,15489,13352,2137,13.8
"28095",28,95,2010,16300,14157,2143,13.1
"28095",28,95,2011,16576,14580,1996,12
"28095",28,95,2012,16142,14356,1786,11.1
"28095",28,95,2013,15505,13681,1824,11.8
"28095",28,95,2014,15461,13905,1556,10.1
"28095",28,95,2015,15484,14343,1141,7.4
"28095",28,95,2016,15654,14667,987,6.3
"28095",28,95,2017,15432,14631,801,5.2
"28097",28,97,1990,5574,5076,498,8.9
"28097",28,97,1991,5472,4878,594,10.9
"28097",28,97,1992,5337,4934,403,7.6
"28097",28,97,1993,5415,5008,407,7.5
"28097",28,97,1994,5525,5160,365,6.6
"28097",28,97,1995,5500,5127,373,6.8
"28097",28,97,1996,5454,5081,373,6.8
"28097",28,97,1997,5521,5137,384,7
"28097",28,97,1998,5422,5088,334,6.2
"28097",28,97,1999,5471,5141,330,6
"28097",28,97,2000,5355,5020,335,6.3
"28097",28,97,2001,5107,4665,442,8.7
"28097",28,97,2002,4962,4406,556,11.2
"28097",28,97,2003,4986,4530,456,9.1
"28097",28,97,2004,4933,4552,381,7.7
"28097",28,97,2005,4818,4435,383,7.9
"28097",28,97,2006,4560,4155,405,8.9
"28097",28,97,2007,4493,4084,409,9.1
"28097",28,97,2008,4492,4104,388,8.6
"28097",28,97,2009,4503,3876,627,13.9
"28097",28,97,2010,4675,4031,644,13.8
"28097",28,97,2011,4677,4097,580,12.4
"28097",28,97,2012,4544,4014,530,11.7
"28097",28,97,2013,4375,3881,494,11.3
"28097",28,97,2014,4194,3807,387,9.2
"28097",28,97,2015,4199,3874,325,7.7
"28097",28,97,2016,4241,3970,271,6.4
"28097",28,97,2017,4173,3961,212,5.1
"28099",28,99,1990,11597,10832,765,6.6
"28099",28,99,1991,12234,11302,932,7.6
"28099",28,99,1992,12598,11835,763,6.1
"28099",28,99,1993,12969,12329,640,4.9
"28099",28,99,1994,12984,12294,690,5.3
"28099",28,99,1995,15313,14710,603,3.9
"28099",28,99,1996,16363,15766,597,3.6
"28099",28,99,1997,16124,15515,609,3.8
"28099",28,99,1998,16355,15748,607,3.7
"28099",28,99,1999,15876,15126,750,4.7
"28099",28,99,2000,13408,12698,710,5.3
"28099",28,99,2001,13139,12412,727,5.5
"28099",28,99,2002,14264,13330,934,6.5
"28099",28,99,2003,14628,13857,771,5.3
"28099",28,99,2004,14671,13829,842,5.7
"28099",28,99,2005,14761,13889,872,5.9
"28099",28,99,2006,14348,13652,696,4.9
"28099",28,99,2007,13988,13284,704,5
"28099",28,99,2008,14097,13349,748,5.3
"28099",28,99,2009,13338,12104,1234,9.3
"28099",28,99,2010,11806,10579,1227,10.4
"28099",28,99,2011,11969,10855,1114,9.3
"28099",28,99,2012,11654,10680,974,8.4
"28099",28,99,2013,10958,10105,853,7.8
"28099",28,99,2014,10779,10049,730,6.8
"28099",28,99,2015,10623,9972,651,6.1
"28099",28,99,2016,10712,10096,616,5.8
"28099",28,99,2017,10576,10039,537,5.1
"28101",28,101,1990,9477,8881,596,6.3
"28101",28,101,1991,9078,8539,539,5.9
"28101",28,101,1992,9068,8367,701,7.7
"28101",28,101,1993,8726,8202,524,6
"28101",28,101,1994,8762,8228,534,6.1
"28101",28,101,1995,8659,7956,703,8.1
"28101",28,101,1996,8452,7977,475,5.6
"28101",28,101,1997,8544,8173,371,4.3
"28101",28,101,1998,8517,8070,447,5.2
"28101",28,101,1999,8513,7952,561,6.6
"28101",28,101,2000,9885,9339,546,5.5
"28101",28,101,2001,9476,8959,517,5.5
"28101",28,101,2002,9667,9016,651,6.7
"28101",28,101,2003,9680,9138,542,5.6
"28101",28,101,2004,9810,9262,548,5.6
"28101",28,101,2005,9741,9135,606,6.2
"28101",28,101,2006,9571,9033,538,5.6
"28101",28,101,2007,9570,9036,534,5.6
"28101",28,101,2008,9450,8838,612,6.5
"28101",28,101,2009,9037,8206,831,9.2
"28101",28,101,2010,9201,8274,927,10.1
"28101",28,101,2011,9393,8526,867,9.2
"28101",28,101,2012,9262,8524,738,8
"28101",28,101,2013,8981,8311,670,7.5
"28101",28,101,2014,8773,8188,585,6.7
"28101",28,101,2015,8719,8185,534,6.1
"28101",28,101,2016,8651,8141,510,5.9
"28101",28,101,2017,8511,8054,457,5.4
"28103",28,103,1990,4948,4363,585,11.8
"28103",28,103,1991,4670,4113,557,11.9
"28103",28,103,1992,4461,3974,487,10.9
"28103",28,103,1993,4500,4081,419,9.3
"28103",28,103,1994,4497,4118,379,8.4
"28103",28,103,1995,4590,4169,421,9.2
"28103",28,103,1996,4524,4097,427,9.4
"28103",28,103,1997,4481,4065,416,9.3
"28103",28,103,1998,4480,4028,452,10.1
"28103",28,103,1999,4591,4070,521,11.3
"28103",28,103,2000,4741,4322,419,8.8
"28103",28,103,2001,4519,4065,454,10
"28103",28,103,2002,4532,4100,432,9.5
"28103",28,103,2003,4517,4089,428,9.5
"28103",28,103,2004,4481,3942,539,12
"28103",28,103,2005,4200,3688,512,12.2
"28103",28,103,2006,4091,3628,463,11.3
"28103",28,103,2007,4018,3518,500,12.4
"28103",28,103,2008,3813,3297,516,13.5
"28103",28,103,2009,3681,2998,683,18.6
"28103",28,103,2010,4430,3731,699,15.8
"28103",28,103,2011,4379,3742,637,14.5
"28103",28,103,2012,4211,3659,552,13.1
"28103",28,103,2013,4087,3540,547,13.4
"28103",28,103,2014,4007,3506,501,12.5
"28103",28,103,2015,3954,3567,387,9.8
"28103",28,103,2016,3969,3641,328,8.3
"28103",28,103,2017,3923,3633,290,7.4
"28105",28,105,1990,18236,17053,1183,6.5
"28105",28,105,1991,18106,17045,1061,5.9
"28105",28,105,1992,18748,17358,1390,7.4
"28105",28,105,1993,18358,17715,643,3.5
"28105",28,105,1994,18389,17745,644,3.5
"28105",28,105,1995,19087,18508,579,3
"28105",28,105,1996,19782,19233,549,2.8
"28105",28,105,1997,20175,19616,559,2.8
"28105",28,105,1998,20667,20132,535,2.6
"28105",28,105,1999,21283,20815,468,2.2
"28105",28,105,2000,20815,19760,1055,5.1
"28105",28,105,2001,20642,19656,986,4.8
"28105",28,105,2002,20038,18902,1136,5.7
"28105",28,105,2003,20046,18905,1141,5.7
"28105",28,105,2004,19918,18796,1122,5.6
"28105",28,105,2005,20208,18993,1215,6
"28105",28,105,2006,19758,18653,1105,5.6
"28105",28,105,2007,19921,18619,1302,6.5
"28105",28,105,2008,20458,19193,1265,6.2
"28105",28,105,2009,19844,18103,1741,8.8
"28105",28,105,2010,21697,19478,2219,10.2
"28105",28,105,2011,22769,20594,2175,9.6
"28105",28,105,2012,22784,20874,1910,8.4
"28105",28,105,2013,22213,20446,1767,8
"28105",28,105,2014,22081,20496,1585,7.2
"28105",28,105,2015,22499,21119,1380,6.1
"28105",28,105,2016,23079,21825,1254,5.4
"28105",28,105,2017,22878,21771,1107,4.8
"28107",28,107,1990,13049,11855,1194,9.2
"28107",28,107,1991,13499,11988,1511,11.2
"28107",28,107,1992,13459,11864,1595,11.9
"28107",28,107,1993,13231,11938,1293,9.8
"28107",28,107,1994,13683,12453,1230,9
"28107",28,107,1995,13527,12357,1170,8.6
"28107",28,107,1996,13839,11467,2372,17.1
"28107",28,107,1997,13140,11614,1526,11.6
"28107",28,107,1998,12725,11653,1072,8.4
"28107",28,107,1999,12552,11532,1020,8.1
"28107",28,107,2000,14786,13760,1026,6.9
"28107",28,107,2001,14575,13458,1117,7.7
"28107",28,107,2002,14478,13275,1203,8.3
"28107",28,107,2003,14663,13357,1306,8.9
"28107",28,107,2004,14708,13372,1336,9.1
"28107",28,107,2005,14792,13517,1275,8.6
"28107",28,107,2006,14852,13730,1122,7.6
"28107",28,107,2007,14994,13808,1186,7.9
"28107",28,107,2008,14715,13492,1223,8.3
"28107",28,107,2009,14540,12761,1779,12.2
"28107",28,107,2010,14409,12457,1952,13.5
"28107",28,107,2011,14708,12768,1940,13.2
"28107",28,107,2012,14307,12570,1737,12.1
"28107",28,107,2013,13674,12047,1627,11.9
"28107",28,107,2014,13415,12001,1414,10.5
"28107",28,107,2015,13440,12271,1169,8.7
"28107",28,107,2016,13199,12227,972,7.4
"28107",28,107,2017,13039,12157,882,6.8
"28109",28,109,1990,16940,15468,1472,8.7
"28109",28,109,1991,16755,15314,1441,8.6
"28109",28,109,1992,17220,15712,1508,8.8
"28109",28,109,1993,17814,16556,1258,7.1
"28109",28,109,1994,18039,16870,1169,6.5
"28109",28,109,1995,18863,17774,1089,5.8
"28109",28,109,1996,19128,18294,834,4.4
"28109",28,109,1997,19635,18722,913,4.6
"28109",28,109,1998,19942,19116,826,4.1
"28109",28,109,1999,20060,19239,821,4.1
"28109",28,109,2000,21343,20275,1068,5
"28109",28,109,2001,21283,20347,936,4.4
"28109",28,109,2002,21320,20161,1159,5.4
"28109",28,109,2003,21275,20138,1137,5.3
"28109",28,109,2004,21455,20276,1179,5.5
"28109",28,109,2005,21363,19403,1960,9.2
"28109",28,109,2006,20482,19139,1343,6.6
"28109",28,109,2007,21604,20333,1271,5.9
"28109",28,109,2008,21457,20042,1415,6.6
"28109",28,109,2009,20920,19030,1890,9
"28109",28,109,2010,23423,21198,2225,9.5
"28109",28,109,2011,24313,22044,2269,9.3
"28109",28,109,2012,23776,21819,1957,8.2
"28109",28,109,2013,22827,21135,1692,7.4
"28109",28,109,2014,22335,20840,1495,6.7
"28109",28,109,2015,22868,21460,1408,6.2
"28109",28,109,2016,23244,21855,1389,6
"28109",28,109,2017,23243,22016,1227,5.3
"28111",28,111,1990,4280,3889,391,9.1
"28111",28,111,1991,4134,3582,552,13.4
"28111",28,111,1992,4299,3762,537,12.5
"28111",28,111,1993,4463,4021,442,9.9
"28111",28,111,1994,4937,4538,399,8.1
"28111",28,111,1995,4963,4576,387,7.8
"28111",28,111,1996,4706,4328,378,8
"28111",28,111,1997,4235,3896,339,8
"28111",28,111,1998,4162,3877,285,6.8
"28111",28,111,1999,4125,3822,303,7.3
"28111",28,111,2000,5211,4893,318,6.1
"28111",28,111,2001,5147,4853,294,5.7
"28111",28,111,2002,5143,4771,372,7.2
"28111",28,111,2003,5159,4782,377,7.3
"28111",28,111,2004,5167,4789,378,7.3
"28111",28,111,2005,5130,4711,419,8.2
"28111",28,111,2006,5114,4777,337,6.6
"28111",28,111,2007,5130,4784,346,6.7
"28111",28,111,2008,5080,4669,411,8.1
"28111",28,111,2009,4847,4326,521,10.7
"28111",28,111,2010,4636,4004,632,13.6
"28111",28,111,2011,4671,4054,617,13.2
"28111",28,111,2012,4436,3927,509,11.5
"28111",28,111,2013,4249,3807,442,10.4
"28111",28,111,2014,4208,3823,385,9.1
"28111",28,111,2015,4314,3972,342,7.9
"28111",28,111,2016,4362,4051,311,7.1
"28111",28,111,2017,4430,4153,277,6.3
"28113",28,113,1990,15114,13916,1198,7.9
"28113",28,113,1991,15293,13776,1517,9.9
"28113",28,113,1992,15298,13814,1484,9.7
"28113",28,113,1993,15689,14384,1305,8.3
"28113",28,113,1994,15710,14488,1222,7.8
"28113",28,113,1995,15762,14788,974,6.2
"28113",28,113,1996,16193,15352,841,5.2
"28113",28,113,1997,16342,15483,859,5.3
"28113",28,113,1998,16405,15611,794,4.8
"28113",28,113,1999,16693,15833,860,5.2
"28113",28,113,2000,16143,15128,1015,6.3
"28113",28,113,2001,15462,14483,979,6.3
"28113",28,113,2002,15187,14046,1141,7.5
"28113",28,113,2003,15101,14117,984,6.5
"28113",28,113,2004,15266,14187,1079,7.1
"28113",28,113,2005,15522,14164,1358,8.7
"28113",28,113,2006,15458,14456,1002,6.5
"28113",28,113,2007,15421,14405,1016,6.6
"28113",28,113,2008,15703,14616,1087,6.9
"28113",28,113,2009,15026,13507,1519,10.1
"28113",28,113,2010,15611,13799,1812,11.6
"28113",28,113,2011,15766,13942,1824,11.6
"28113",28,113,2012,15271,13663,1608,10.5
"28113",28,113,2013,14642,13206,1436,9.8
"28113",28,113,2014,14542,13340,1202,8.3
"28113",28,113,2015,14697,13623,1074,7.3
"28113",28,113,2016,14688,13690,998,6.8
"28113",28,113,2017,14690,13812,878,6
"28115",28,115,1990,11786,11068,718,6.1
"28115",28,115,1991,11648,10824,824,7.1
"28115",28,115,1992,12190,11355,835,6.8
"28115",28,115,1993,12375,11777,598,4.8
"28115",28,115,1994,12821,12315,506,3.9
"28115",28,115,1995,13158,12459,699,5.3
"28115",28,115,1996,13173,12478,695,5.3
"28115",28,115,1997,13075,12496,579,4.4
"28115",28,115,1998,13147,12647,500,3.8
"28115",28,115,1999,13654,13194,460,3.4
"28115",28,115,2000,13723,13105,618,4.5
"28115",28,115,2001,13372,12659,713,5.3
"28115",28,115,2002,13052,12310,742,5.7
"28115",28,115,2003,13032,12294,738,5.7
"28115",28,115,2004,13264,12578,686,5.2
"28115",28,115,2005,13370,12578,792,5.9
"28115",28,115,2006,13289,12520,769,5.8
"28115",28,115,2007,13195,12345,850,6.4
"28115",28,115,2008,13262,12247,1015,7.7
"28115",28,115,2009,12703,11406,1297,10.2
"28115",28,115,2010,13672,12280,1392,10.2
"28115",28,115,2011,14019,12710,1309,9.3
"28115",28,115,2012,14081,12980,1101,7.8
"28115",28,115,2013,13672,12659,1013,7.4
"28115",28,115,2014,13486,12570,916,6.8
"28115",28,115,2015,13876,13102,774,5.6
"28115",28,115,2016,14450,13767,683,4.7
"28115",28,115,2017,14424,13862,562,3.9
"28117",28,117,1990,11864,10754,1110,9.4
"28117",28,117,1991,11799,10502,1297,11
"28117",28,117,1992,11690,10821,869,7.4
"28117",28,117,1993,11783,11189,594,5
"28117",28,117,1994,12293,11474,819,6.7
"28117",28,117,1995,12270,11430,840,6.8
"28117",28,117,1996,12408,11392,1016,8.2
"28117",28,117,1997,12228,11386,842,6.9
"28117",28,117,1998,12233,11345,888,7.3
"28117",28,117,1999,12506,11730,776,6.2
"28117",28,117,2000,12329,11704,625,5.1
"28117",28,117,2001,12029,11414,615,5.1
"28117",28,117,2002,12003,11264,739,6.2
"28117",28,117,2003,12088,11328,760,6.3
"28117",28,117,2004,11870,11018,852,7.2
"28117",28,117,2005,11426,10554,872,7.6
"28117",28,117,2006,11159,10375,784,7
"28117",28,117,2007,11107,10277,830,7.5
"28117",28,117,2008,11167,10275,892,8
"28117",28,117,2009,10818,9424,1394,12.9
"28117",28,117,2010,11604,10235,1369,11.8
"28117",28,117,2011,11731,10511,1220,10.4
"28117",28,117,2012,11423,10438,985,8.6
"28117",28,117,2013,10947,10023,924,8.4
"28117",28,117,2014,10857,10045,812,7.5
"28117",28,117,2015,10992,10328,664,6
"28117",28,117,2016,11072,10469,603,5.4
"28117",28,117,2017,11118,10606,512,4.6
"28119",28,119,1990,4141,3688,453,10.9
"28119",28,119,1991,4085,3557,528,12.9
"28119",28,119,1992,4269,3747,522,12.2
"28119",28,119,1993,3959,3491,468,11.8
"28119",28,119,1994,3766,3331,435,11.6
"28119",28,119,1995,3725,3238,487,13.1
"28119",28,119,1996,3534,2940,594,16.8
"28119",28,119,1997,3388,2953,435,12.8
"28119",28,119,1998,3266,2920,346,10.6
"28119",28,119,1999,3311,3020,291,8.8
"28119",28,119,2000,4045,3754,291,7.2
"28119",28,119,2001,3967,3636,331,8.3
"28119",28,119,2002,4049,3707,342,8.4
"28119",28,119,2003,4157,3808,349,8.4
"28119",28,119,2004,4037,3639,398,9.9
"28119",28,119,2005,3953,3588,365,9.2
"28119",28,119,2006,3870,3551,319,8.2
"28119",28,119,2007,3780,3470,310,8.2
"28119",28,119,2008,3618,3301,317,8.8
"28119",28,119,2009,3431,3006,425,12.4
"28119",28,119,2010,3197,2721,476,14.9
"28119",28,119,2011,3123,2658,465,14.9
"28119",28,119,2012,2971,2557,414,13.9
"28119",28,119,2013,2858,2434,424,14.8
"28119",28,119,2014,2751,2392,359,13
"28119",28,119,2015,2687,2398,289,10.8
"28119",28,119,2016,2621,2365,256,9.8
"28119",28,119,2017,2485,2268,217,8.7
"28121",28,121,1990,46918,44900,2018,4.3
"28121",28,121,1991,47161,45070,2091,4.4
"28121",28,121,1992,48111,46079,2032,4.2
"28121",28,121,1993,49484,47797,1687,3.4
"28121",28,121,1994,51626,49956,1670,3.2
"28121",28,121,1995,53671,52063,1608,3
"28121",28,121,1996,55750,54265,1485,2.7
"28121",28,121,1997,58396,57003,1393,2.4
"28121",28,121,1998,60078,58761,1317,2.2
"28121",28,121,1999,60821,59513,1308,2.2
"28121",28,121,2000,63636,61377,2259,3.5
"28121",28,121,2001,65176,62977,2199,3.4
"28121",28,121,2002,65323,62576,2747,4.2
"28121",28,121,2003,68079,65286,2793,4.1
"28121",28,121,2004,71224,68388,2836,4
"28121",28,121,2005,71680,68458,3222,4.5
"28121",28,121,2006,71927,69036,2891,4
"28121",28,121,2007,73005,70131,2874,3.9
"28121",28,121,2008,73879,70829,3050,4.1
"28121",28,121,2009,72616,68249,4367,6
"28121",28,121,2010,70858,66002,4856,6.9
"28121",28,121,2011,73498,68814,4684,6.4
"28121",28,121,2012,72785,68604,4181,5.7
"28121",28,121,2013,71226,67505,3721,5.2
"28121",28,121,2014,70991,67699,3292,4.6
"28121",28,121,2015,73013,69983,3030,4.1
"28121",28,121,2016,75023,72051,2972,4
"28121",28,121,2017,75655,72957,2698,3.6
"28123",28,123,1990,11369,10683,686,6
"28123",28,123,1991,12326,11544,782,6.3
"28123",28,123,1992,12590,11962,628,5
"28123",28,123,1993,13265,12699,566,4.3
"28123",28,123,1994,13240,12683,557,4.2
"28123",28,123,1995,13170,12522,648,4.9
"28123",28,123,1996,12748,12027,721,5.7
"28123",28,123,1997,12448,11599,849,6.8
"28123",28,123,1998,11914,11410,504,4.2
"28123",28,123,1999,12324,11909,415,3.4
"28123",28,123,2000,12790,12195,595,4.7
"28123",28,123,2001,12536,11918,618,4.9
"28123",28,123,2002,12498,11725,773,6.2
"28123",28,123,2003,13048,12339,709,5.4
"28123",28,123,2004,13046,12380,666,5.1
"28123",28,123,2005,13266,12535,731,5.5
"28123",28,123,2006,13262,12566,696,5.2
"28123",28,123,2007,13266,12619,647,4.9
"28123",28,123,2008,13486,12817,669,5
"28123",28,123,2009,13412,12472,940,7
"28123",28,123,2010,13551,12469,1082,8
"28123",28,123,2011,13667,12513,1154,8.4
"28123",28,123,2012,13093,12096,997,7.6
"28123",28,123,2013,12742,11900,842,6.6
"28123",28,123,2014,12672,11976,696,5.5
"28123",28,123,2015,12983,12359,624,4.8
"28123",28,123,2016,13277,12666,611,4.6
"28123",28,123,2017,13403,12866,537,4
"28125",28,125,1990,2974,2590,384,12.9
"28125",28,125,1991,3025,2609,416,13.8
"28125",28,125,1992,3112,2713,399,12.8
"28125",28,125,1993,3255,2850,405,12.4
"28125",28,125,1994,3268,2726,542,16.6
"28125",28,125,1995,3114,2538,576,18.5
"28125",28,125,1996,2753,2275,478,17.4
"28125",28,125,1997,2636,2249,387,14.7
"28125",28,125,1998,2548,2219,329,12.9
"28125",28,125,1999,2536,2077,459,18.1
"28125",28,125,2000,2650,2390,260,9.8
"28125",28,125,2001,2615,2363,252,9.6
"28125",28,125,2002,2628,2362,266,10.1
"28125",28,125,2003,2700,2453,247,9.1
"28125",28,125,2004,2649,2368,281,10.6
"28125",28,125,2005,2561,2280,281,11
"28125",28,125,2006,2537,2303,234,9.2
"28125",28,125,2007,2549,2339,210,8.2
"28125",28,125,2008,2484,2274,210,8.5
"28125",28,125,2009,2381,2124,257,10.8
"28125",28,125,2010,2059,1760,299,14.5
"28125",28,125,2011,2024,1729,295,14.6
"28125",28,125,2012,1938,1675,263,13.6
"28125",28,125,2013,1844,1604,240,13
"28125",28,125,2014,1769,1574,195,11
"28125",28,125,2015,1727,1561,166,9.6
"28125",28,125,2016,1716,1565,151,8.8
"28125",28,125,2017,1703,1572,131,7.7
"28127",28,127,1990,10362,9774,588,5.7
"28127",28,127,1991,10250,9545,705,6.9
"28127",28,127,1992,10489,9883,606,5.8
"28127",28,127,1993,10906,10386,520,4.8
"28127",28,127,1994,10746,10246,500,4.7
"28127",28,127,1995,10631,10061,570,5.4
"28127",28,127,1996,10578,9800,778,7.4
"28127",28,127,1997,10575,10033,542,5.1
"28127",28,127,1998,10568,9558,1010,9.6
"28127",28,127,1999,9874,9247,627,6.4
"28127",28,127,2000,11907,11336,571,4.8
"28127",28,127,2001,11837,11259,578,4.9
"28127",28,127,2002,11714,11055,659,5.6
"28127",28,127,2003,11834,11180,654,5.5
"28127",28,127,2004,11991,11373,618,5.2
"28127",28,127,2005,11967,11248,719,6
"28127",28,127,2006,11658,11021,637,5.5
"28127",28,127,2007,11566,10933,633,5.5
"28127",28,127,2008,11603,10925,678,5.8
"28127",28,127,2009,11290,10321,969,8.6
"28127",28,127,2010,11372,10304,1068,9.4
"28127",28,127,2011,11579,10522,1057,9.1
"28127",28,127,2012,11285,10355,930,8.2
"28127",28,127,2013,10948,10137,811,7.4
"28127",28,127,2014,10761,10074,687,6.4
"28127",28,127,2015,10897,10257,640,5.9
"28127",28,127,2016,10942,10348,594,5.4
"28127",28,127,2017,10997,10466,531,4.8
"28129",28,129,1990,6545,6174,371,5.7
"28129",28,129,1991,6364,5913,451,7.1
"28129",28,129,1992,6249,5830,419,6.7
"28129",28,129,1993,6404,6107,297,4.6
"28129",28,129,1994,6306,6000,306,4.9
"28129",28,129,1995,6161,5903,258,4.2
"28129",28,129,1996,6032,5757,275,4.6
"28129",28,129,1997,5968,5729,239,4
"28129",28,129,1998,6026,5802,224,3.7
"28129",28,129,1999,5802,5579,223,3.8
"28129",28,129,2000,7366,7019,347,4.7
"28129",28,129,2001,7131,6777,354,5
"28129",28,129,2002,7242,6859,383,5.3
"28129",28,129,2003,7341,6986,355,4.8
"28129",28,129,2004,6942,6572,370,5.3
"28129",28,129,2005,6847,6435,412,6
"28129",28,129,2006,6772,6408,364,5.4
"28129",28,129,2007,6732,6370,362,5.4
"28129",28,129,2008,6495,6079,416,6.4
"28129",28,129,2009,6282,5708,574,9.1
"28129",28,129,2010,7314,6650,664,9.1
"28129",28,129,2011,7400,6792,608,8.2
"28129",28,129,2012,7096,6580,516,7.3
"28129",28,129,2013,6839,6380,459,6.7
"28129",28,129,2014,6727,6338,389,5.8
"28129",28,129,2015,6754,6392,362,5.4
"28129",28,129,2016,6744,6389,355,5.3
"28129",28,129,2017,6752,6434,318,4.7
"28131",28,131,1990,4833,4481,352,7.3
"28131",28,131,1991,4944,4539,405,8.2
"28131",28,131,1992,5095,4565,530,10.4
"28131",28,131,1993,5067,4665,402,7.9
"28131",28,131,1994,5114,4705,409,8
"28131",28,131,1995,5003,4663,340,6.8
"28131",28,131,1996,5037,4710,327,6.5
"28131",28,131,1997,5188,4907,281,5.4
"28131",28,131,1998,5276,5017,259,4.9
"28131",28,131,1999,5091,4828,263,5.2
"28131",28,131,2000,6600,6236,364,5.5
"28131",28,131,2001,6745,6425,320,4.7
"28131",28,131,2002,6625,6253,372,5.6
"28131",28,131,2003,6845,6464,381,5.6
"28131",28,131,2004,6939,6555,384,5.5
"28131",28,131,2005,6830,6307,523,7.7
"28131",28,131,2006,7252,6716,536,7.4
"28131",28,131,2007,7700,7268,432,5.6
"28131",28,131,2008,7782,7334,448,5.8
"28131",28,131,2009,7756,7140,616,7.9
"28131",28,131,2010,6843,6117,726,10.6
"28131",28,131,2011,7040,6283,757,10.8
"28131",28,131,2012,6694,6004,690,10.3
"28131",28,131,2013,6461,5846,615,9.5
"28131",28,131,2014,6332,5792,540,8.5
"28131",28,131,2015,6410,5935,475,7.4
"28131",28,131,2016,6500,6062,438,6.7
"28131",28,131,2017,6570,6172,398,6.1
"28133",28,133,1990,12359,10924,1435,11.6
"28133",28,133,1991,12278,10900,1378,11.2
"28133",28,133,1992,12335,10935,1400,11.3
"28133",28,133,1993,12200,10768,1432,11.7
"28133",28,133,1994,11900,10565,1335,11.2
"28133",28,133,1995,11694,10374,1320,11.3
"28133",28,133,1996,11220,9819,1401,12.5
"28133",28,133,1997,11053,9536,1517,13.7
"28133",28,133,1998,10595,9362,1233,11.6
"28133",28,133,1999,10999,9905,1094,9.9
"28133",28,133,2000,12162,11087,1075,8.8
"28133",28,133,2001,10327,9238,1089,10.5
"28133",28,133,2002,11598,10376,1222,10.5
"28133",28,133,2003,11465,10401,1064,9.3
"28133",28,133,2004,11166,10165,1001,9
"28133",28,133,2005,11187,10060,1127,10.1
"28133",28,133,2006,11172,10158,1014,9.1
"28133",28,133,2007,10892,9853,1039,9.5
"28133",28,133,2008,10660,9575,1085,10.2
"28133",28,133,2009,10258,8951,1307,12.7
"28133",28,133,2010,9869,8348,1521,15.4
"28133",28,133,2011,9849,8363,1486,15.1
"28133",28,133,2012,9485,8123,1362,14.4
"28133",28,133,2013,8994,7744,1250,13.9
"28133",28,133,2014,8660,7579,1081,12.5
"28133",28,133,2015,8474,7585,889,10.5
"28133",28,133,2016,8348,7572,776,9.3
"28133",28,133,2017,8091,7425,666,8.2
"28135",28,135,1990,6058,5373,685,11.3
"28135",28,135,1991,6048,5272,776,12.8
"28135",28,135,1992,5865,5214,651,11.1
"28135",28,135,1993,5889,5254,635,10.8
"28135",28,135,1994,5736,5014,722,12.6
"28135",28,135,1995,5591,4935,656,11.7
"28135",28,135,1996,5457,4780,677,12.4
"28135",28,135,1997,5562,4925,637,11.5
"28135",28,135,1998,5272,4631,641,12.2
"28135",28,135,1999,5360,4843,517,9.6
"28135",28,135,2000,6056,5565,491,8.1
"28135",28,135,2001,5812,5287,525,9
"28135",28,135,2002,5723,5185,538,9.4
"28135",28,135,2003,6333,5768,565,8.9
"28135",28,135,2004,6490,5879,611,9.4
"28135",28,135,2005,6428,5849,579,9
"28135",28,135,2006,6157,5699,458,7.4
"28135",28,135,2007,6034,5571,463,7.7
"28135",28,135,2008,5986,5491,495,8.3
"28135",28,135,2009,5870,5212,658,11.2
"28135",28,135,2010,5885,5166,719,12.2
"28135",28,135,2011,6078,5341,737,12.1
"28135",28,135,2012,5775,5124,651,11.3
"28135",28,135,2013,5809,5163,646,11.1
"28135",28,135,2014,5841,5300,541,9.3
"28135",28,135,2015,5810,5371,439,7.6
"28135",28,135,2016,5741,5352,389,6.8
"28135",28,135,2017,5631,5333,298,5.3
"28137",28,137,1990,10459,9682,777,7.4
"28137",28,137,1991,10379,9350,1029,9.9
"28137",28,137,1992,10333,9388,945,9.1
"28137",28,137,1993,10446,9701,745,7.1
"28137",28,137,1994,10555,9908,647,6.1
"28137",28,137,1995,10701,10019,682,6.4
"28137",28,137,1996,10637,10053,584,5.5
"28137",28,137,1997,10598,10038,560,5.3
"28137",28,137,1998,10525,10069,456,4.3
"28137",28,137,1999,10457,9857,600,5.7
"28137",28,137,2000,11765,11341,424,3.6
"28137",28,137,2001,11648,11141,507,4.4
"28137",28,137,2002,11420,10793,627,5.5
"28137",28,137,2003,11695,10985,710,6.1
"28137",28,137,2004,11841,11138,703,5.9
"28137",28,137,2005,11896,11121,775,6.5
"28137",28,137,2006,11742,10974,768,6.5
"28137",28,137,2007,11838,11132,706,6
"28137",28,137,2008,11807,11020,787,6.7
"28137",28,137,2009,11448,10222,1226,10.7
"28137",28,137,2010,12631,11271,1360,10.8
"28137",28,137,2011,12835,11504,1331,10.4
"28137",28,137,2012,12430,11281,1149,9.2
"28137",28,137,2013,11969,10902,1067,8.9
"28137",28,137,2014,11775,10777,998,8.5
"28137",28,137,2015,11996,11149,847,7.1
"28137",28,137,2016,12092,11386,706,5.8
"28137",28,137,2017,12138,11530,608,5
"28139",28,139,1990,9655,8850,805,8.3
"28139",28,139,1991,9557,8395,1162,12.2
"28139",28,139,1992,9328,8566,762,8.2
"28139",28,139,1993,9568,9005,563,5.9
"28139",28,139,1994,9794,9208,586,6
"28139",28,139,1995,9622,9040,582,6
"28139",28,139,1996,9667,9011,656,6.8
"28139",28,139,1997,10177,9602,575,5.6
"28139",28,139,1998,10412,9767,645,6.2
"28139",28,139,1999,9968,9482,486,4.9
"28139",28,139,2000,9847,9296,551,5.6
"28139",28,139,2001,9377,8805,572,6.1
"28139",28,139,2002,9212,8517,695,7.5
"28139",28,139,2003,9223,8487,736,8
"28139",28,139,2004,9488,8835,653,6.9
"28139",28,139,2005,9567,8918,649,6.8
"28139",28,139,2006,9311,8684,627,6.7
"28139",28,139,2007,9237,8586,651,7
"28139",28,139,2008,8800,7927,873,9.9
"28139",28,139,2009,8334,7106,1228,14.7
"28139",28,139,2010,8991,7777,1214,13.5
"28139",28,139,2011,9290,8191,1099,11.8
"28139",28,139,2012,9038,8127,911,10.1
"28139",28,139,2013,8735,7879,856,9.8
"28139",28,139,2014,8727,8003,724,8.3
"28139",28,139,2015,9440,8839,601,6.4
"28139",28,139,2016,9407,8884,523,5.6
"28139",28,139,2017,9486,9061,425,4.5
"28141",28,141,1990,9091,7910,1181,13
"28141",28,141,1991,9938,8892,1046,10.5
"28141",28,141,1992,10365,9529,836,8.1
"28141",28,141,1993,10542,9910,632,6
"28141",28,141,1994,9990,9113,877,8.8
"28141",28,141,1995,9993,9294,699,7
"28141",28,141,1996,9965,9018,947,9.5
"28141",28,141,1997,9683,8823,860,8.9
"28141",28,141,1998,9228,8204,1024,11.1
"28141",28,141,1999,9459,8701,758,8
"28141",28,141,2000,8971,8345,626,7
"28141",28,141,2001,8545,7911,634,7.4
"28141",28,141,2002,8636,7790,846,9.8
"28141",28,141,2003,8224,7460,764,9.3
"28141",28,141,2004,8143,7501,642,7.9
"28141",28,141,2005,8097,7408,689,8.5
"28141",28,141,2006,8107,7529,578,7.1
"28141",28,141,2007,7974,7342,632,7.9
"28141",28,141,2008,7937,7240,697,8.8
"28141",28,141,2009,7548,6603,945,12.5
"28141",28,141,2010,7813,6817,996,12.7
"28141",28,141,2011,8070,7097,973,12.1
"28141",28,141,2012,7890,7076,814,10.3
"28141",28,141,2013,7695,6985,710,9.2
"28141",28,141,2014,7592,7007,585,7.7
"28141",28,141,2015,8012,7503,509,6.4
"28141",28,141,2016,8264,7811,453,5.5
"28141",28,141,2017,8308,7893,415,5
"28143",28,143,1990,2947,2551,396,13.4
"28143",28,143,1991,2959,2515,444,15
"28143",28,143,1992,3017,2611,406,13.5
"28143",28,143,1993,3448,3110,338,9.8
"28143",28,143,1994,4550,4100,450,9.9
"28143",28,143,1995,5039,4384,655,13
"28143",28,143,1996,5722,5292,430,7.5
"28143",28,143,1997,5692,5282,410,7.2
"28143",28,143,1998,5084,4705,379,7.5
"28143",28,143,1999,5726,5355,371,6.5
"28143",28,143,2000,4053,3850,203,5
"28143",28,143,2001,4070,3827,243,6
"28143",28,143,2002,4120,3827,293,7.1
"28143",28,143,2003,4461,3975,486,10.9
"28143",28,143,2004,4387,4000,387,8.8
"28143",28,143,2005,4505,4047,458,10.2
"28143",28,143,2006,4357,4005,352,8.1
"28143",28,143,2007,4392,4047,345,7.9
"28143",28,143,2008,4431,3966,465,10.5
"28143",28,143,2009,4275,3653,622,14.5
"28143",28,143,2010,5027,4339,688,13.7
"28143",28,143,2011,5140,4396,744,14.5
"28143",28,143,2012,4902,4297,605,12.3
"28143",28,143,2013,4791,4196,595,12.4
"28143",28,143,2014,4759,4199,560,11.8
"28143",28,143,2015,4656,4224,432,9.3
"28143",28,143,2016,4615,4286,329,7.1
"28143",28,143,2017,4597,4330,267,5.8
"28145",28,145,1990,11524,10729,795,6.9
"28145",28,145,1991,11365,10476,889,7.8
"28145",28,145,1992,11582,10888,694,6
"28145",28,145,1993,11842,11243,599,5.1
"28145",28,145,1994,12220,11562,658,5.4
"28145",28,145,1995,12239,11571,668,5.5
"28145",28,145,1996,12319,11535,784,6.4
"28145",28,145,1997,12153,11643,510,4.2
"28145",28,145,1998,12144,11690,454,3.7
"28145",28,145,1999,12626,12147,479,3.8
"28145",28,145,2000,12577,12024,553,4.4
"28145",28,145,2001,12161,11571,590,4.9
"28145",28,145,2002,11810,11046,764,6.5
"28145",28,145,2003,11700,10933,767,6.6
"28145",28,145,2004,11734,11008,726,6.2
"28145",28,145,2005,11913,11155,758,6.4
"28145",28,145,2006,11572,10892,680,5.9
"28145",28,145,2007,11808,11086,722,6.1
"28145",28,145,2008,11966,11136,830,6.9
"28145",28,145,2009,11544,10347,1197,10.4
"28145",28,145,2010,12138,10814,1324,10.9
"28145",28,145,2011,13295,11980,1315,9.9
"28145",28,145,2012,13548,12460,1088,8
"28145",28,145,2013,13076,12149,927,7.1
"28145",28,145,2014,12849,12060,789,6.1
"28145",28,145,2015,13213,12539,674,5.1
"28145",28,145,2016,13674,13069,605,4.4
"28145",28,145,2017,13976,13474,502,3.6
"28147",28,147,1990,5355,4990,365,6.8
"28147",28,147,1991,5539,5049,490,8.8
"28147",28,147,1992,5594,5034,560,10
"28147",28,147,1993,5732,5301,431,7.5
"28147",28,147,1994,5890,5491,399,6.8
"28147",28,147,1995,5829,5483,346,5.9
"28147",28,147,1996,6103,5754,349,5.7
"28147",28,147,1997,6182,5784,398,6.4
"28147",28,147,1998,5921,5568,353,6
"28147",28,147,1999,5944,5603,341,5.7
"28147",28,147,2000,6342,5915,427,6.7
"28147",28,147,2001,6044,5677,367,6.1
"28147",28,147,2002,5924,5477,447,7.5
"28147",28,147,2003,5850,5440,410,7
"28147",28,147,2004,5794,5397,397,6.9
"28147",28,147,2005,5894,5361,533,9
"28147",28,147,2006,5824,5449,375,6.4
"28147",28,147,2007,5878,5510,368,6.3
"28147",28,147,2008,5884,5465,419,7.1
"28147",28,147,2009,5595,4961,634,11.3
"28147",28,147,2010,5813,5060,753,13
"28147",28,147,2011,5826,5124,702,12
"28147",28,147,2012,5574,4948,626,11.2
"28147",28,147,2013,5295,4730,565,10.7
"28147",28,147,2014,5156,4669,487,9.4
"28147",28,147,2015,5150,4734,416,8.1
"28147",28,147,2016,5041,4652,389,7.7
"28147",28,147,2017,5008,4667,341,6.8
"28149",28,149,1990,22463,20786,1677,7.5
"28149",28,149,1991,22586,20737,1849,8.2
"28149",28,149,1992,22708,20751,1957,8.6
"28149",28,149,1993,23640,21744,1896,8
"28149",28,149,1994,27449,25655,1794,6.5
"28149",28,149,1995,27402,25740,1662,6.1
"28149",28,149,1996,26535,25118,1417,5.3
"28149",28,149,1997,26522,25099,1423,5.4
"28149",28,149,1998,26191,24908,1283,4.9
"28149",28,149,1999,26583,25380,1203,4.5
"28149",28,149,2000,24454,23233,1221,5
"28149",28,149,2001,23608,22499,1109,4.7
"28149",28,149,2002,23250,21803,1447,6.2
"28149",28,149,2003,23279,21863,1416,6.1
"28149",28,149,2004,23248,21857,1391,6
"28149",28,149,2005,23031,21454,1577,6.8
"28149",28,149,2006,22385,21094,1291,5.8
"28149",28,149,2007,22131,20783,1348,6.1
"28149",28,149,2008,22552,21133,1419,6.3
"28149",28,149,2009,21410,19310,2100,9.8
"28149",28,149,2010,23335,20888,2447,10.5
"28149",28,149,2011,23541,21148,2393,10.2
"28149",28,149,2012,23257,21161,2096,9
"28149",28,149,2013,21636,19688,1948,9
"28149",28,149,2014,20942,19343,1599,7.6
"28149",28,149,2015,20883,19495,1388,6.6
"28149",28,149,2016,20829,19510,1319,6.3
"28149",28,149,2017,20649,19467,1182,5.7
"28151",28,151,1990,29066,26037,3029,10.4
"28151",28,151,1991,28652,25376,3276,11.4
"28151",28,151,1992,27700,24313,3387,12.2
"28151",28,151,1993,27949,24932,3017,10.8
"28151",28,151,1994,29875,26747,3128,10.5
"28151",28,151,1995,29363,26380,2983,10.2
"28151",28,151,1996,29058,26154,2904,10
"28151",28,151,1997,28783,26155,2628,9.1
"28151",28,151,1998,28428,25854,2574,9.1
"28151",28,151,1999,27062,24499,2563,9.5
"28151",28,151,2000,26135,24136,1999,7.6
"28151",28,151,2001,25037,22766,2271,9.1
"28151",28,151,2002,24613,22050,2563,10.4
"28151",28,151,2003,24557,22356,2201,9
"28151",28,151,2004,24175,21881,2294,9.5
"28151",28,151,2005,23151,20602,2549,11
"28151",28,151,2006,22139,20065,2074,9.4
"28151",28,151,2007,22053,20204,1849,8.4
"28151",28,151,2008,22335,20244,2091,9.4
"28151",28,151,2009,21400,18491,2909,13.6
"28151",28,151,2010,20950,17637,3313,15.8
"28151",28,151,2011,21179,17894,3285,15.5
"28151",28,151,2012,20027,17118,2909,14.5
"28151",28,151,2013,19117,16343,2774,14.5
"28151",28,151,2014,18363,16064,2299,12.5
"28151",28,151,2015,18043,16190,1853,10.3
"28151",28,151,2016,17779,16179,1600,9
"28151",28,151,2017,17237,15956,1281,7.4
"28153",28,153,1990,8678,7907,771,8.9
"28153",28,153,1991,8983,7804,1179,13.1
"28153",28,153,1992,8898,7860,1038,11.7
"28153",28,153,1993,8828,8014,814,9.2
"28153",28,153,1994,8795,8092,703,8
"28153",28,153,1995,9127,8467,660,7.2
"28153",28,153,1996,9169,8666,503,5.5
"28153",28,153,1997,8932,8263,669,7.5
"28153",28,153,1998,8773,8197,576,6.6
"28153",28,153,1999,8500,7959,541,6.4
"28153",28,153,2000,8859,8293,566,6.4
"28153",28,153,2001,8686,8103,583,6.7
"28153",28,153,2002,8551,7787,764,8.9
"28153",28,153,2003,8620,7923,697,8.1
"28153",28,153,2004,8534,7942,592,6.9
"28153",28,153,2005,8568,7927,641,7.5
"28153",28,153,2006,8522,8008,514,6
"28153",28,153,2007,8678,8122,556,6.4
"28153",28,153,2008,8566,7929,637,7.4
"28153",28,153,2009,8134,7256,878,10.8
"28153",28,153,2010,8631,7589,1042,12.1
"28153",28,153,2011,8743,7745,998,11.4
"28153",28,153,2012,8443,7504,939,11.1
"28153",28,153,2013,7893,7049,844,10.7
"28153",28,153,2014,7737,7052,685,8.9
"28153",28,153,2015,7620,7018,602,7.9
"28153",28,153,2016,7543,6991,552,7.3
"28153",28,153,2017,7505,7034,471,6.3
"28155",28,155,1990,4371,3998,373,8.5
"28155",28,155,1991,4338,3871,467,10.8
"28155",28,155,1992,4471,4064,407,9.1
"28155",28,155,1993,4505,4252,253,5.6
"28155",28,155,1994,4554,4296,258,5.7
"28155",28,155,1995,4457,4068,389,8.7
"28155",28,155,1996,4426,4161,265,6
"28155",28,155,1997,4490,4276,214,4.8
"28155",28,155,1998,4494,4291,203,4.5
"28155",28,155,1999,4407,4176,231,5.2
"28155",28,155,2000,4714,4483,231,4.9
"28155",28,155,2001,4347,3954,393,9
"28155",28,155,2002,3778,3168,610,16.1
"28155",28,155,2003,3468,3073,395,11.4
"28155",28,155,2004,3485,3197,288,8.3
"28155",28,155,2005,3546,3265,281,7.9
"28155",28,155,2006,3412,3140,272,8
"28155",28,155,2007,3413,3137,276,8.1
"28155",28,155,2008,3416,3103,313,9.2
"28155",28,155,2009,3402,2935,467,13.7
"28155",28,155,2010,4372,3868,504,11.5
"28155",28,155,2011,4399,3941,458,10.4
"28155",28,155,2012,4233,3846,387,9.1
"28155",28,155,2013,4070,3682,388,9.5
"28155",28,155,2014,3965,3625,340,8.6
"28155",28,155,2015,3940,3657,283,7.2
"28155",28,155,2016,3910,3665,245,6.3
"28155",28,155,2017,3908,3704,204,5.2
"28157",28,157,1990,3452,3142,310,9
"28157",28,157,1991,3516,3020,496,14.1
"28157",28,157,1992,3369,2960,409,12.1
"28157",28,157,1993,3443,3059,384,11.2
"28157",28,157,1994,3568,3195,373,10.5
"28157",28,157,1995,3600,3202,398,11.1
"28157",28,157,1996,3530,3040,490,13.9
"28157",28,157,1997,3411,3050,361,10.6
"28157",28,157,1998,3337,3000,337,10.1
"28157",28,157,1999,3010,2549,461,15.3
"28157",28,157,2000,3536,3239,297,8.4
"28157",28,157,2001,3401,3143,258,7.6
"28157",28,157,2002,3367,3068,299,8.9
"28157",28,157,2003,3747,3395,352,9.4
"28157",28,157,2004,3691,3373,318,8.6
"28157",28,157,2005,3724,3268,456,12.2
"28157",28,157,2006,3505,3228,277,7.9
"28157",28,157,2007,3597,3294,303,8.4
"28157",28,157,2008,3699,3407,292,7.9
"28157",28,157,2009,3875,3457,418,10.8
"28157",28,157,2010,3444,2968,476,13.8
"28157",28,157,2011,3457,3008,449,13
"28157",28,157,2012,3263,2862,401,12.3
"28157",28,157,2013,2983,2613,370,12.4
"28157",28,157,2014,2835,2511,324,11.4
"28157",28,157,2015,2882,2577,305,10.6
"28157",28,157,2016,2838,2549,289,10.2
"28157",28,157,2017,2836,2589,247,8.7
"28159",28,159,1990,8556,7885,671,7.8
"28159",28,159,1991,8448,7341,1107,13.1
"28159",28,159,1992,8055,6787,1268,15.7
"28159",28,159,1993,7930,7009,921,11.6
"28159",28,159,1994,7955,7243,712,9
"28159",28,159,1995,7705,7205,500,6.5
"28159",28,159,1996,7932,7312,620,7.8
"28159",28,159,1997,8001,7218,783,9.8
"28159",28,159,1998,7764,7188,576,7.4
"28159",28,159,1999,7731,7236,495,6.4
"28159",28,159,2000,8718,8130,588,6.7
"28159",28,159,2001,8110,7316,794,9.8
"28159",28,159,2002,7926,7149,777,9.8
"28159",28,159,2003,7823,7198,625,8
"28159",28,159,2004,7890,7294,596,7.6
"28159",28,159,2005,7981,7390,591,7.4
"28159",28,159,2006,7927,7396,531,6.7
"28159",28,159,2007,8025,7496,529,6.6
"28159",28,159,2008,8034,7438,596,7.4
"28159",28,159,2009,7611,6331,1280,16.8
"28159",28,159,2010,7945,6597,1348,17
"28159",28,159,2011,8003,6936,1067,13.3
"28159",28,159,2012,7724,6837,887,11.5
"28159",28,159,2013,7388,6575,813,11
"28159",28,159,2014,7153,6440,713,10
"28159",28,159,2015,7084,6500,584,8.2
"28159",28,159,2016,7113,6608,505,7.1
"28159",28,159,2017,7245,6813,432,6
"28161",28,161,1990,5461,4960,501,9.2
"28161",28,161,1991,5164,4598,566,11
"28161",28,161,1992,5070,4561,509,10
"28161",28,161,1993,5068,4727,341,6.7
"28161",28,161,1994,5205,4876,329,6.3
"28161",28,161,1995,5349,4968,381,7.1
"28161",28,161,1996,5233,4846,387,7.4
"28161",28,161,1997,5230,4867,363,6.9
"28161",28,161,1998,4984,4697,287,5.8
"28161",28,161,1999,4695,4313,382,8.1
"28161",28,161,2000,5766,5433,333,5.8
"28161",28,161,2001,5586,5229,357,6.4
"28161",28,161,2002,5575,5187,388,7
"28161",28,161,2003,5622,5149,473,8.4
"28161",28,161,2004,5504,5022,482,8.8
"28161",28,161,2005,5273,4814,459,8.7
"28161",28,161,2006,5272,4876,396,7.5
"28161",28,161,2007,5319,4911,408,7.7
"28161",28,161,2008,5442,4978,464,8.5
"28161",28,161,2009,5441,4672,769,14.1
"28161",28,161,2010,5205,4499,706,13.6
"28161",28,161,2011,5372,4740,632,11.8
"28161",28,161,2012,5433,4885,548,10.1
"28161",28,161,2013,5024,4523,501,10
"28161",28,161,2014,4922,4469,453,9.2
"28161",28,161,2015,4927,4575,352,7.1
"28161",28,161,2016,4892,4585,307,6.3
"28161",28,161,2017,5005,4730,275,5.5
"28163",28,163,1990,9407,8748,659,7
"28163",28,163,1991,9402,8585,817,8.7
"28163",28,163,1992,9466,8634,832,8.8
"28163",28,163,1993,9766,8946,820,8.4
"28163",28,163,1994,10011,9136,875,8.7
"28163",28,163,1995,9610,8704,906,9.4
"28163",28,163,1996,9388,8485,903,9.6
"28163",28,163,1997,9541,8707,834,8.7
"28163",28,163,1998,9549,8781,768,8
"28163",28,163,1999,9407,8640,767,8.2
"28163",28,163,2000,10768,10004,764,7.1
"28163",28,163,2001,10458,9750,708,6.8
"28163",28,163,2002,10684,9905,779,7.3
"28163",28,163,2003,10786,9941,845,7.8
"28163",28,163,2004,10343,9454,889,8.6
"28163",28,163,2005,10139,9168,971,9.6
"28163",28,163,2006,10023,9188,835,8.3
"28163",28,163,2007,10156,9387,769,7.6
"28163",28,163,2008,10130,9252,878,8.7
"28163",28,163,2009,9952,8791,1161,11.7
"28163",28,163,2010,9913,8701,1212,12.2
"28163",28,163,2011,10139,8920,1219,12
"28163",28,163,2012,9844,8739,1105,11.2
"28163",28,163,2013,9442,8404,1038,11
"28163",28,163,2014,9277,8355,922,9.9
"28163",28,163,2015,9206,8454,752,8.2
"28163",28,163,2016,9256,8573,683,7.4
"28163",28,163,2017,9212,8657,555,6
"29001",29,1,1990,13167,12367,800,6.1
"29001",29,1,1991,12981,12429,552,4.3
"29001",29,1,1992,13498,13128,370,2.7
"29001",29,1,1993,13735,13204,531,3.9
"29001",29,1,1994,14401,13952,449,3.1
"29001",29,1,1995,14823,14396,427,2.9
"29001",29,1,1996,15128,14693,435,2.9
"29001",29,1,1997,15218,14856,362,2.4
"29001",29,1,1998,14283,13922,361,2.5
"29001",29,1,1999,13995,13746,249,1.8
"29001",29,1,2000,13682,13257,425,3.1
"29001",29,1,2001,13838,13242,596,4.3
"29001",29,1,2002,13384,12800,584,4.4
"29001",29,1,2003,13484,12819,665,4.9
"29001",29,1,2004,13151,12500,651,5
"29001",29,1,2005,13390,12824,566,4.2
"29001",29,1,2006,13728,13136,592,4.3
"29001",29,1,2007,13500,12851,649,4.8
"29001",29,1,2008,13601,12885,716,5.3
"29001",29,1,2009,13601,12704,897,6.6
"29001",29,1,2010,11083,10124,959,8.7
"29001",29,1,2011,10917,9981,936,8.6
"29001",29,1,2012,10749,9994,755,7
"29001",29,1,2013,10778,10038,740,6.9
"29001",29,1,2014,10602,9918,684,6.5
"29001",29,1,2015,10446,9858,588,5.6
"29001",29,1,2016,10382,9792,590,5.7
"29001",29,1,2017,10204,9759,445,4.4
"29003",29,3,1990,7467,7056,411,5.5
"29003",29,3,1991,7637,7132,505,6.6
"29003",29,3,1992,7535,7098,437,5.8
"29003",29,3,1993,7515,7003,512,6.8
"29003",29,3,1994,7739,7223,516,6.7
"29003",29,3,1995,8143,7680,463,5.7
"29003",29,3,1996,8003,7579,424,5.3
"29003",29,3,1997,8260,7942,318,3.8
"29003",29,3,1998,8289,7983,306,3.7
"29003",29,3,1999,8393,8157,236,2.8
"29003",29,3,2000,8818,8534,284,3.2
"29003",29,3,2001,9142,8740,402,4.4
"29003",29,3,2002,9193,8741,452,4.9
"29003",29,3,2003,9563,9084,479,5
"29003",29,3,2004,9744,9236,508,5.2
"29003",29,3,2005,9805,9298,507,5.2
"29003",29,3,2006,10194,9781,413,4.1
"29003",29,3,2007,10197,9795,402,3.9
"29003",29,3,2008,9991,9512,479,4.8
"29003",29,3,2009,10161,9379,782,7.7
"29003",29,3,2010,9898,9078,820,8.3
"29003",29,3,2011,9753,9077,676,6.9
"29003",29,3,2012,9908,9378,530,5.3
"29003",29,3,2013,9896,9366,530,5.4
"29003",29,3,2014,9859,9351,508,5.2
"29003",29,3,2015,9925,9512,413,4.2
"29003",29,3,2016,10042,9668,374,3.7
"29003",29,3,2017,9919,9608,311,3.1
"29005",29,5,1990,3469,3365,104,3
"29005",29,5,1991,3272,3162,110,3.4
"29005",29,5,1992,2955,2816,139,4.7
"29005",29,5,1993,2848,2722,126,4.4
"29005",29,5,1994,2969,2886,83,2.8
"29005",29,5,1995,3265,3177,88,2.7
"29005",29,5,1996,3620,3513,107,3
"29005",29,5,1997,3600,3509,91,2.5
"29005",29,5,1998,3295,3223,72,2.2
"29005",29,5,1999,3147,3083,64,2
"29005",29,5,2000,3455,3361,94,2.7
"29005",29,5,2001,3586,3465,121,3.4
"29005",29,5,2002,3389,3258,131,3.9
"29005",29,5,2003,3419,3283,136,4
"29005",29,5,2004,3355,3199,156,4.6
"29005",29,5,2005,3181,3032,149,4.7
"29005",29,5,2006,3157,3033,124,3.9
"29005",29,5,2007,3209,3069,140,4.4
"29005",29,5,2008,3215,3062,153,4.8
"29005",29,5,2009,3232,2995,237,7.3
"29005",29,5,2010,2999,2741,258,8.6
"29005",29,5,2011,2894,2657,237,8.2
"29005",29,5,2012,2879,2696,183,6.4
"29005",29,5,2013,2880,2712,168,5.8
"29005",29,5,2014,2874,2719,155,5.4
"29005",29,5,2015,2834,2707,127,4.5
"29005",29,5,2016,2845,2715,130,4.6
"29005",29,5,2017,2817,2718,99,3.5
"29007",29,7,1990,11271,10718,553,4.9
"29007",29,7,1991,11479,10826,653,5.7
"29007",29,7,1992,11543,10859,684,5.9
"29007",29,7,1993,11880,11214,666,5.6
"29007",29,7,1994,12474,11974,500,4
"29007",29,7,1995,12582,12056,526,4.2
"29007",29,7,1996,12678,12091,587,4.6
"29007",29,7,1997,13353,12867,486,3.6
"29007",29,7,1998,13229,12780,449,3.4
"29007",29,7,1999,13127,12787,340,2.6
"29007",29,7,2000,13110,12688,422,3.2
"29007",29,7,2001,13199,12627,572,4.3
"29007",29,7,2002,12456,11772,684,5.5
"29007",29,7,2003,12068,11329,739,6.1
"29007",29,7,2004,11839,11154,685,5.8
"29007",29,7,2005,12125,11500,625,5.2
"29007",29,7,2006,12098,11563,535,4.4
"29007",29,7,2007,12293,11688,605,4.9
"29007",29,7,2008,12396,11623,773,6.2
"29007",29,7,2009,12164,11029,1135,9.3
"29007",29,7,2010,11136,10068,1068,9.6
"29007",29,7,2011,11294,10368,926,8.2
"29007",29,7,2012,11355,10616,739,6.5
"29007",29,7,2013,11236,10525,711,6.3
"29007",29,7,2014,11244,10616,628,5.6
"29007",29,7,2015,11316,10792,524,4.6
"29007",29,7,2016,11145,10671,474,4.3
"29007",29,7,2017,10937,10550,387,3.5
"29009",29,9,1990,12692,12121,571,4.5
"29009",29,9,1991,13180,12408,772,5.9
"29009",29,9,1992,13370,12535,835,6.2
"29009",29,9,1993,13574,12629,945,7
"29009",29,9,1994,14322,13615,707,4.9
"29009",29,9,1995,15188,14442,746,4.9
"29009",29,9,1996,15495,14553,942,6.1
"29009",29,9,1997,15797,14938,859,5.4
"29009",29,9,1998,15355,14620,735,4.8
"29009",29,9,1999,15480,14933,547,3.5
"29009",29,9,2000,17211,16609,602,3.5
"29009",29,9,2001,17871,17088,783,4.4
"29009",29,9,2002,17460,16621,839,4.8
"29009",29,9,2003,17411,16534,877,5
"29009",29,9,2004,17260,16369,891,5.2
"29009",29,9,2005,17406,16544,862,5
"29009",29,9,2006,17790,17066,724,4.1
"29009",29,9,2007,17739,16874,865,4.9
"29009",29,9,2008,17789,16812,977,5.5
"29009",29,9,2009,17376,15948,1428,8.2
"29009",29,9,2010,15616,14109,1507,9.7
"29009",29,9,2011,15264,13895,1369,9
"29009",29,9,2012,15129,14059,1070,7.1
"29009",29,9,2013,14905,13888,1017,6.8
"29009",29,9,2014,14816,13907,909,6.1
"29009",29,9,2015,14918,14171,747,5
"29009",29,9,2016,15208,14524,684,4.5
"29009",29,9,2017,15109,14590,519,3.4
"29011",29,11,1990,5467,5312,155,2.8
"29011",29,11,1991,5820,5616,204,3.5
"29011",29,11,1992,6105,5890,215,3.5
"29011",29,11,1993,6257,6008,249,4
"29011",29,11,1994,6760,6558,202,3
"29011",29,11,1995,6904,6687,217,3.1
"29011",29,11,1996,6981,6696,285,4.1
"29011",29,11,1997,7293,7050,243,3.3
"29011",29,11,1998,7263,7045,218,3
"29011",29,11,1999,7346,7164,182,2.5
"29011",29,11,2000,6720,6529,191,2.8
"29011",29,11,2001,6814,6555,259,3.8
"29011",29,11,2002,6770,6474,296,4.4
"29011",29,11,2003,6691,6361,330,4.9
"29011",29,11,2004,6771,6427,344,5.1
"29011",29,11,2005,6456,6130,326,5
"29011",29,11,2006,6083,5769,314,5.2
"29011",29,11,2007,5722,5226,496,8.7
"29011",29,11,2008,5322,4826,496,9.3
"29011",29,11,2009,5244,4685,559,10.7
"29011",29,11,2010,5757,5164,593,10.3
"29011",29,11,2011,5636,5140,496,8.8
"29011",29,11,2012,5544,5133,411,7.4
"29011",29,11,2013,5490,5096,394,7.2
"29011",29,11,2014,5489,5144,345,6.3
"29011",29,11,2015,5329,5040,289,5.4
"29011",29,11,2016,5325,5046,279,5.2
"29011",29,11,2017,5116,4901,215,4.2
"29013",29,13,1990,6567,6114,453,6.9
"29013",29,13,1991,7045,6544,501,7.1
"29013",29,13,1992,7323,6811,512,7
"29013",29,13,1993,7333,6757,576,7.9
"29013",29,13,1994,7348,6872,476,6.5
"29013",29,13,1995,7528,7113,415,5.5
"29013",29,13,1996,7757,7252,505,6.5
"29013",29,13,1997,7814,7345,469,6
"29013",29,13,1998,7498,7071,427,5.7
"29013",29,13,1999,7502,7190,312,4.2
"29013",29,13,2000,8139,7826,313,3.8
"29013",29,13,2001,8148,7753,395,4.8
"29013",29,13,2002,8117,7637,480,5.9
"29013",29,13,2003,8084,7584,500,6.2
"29013",29,13,2004,8048,7469,579,7.2
"29013",29,13,2005,7936,7432,504,6.4
"29013",29,13,2006,7941,7490,451,5.7
"29013",29,13,2007,7921,7440,481,6.1
"29013",29,13,2008,7858,7296,562,7.2
"29013",29,13,2009,7549,6745,804,10.7
"29013",29,13,2010,8397,7474,923,11
"29013",29,13,2011,8385,7539,846,10.1
"29013",29,13,2012,8185,7511,674,8.2
"29013",29,13,2013,8001,7390,611,7.6
"29013",29,13,2014,8104,7531,573,7.1
"29013",29,13,2015,8154,7658,496,6.1
"29013",29,13,2016,8165,7727,438,5.4
"29013",29,13,2017,8116,7762,354,4.4
"29015",29,15,1990,5547,5090,457,8.2
"29015",29,15,1991,5662,5127,535,9.4
"29015",29,15,1992,5634,5074,560,9.9
"29015",29,15,1993,5629,5050,579,10.3
"29015",29,15,1994,5973,5500,473,7.9
"29015",29,15,1995,6138,5653,485,7.9
"29015",29,15,1996,6414,5982,432,6.7
"29015",29,15,1997,6424,6024,400,6.2
"29015",29,15,1998,6167,5763,404,6.6
"29015",29,15,1999,6090,5751,339,5.6
"29015",29,15,2000,7732,7309,423,5.5
"29015",29,15,2001,8039,7526,513,6.4
"29015",29,15,2002,8097,7564,533,6.6
"29015",29,15,2003,8375,7819,556,6.6
"29015",29,15,2004,8568,8016,552,6.4
"29015",29,15,2005,8461,7941,520,6.1
"29015",29,15,2006,8525,8060,465,5.5
"29015",29,15,2007,8358,7861,497,5.9
"29015",29,15,2008,8355,7779,576,6.9
"29015",29,15,2009,8285,7461,824,9.9
"29015",29,15,2010,7291,6407,884,12.1
"29015",29,15,2011,7228,6439,789,10.9
"29015",29,15,2012,7146,6499,647,9.1
"29015",29,15,2013,7256,6640,616,8.5
"29015",29,15,2014,7181,6623,558,7.8
"29015",29,15,2015,7195,6725,470,6.5
"29015",29,15,2016,7265,6824,441,6.1
"29015",29,15,2017,7120,6751,369,5.2
"29017",29,17,1990,4719,4308,411,8.7
"29017",29,17,1991,4778,4251,527,11
"29017",29,17,1992,4705,4278,427,9.1
"29017",29,17,1993,4795,4360,435,9.1
"29017",29,17,1994,4943,4624,319,6.5
"29017",29,17,1995,5093,4768,325,6.4
"29017",29,17,1996,5312,4864,448,8.4
"29017",29,17,1997,5490,5079,411,7.5
"29017",29,17,1998,5360,5062,298,5.6
"29017",29,17,1999,5467,5254,213,3.9
"29017",29,17,2000,6222,5951,271,4.4
"29017",29,17,2001,6318,5944,374,5.9
"29017",29,17,2002,6290,5888,402,6.4
"29017",29,17,2003,6309,5934,375,5.9
"29017",29,17,2004,6154,5784,370,6
"29017",29,17,2005,5856,5493,363,6.2
"29017",29,17,2006,5862,5541,321,5.5
"29017",29,17,2007,5739,5427,312,5.4
"29017",29,17,2008,5587,5212,375,6.7
"29017",29,17,2009,5594,5019,575,10.3
"29017",29,17,2010,5842,5254,588,10.1
"29017",29,17,2011,5757,5239,518,9
"29017",29,17,2012,5724,5322,402,7
"29017",29,17,2013,5753,5345,408,7.1
"29017",29,17,2014,5647,5265,382,6.8
"29017",29,17,2015,5556,5245,311,5.6
"29017",29,17,2016,5465,5179,286,5.2
"29017",29,17,2017,5382,5144,238,4.4
"29019",29,19,1990,67732,65172,2560,3.8
"29019",29,19,1991,69389,67309,2080,3
"29019",29,19,1992,70812,68933,1879,2.7
"29019",29,19,1993,72042,69836,2206,3.1
"29019",29,19,1994,74404,72882,1522,2
"29019",29,19,1995,77406,75997,1409,1.8
"29019",29,19,1996,79947,78557,1390,1.7
"29019",29,19,1997,85006,83700,1306,1.5
"29019",29,19,1998,84689,83410,1279,1.5
"29019",29,19,1999,84006,83003,1003,1.2
"29019",29,19,2000,78731,76887,1844,2.3
"29019",29,19,2001,79995,77582,2413,3
"29019",29,19,2002,81917,79083,2834,3.5
"29019",29,19,2003,83738,80767,2971,3.5
"29019",29,19,2004,83660,80420,3240,3.9
"29019",29,19,2005,85727,82672,3055,3.6
"29019",29,19,2006,86737,83884,2853,3.3
"29019",29,19,2007,87412,84162,3250,3.7
"29019",29,19,2008,86871,83038,3833,4.4
"29019",29,19,2009,88081,82526,5555,6.3
"29019",29,19,2010,92559,86588,5971,6.5
"29019",29,19,2011,94108,88736,5372,5.7
"29019",29,19,2012,96446,92078,4368,4.5
"29019",29,19,2013,97547,93154,4393,4.5
"29019",29,19,2014,97699,93628,4071,4.2
"29019",29,19,2015,98904,95425,3479,3.5
"29019",29,19,2016,98256,95017,3239,3.3
"29019",29,19,2017,97496,94953,2543,2.6
"29021",29,21,1990,40888,38077,2811,6.9
"29021",29,21,1991,41579,38083,3496,8.4
"29021",29,21,1992,41019,37864,3155,7.7
"29021",29,21,1993,40955,37299,3656,8.9
"29021",29,21,1994,42003,37905,4098,9.8
"29021",29,21,1995,42608,39500,3108,7.3
"29021",29,21,1996,41876,38857,3019,7.2
"29021",29,21,1997,42584,40279,2305,5.4
"29021",29,21,1998,42054,40010,2044,4.9
"29021",29,21,1999,42225,40710,1515,3.6
"29021",29,21,2000,42347,40774,1573,3.7
"29021",29,21,2001,43397,41183,2214,5.1
"29021",29,21,2002,43536,41009,2527,5.8
"29021",29,21,2003,44592,42008,2584,5.8
"29021",29,21,2004,45398,42592,2806,6.2
"29021",29,21,2005,45542,42886,2656,5.8
"29021",29,21,2006,46535,44413,2122,4.6
"29021",29,21,2007,48263,46115,2148,4.5
"29021",29,21,2008,48673,46134,2539,5.2
"29021",29,21,2009,49582,45372,4210,8.5
"29021",29,21,2010,46660,42383,4277,9.2
"29021",29,21,2011,46473,42713,3760,8.1
"29021",29,21,2012,46745,43810,2935,6.3
"29021",29,21,2013,46590,43698,2892,6.2
"29021",29,21,2014,46293,43657,2636,5.7
"29021",29,21,2015,46511,44374,2137,4.6
"29021",29,21,2016,46742,44830,1912,4.1
"29021",29,21,2017,46169,44568,1601,3.5
"29023",29,23,1990,16964,15681,1283,7.6
"29023",29,23,1991,17422,15861,1561,9
"29023",29,23,1992,17600,16139,1461,8.3
"29023",29,23,1993,18167,16561,1606,8.8
"29023",29,23,1994,18859,17495,1364,7.2
"29023",29,23,1995,19540,18291,1249,6.4
"29023",29,23,1996,19841,18592,1249,6.3
"29023",29,23,1997,20119,19041,1078,5.4
"29023",29,23,1998,20084,19117,967,4.8
"29023",29,23,1999,19794,19009,785,4
"29023",29,23,2000,19794,18824,970,4.9
"29023",29,23,2001,20348,19203,1145,5.6
"29023",29,23,2002,20564,19431,1133,5.5
"29023",29,23,2003,20929,19744,1185,5.7
"29023",29,23,2004,21783,20589,1194,5.5
"29023",29,23,2005,22234,21085,1149,5.2
"29023",29,23,2006,21826,20664,1162,5.3
"29023",29,23,2007,21386,19981,1405,6.6
"29023",29,23,2008,21858,20504,1354,6.2
"29023",29,23,2009,21496,19762,1734,8.1
"29023",29,23,2010,18765,16969,1796,9.6
"29023",29,23,2011,18816,17122,1694,9
"29023",29,23,2012,18688,17157,1531,8.2
"29023",29,23,2013,18709,17237,1472,7.9
"29023",29,23,2014,19102,17757,1345,7
"29023",29,23,2015,18983,17806,1177,6.2
"29023",29,23,2016,18815,17737,1078,5.7
"29023",29,23,2017,18085,17250,835,4.6
"29025",29,25,1990,3586,3367,219,6.1
"29025",29,25,1991,3594,3308,286,8
"29025",29,25,1992,3615,3334,281,7.8
"29025",29,25,1993,3642,3336,306,8.4
"29025",29,25,1994,3831,3597,234,6.1
"29025",29,25,1995,3773,3578,195,5.2
"29025",29,25,1996,3845,3649,196,5.1
"29025",29,25,1997,3683,3359,324,8.8
"29025",29,25,1998,3298,3053,245,7.4
"29025",29,25,1999,3183,3035,148,4.6
"29025",29,25,2000,4449,4294,155,3.5
"29025",29,25,2001,4447,4245,202,4.5
"29025",29,25,2002,4406,4166,240,5.4
"29025",29,25,2003,4431,4173,258,5.8
"29025",29,25,2004,4417,4150,267,6
"29025",29,25,2005,4406,4143,263,6
"29025",29,25,2006,4390,4157,233,5.3
"29025",29,25,2007,4374,4135,239,5.5
"29025",29,25,2008,4320,4030,290,6.7
"29025",29,25,2009,4165,3759,406,9.7
"29025",29,25,2010,4560,4124,436,9.6
"29025",29,25,2011,4450,4064,386,8.7
"29025",29,25,2012,4401,4093,308,7
"29025",29,25,2013,4348,4057,291,6.7
"29025",29,25,2014,4337,4099,238,5.5
"29025",29,25,2015,4396,4196,200,4.5
"29025",29,25,2016,4479,4268,211,4.7
"29025",29,25,2017,4465,4286,179,4
"29027",29,27,1990,17166,16424,742,4.3
"29027",29,27,1991,17682,16781,901,5.1
"29027",29,27,1992,17851,16936,915,5.1
"29027",29,27,1993,18191,17189,1002,5.5
"29027",29,27,1994,18536,17833,703,3.8
"29027",29,27,1995,19645,18962,683,3.5
"29027",29,27,1996,20785,19973,812,3.9
"29027",29,27,1997,21760,20993,767,3.5
"29027",29,27,1998,21750,20970,780,3.6
"29027",29,27,1999,21713,21187,526,2.4
"29027",29,27,2000,21758,21106,652,3
"29027",29,27,2001,22453,21585,868,3.9
"29027",29,27,2002,22369,21373,996,4.5
"29027",29,27,2003,22815,21761,1054,4.6
"29027",29,27,2004,22757,21676,1081,4.8
"29027",29,27,2005,22596,21530,1066,4.7
"29027",29,27,2006,22599,21613,986,4.4
"29027",29,27,2007,22741,21734,1007,4.4
"29027",29,27,2008,22636,21419,1217,5.4
"29027",29,27,2009,22887,21041,1846,8.1
"29027",29,27,2010,22377,20524,1853,8.3
"29027",29,27,2011,22085,20405,1680,7.6
"29027",29,27,2012,21834,20482,1352,6.2
"29027",29,27,2013,21630,20329,1301,6
"29027",29,27,2014,21801,20575,1226,5.6
"29027",29,27,2015,21682,20660,1022,4.7
"29027",29,27,2016,21844,20949,895,4.1
"29027",29,27,2017,21514,20768,746,3.5
"29029",29,29,1990,13304,12307,997,7.5
"29029",29,29,1991,13313,12041,1272,9.6
"29029",29,29,1992,13607,12407,1200,8.8
"29029",29,29,1993,14277,12881,1396,9.8
"29029",29,29,1994,15047,13904,1143,7.6
"29029",29,29,1995,16123,15031,1092,6.8
"29029",29,29,1996,16598,15481,1117,6.7
"29029",29,29,1997,17353,16269,1084,6.2
"29029",29,29,1998,17204,16280,924,5.4
"29029",29,29,1999,17487,16699,788,4.5
"29029",29,29,2000,19765,18924,841,4.3
"29029",29,29,2001,20416,19355,1061,5.2
"29029",29,29,2002,20304,19120,1184,5.8
"29029",29,29,2003,20620,19451,1169,5.7
"29029",29,29,2004,20935,19740,1195,5.7
"29029",29,29,2005,22205,21067,1138,5.1
"29029",29,29,2006,22324,21267,1057,4.7
"29029",29,29,2007,22017,20942,1075,4.9
"29029",29,29,2008,22440,21034,1406,6.3
"29029",29,29,2009,22086,19946,2140,9.7
"29029",29,29,2010,19459,17129,2330,12
"29029",29,29,2011,19150,17015,2135,11.1
"29029",29,29,2012,18967,17154,1813,9.6
"29029",29,29,2013,18806,17070,1736,9.2
"29029",29,29,2014,18816,17285,1531,8.1
"29029",29,29,2015,18758,17529,1229,6.6
"29029",29,29,2016,18739,17653,1086,5.8
"29029",29,29,2017,18475,17586,889,4.8
"29031",29,31,1990,32770,31012,1758,5.4
"29031",29,31,1991,32741,30896,1845,5.6
"29031",29,31,1992,33274,31397,1877,5.6
"29031",29,31,1993,33756,31766,1990,5.9
"29031",29,31,1994,34748,33294,1454,4.2
"29031",29,31,1995,35722,34467,1255,3.5
"29031",29,31,1996,36659,34936,1723,4.7
"29031",29,31,1997,37855,36325,1530,4
"29031",29,31,1998,37385,36062,1323,3.5
"29031",29,31,1999,38096,37094,1002,2.6
"29031",29,31,2000,40092,38848,1244,3.1
"29031",29,31,2001,39934,38376,1558,3.9
"29031",29,31,2002,39782,38102,1680,4.2
"29031",29,31,2003,40186,38490,1696,4.2
"29031",29,31,2004,39815,37990,1825,4.6
"29031",29,31,2005,38033,36330,1703,4.5
"29031",29,31,2006,38626,37034,1592,4.1
"29031",29,31,2007,38991,37317,1674,4.3
"29031",29,31,2008,38455,36469,1986,5.2
"29031",29,31,2009,38723,35906,2817,7.3
"29031",29,31,2010,41030,38022,3008,7.3
"29031",29,31,2011,40687,37944,2743,6.7
"29031",29,31,2012,40815,38558,2257,5.5
"29031",29,31,2013,40913,38559,2354,5.8
"29031",29,31,2014,40694,38473,2221,5.5
"29031",29,31,2015,40881,39118,1763,4.3
"29031",29,31,2016,40802,39030,1772,4.3
"29031",29,31,2017,40154,38772,1382,3.4
"29033",29,33,1990,4727,4385,342,7.2
"29033",29,33,1991,4989,4619,370,7.4
"29033",29,33,1992,4992,4642,350,7
"29033",29,33,1993,5067,4609,458,9
"29033",29,33,1994,5225,4904,321,6.1
"29033",29,33,1995,5594,5298,296,5.3
"29033",29,33,1996,5592,5301,291,5.2
"29033",29,33,1997,5501,5250,251,4.6
"29033",29,33,1998,4941,4682,259,5.2
"29033",29,33,1999,4908,4719,189,3.9
"29033",29,33,2000,5200,5022,178,3.4
"29033",29,33,2001,5503,5258,245,4.5
"29033",29,33,2002,5188,4906,282,5.4
"29033",29,33,2003,5160,4878,282,5.5
"29033",29,33,2004,5074,4789,285,5.6
"29033",29,33,2005,5085,4812,273,5.4
"29033",29,33,2006,5284,5042,242,4.6
"29033",29,33,2007,5226,4962,264,5.1
"29033",29,33,2008,5046,4688,358,7.1
"29033",29,33,2009,5091,4561,530,10.4
"29033",29,33,2010,4796,4246,550,11.5
"29033",29,33,2011,4743,4247,496,10.5
"29033",29,33,2012,4598,4215,383,8.3
"29033",29,33,2013,4678,4336,342,7.3
"29033",29,33,2014,4741,4403,338,7.1
"29033",29,33,2015,4819,4528,291,6
"29033",29,33,2016,4774,4517,257,5.4
"29033",29,33,2017,4716,4520,196,4.2
"29035",29,35,1990,2196,1970,226,10.3
"29035",29,35,1991,2277,2018,259,11.4
"29035",29,35,1992,2281,2052,229,10
"29035",29,35,1993,2441,2148,293,12
"29035",29,35,1994,2515,2290,225,8.9
"29035",29,35,1995,2634,2416,218,8.3
"29035",29,35,1996,2762,2509,253,9.2
"29035",29,35,1997,2816,2631,185,6.6
"29035",29,35,1998,2807,2659,148,5.3
"29035",29,35,1999,2784,2611,173,6.2
"29035",29,35,2000,2619,2468,151,5.8
"29035",29,35,2001,2656,2484,172,6.5
"29035",29,35,2002,2809,2620,189,6.7
"29035",29,35,2003,2898,2708,190,6.6
"29035",29,35,2004,2966,2766,200,6.7
"29035",29,35,2005,2958,2774,184,6.2
"29035",29,35,2006,2964,2789,175,5.9
"29035",29,35,2007,2904,2721,183,6.3
"29035",29,35,2008,2970,2756,214,7.2
"29035",29,35,2009,3103,2800,303,9.8
"29035",29,35,2010,2666,2359,307,11.5
"29035",29,35,2011,2640,2342,298,11.3
"29035",29,35,2012,2547,2306,241,9.5
"29035",29,35,2013,2548,2304,244,9.6
"29035",29,35,2014,2559,2330,229,8.9
"29035",29,35,2015,2510,2324,186,7.4
"29035",29,35,2016,2546,2365,181,7.1
"29035",29,35,2017,2471,2323,148,6
"29037",29,37,1990,33970,32352,1618,4.8
"29037",29,37,1991,35256,33166,2090,5.9
"29037",29,37,1992,35806,33820,1986,5.5
"29037",29,37,1993,36673,34909,1764,4.8
"29037",29,37,1994,39134,37404,1730,4.4
"29037",29,37,1995,41077,39506,1571,3.8
"29037",29,37,1996,42242,40654,1588,3.8
"29037",29,37,1997,43038,41584,1454,3.4
"29037",29,37,1998,44496,43124,1372,3.1
"29037",29,37,1999,45506,44435,1071,2.4
"29037",29,37,2000,44777,43479,1298,2.9
"29037",29,37,2001,45716,43968,1748,3.8
"29037",29,37,2002,46234,44094,2140,4.6
"29037",29,37,2003,47030,44587,2443,5.2
"29037",29,37,2004,48177,45428,2749,5.7
"29037",29,37,2005,48720,46229,2491,5.1
"29037",29,37,2006,49374,47112,2262,4.6
"29037",29,37,2007,50176,47686,2490,5
"29037",29,37,2008,50270,47276,2994,6
"29037",29,37,2009,50103,45313,4790,9.6
"29037",29,37,2010,53355,48217,5138,9.6
"29037",29,37,2011,53085,48586,4499,8.5
"29037",29,37,2012,52827,49305,3522,6.7
"29037",29,37,2013,52287,48993,3294,6.3
"29037",29,37,2014,52846,49824,3022,5.7
"29037",29,37,2015,53903,51311,2592,4.8
"29037",29,37,2016,54567,52300,2267,4.2
"29037",29,37,2017,54502,52605,1897,3.5
"29039",29,39,1990,5149,4858,291,5.7
"29039",29,39,1991,5196,4859,337,6.5
"29039",29,39,1992,5196,4875,321,6.2
"29039",29,39,1993,5220,4904,316,6.1
"29039",29,39,1994,5334,5087,247,4.6
"29039",29,39,1995,5539,5250,289,5.2
"29039",29,39,1996,5692,5345,347,6.1
"29039",29,39,1997,5765,5452,313,5.4
"29039",29,39,1998,5537,5295,242,4.4
"29039",29,39,1999,5167,4987,180,3.5
"29039",29,39,2000,6091,5858,233,3.8
"29039",29,39,2001,6349,6031,318,5
"29039",29,39,2002,6183,5813,370,6
"29039",29,39,2003,6278,5863,415,6.6
"29039",29,39,2004,6469,6064,405,6.3
"29039",29,39,2005,6390,6013,377,5.9
"29039",29,39,2006,6371,6045,326,5.1
"29039",29,39,2007,6483,6114,369,5.7
"29039",29,39,2008,6455,6033,422,6.5
"29039",29,39,2009,6307,5731,576,9.1
"29039",29,39,2010,6113,5530,583,9.5
"29039",29,39,2011,6002,5480,522,8.7
"29039",29,39,2012,5799,5368,431,7.4
"29039",29,39,2013,5879,5465,414,7
"29039",29,39,2014,5866,5493,373,6.4
"29039",29,39,2015,5894,5583,311,5.3
"29039",29,39,2016,5802,5512,290,5
"29039",29,39,2017,5667,5434,233,4.1
"29041",29,41,1990,4324,4120,204,4.7
"29041",29,41,1991,4484,4097,387,8.6
"29041",29,41,1992,4167,3846,321,7.7
"29041",29,41,1993,4031,3658,373,9.3
"29041",29,41,1994,4104,3833,271,6.6
"29041",29,41,1995,4156,3889,267,6.4
"29041",29,41,1996,4285,3992,293,6.8
"29041",29,41,1997,4205,3940,265,6.3
"29041",29,41,1998,3964,3750,214,5.4
"29041",29,41,1999,4184,4019,165,3.9
"29041",29,41,2000,4473,4301,172,3.8
"29041",29,41,2001,4603,4350,253,5.5
"29041",29,41,2002,4376,4101,275,6.3
"29041",29,41,2003,4320,4070,250,5.8
"29041",29,41,2004,4333,4080,253,5.8
"29041",29,41,2005,4221,3988,233,5.5
"29041",29,41,2006,4061,3857,204,5
"29041",29,41,2007,3936,3717,219,5.6
"29041",29,41,2008,3979,3734,245,6.2
"29041",29,41,2009,4044,3649,395,9.8
"29041",29,41,2010,4128,3736,392,9.5
"29041",29,41,2011,4098,3731,367,9
"29041",29,41,2012,4033,3769,264,6.5
"29041",29,41,2013,3740,3506,234,6.3
"29041",29,41,2014,3853,3630,223,5.8
"29041",29,41,2015,3853,3673,180,4.7
"29041",29,41,2016,3859,3691,168,4.4
"29041",29,41,2017,3780,3648,132,3.5
"29043",29,43,1990,17366,16389,977,5.6
"29043",29,43,1991,18404,17362,1042,5.7
"29043",29,43,1992,19186,18266,920,4.8
"29043",29,43,1993,20748,19568,1180,5.7
"29043",29,43,1994,22429,21567,862,3.8
"29043",29,43,1995,24374,23454,920,3.8
"29043",29,43,1996,25907,24893,1014,3.9
"29043",29,43,1997,26560,25585,975,3.7
"29043",29,43,1998,27269,26312,957,3.5
"29043",29,43,1999,28465,27789,676,2.4
"29043",29,43,2000,30599,29688,911,3
"29043",29,43,2001,31953,30657,1296,4.1
"29043",29,43,2002,33289,31676,1613,4.8
"29043",29,43,2003,34737,33029,1708,4.9
"29043",29,43,2004,35583,33914,1669,4.7
"29043",29,43,2005,37337,35744,1593,4.3
"29043",29,43,2006,39127,37659,1468,3.8
"29043",29,43,2007,39791,38246,1545,3.9
"29043",29,43,2008,39985,37970,2015,5
"29043",29,43,2009,40626,37287,3339,8.2
"29043",29,43,2010,40861,37420,3441,8.4
"29043",29,43,2011,40908,37869,3039,7.4
"29043",29,43,2012,40817,38442,2375,5.8
"29043",29,43,2013,41036,38796,2240,5.5
"29043",29,43,2014,42225,40148,2077,4.9
"29043",29,43,2015,43069,41248,1821,4.2
"29043",29,43,2016,43401,41696,1705,3.9
"29043",29,43,2017,43119,41790,1329,3.1
"29045",29,45,1990,3481,3360,121,3.5
"29045",29,45,1991,3701,3463,238,6.4
"29045",29,45,1992,3619,3400,219,6.1
"29045",29,45,1993,3412,3208,204,6
"29045",29,45,1994,3561,3437,124,3.5
"29045",29,45,1995,3672,3498,174,4.7
"29045",29,45,1996,3802,3574,228,6
"29045",29,45,1997,3838,3575,263,6.9
"29045",29,45,1998,3670,3459,211,5.7
"29045",29,45,1999,3720,3547,173,4.7
"29045",29,45,2000,3808,3662,146,3.8
"29045",29,45,2001,3563,3347,216,6.1
"29045",29,45,2002,3724,3485,239,6.4
"29045",29,45,2003,3678,3412,266,7.2
"29045",29,45,2004,3627,3381,246,6.8
"29045",29,45,2005,3582,3370,212,5.9
"29045",29,45,2006,3575,3396,179,5
"29045",29,45,2007,3601,3402,199,5.5
"29045",29,45,2008,3551,3333,218,6.1
"29045",29,45,2009,3578,3149,429,12
"29045",29,45,2010,3462,3032,430,12.4
"29045",29,45,2011,3405,3064,341,10
"29045",29,45,2012,3346,3076,270,8.1
"29045",29,45,2013,3361,3094,267,7.9
"29045",29,45,2014,3441,3203,238,6.9
"29045",29,45,2015,3435,3190,245,7.1
"29045",29,45,2016,3374,3126,248,7.4
"29045",29,45,2017,3160,2981,179,5.7
"29047",29,47,1990,88188,84475,3713,4.2
"29047",29,47,1991,90380,85633,4747,5.3
"29047",29,47,1992,90304,86508,3796,4.2
"29047",29,47,1993,92003,88309,3694,4
"29047",29,47,1994,96441,92934,3507,3.6
"29047",29,47,1995,100373,97148,3225,3.2
"29047",29,47,1996,102666,99534,3132,3.1
"29047",29,47,1997,103946,100833,3113,3
"29047",29,47,1998,105578,102691,2887,2.7
"29047",29,47,1999,107242,104736,2506,2.3
"29047",29,47,2000,106765,104031,2734,2.6
"29047",29,47,2001,108107,104413,3694,3.4
"29047",29,47,2002,108253,103560,4693,4.3
"29047",29,47,2003,109412,104284,5128,4.7
"29047",29,47,2004,110155,104674,5481,5
"29047",29,47,2005,111211,106067,5144,4.6
"29047",29,47,2006,113806,108913,4893,4.3
"29047",29,47,2007,116357,111327,5030,4.3
"29047",29,47,2008,116877,110846,6031,5.2
"29047",29,47,2009,120656,110505,10151,8.4
"29047",29,47,2010,125001,114532,10469,8.4
"29047",29,47,2011,125652,116366,9286,7.4
"29047",29,47,2012,126525,118815,7710,6.1
"29047",29,47,2013,126817,119105,7712,6.1
"29047",29,47,2014,129494,122474,7020,5.4
"29047",29,47,2015,132244,126231,6013,4.5
"29047",29,47,2016,134141,128903,5238,3.9
"29047",29,47,2017,134548,129721,4827,3.6
"29049",29,49,1990,8108,7702,406,5
"29049",29,49,1991,8219,7790,429,5.2
"29049",29,49,1992,8325,7866,459,5.5
"29049",29,49,1993,8398,7977,421,5
"29049",29,49,1994,8771,8355,416,4.7
"29049",29,49,1995,9144,8754,390,4.3
"29049",29,49,1996,9314,8935,379,4.1
"29049",29,49,1997,9553,9140,413,4.3
"29049",29,49,1998,9721,9354,367,3.8
"29049",29,49,1999,9868,9577,291,2.9
"29049",29,49,2000,9941,9631,310,3.1
"29049",29,49,2001,10078,9682,396,3.9
"29049",29,49,2002,10061,9538,523,5.2
"29049",29,49,2003,10256,9706,550,5.4
"29049",29,49,2004,10421,9808,613,5.9
"29049",29,49,2005,10328,9766,562,5.4
"29049",29,49,2006,10278,9771,507,4.9
"29049",29,49,2007,10394,9857,537,5.2
"29049",29,49,2008,10350,9736,614,5.9
"29049",29,49,2009,10121,9128,993,9.8
"29049",29,49,2010,11071,10002,1069,9.7
"29049",29,49,2011,11033,10050,983,8.9
"29049",29,49,2012,10855,10094,761,7
"29049",29,49,2013,10753,10041,712,6.6
"29049",29,49,2014,10693,10065,628,5.9
"29049",29,49,2015,10995,10461,534,4.9
"29049",29,49,2016,11023,10557,466,4.2
"29049",29,49,2017,11051,10619,432,3.9
"29051",29,51,1990,33686,32484,1202,3.6
"29051",29,51,1991,34690,33304,1386,4
"29051",29,51,1992,34927,33656,1271,3.6
"29051",29,51,1993,35325,33774,1551,4.4
"29051",29,51,1994,36941,35829,1112,3
"29051",29,51,1995,38156,37227,929,2.4
"29051",29,51,1996,39346,38286,1060,2.7
"29051",29,51,1997,41006,39945,1061,2.6
"29051",29,51,1998,40499,39507,992,2.4
"29051",29,51,1999,40415,39651,764,1.9
"29051",29,51,2000,39625,38542,1083,2.7
"29051",29,51,2001,40173,38783,1390,3.5
"29051",29,51,2002,39590,38046,1544,3.9
"29051",29,51,2003,40557,38959,1598,3.9
"29051",29,51,2004,40460,38824,1636,4
"29051",29,51,2005,40148,38512,1636,4.1
"29051",29,51,2006,39989,38468,1521,3.8
"29051",29,51,2007,40140,38575,1565,3.9
"29051",29,51,2008,40105,38301,1804,4.5
"29051",29,51,2009,40515,37754,2761,6.8
"29051",29,51,2010,40685,37894,2791,6.9
"29051",29,51,2011,40384,37846,2538,6.3
"29051",29,51,2012,39901,37846,2055,5.2
"29051",29,51,2013,39752,37668,2084,5.2
"29051",29,51,2014,39680,37689,1991,5
"29051",29,51,2015,39394,37818,1576,4
"29051",29,51,2016,39466,38058,1408,3.6
"29051",29,51,2017,38860,37720,1140,2.9
"29053",29,53,1990,7260,6784,476,6.6
"29053",29,53,1991,7928,7570,358,4.5
"29053",29,53,1992,8317,7862,455,5.5
"29053",29,53,1993,8131,7582,549,6.8
"29053",29,53,1994,8382,8049,333,4
"29053",29,53,1995,8497,8156,341,4
"29053",29,53,1996,8600,8272,328,3.8
"29053",29,53,1997,8741,8352,389,4.5
"29053",29,53,1998,8632,8299,333,3.9
"29053",29,53,1999,8482,8240,242,2.9
"29053",29,53,2000,8329,8048,281,3.4
"29053",29,53,2001,8500,8091,409,4.8
"29053",29,53,2002,8844,8424,420,4.7
"29053",29,53,2003,8832,8418,414,4.7
"29053",29,53,2004,8883,8432,451,5.1
"29053",29,53,2005,9064,8635,429,4.7
"29053",29,53,2006,9111,8720,391,4.3
"29053",29,53,2007,9187,8775,412,4.5
"29053",29,53,2008,9222,8692,530,5.7
"29053",29,53,2009,9105,8296,809,8.9
"29053",29,53,2010,7961,7184,777,9.8
"29053",29,53,2011,7948,7231,717,9
"29053",29,53,2012,7814,7255,559,7.2
"29053",29,53,2013,7692,7158,534,6.9
"29053",29,53,2014,7655,7198,457,6
"29053",29,53,2015,7616,7176,440,5.8
"29053",29,53,2016,7489,7121,368,4.9
"29053",29,53,2017,7348,7077,271,3.7
"29055",29,55,1990,8724,7948,776,8.9
"29055",29,55,1991,9183,8130,1053,11.5
"29055",29,55,1992,9732,8710,1022,10.5
"29055",29,55,1993,9910,8846,1064,10.7
"29055",29,55,1994,10062,9303,759,7.5
"29055",29,55,1995,10497,9787,710,6.8
"29055",29,55,1996,10472,9485,987,9.4
"29055",29,55,1997,10674,9941,733,6.9
"29055",29,55,1998,10307,9647,660,6.4
"29055",29,55,1999,9816,9324,492,5
"29055",29,55,2000,11359,10839,520,4.6
"29055",29,55,2001,11619,11007,612,5.3
"29055",29,55,2002,11813,11112,701,5.9
"29055",29,55,2003,11852,11085,767,6.5
"29055",29,55,2004,11756,10997,759,6.5
"29055",29,55,2005,11834,11119,715,6
"29055",29,55,2006,12076,11379,697,5.8
"29055",29,55,2007,12165,11309,856,7
"29055",29,55,2008,12086,11107,979,8.1
"29055",29,55,2009,12221,10877,1344,11
"29055",29,55,2010,10811,9439,1372,12.7
"29055",29,55,2011,10856,9676,1180,10.9
"29055",29,55,2012,10740,9794,946,8.8
"29055",29,55,2013,10900,9968,932,8.6
"29055",29,55,2014,10896,10025,871,8
"29055",29,55,2015,10911,10254,657,6
"29055",29,55,2016,10838,10260,578,5.3
"29055",29,55,2017,10644,10146,498,4.7
"29057",29,57,1990,3044,2914,130,4.3
"29057",29,57,1991,3037,2845,192,6.3
"29057",29,57,1992,3171,2969,202,6.4
"29057",29,57,1993,3052,2839,213,7
"29057",29,57,1994,3189,3018,171,5.4
"29057",29,57,1995,3268,3119,149,4.6
"29057",29,57,1996,3406,3221,185,5.4
"29057",29,57,1997,3585,3417,168,4.7
"29057",29,57,1998,3428,3259,169,4.9
"29057",29,57,1999,3418,3289,129,3.8
"29057",29,57,2000,3865,3724,141,3.6
"29057",29,57,2001,4030,3862,168,4.2
"29057",29,57,2002,3877,3686,191,4.9
"29057",29,57,2003,3929,3741,188,4.8
"29057",29,57,2004,3899,3694,205,5.3
"29057",29,57,2005,3741,3535,206,5.5
"29057",29,57,2006,3880,3699,181,4.7
"29057",29,57,2007,3745,3546,199,5.3
"29057",29,57,2008,3570,3346,224,6.3
"29057",29,57,2009,3564,3248,316,8.9
"29057",29,57,2010,3402,3071,331,9.7
"29057",29,57,2011,3433,3114,319,9.3
"29057",29,57,2012,3368,3116,252,7.5
"29057",29,57,2013,3450,3215,235,6.8
"29057",29,57,2014,3511,3300,211,6
"29057",29,57,2015,3571,3390,181,5.1
"29057",29,57,2016,3589,3429,160,4.5
"29057",29,57,2017,3544,3423,121,3.4
"29059",29,59,1990,5535,5094,441,8
"29059",29,59,1991,5711,5188,523,9.2
"29059",29,59,1992,5783,5260,523,9
"29059",29,59,1993,5927,5376,551,9.3
"29059",29,59,1994,6038,5655,383,6.3
"29059",29,59,1995,6376,5955,421,6.6
"29059",29,59,1996,6596,6145,451,6.8
"29059",29,59,1997,6669,6335,334,5
"29059",29,59,1998,6623,6307,316,4.8
"29059",29,59,1999,6587,6322,265,4
"29059",29,59,2000,7170,6836,334,4.7
"29059",29,59,2001,7241,6856,385,5.3
"29059",29,59,2002,7299,6867,432,5.9
"29059",29,59,2003,7402,6960,442,6
"29059",29,59,2004,7409,6962,447,6
"29059",29,59,2005,7448,7043,405,5.4
"29059",29,59,2006,7579,7191,388,5.1
"29059",29,59,2007,7501,7105,396,5.3
"29059",29,59,2008,7396,6833,563,7.6
"29059",29,59,2009,7309,6459,850,11.6
"29059",29,59,2010,7285,6369,916,12.6
"29059",29,59,2011,7226,6429,797,11
"29059",29,59,2012,7110,6463,647,9.1
"29059",29,59,2013,6960,6359,601,8.6
"29059",29,59,2014,6970,6441,529,7.6
"29059",29,59,2015,6981,6546,435,6.2
"29059",29,59,2016,6963,6580,383,5.5
"29059",29,59,2017,6917,6593,324,4.7
"29061",29,61,1990,3310,3125,185,5.6
"29061",29,61,1991,3337,3088,249,7.5
"29061",29,61,1992,3267,3008,259,7.9
"29061",29,61,1993,3304,3019,285,8.6
"29061",29,61,1994,3526,3332,194,5.5
"29061",29,61,1995,3668,3478,190,5.2
"29061",29,61,1996,3681,3477,204,5.5
"29061",29,61,1997,3946,3732,214,5.4
"29061",29,61,1998,3705,3533,172,4.6
"29061",29,61,1999,3553,3438,115,3.2
"29061",29,61,2000,4027,3893,134,3.3
"29061",29,61,2001,4152,3972,180,4.3
"29061",29,61,2002,4011,3813,198,4.9
"29061",29,61,2003,3958,3739,219,5.5
"29061",29,61,2004,4143,3926,217,5.2
"29061",29,61,2005,4023,3827,196,4.9
"29061",29,61,2006,4097,3916,181,4.4
"29061",29,61,2007,4031,3850,181,4.5
"29061",29,61,2008,3922,3712,210,5.4
"29061",29,61,2009,3874,3529,345,8.9
"29061",29,61,2010,4011,3617,394,9.8
"29061",29,61,2011,4056,3695,361,8.9
"29061",29,61,2012,4068,3786,282,6.9
"29061",29,61,2013,4074,3820,254,6.2
"29061",29,61,2014,4039,3804,235,5.8
"29061",29,61,2015,4088,3901,187,4.6
"29061",29,61,2016,4119,3960,159,3.9
"29061",29,61,2017,4031,3897,134,3.3
"29063",29,63,1990,3680,3492,188,5.1
"29063",29,63,1991,3730,3469,261,7
"29063",29,63,1992,3690,3444,246,6.7
"29063",29,63,1993,3839,3577,262,6.8
"29063",29,63,1994,3925,3712,213,5.4
"29063",29,63,1995,4134,3932,202,4.9
"29063",29,63,1996,4270,4059,211,4.9
"29063",29,63,1997,4747,4515,232,4.9
"29063",29,63,1998,4847,4659,188,3.9
"29063",29,63,1999,4817,4686,131,2.7
"29063",29,63,2000,4949,4748,201,4.1
"29063",29,63,2001,5018,4771,247,4.9
"29063",29,63,2002,5072,4765,307,6.1
"29063",29,63,2003,5223,4898,325,6.2
"29063",29,63,2004,5051,4737,314,6.2
"29063",29,63,2005,5062,4765,297,5.9
"29063",29,63,2006,5196,4918,278,5.4
"29063",29,63,2007,5259,4986,273,5.2
"29063",29,63,2008,5166,4841,325,6.3
"29063",29,63,2009,5163,4675,488,9.5
"29063",29,63,2010,5025,4581,444,8.8
"29063",29,63,2011,5035,4632,403,8
"29063",29,63,2012,5055,4755,300,5.9
"29063",29,63,2013,5041,4738,303,6
"29063",29,63,2014,4974,4705,269,5.4
"29063",29,63,2015,5050,4816,234,4.6
"29063",29,63,2016,5087,4866,221,4.3
"29063",29,63,2017,5031,4839,192,3.8
"29065",29,65,1990,5561,5157,404,7.3
"29065",29,65,1991,5730,5208,522,9.1
"29065",29,65,1992,5996,5449,547,9.1
"29065",29,65,1993,6178,5626,552,8.9
"29065",29,65,1994,6417,5939,478,7.4
"29065",29,65,1995,6451,6038,413,6.4
"29065",29,65,1996,6658,6237,421,6.3
"29065",29,65,1997,6857,6480,377,5.5
"29065",29,65,1998,6845,6431,414,6
"29065",29,65,1999,6493,6097,396,6.1
"29065",29,65,2000,7062,6711,351,5
"29065",29,65,2001,6916,6443,473,6.8
"29065",29,65,2002,6728,6306,422,6.3
"29065",29,65,2003,6604,6184,420,6.4
"29065",29,65,2004,6545,6109,436,6.7
"29065",29,65,2005,6546,6136,410,6.3
"29065",29,65,2006,6660,6269,391,5.9
"29065",29,65,2007,6654,6207,447,6.7
"29065",29,65,2008,6821,6299,522,7.7
"29065",29,65,2009,6830,6182,648,9.5
"29065",29,65,2010,6512,5838,674,10.4
"29065",29,65,2011,6418,5796,622,9.7
"29065",29,65,2012,6010,5519,491,8.2
"29065",29,65,2013,6255,5783,472,7.5
"29065",29,65,2014,6274,5850,424,6.8
"29065",29,65,2015,6301,5934,367,5.8
"29065",29,65,2016,6209,5874,335,5.4
"29065",29,65,2017,6040,5782,258,4.3
"29067",29,67,1990,5321,4940,381,7.2
"29067",29,67,1991,5269,4865,404,7.7
"29067",29,67,1992,5330,4932,398,7.5
"29067",29,67,1993,5539,5171,368,6.6
"29067",29,67,1994,5890,5531,359,6.1
"29067",29,67,1995,5941,5384,557,9.4
"29067",29,67,1996,6278,5480,798,12.7
"29067",29,67,1997,6348,5548,800,12.6
"29067",29,67,1998,5679,5260,419,7.4
"29067",29,67,1999,5608,5313,295,5.3
"29067",29,67,2000,6250,5956,294,4.7
"29067",29,67,2001,6437,5974,463,7.2
"29067",29,67,2002,6038,5519,519,8.6
"29067",29,67,2003,5933,5498,435,7.3
"29067",29,67,2004,6224,5848,376,6
"29067",29,67,2005,5992,5624,368,6.1
"29067",29,67,2006,6006,5685,321,5.3
"29067",29,67,2007,5881,5534,347,5.9
"29067",29,67,2008,6038,5629,409,6.8
"29067",29,67,2009,6742,6145,597,8.9
"29067",29,67,2010,5249,4612,637,12.1
"29067",29,67,2011,5196,4666,530,10.2
"29067",29,67,2012,5151,4645,506,9.8
"29067",29,67,2013,5072,4596,476,9.4
"29067",29,67,2014,5031,4647,384,7.6
"29067",29,67,2015,5040,4698,342,6.8
"29067",29,67,2016,5087,4777,310,6.1
"29067",29,67,2017,4971,4736,235,4.7
"29069",29,69,1990,13319,12088,1231,9.2
"29069",29,69,1991,12805,11570,1235,9.6
"29069",29,69,1992,13329,11974,1355,10.2
"29069",29,69,1993,13463,12062,1401,10.4
"29069",29,69,1994,13726,12547,1179,8.6
"29069",29,69,1995,14147,13068,1079,7.6
"29069",29,69,1996,14498,13468,1030,7.1
"29069",29,69,1997,14923,13937,986,6.6
"29069",29,69,1998,15007,14011,996,6.6
"29069",29,69,1999,14293,13586,707,4.9
"29069",29,69,2000,15121,14412,709,4.7
"29069",29,69,2001,15326,14366,960,6.3
"29069",29,69,2002,14995,13952,1043,7
"29069",29,69,2003,15030,13896,1134,7.5
"29069",29,69,2004,14980,13874,1106,7.4
"29069",29,69,2005,14607,13549,1058,7.2
"29069",29,69,2006,14572,13545,1027,7
"29069",29,69,2007,14273,13128,1145,8
"29069",29,69,2008,14303,13170,1133,7.9
"29069",29,69,2009,14905,13307,1598,10.7
"29069",29,69,2010,12289,10632,1657,13.5
"29069",29,69,2011,12350,10853,1497,12.1
"29069",29,69,2012,12199,10931,1268,10.4
"29069",29,69,2013,13008,11718,1290,9.9
"29069",29,69,2014,13146,11955,1191,9.1
"29069",29,69,2015,13128,12072,1056,8
"29069",29,69,2016,12850,11791,1059,8.2
"29069",29,69,2017,12219,11406,813,6.7
"29071",29,71,1990,42830,38959,3871,9
"29071",29,71,1991,43369,39197,4172,9.6
"29071",29,71,1992,42923,39378,3545,8.3
"29071",29,71,1993,42745,39886,2859,6.7
"29071",29,71,1994,44100,41890,2210,5
"29071",29,71,1995,46418,43954,2464,5.3
"29071",29,71,1996,47636,45229,2407,5.1
"29071",29,71,1997,47307,45058,2249,4.8
"29071",29,71,1998,47572,45441,2131,4.5
"29071",29,71,1999,47642,46013,1629,3.4
"29071",29,71,2000,50952,49037,1915,3.8
"29071",29,71,2001,51798,49243,2555,4.9
"29071",29,71,2002,52344,49445,2899,5.5
"29071",29,71,2003,52433,49466,2967,5.7
"29071",29,71,2004,52312,49182,3130,6
"29071",29,71,2005,52490,49466,3024,5.8
"29071",29,71,2006,52801,50008,2793,5.3
"29071",29,71,2007,52534,49604,2930,5.6
"29071",29,71,2008,52866,48907,3959,7.5
"29071",29,71,2009,53651,47196,6455,12
"29071",29,71,2010,53456,47397,6059,11.3
"29071",29,71,2011,52944,47965,4979,9.4
"29071",29,71,2012,52013,47919,4094,7.9
"29071",29,71,2013,51642,47925,3717,7.2
"29071",29,71,2014,52120,48755,3365,6.5
"29071",29,71,2015,52540,49878,2662,5.1
"29071",29,71,2016,52726,50423,2303,4.4
"29071",29,71,2017,52277,50386,1891,3.6
"29073",29,73,1990,7128,6599,529,7.4
"29073",29,73,1991,7200,6717,483,6.7
"29073",29,73,1992,7175,6475,700,9.8
"29073",29,73,1993,7282,6476,806,11.1
"29073",29,73,1994,7378,6947,431,5.8
"29073",29,73,1995,7524,7161,363,4.8
"29073",29,73,1996,7615,7194,421,5.5
"29073",29,73,1997,7754,7372,382,4.9
"29073",29,73,1998,7826,7503,323,4.1
"29073",29,73,1999,7923,7696,227,2.9
"29073",29,73,2000,8039,7752,287,3.6
"29073",29,73,2001,8041,7645,396,4.9
"29073",29,73,2002,7822,7379,443,5.7
"29073",29,73,2003,7748,7268,480,6.2
"29073",29,73,2004,7786,7305,481,6.2
"29073",29,73,2005,7898,7459,439,5.6
"29073",29,73,2006,8174,7731,443,5.4
"29073",29,73,2007,8110,7662,448,5.5
"29073",29,73,2008,7891,7289,602,7.6
"29073",29,73,2009,7991,7068,923,11.6
"29073",29,73,2010,7752,6943,809,10.4
"29073",29,73,2011,7633,6958,675,8.8
"29073",29,73,2012,7542,7010,532,7.1
"29073",29,73,2013,7541,7064,477,6.3
"29073",29,73,2014,7623,7220,403,5.3
"29073",29,73,2015,7685,7358,327,4.3
"29073",29,73,2016,7708,7376,332,4.3
"29073",29,73,2017,7678,7378,300,3.9
"29075",29,75,1990,3000,2916,84,2.8
"29075",29,75,1991,3233,3122,111,3.4
"29075",29,75,1992,3247,3123,124,3.8
"29075",29,75,1993,3306,3159,147,4.4
"29075",29,75,1994,3598,3488,110,3.1
"29075",29,75,1995,3652,3536,116,3.2
"29075",29,75,1996,3855,3735,120,3.1
"29075",29,75,1997,3777,3675,102,2.7
"29075",29,75,1998,3650,3539,111,3
"29075",29,75,1999,3652,3561,91,2.5
"29075",29,75,2000,3423,3311,112,3.3
"29075",29,75,2001,3556,3410,146,4.1
"29075",29,75,2002,3396,3227,169,5
"29075",29,75,2003,3381,3229,152,4.5
"29075",29,75,2004,3355,3199,156,4.6
"29075",29,75,2005,3332,3184,148,4.4
"29075",29,75,2006,3395,3258,137,4
"29075",29,75,2007,3398,3259,139,4.1
"29075",29,75,2008,3482,3325,157,4.5
"29075",29,75,2009,3589,3362,227,6.3
"29075",29,75,2010,3523,3245,278,7.9
"29075",29,75,2011,3587,3338,249,6.9
"29075",29,75,2012,3593,3402,191,5.3
"29075",29,75,2013,3598,3409,189,5.3
"29075",29,75,2014,3637,3432,205,5.6
"29075",29,75,2015,3616,3464,152,4.2
"29075",29,75,2016,3592,3458,134,3.7
"29075",29,75,2017,3572,3470,102,2.9
"29077",29,77,1990,109432,104109,5323,4.9
"29077",29,77,1991,111982,106404,5578,5
"29077",29,77,1992,114827,109226,5601,4.9
"29077",29,77,1993,118330,112065,6265,5.3
"29077",29,77,1994,122851,118777,4074,3.3
"29077",29,77,1995,127742,123693,4049,3.2
"29077",29,77,1996,129273,124868,4405,3.4
"29077",29,77,1997,127621,123456,4165,3.3
"29077",29,77,1998,126141,122355,3786,3
"29077",29,77,1999,126325,123486,2839,2.2
"29077",29,77,2000,131978,128058,3920,3
"29077",29,77,2001,132960,127852,5108,3.8
"29077",29,77,2002,134152,128066,6086,4.5
"29077",29,77,2003,135887,129803,6084,4.5
"29077",29,77,2004,135351,129014,6337,4.7
"29077",29,77,2005,137034,131282,5752,4.2
"29077",29,77,2006,139277,134046,5231,3.8
"29077",29,77,2007,141794,136126,5668,4
"29077",29,77,2008,139388,132293,7095,5.1
"29077",29,77,2009,139574,127872,11702,8.4
"29077",29,77,2010,144734,132665,12069,8.3
"29077",29,77,2011,144414,133822,10592,7.3
"29077",29,77,2012,144032,135502,8530,5.9
"29077",29,77,2013,144536,136572,7964,5.5
"29077",29,77,2014,147446,140284,7162,4.9
"29077",29,77,2015,149353,143141,6212,4.2
"29077",29,77,2016,148738,143088,5650,3.8
"29077",29,77,2017,147999,143497,4502,3
"29079",29,79,1990,4692,4442,250,5.3
"29079",29,79,1991,4830,4584,246,5.1
"29079",29,79,1992,4932,4695,237,4.8
"29079",29,79,1993,5050,4730,320,6.3
"29079",29,79,1994,5140,4889,251,4.9
"29079",29,79,1995,5334,5080,254,4.8
"29079",29,79,1996,5172,4984,188,3.6
"29079",29,79,1997,5126,4937,189,3.7
"29079",29,79,1998,4922,4729,193,3.9
"29079",29,79,1999,4975,4823,152,3.1
"29079",29,79,2000,5379,5199,180,3.3
"29079",29,79,2001,5434,5202,232,4.3
"29079",29,79,2002,5172,4901,271,5.2
"29079",29,79,2003,5032,4724,308,6.1
"29079",29,79,2004,5003,4717,286,5.7
"29079",29,79,2005,4920,4665,255,5.2
"29079",29,79,2006,4854,4633,221,4.6
"29079",29,79,2007,4804,4572,232,4.8
"29079",29,79,2008,4930,4655,275,5.6
"29079",29,79,2009,4918,4541,377,7.7
"29079",29,79,2010,4837,4450,387,8
"29079",29,79,2011,4955,4604,351,7.1
"29079",29,79,2012,4948,4629,319,6.4
"29079",29,79,2013,4922,4634,288,5.9
"29079",29,79,2014,4904,4645,259,5.3
"29079",29,79,2015,4912,4709,203,4.1
"29079",29,79,2016,4907,4683,224,4.6
"29079",29,79,2017,4744,4572,172,3.6
"29081",29,81,1990,4008,3839,169,4.2
"29081",29,81,1991,4021,3830,191,4.8
"29081",29,81,1992,4060,3886,174,4.3
"29081",29,81,1993,4131,3920,211,5.1
"29081",29,81,1994,4291,4153,138,3.2
"29081",29,81,1995,4566,4371,195,4.3
"29081",29,81,1996,4664,4442,222,4.8
"29081",29,81,1997,4604,4437,167,3.6
"29081",29,81,1998,4418,4279,139,3.1
"29081",29,81,1999,4406,4305,101,2.3
"29081",29,81,2000,4638,4488,150,3.2
"29081",29,81,2001,4745,4572,173,3.6
"29081",29,81,2002,4488,4263,225,5
"29081",29,81,2003,4427,4199,228,5.2
"29081",29,81,2004,4489,4254,235,5.2
"29081",29,81,2005,4624,4381,243,5.3
"29081",29,81,2006,4584,4372,212,4.6
"29081",29,81,2007,4547,4340,207,4.6
"29081",29,81,2008,4570,4346,224,4.9
"29081",29,81,2009,4614,4261,353,7.7
"29081",29,81,2010,4062,3676,386,9.5
"29081",29,81,2011,4021,3679,342,8.5
"29081",29,81,2012,3970,3682,288,7.3
"29081",29,81,2013,3966,3676,290,7.3
"29081",29,81,2014,3984,3723,261,6.6
"29081",29,81,2015,3988,3786,202,5.1
"29081",29,81,2016,3976,3808,168,4.2
"29081",29,81,2017,3863,3726,137,3.5
"29083",29,83,1990,9174,8464,710,7.7
"29083",29,83,1991,9252,8494,758,8.2
"29083",29,83,1992,9395,8586,809,8.6
"29083",29,83,1993,9543,8725,818,8.6
"29083",29,83,1994,9807,9116,691,7
"29083",29,83,1995,10001,9299,702,7
"29083",29,83,1996,10307,9650,657,6.4
"29083",29,83,1997,10525,10034,491,4.7
"29083",29,83,1998,10468,9986,482,4.6
"29083",29,83,1999,10706,10314,392,3.7
"29083",29,83,2000,11352,10927,425,3.7
"29083",29,83,2001,11403,10797,606,5.3
"29083",29,83,2002,11081,10435,646,5.8
"29083",29,83,2003,11123,10316,807,7.3
"29083",29,83,2004,10944,10194,750,6.9
"29083",29,83,2005,10809,10152,657,6.1
"29083",29,83,2006,10870,10314,556,5.1
"29083",29,83,2007,10911,10298,613,5.6
"29083",29,83,2008,10899,10169,730,6.7
"29083",29,83,2009,10958,9912,1046,9.5
"29083",29,83,2010,10139,9045,1094,10.8
"29083",29,83,2011,9923,8965,958,9.7
"29083",29,83,2012,9849,9084,765,7.8
"29083",29,83,2013,9867,9162,705,7.1
"29083",29,83,2014,10128,9471,657,6.5
"29083",29,83,2015,10112,9562,550,5.4
"29083",29,83,2016,9902,9407,495,5
"29083",29,83,2017,9663,9258,405,4.2
"29085",29,85,1990,2559,2391,168,6.6
"29085",29,85,1991,2611,2375,236,9
"29085",29,85,1992,2668,2434,234,8.8
"29085",29,85,1993,2714,2482,232,8.5
"29085",29,85,1994,2831,2646,185,6.5
"29085",29,85,1995,2891,2690,201,7
"29085",29,85,1996,3109,2876,233,7.5
"29085",29,85,1997,3102,2894,208,6.7
"29085",29,85,1998,2786,2568,218,7.8
"29085",29,85,1999,2869,2719,150,5.2
"29085",29,85,2000,3417,3203,214,6.3
"29085",29,85,2001,3509,3267,242,6.9
"29085",29,85,2002,3375,3140,235,7
"29085",29,85,2003,3458,3176,282,8.2
"29085",29,85,2004,3435,3141,294,8.6
"29085",29,85,2005,3411,3146,265,7.8
"29085",29,85,2006,3410,3174,236,6.9
"29085",29,85,2007,3422,3166,256,7.5
"29085",29,85,2008,3452,3118,334,9.7
"29085",29,85,2009,3512,3042,470,13.4
"29085",29,85,2010,3677,3213,464,12.6
"29085",29,85,2011,3572,3155,417,11.7
"29085",29,85,2012,3622,3188,434,12
"29085",29,85,2013,3689,3322,367,9.9
"29085",29,85,2014,3699,3390,309,8.4
"29085",29,85,2015,3723,3476,247,6.6
"29085",29,85,2016,3699,3491,208,5.6
"29085",29,85,2017,3691,3525,166,4.5
"29087",29,87,1990,2680,2574,106,4
"29087",29,87,1991,2687,2548,139,5.2
"29087",29,87,1992,2853,2708,145,5.1
"29087",29,87,1993,2839,2676,163,5.7
"29087",29,87,1994,2925,2785,140,4.8
"29087",29,87,1995,2817,2685,132,4.7
"29087",29,87,1996,2834,2699,135,4.8
"29087",29,87,1997,2776,2667,109,3.9
"29087",29,87,1998,2669,2568,101,3.8
"29087",29,87,1999,2751,2660,91,3.3
"29087",29,87,2000,2800,2710,90,3.2
"29087",29,87,2001,2826,2708,118,4.2
"29087",29,87,2002,2728,2603,125,4.6
"29087",29,87,2003,2624,2483,141,5.4
"29087",29,87,2004,2620,2488,132,5
"29087",29,87,2005,2630,2511,119,4.5
"29087",29,87,2006,2706,2598,108,4
"29087",29,87,2007,2702,2566,136,5
"29087",29,87,2008,2759,2621,138,5
"29087",29,87,2009,2786,2589,197,7.1
"29087",29,87,2010,2693,2479,214,7.9
"29087",29,87,2011,2701,2506,195,7.2
"29087",29,87,2012,2693,2552,141,5.2
"29087",29,87,2013,2742,2595,147,5.4
"29087",29,87,2014,2699,2567,132,4.9
"29087",29,87,2015,2711,2613,98,3.6
"29087",29,87,2016,2687,2600,87,3.2
"29087",29,87,2017,2669,2591,78,2.9
"29089",29,89,1990,4627,4412,215,4.6
"29089",29,89,1991,4645,4435,210,4.5
"29089",29,89,1992,4709,4490,219,4.7
"29089",29,89,1993,4740,4478,262,5.5
"29089",29,89,1994,4890,4707,183,3.7
"29089",29,89,1995,4952,4721,231,4.7
"29089",29,89,1996,4840,4651,189,3.9
"29089",29,89,1997,5080,4884,196,3.9
"29089",29,89,1998,4833,4657,176,3.6
"29089",29,89,1999,4701,4542,159,3.4
"29089",29,89,2000,5358,5189,169,3.2
"29089",29,89,2001,5396,5170,226,4.2
"29089",29,89,2002,5398,5153,245,4.5
"29089",29,89,2003,5404,5179,225,4.2
"29089",29,89,2004,5341,5085,256,4.8
"29089",29,89,2005,5411,5166,245,4.5
"29089",29,89,2006,5379,5140,239,4.4
"29089",29,89,2007,5136,4907,229,4.5
"29089",29,89,2008,5105,4800,305,6
"29089",29,89,2009,5109,4679,430,8.4
"29089",29,89,2010,5002,4565,437,8.7
"29089",29,89,2011,4866,4465,401,8.2
"29089",29,89,2012,4844,4516,328,6.8
"29089",29,89,2013,4927,4609,318,6.5
"29089",29,89,2014,4992,4723,269,5.4
"29089",29,89,2015,5047,4800,247,4.9
"29089",29,89,2016,5035,4812,223,4.4
"29089",29,89,2017,4987,4795,192,3.9
"29091",29,91,1990,14176,13305,871,6.1
"29091",29,91,1991,14928,13854,1074,7.2
"29091",29,91,1992,15359,14281,1078,7
"29091",29,91,1993,16174,14958,1216,7.5
"29091",29,91,1994,16960,15693,1267,7.5
"29091",29,91,1995,17359,16204,1155,6.7
"29091",29,91,1996,17796,16574,1222,6.9
"29091",29,91,1997,18447,17323,1124,6.1
"29091",29,91,1998,17983,17033,950,5.3
"29091",29,91,1999,17743,17057,686,3.9
"29091",29,91,2000,18669,17938,731,3.9
"29091",29,91,2001,19430,18557,873,4.5
"29091",29,91,2002,19209,18250,959,5
"29091",29,91,2003,19663,18593,1070,5.4
"29091",29,91,2004,19805,18757,1048,5.3
"29091",29,91,2005,19929,18990,939,4.7
"29091",29,91,2006,20009,19170,839,4.2
"29091",29,91,2007,19812,18889,923,4.7
"29091",29,91,2008,19855,18729,1126,5.7
"29091",29,91,2009,19838,17921,1917,9.7
"29091",29,91,2010,17064,15218,1846,10.8
"29091",29,91,2011,16532,14948,1584,9.6
"29091",29,91,2012,16554,15206,1348,8.1
"29091",29,91,2013,16415,15131,1284,7.8
"29091",29,91,2014,16289,15127,1162,7.1
"29091",29,91,2015,16355,15303,1052,6.4
"29091",29,91,2016,16133,15109,1024,6.3
"29091",29,91,2017,15467,14709,758,4.9
"29093",29,93,1990,4282,3847,435,10.2
"29093",29,93,1991,4109,3565,544,13.2
"29093",29,93,1992,4174,3630,544,13
"29093",29,93,1993,4295,3725,570,13.3
"29093",29,93,1994,4353,3863,490,11.3
"29093",29,93,1995,4445,4016,429,9.7
"29093",29,93,1996,4496,4095,401,8.9
"29093",29,93,1997,4631,4260,371,8
"29093",29,93,1998,4419,4067,352,8
"29093",29,93,1999,4190,3891,299,7.1
"29093",29,93,2000,4937,4653,284,5.8
"29093",29,93,2001,5139,4794,345,6.7
"29093",29,93,2002,5073,4662,411,8.1
"29093",29,93,2003,5022,4643,379,7.5
"29093",29,93,2004,5038,4616,422,8.4
"29093",29,93,2005,5007,4657,350,7
"29093",29,93,2006,5014,4741,273,5.4
"29093",29,93,2007,5372,5085,287,5.3
"29093",29,93,2008,5731,5406,325,5.7
"29093",29,93,2009,5775,5265,510,8.8
"29093",29,93,2010,3574,2977,597,16.7
"29093",29,93,2011,3570,3068,502,14.1
"29093",29,93,2012,3748,3321,427,11.4
"29093",29,93,2013,3932,3514,418,10.6
"29093",29,93,2014,3928,3540,388,9.9
"29093",29,93,2015,3853,3547,306,7.9
"29093",29,93,2016,3719,3452,267,7.2
"29093",29,93,2017,3486,3258,228,6.5
"29095",29,95,1990,336967,319303,17664,5.2
"29095",29,95,1991,340447,318959,21488,6.3
"29095",29,95,1992,338546,318099,20447,6
"29095",29,95,1993,339078,319685,19393,5.7
"29095",29,95,1994,349540,331653,17887,5.1
"29095",29,95,1995,361952,344550,17402,4.8
"29095",29,95,1996,363917,346810,17107,4.7
"29095",29,95,1997,364362,348592,15770,4.3
"29095",29,95,1998,366393,350741,15652,4.3
"29095",29,95,1999,362708,350108,12600,3.5
"29095",29,95,2000,346703,333861,12842,3.7
"29095",29,95,2001,347409,330481,16928,4.9
"29095",29,95,2002,344703,323714,20989,6.1
"29095",29,95,2003,343792,321297,22495,6.5
"29095",29,95,2004,341134,317117,24017,7
"29095",29,95,2005,336286,314780,21506,6.4
"29095",29,95,2006,335295,316140,19155,5.7
"29095",29,95,2007,336581,316869,19712,5.9
"29095",29,95,2008,333855,310717,23138,6.9
"29095",29,95,2009,343945,308926,35019,10.2
"29095",29,95,2010,361018,322489,38529,10.7
"29095",29,95,2011,358230,324169,34061,9.5
"29095",29,95,2012,355862,328189,27673,7.8
"29095",29,95,2013,353084,326123,26961,7.6
"29095",29,95,2014,357620,332214,25406,7.1
"29095",29,95,2015,363168,341720,21448,5.9
"29095",29,95,2016,364575,345882,18693,5.1
"29095",29,95,2017,363854,348003,15851,4.4
"29097",29,97,1990,45244,42819,2425,5.4
"29097",29,97,1991,46115,43563,2552,5.5
"29097",29,97,1992,47461,44852,2609,5.5
"29097",29,97,1993,48647,45843,2804,5.8
"29097",29,97,1994,50305,47880,2425,4.8
"29097",29,97,1995,52074,49889,2185,4.2
"29097",29,97,1996,53562,51334,2228,4.2
"29097",29,97,1997,56759,54661,2098,3.7
"29097",29,97,1998,56221,54133,2088,3.7
"29097",29,97,1999,55644,54060,1584,2.8
"29097",29,97,2000,53949,52081,1868,3.5
"29097",29,97,2001,54331,51958,2373,4.4
"29097",29,97,2002,53777,50948,2829,5.3
"29097",29,97,2003,55142,52206,2936,5.3
"29097",29,97,2004,54981,52053,2928,5.3
"29097",29,97,2005,54567,51929,2638,4.8
"29097",29,97,2006,55703,53329,2374,4.3
"29097",29,97,2007,56572,54023,2549,4.5
"29097",29,97,2008,56721,53747,2974,5.2
"29097",29,97,2009,57882,53156,4726,8.2
"29097",29,97,2010,59026,54018,5008,8.5
"29097",29,97,2011,58850,54387,4463,7.6
"29097",29,97,2012,58257,54818,3439,5.9
"29097",29,97,2013,57982,54596,3386,5.8
"29097",29,97,2014,57779,54724,3055,5.3
"29097",29,97,2015,58085,55597,2488,4.3
"29097",29,97,2016,57791,55390,2401,4.2
"29097",29,97,2017,56734,54838,1896,3.3
"29099",29,99,1990,92597,85482,7115,7.7
"29099",29,99,1991,93817,86036,7781,8.3
"29099",29,99,1992,93057,86536,6521,7
"29099",29,99,1993,93704,87950,5754,6.1
"29099",29,99,1994,97178,92362,4816,5
"29099",29,99,1995,100994,96134,4860,4.8
"29099",29,99,1996,103389,98751,4638,4.5
"29099",29,99,1997,102877,98669,4208,4.1
"29099",29,99,1998,103977,99695,4282,4.1
"29099",29,99,1999,104191,100915,3276,3.1
"29099",29,99,2000,110127,106436,3691,3.4
"29099",29,99,2001,112300,107261,5039,4.5
"29099",29,99,2002,113736,107781,5955,5.2
"29099",29,99,2003,114629,108503,6126,5.3
"29099",29,99,2004,115135,108458,6677,5.8
"29099",29,99,2005,115830,109561,6269,5.4
"29099",29,99,2006,116819,111115,5704,4.9
"29099",29,99,2007,116051,110041,6010,5.2
"29099",29,99,2008,116350,108378,7972,6.9
"29099",29,99,2009,117270,104862,12408,10.6
"29099",29,99,2010,117544,105349,12195,10.4
"29099",29,99,2011,116930,106665,10265,8.8
"29099",29,99,2012,115282,107002,8280,7.2
"29099",29,99,2013,114854,107043,7811,6.8
"29099",29,99,2014,116430,109190,7240,6.2
"29099",29,99,2015,117702,111976,5726,4.9
"29099",29,99,2016,117757,112685,5072,4.3
"29099",29,99,2017,116746,112586,4160,3.6
"29101",29,101,1990,21735,20447,1288,5.9
"29101",29,101,1991,20973,19828,1145,5.5
"29101",29,101,1992,20830,19915,915,4.4
"29101",29,101,1993,21377,20506,871,4.1
"29101",29,101,1994,22013,21287,726,3.3
"29101",29,101,1995,22406,21782,624,2.8
"29101",29,101,1996,22600,21953,647,2.9
"29101",29,101,1997,23836,23234,602,2.5
"29101",29,101,1998,23781,23205,576,2.4
"29101",29,101,1999,23241,22743,498,2.1
"29101",29,101,2000,24755,23929,826,3.3
"29101",29,101,2001,24771,23760,1011,4.1
"29101",29,101,2002,24883,23734,1149,4.6
"29101",29,101,2003,25113,23928,1185,4.7
"29101",29,101,2004,25331,24055,1276,5
"29101",29,101,2005,25822,24641,1181,4.6
"29101",29,101,2006,26577,25517,1060,4
"29101",29,101,2007,26272,25055,1217,4.6
"29101",29,101,2008,26490,25088,1402,5.3
"29101",29,101,2009,26190,23976,2214,8.5
"29101",29,101,2010,23492,21158,2334,9.9
"29101",29,101,2011,23500,21356,2144,9.1
"29101",29,101,2012,23079,21311,1768,7.7
"29101",29,101,2013,22943,21282,1661,7.2
"29101",29,101,2014,22822,21353,1469,6.4
"29101",29,101,2015,23117,21873,1244,5.4
"29101",29,101,2016,23208,22068,1140,4.9
"29101",29,101,2017,23157,22133,1024,4.4
"29103",29,103,1990,2015,1927,88,4.4
"29103",29,103,1991,1919,1825,94,4.9
"29103",29,103,1992,1949,1851,98,5
"29103",29,103,1993,1852,1744,108,5.8
"29103",29,103,1994,1893,1811,82,4.3
"29103",29,103,1995,1901,1810,91,4.8
"29103",29,103,1996,2005,1926,79,3.9
"29103",29,103,1997,2094,2033,61,2.9
"29103",29,103,1998,2017,1942,75,3.7
"29103",29,103,1999,2014,1962,52,2.6
"29103",29,103,2000,2187,2107,80,3.7
"29103",29,103,2001,2347,2243,104,4.4
"29103",29,103,2002,2164,2067,97,4.5
"29103",29,103,2003,2165,2067,98,4.5
"29103",29,103,2004,2369,2270,99,4.2
"29103",29,103,2005,2439,2345,94,3.9
"29103",29,103,2006,2357,2265,92,3.9
"29103",29,103,2007,2344,2255,89,3.8
"29103",29,103,2008,2360,2250,110,4.7
"29103",29,103,2009,2343,2202,141,6
"29103",29,103,2010,2007,1851,156,7.8
"29103",29,103,2011,1979,1837,142,7.2
"29103",29,103,2012,1970,1859,111,5.6
"29103",29,103,2013,1984,1875,109,5.5
"29103",29,103,2014,1973,1882,91,4.6
"29103",29,103,2015,1963,1887,76,3.9
"29103",29,103,2016,1986,1914,72,3.6
"29103",29,103,2017,1956,1892,64,3.3
"29105",29,105,1990,13349,11850,1499,11.2
"29105",29,105,1991,12858,11330,1528,11.9
"29105",29,105,1992,12970,11765,1205,9.3
"29105",29,105,1993,13505,12331,1174,8.7
"29105",29,105,1994,14035,13139,896,6.4
"29105",29,105,1995,15007,13917,1090,7.3
"29105",29,105,1996,15542,14494,1048,6.7
"29105",29,105,1997,16357,15347,1010,6.2
"29105",29,105,1998,16296,15380,916,5.6
"29105",29,105,1999,16198,15512,686,4.2
"29105",29,105,2000,17009,16358,651,3.8
"29105",29,105,2001,17121,16149,972,5.7
"29105",29,105,2002,16915,15938,977,5.8
"29105",29,105,2003,16903,15496,1407,8.3
"29105",29,105,2004,16956,15699,1257,7.4
"29105",29,105,2005,17124,16190,934,5.5
"29105",29,105,2006,17611,16780,831,4.7
"29105",29,105,2007,17588,16607,981,5.6
"29105",29,105,2008,17873,16516,1357,7.6
"29105",29,105,2009,16533,14465,2068,12.5
"29105",29,105,2010,15918,13942,1976,12.4
"29105",29,105,2011,15921,14122,1799,11.3
"29105",29,105,2012,15794,14334,1460,9.2
"29105",29,105,2013,15595,14099,1496,9.6
"29105",29,105,2014,15915,14628,1287,8.1
"29105",29,105,2015,15940,14928,1012,6.3
"29105",29,105,2016,16175,15293,882,5.5
"29105",29,105,2017,16189,15401,788,4.9
"29107",29,107,1990,15224,14288,936,6.1
"29107",29,107,1991,15266,14315,951,6.2
"29107",29,107,1992,15105,14273,832,5.5
"29107",29,107,1993,15365,14537,828,5.4
"29107",29,107,1994,15958,15264,694,4.3
"29107",29,107,1995,16387,15648,739,4.5
"29107",29,107,1996,16570,15833,737,4.4
"29107",29,107,1997,16487,15787,700,4.2
"29107",29,107,1998,16625,15959,666,4
"29107",29,107,1999,16588,16012,576,3.5
"29107",29,107,2000,17486,16898,588,3.4
"29107",29,107,2001,17360,16626,734,4.2
"29107",29,107,2002,17109,16239,870,5.1
"29107",29,107,2003,17011,16115,896,5.3
"29107",29,107,2004,16858,15876,982,5.8
"29107",29,107,2005,16710,15794,916,5.5
"29107",29,107,2006,16673,15873,800,4.8
"29107",29,107,2007,16448,15599,849,5.2
"29107",29,107,2008,16374,15371,1003,6.1
"29107",29,107,2009,15872,14325,1547,9.7
"29107",29,107,2010,17549,15830,1719,9.8
"29107",29,107,2011,17464,15875,1589,9.1
"29107",29,107,2012,17249,16025,1224,7.1
"29107",29,107,2013,16918,15831,1087,6.4
"29107",29,107,2014,16972,15962,1010,6
"29107",29,107,2015,17186,16353,833,4.8
"29107",29,107,2016,17209,16466,743,4.3
"29107",29,107,2017,17206,16563,643,3.7
"29109",29,109,1990,14386,13652,734,5.1
"29109",29,109,1991,14726,13895,831,5.6
"29109",29,109,1992,14788,13832,956,6.5
"29109",29,109,1993,14835,13845,990,6.7
"29109",29,109,1994,15349,14508,841,5.5
"29109",29,109,1995,15840,15107,733,4.6
"29109",29,109,1996,15948,15041,907,5.7
"29109",29,109,1997,16447,15422,1025,6.2
"29109",29,109,1998,15794,15031,763,4.8
"29109",29,109,1999,16066,15520,546,3.4
"29109",29,109,2000,18364,17749,615,3.3
"29109",29,109,2001,18738,17916,822,4.4
"29109",29,109,2002,18445,17543,902,4.9
"29109",29,109,2003,18695,17779,916,4.9
"29109",29,109,2004,18803,17884,919,4.9
"29109",29,109,2005,18854,17984,870,4.6
"29109",29,109,2006,19294,18545,749,3.9
"29109",29,109,2007,19267,18487,780,4
"29109",29,109,2008,19405,18465,940,4.8
"29109",29,109,2009,19110,17522,1588,8.3
"29109",29,109,2010,17558,15925,1633,9.3
"29109",29,109,2011,17396,15949,1447,8.3
"29109",29,109,2012,17317,16189,1128,6.5
"29109",29,109,2013,17426,16276,1150,6.6
"29109",29,109,2014,17488,16459,1029,5.9
"29109",29,109,2015,17888,17011,877,4.9
"29109",29,109,2016,17805,17026,779,4.4
"29109",29,109,2017,17564,16930,634,3.6
"29111",29,111,1990,4887,4619,268,5.5
"29111",29,111,1991,4887,4509,378,7.7
"29111",29,111,1992,4839,4543,296,6.1
"29111",29,111,1993,5048,4755,293,5.8
"29111",29,111,1994,5340,5117,223,4.2
"29111",29,111,1995,5448,5231,217,4
"29111",29,111,1996,5595,5368,227,4.1
"29111",29,111,1997,6148,5944,204,3.3
"29111",29,111,1998,5736,5525,211,3.7
"29111",29,111,1999,5664,5489,175,3.1
"29111",29,111,2000,5660,5463,197,3.5
"29111",29,111,2001,5694,5427,267,4.7
"29111",29,111,2002,5757,5470,287,5
"29111",29,111,2003,5659,5344,315,5.6
"29111",29,111,2004,5614,5334,280,5
"29111",29,111,2005,5761,5500,261,4.5
"29111",29,111,2006,5802,5586,216,3.7
"29111",29,111,2007,5682,5457,225,4
"29111",29,111,2008,5526,5259,267,4.8
"29111",29,111,2009,5475,5022,453,8.3
"29111",29,111,2010,5203,4759,444,8.5
"29111",29,111,2011,5142,4784,358,7
"29111",29,111,2012,5166,4881,285,5.5
"29111",29,111,2013,5081,4799,282,5.6
"29111",29,111,2014,5162,4893,269,5.2
"29111",29,111,2015,5214,4958,256,4.9
"29111",29,111,2016,5142,4910,232,4.5
"29111",29,111,2017,5056,4879,177,3.5
"29113",29,113,1990,14542,13542,1000,6.9
"29113",29,113,1991,14961,13809,1152,7.7
"29113",29,113,1992,15058,13901,1157,7.7
"29113",29,113,1993,15625,14317,1308,8.4
"29113",29,113,1994,16012,15058,954,6
"29113",29,113,1995,16942,16039,903,5.3
"29113",29,113,1996,17586,16741,845,4.8
"29113",29,113,1997,17744,16967,777,4.4
"29113",29,113,1998,18441,17582,859,4.7
"29113",29,113,1999,18682,18098,584,3.1
"29113",29,113,2000,20638,19920,718,3.5
"29113",29,113,2001,21616,20611,1005,4.6
"29113",29,113,2002,22467,21245,1222,5.4
"29113",29,113,2003,23307,21985,1322,5.7
"29113",29,113,2004,23741,22334,1407,5.9
"29113",29,113,2005,24529,23192,1337,5.5
"29113",29,113,2006,25735,24382,1353,5.3
"29113",29,113,2007,26364,24869,1495,5.7
"29113",29,113,2008,27016,24901,2115,7.8
"29113",29,113,2009,27431,24186,3245,11.8
"29113",29,113,2010,26706,23558,3148,11.8
"29113",29,113,2011,26691,24003,2688,10.1
"29113",29,113,2012,26361,24169,2192,8.3
"29113",29,113,2013,26314,24321,1993,7.6
"29113",29,113,2014,26596,24866,1730,6.5
"29113",29,113,2015,26966,25572,1394,5.2
"29113",29,113,2016,27256,26032,1224,4.5
"29113",29,113,2017,26985,26015,970,3.6
"29115",29,115,1990,6325,5823,502,7.9
"29115",29,115,1991,6570,6035,535,8.1
"29115",29,115,1992,6654,6049,605,9.1
"29115",29,115,1993,6890,6132,758,11
"29115",29,115,1994,7052,6403,649,9.2
"29115",29,115,1995,7201,6577,624,8.7
"29115",29,115,1996,7222,6518,704,9.7
"29115",29,115,1997,6889,6314,575,8.3
"29115",29,115,1998,6637,6131,506,7.6
"29115",29,115,1999,6525,6152,373,5.7
"29115",29,115,2000,7217,6834,383,5.3
"29115",29,115,2001,7307,6826,481,6.6
"29115",29,115,2002,7164,6658,506,7.1
"29115",29,115,2003,7150,6618,532,7.4
"29115",29,115,2004,6992,6472,520,7.4
"29115",29,115,2005,6725,6185,540,8
"29115",29,115,2006,6598,6170,428,6.5
"29115",29,115,2007,6455,6043,412,6.4
"29115",29,115,2008,6531,6077,454,7
"29115",29,115,2009,6635,6002,633,9.5
"29115",29,115,2010,5450,4766,684,12.6
"29115",29,115,2011,5335,4701,634,11.9
"29115",29,115,2012,5179,4700,479,9.2
"29115",29,115,2013,5317,4849,468,8.8
"29115",29,115,2014,5226,4800,426,8.2
"29115",29,115,2015,5244,4876,368,7
"29115",29,115,2016,5279,4924,355,6.7
"29115",29,115,2017,5169,4864,305,5.9
"29117",29,117,1990,6630,6369,261,3.9
"29117",29,117,1991,6722,6403,319,4.7
"29117",29,117,1992,6861,6573,288,4.2
"29117",29,117,1993,6986,6599,387,5.5
"29117",29,117,1994,7183,6839,344,4.8
"29117",29,117,1995,7343,7041,302,4.1
"29117",29,117,1996,7464,7161,303,4.1
"29117",29,117,1997,7944,7690,254,3.2
"29117",29,117,1998,7610,7349,261,3.4
"29117",29,117,1999,7355,7173,182,2.5
"29117",29,117,2000,7548,7331,217,2.9
"29117",29,117,2001,7711,7412,299,3.9
"29117",29,117,2002,7550,7216,334,4.4
"29117",29,117,2003,7220,6843,377,5.2
"29117",29,117,2004,7240,6865,375,5.2
"29117",29,117,2005,7338,6989,349,4.8
"29117",29,117,2006,7100,6797,303,4.3
"29117",29,117,2007,7160,6845,315,4.4
"29117",29,117,2008,7103,6736,367,5.2
"29117",29,117,2009,7364,6795,569,7.7
"29117",29,117,2010,7146,6563,583,8.2
"29117",29,117,2011,7090,6553,537,7.6
"29117",29,117,2012,7228,6780,448,6.2
"29117",29,117,2013,7269,6859,410,5.6
"29117",29,117,2014,7313,6946,367,5
"29117",29,117,2015,7307,6996,311,4.3
"29117",29,117,2016,7358,7070,288,3.9
"29117",29,117,2017,7290,7069,221,3
"29119",29,119,1990,7222,6816,406,5.6
"29119",29,119,1991,6933,6486,447,6.4
"29119",29,119,1992,6918,6401,517,7.5
"29119",29,119,1993,6970,6476,494,7.1
"29119",29,119,1994,7358,6980,378,5.1
"29119",29,119,1995,8154,7766,388,4.8
"29119",29,119,1996,8737,8286,451,5.2
"29119",29,119,1997,9314,8865,449,4.8
"29119",29,119,1998,8833,8398,435,4.9
"29119",29,119,1999,8538,8219,319,3.7
"29119",29,119,2000,10660,10261,399,3.7
"29119",29,119,2001,11012,10535,477,4.3
"29119",29,119,2002,11549,10962,587,5.1
"29119",29,119,2003,11766,11188,578,4.9
"29119",29,119,2004,11738,11135,603,5.1
"29119",29,119,2005,11905,11397,508,4.3
"29119",29,119,2006,11914,11453,461,3.9
"29119",29,119,2007,11504,11028,476,4.1
"29119",29,119,2008,11033,10491,542,4.9
"29119",29,119,2009,10656,9826,830,7.8
"29119",29,119,2010,10360,9411,949,9.2
"29119",29,119,2011,10239,9384,855,8.4
"29119",29,119,2012,10186,9507,679,6.7
"29119",29,119,2013,9980,9338,642,6.4
"29119",29,119,2014,10297,9701,596,5.8
"29119",29,119,2015,10415,9921,494,4.7
"29119",29,119,2016,10486,10030,456,4.3
"29119",29,119,2017,10573,10195,378,3.6
"29121",29,121,1990,7267,6673,594,8.2
"29121",29,121,1991,7258,6740,518,7.1
"29121",29,121,1992,7434,6944,490,6.6
"29121",29,121,1993,7612,6770,842,11.1
"29121",29,121,1994,7730,7185,545,7.1
"29121",29,121,1995,7894,7349,545,6.9
"29121",29,121,1996,7746,7283,463,6
"29121",29,121,1997,7965,7523,442,5.5
"29121",29,121,1998,7690,7272,418,5.4
"29121",29,121,1999,7626,7324,302,4
"29121",29,121,2000,8587,8213,374,4.4
"29121",29,121,2001,8532,7915,617,7.2
"29121",29,121,2002,8299,7831,468,5.6
"29121",29,121,2003,8382,7942,440,5.2
"29121",29,121,2004,8352,7900,452,5.4
"29121",29,121,2005,8302,7894,408,4.9
"29121",29,121,2006,8288,7889,399,4.8
"29121",29,121,2007,8044,7643,401,5
"29121",29,121,2008,7851,7382,469,6
"29121",29,121,2009,8213,7520,693,8.4
"29121",29,121,2010,7482,6789,693,9.3
"29121",29,121,2011,7489,6870,619,8.3
"29121",29,121,2012,7509,7004,505,6.7
"29121",29,121,2013,7426,6941,485,6.5
"29121",29,121,2014,7454,6996,458,6.1
"29121",29,121,2015,7473,7075,398,5.3
"29121",29,121,2016,7622,7258,364,4.8
"29121",29,121,2017,7403,7130,273,3.7
"29123",29,123,1990,4725,4281,444,9.4
"29123",29,123,1991,4728,4123,605,12.8
"29123",29,123,1992,4637,3858,779,16.8
"29123",29,123,1993,4821,4195,626,13
"29123",29,123,1994,4804,4354,450,9.4
"29123",29,123,1995,4677,4267,410,8.8
"29123",29,123,1996,4597,4127,470,10.2
"29123",29,123,1997,4756,4381,375,7.9
"29123",29,123,1998,4594,4296,298,6.5
"29123",29,123,1999,4393,4143,250,5.7
"29123",29,123,2000,5601,5318,283,5.1
"29123",29,123,2001,5730,5374,356,6.2
"29123",29,123,2002,5778,5367,411,7.1
"29123",29,123,2003,5856,5484,372,6.4
"29123",29,123,2004,5972,5590,382,6.4
"29123",29,123,2005,6016,5639,377,6.3
"29123",29,123,2006,6024,5702,322,5.3
"29123",29,123,2007,6056,5711,345,5.7
"29123",29,123,2008,6174,5797,377,6.1
"29123",29,123,2009,6269,5625,644,10.3
"29123",29,123,2010,5457,4793,664,12.2
"29123",29,123,2011,5361,4803,558,10.4
"29123",29,123,2012,5379,4935,444,8.3
"29123",29,123,2013,5564,5139,425,7.6
"29123",29,123,2014,5507,5125,382,6.9
"29123",29,123,2015,5521,5196,325,5.9
"29123",29,123,2016,5484,5182,302,5.5
"29123",29,123,2017,5367,5117,250,4.7
"29125",29,125,1990,4034,3746,288,7.1
"29125",29,125,1991,4101,3817,284,6.9
"29125",29,125,1992,4164,3787,377,9.1
"29125",29,125,1993,4098,3788,310,7.6
"29125",29,125,1994,4120,3944,176,4.3
"29125",29,125,1995,4175,3998,177,4.2
"29125",29,125,1996,4307,4097,210,4.9
"29125",29,125,1997,4460,4274,186,4.2
"29125",29,125,1998,4553,4372,181,4
"29125",29,125,1999,4495,4359,136,3
"29125",29,125,2000,4686,4507,179,3.8
"29125",29,125,2001,4761,4523,238,5
"29125",29,125,2002,4807,4547,260,5.4
"29125",29,125,2003,4821,4579,242,5
"29125",29,125,2004,4753,4511,242,5.1
"29125",29,125,2005,4807,4583,224,4.7
"29125",29,125,2006,4868,4650,218,4.5
"29125",29,125,2007,4772,4524,248,5.2
"29125",29,125,2008,4788,4488,300,6.3
"29125",29,125,2009,4824,4435,389,8.1
"29125",29,125,2010,4256,3853,403,9.5
"29125",29,125,2011,4207,3852,355,8.4
"29125",29,125,2012,4152,3852,300,7.2
"29125",29,125,2013,4179,3903,276,6.6
"29125",29,125,2014,3976,3729,247,6.2
"29125",29,125,2015,3938,3729,209,5.3
"29125",29,125,2016,3914,3717,197,5
"29125",29,125,2017,3860,3691,169,4.4
"29127",29,127,1990,13379,12671,708,5.3
"29127",29,127,1991,14111,13186,925,6.6
"29127",29,127,1992,14449,13607,842,5.8
"29127",29,127,1993,14636,13636,1000,6.8
"29127",29,127,1994,15030,14313,717,4.8
"29127",29,127,1995,15467,14740,727,4.7
"29127",29,127,1996,15799,15032,767,4.9
"29127",29,127,1997,16239,15529,710,4.4
"29127",29,127,1998,16008,15279,729,4.6
"29127",29,127,1999,15808,15241,567,3.6
"29127",29,127,2000,15019,14416,603,4
"29127",29,127,2001,15114,14361,753,5
"29127",29,127,2002,14749,13950,799,5.4
"29127",29,127,2003,14721,13875,846,5.7
"29127",29,127,2004,14692,13863,829,5.6
"29127",29,127,2005,14545,13795,750,5.2
"29127",29,127,2006,14478,13769,709,4.9
"29127",29,127,2007,14435,13670,765,5.3
"29127",29,127,2008,14705,13875,830,5.6
"29127",29,127,2009,14946,13537,1409,9.4
"29127",29,127,2010,14770,13427,1343,9.1
"29127",29,127,2011,14547,13459,1088,7.5
"29127",29,127,2012,14494,13611,883,6.1
"29127",29,127,2013,14636,13756,880,6
"29127",29,127,2014,14639,13830,809,5.5
"29127",29,127,2015,14756,14099,657,4.5
"29127",29,127,2016,14588,13963,625,4.3
"29127",29,127,2017,14321,13800,521,3.6
"29129",29,129,1990,1498,1430,68,4.5
"29129",29,129,1991,1519,1446,73,4.8
"29129",29,129,1992,1712,1639,73,4.3
"29129",29,129,1993,1844,1764,80,4.3
"29129",29,129,1994,2181,2121,60,2.8
"29129",29,129,1995,2238,2148,90,4
"29129",29,129,1996,2188,2116,72,3.3
"29129",29,129,1997,1720,1669,51,3
"29129",29,129,1998,1622,1571,51,3.1
"29129",29,129,1999,1637,1589,48,2.9
"29129",29,129,2000,1974,1914,60,3
"29129",29,129,2001,2090,2017,73,3.5
"29129",29,129,2002,1836,1746,90,4.9
"29129",29,129,2003,1766,1663,103,5.8
"29129",29,129,2004,1773,1681,92,5.2
"29129",29,129,2005,1810,1732,78,4.3
"29129",29,129,2006,1850,1771,79,4.3
"29129",29,129,2007,1804,1730,74,4.1
"29129",29,129,2008,1834,1746,88,4.8
"29129",29,129,2009,1760,1632,128,7.3
"29129",29,129,2010,1796,1646,150,8.4
"29129",29,129,2011,1838,1715,123,6.7
"29129",29,129,2012,1835,1740,95,5.2
"29129",29,129,2013,1810,1711,99,5.5
"29129",29,129,2014,1871,1776,95,5.1
"29129",29,129,2015,1888,1804,84,4.4
"29129",29,129,2016,1931,1842,89,4.6
"29129",29,129,2017,1936,1863,73,3.8
"29131",29,131,1990,10391,9446,945,9.1
"29131",29,131,1991,10254,9139,1115,10.9
"29131",29,131,1992,10423,9369,1054,10.1
"29131",29,131,1993,10627,9482,1145,10.8
"29131",29,131,1994,11026,10134,892,8.1
"29131",29,131,1995,11463,10683,780,6.8
"29131",29,131,1996,11638,10798,840,7.2
"29131",29,131,1997,12096,11247,849,7
"29131",29,131,1998,11756,11000,756,6.4
"29131",29,131,1999,11698,11147,551,4.7
"29131",29,131,2000,12777,12197,580,4.5
"29131",29,131,2001,13071,12345,726,5.6
"29131",29,131,2002,12856,12020,836,6.5
"29131",29,131,2003,12934,12160,774,6
"29131",29,131,2004,12944,12117,827,6.4
"29131",29,131,2005,13333,12574,759,5.7
"29131",29,131,2006,13562,12859,703,5.2
"29131",29,131,2007,13345,12643,702,5.3
"29131",29,131,2008,13191,12304,887,6.7
"29131",29,131,2009,12812,11319,1493,11.7
"29131",29,131,2010,11858,10331,1527,12.9
"29131",29,131,2011,11381,10077,1304,11.5
"29131",29,131,2012,11373,10346,1027,9
"29131",29,131,2013,11497,10492,1005,8.7
"29131",29,131,2014,11652,10754,898,7.7
"29131",29,131,2015,11656,10954,702,6
"29131",29,131,2016,11895,11279,616,5.2
"29131",29,131,2017,11823,11289,534,4.5
"29133",29,133,1990,6239,5610,629,10.1
"29133",29,133,1991,6109,5478,631,10.3
"29133",29,133,1992,6155,5390,765,12.4
"29133",29,133,1993,6071,5384,687,11.3
"29133",29,133,1994,6298,5600,698,11.1
"29133",29,133,1995,6214,5630,584,9.4
"29133",29,133,1996,6142,5608,534,8.7
"29133",29,133,1997,6248,5739,509,8.1
"29133",29,133,1998,6166,5677,489,7.9
"29133",29,133,1999,6010,5698,312,5.2
"29133",29,133,2000,6209,5873,336,5.4
"29133",29,133,2001,6411,5912,499,7.8
"29133",29,133,2002,6017,5555,462,7.7
"29133",29,133,2003,6248,5795,453,7.3
"29133",29,133,2004,6200,5734,466,7.5
"29133",29,133,2005,5835,5415,420,7.2
"29133",29,133,2006,5924,5545,379,6.4
"29133",29,133,2007,5878,5492,386,6.6
"29133",29,133,2008,5820,5397,423,7.3
"29133",29,133,2009,6181,5645,536,8.7
"29133",29,133,2010,6108,5518,590,9.7
"29133",29,133,2011,6072,5488,584,9.6
"29133",29,133,2012,6154,5667,487,7.9
"29133",29,133,2013,6303,5811,492,7.8
"29133",29,133,2014,6271,5815,456,7.3
"29133",29,133,2015,6285,5921,364,5.8
"29133",29,133,2016,6222,5808,414,6.7
"29133",29,133,2017,5972,5668,304,5.1
"29135",29,135,1990,6425,5990,435,6.8
"29135",29,135,1991,6443,6057,386,6
"29135",29,135,1992,6566,6096,470,7.2
"29135",29,135,1993,6543,6095,448,6.8
"29135",29,135,1994,6766,6482,284,4.2
"29135",29,135,1995,7058,6768,290,4.1
"29135",29,135,1996,7260,6969,291,4
"29135",29,135,1997,7614,7338,276,3.6
"29135",29,135,1998,7478,7218,260,3.5
"29135",29,135,1999,7437,7247,190,2.6
"29135",29,135,2000,7441,7200,241,3.2
"29135",29,135,2001,7559,7224,335,4.4
"29135",29,135,2002,7504,7124,380,5.1
"29135",29,135,2003,7605,7262,343,4.5
"29135",29,135,2004,7621,7256,365,4.8
"29135",29,135,2005,7564,7182,382,5.1
"29135",29,135,2006,7472,7125,347,4.6
"29135",29,135,2007,7487,7141,346,4.6
"29135",29,135,2008,7419,7010,409,5.5
"29135",29,135,2009,7459,6850,609,8.2
"29135",29,135,2010,7397,6772,625,8.4
"29135",29,135,2011,7374,6809,565,7.7
"29135",29,135,2012,7325,6841,484,6.6
"29135",29,135,2013,7318,6853,465,6.4
"29135",29,135,2014,7388,6946,442,6
"29135",29,135,2015,7402,7039,363,4.9
"29135",29,135,2016,7479,7154,325,4.3
"29135",29,135,2017,7361,7097,264,3.6
"29137",29,137,1990,4105,3905,200,4.9
"29137",29,137,1991,4152,3880,272,6.6
"29137",29,137,1992,4314,4079,235,5.4
"29137",29,137,1993,4074,3769,305,7.5
"29137",29,137,1994,4082,3862,220,5.4
"29137",29,137,1995,4277,4031,246,5.8
"29137",29,137,1996,4468,4219,249,5.6
"29137",29,137,1997,4479,4254,225,5
"29137",29,137,1998,4445,4200,245,5.5
"29137",29,137,1999,4555,4361,194,4.3
"29137",29,137,2000,4899,4706,193,3.9
"29137",29,137,2001,4845,4587,258,5.3
"29137",29,137,2002,4572,4318,254,5.6
"29137",29,137,2003,4510,4245,265,5.9
"29137",29,137,2004,4603,4326,277,6
"29137",29,137,2005,4513,4266,247,5.5
"29137",29,137,2006,4409,4171,238,5.4
"29137",29,137,2007,4351,4102,249,5.7
"29137",29,137,2008,4344,4041,303,7
"29137",29,137,2009,4232,3685,547,12.9
"29137",29,137,2010,4118,3613,505,12.3
"29137",29,137,2011,4093,3689,404,9.9
"29137",29,137,2012,4060,3749,311,7.7
"29137",29,137,2013,4111,3810,301,7.3
"29137",29,137,2014,4189,3921,268,6.4
"29137",29,137,2015,4211,3992,219,5.2
"29137",29,137,2016,4167,3965,202,4.8
"29137",29,137,2017,3985,3811,174,4.4
"29139",29,139,1990,5366,5011,355,6.6
"29139",29,139,1991,5471,5075,396,7.2
"29139",29,139,1992,5542,5162,380,6.9
"29139",29,139,1993,5616,5199,417,7.4
"29139",29,139,1994,5834,5510,324,5.6
"29139",29,139,1995,6055,5767,288,4.8
"29139",29,139,1996,6284,5982,302,4.8
"29139",29,139,1997,6386,5940,446,7
"29139",29,139,1998,6026,5630,396,6.6
"29139",29,139,1999,5750,5503,247,4.3
"29139",29,139,2000,6362,6135,227,3.6
"29139",29,139,2001,6530,6210,320,4.9
"29139",29,139,2002,6486,6143,343,5.3
"29139",29,139,2003,6443,6048,395,6.1
"29139",29,139,2004,6430,6024,406,6.3
"29139",29,139,2005,6266,5907,359,5.7
"29139",29,139,2006,6292,5950,342,5.4
"29139",29,139,2007,6123,5789,334,5.5
"29139",29,139,2008,6124,5685,439,7.2
"29139",29,139,2009,6109,5388,721,11.8
"29139",29,139,2010,6047,5374,673,11.1
"29139",29,139,2011,5954,5363,591,9.9
"29139",29,139,2012,5806,5350,456,7.9
"29139",29,139,2013,5720,5308,412,7.2
"29139",29,139,2014,5692,5355,337,5.9
"29139",29,139,2015,5709,5425,284,5
"29139",29,139,2016,5754,5491,263,4.6
"29139",29,139,2017,5582,5397,185,3.3
"29141",29,141,1990,7222,6651,571,7.9
"29141",29,141,1991,7239,6673,566,7.8
"29141",29,141,1992,7456,6809,647,8.7
"29141",29,141,1993,7486,6783,703,9.4
"29141",29,141,1994,7966,7421,545,6.8
"29141",29,141,1995,8216,7700,516,6.3
"29141",29,141,1996,8501,7951,550,6.5
"29141",29,141,1997,8629,8091,538,6.2
"29141",29,141,1998,8628,8168,460,5.3
"29141",29,141,1999,8540,8196,344,4
"29141",29,141,2000,9563,9153,410,4.3
"29141",29,141,2001,9777,9189,588,6
"29141",29,141,2002,9523,8886,637,6.7
"29141",29,141,2003,9499,8907,592,6.2
"29141",29,141,2004,9595,8968,627,6.5
"29141",29,141,2005,9560,8947,613,6.4
"29141",29,141,2006,9554,8922,632,6.6
"29141",29,141,2007,9334,8758,576,6.2
"29141",29,141,2008,9344,8640,704,7.5
"29141",29,141,2009,9297,8129,1168,12.6
"29141",29,141,2010,7984,6824,1160,14.5
"29141",29,141,2011,7874,6878,996,12.6
"29141",29,141,2012,7810,7034,776,9.9
"29141",29,141,2013,7850,7108,742,9.5
"29141",29,141,2014,7971,7281,690,8.7
"29141",29,141,2015,8078,7534,544,6.7
"29141",29,141,2016,7975,7506,469,5.9
"29141",29,141,2017,7794,7404,390,5
"29143",29,143,1990,8732,7847,885,10.1
"29143",29,143,1991,8512,7671,841,9.9
"29143",29,143,1992,8503,7685,818,9.6
"29143",29,143,1993,8518,7666,852,10
"29143",29,143,1994,8648,7979,669,7.7
"29143",29,143,1995,8862,8192,670,7.6
"29143",29,143,1996,8839,8173,666,7.5
"29143",29,143,1997,9142,8431,711,7.8
"29143",29,143,1998,8966,8283,683,7.6
"29143",29,143,1999,8676,8221,455,5.2
"29143",29,143,2000,9486,9009,477,5
"29143",29,143,2001,9705,9071,634,6.5
"29143",29,143,2002,9026,8306,720,8
"29143",29,143,2003,8892,8032,860,9.7
"29143",29,143,2004,8727,8000,727,8.3
"29143",29,143,2005,8634,8043,591,6.8
"29143",29,143,2006,8736,8176,560,6.4
"29143",29,143,2007,8924,8310,614,6.9
"29143",29,143,2008,8920,8283,637,7.1
"29143",29,143,2009,8478,7688,790,9.3
"29143",29,143,2010,8225,7406,819,10
"29143",29,143,2011,8236,7436,800,9.7
"29143",29,143,2012,8134,7479,655,8.1
"29143",29,143,2013,8286,7638,648,7.8
"29143",29,143,2014,8470,7842,628,7.4
"29143",29,143,2015,8584,8050,534,6.2
"29143",29,143,2016,8250,7484,766,9.3
"29143",29,143,2017,7888,7358,530,6.7
"29145",29,145,1990,22798,21280,1518,6.7
"29145",29,145,1991,23369,21815,1554,6.6
"29145",29,145,1992,24195,22482,1713,7.1
"29145",29,145,1993,24471,22929,1542,6.3
"29145",29,145,1994,25267,23936,1331,5.3
"29145",29,145,1995,25990,24666,1324,5.1
"29145",29,145,1996,26722,25351,1371,5.1
"29145",29,145,1997,28238,27019,1219,4.3
"29145",29,145,1998,28306,27009,1297,4.6
"29145",29,145,1999,28061,27074,987,3.5
"29145",29,145,2000,27535,26436,1099,4
"29145",29,145,2001,27592,26194,1398,5.1
"29145",29,145,2002,27231,25624,1607,5.9
"29145",29,145,2003,28056,26380,1676,6
"29145",29,145,2004,27843,26308,1535,5.5
"29145",29,145,2005,27744,26347,1397,5
"29145",29,145,2006,28111,26842,1269,4.5
"29145",29,145,2007,27856,26541,1315,4.7
"29145",29,145,2008,27618,26088,1530,5.5
"29145",29,145,2009,27751,25504,2247,8.1
"29145",29,145,2010,28759,26175,2584,9
"29145",29,145,2011,28981,26668,2313,8
"29145",29,145,2012,29400,27590,1810,6.2
"29145",29,145,2013,28942,27198,1744,6
"29145",29,145,2014,28455,26920,1535,5.4
"29145",29,145,2015,28449,27149,1300,4.6
"29145",29,145,2016,28250,27015,1235,4.4
"29145",29,145,2017,27750,26751,999,3.6
"29147",29,147,1990,12073,11579,494,4.1
"29147",29,147,1991,11991,11599,392,3.3
"29147",29,147,1992,11992,11719,273,2.3
"29147",29,147,1993,11534,11183,351,3
"29147",29,147,1994,12045,11809,236,2
"29147",29,147,1995,12256,12075,181,1.5
"29147",29,147,1996,12823,12630,193,1.5
"29147",29,147,1997,13189,12994,195,1.5
"29147",29,147,1998,12981,12788,193,1.5
"29147",29,147,1999,12974,12816,158,1.2
"29147",29,147,2000,12349,12049,300,2.4
"29147",29,147,2001,12797,12410,387,3
"29147",29,147,2002,12144,11718,426,3.5
"29147",29,147,2003,12834,12385,449,3.5
"29147",29,147,2004,12709,12225,484,3.8
"29147",29,147,2005,12513,12049,464,3.7
"29147",29,147,2006,12618,12193,425,3.4
"29147",29,147,2007,12575,12104,471,3.7
"29147",29,147,2008,12871,12328,543,4.2
"29147",29,147,2009,12735,11923,812,6.4
"29147",29,147,2010,11758,10909,849,7.2
"29147",29,147,2011,11602,10805,797,6.9
"29147",29,147,2012,11730,11077,653,5.6
"29147",29,147,2013,11357,10614,743,6.5
"29147",29,147,2014,11109,10351,758,6.8
"29147",29,147,2015,11018,10476,542,4.9
"29147",29,147,2016,10863,10355,508,4.7
"29147",29,147,2017,10485,10101,384,3.7
"29149",29,149,1990,3729,3523,206,5.5
"29149",29,149,1991,3894,3628,266,6.8
"29149",29,149,1992,3984,3682,302,7.6
"29149",29,149,1993,4135,3833,302,7.3
"29149",29,149,1994,4289,4032,257,6
"29149",29,149,1995,4470,4191,279,6.2
"29149",29,149,1996,4506,4193,313,6.9
"29149",29,149,1997,4562,4292,270,5.9
"29149",29,149,1998,4487,4276,211,4.7
"29149",29,149,1999,4476,4294,182,4.1
"29149",29,149,2000,4463,4281,182,4.1
"29149",29,149,2001,4492,4275,217,4.8
"29149",29,149,2002,4330,4091,239,5.5
"29149",29,149,2003,4279,4042,237,5.5
"29149",29,149,2004,4296,4054,242,5.6
"29149",29,149,2005,4301,4071,230,5.3
"29149",29,149,2006,4371,4158,213,4.9
"29149",29,149,2007,4554,4318,236,5.2
"29149",29,149,2008,4574,4306,268,5.9
"29149",29,149,2009,4664,4237,427,9.2
"29149",29,149,2010,4107,3651,456,11.1
"29149",29,149,2011,4063,3665,398,9.8
"29149",29,149,2012,4052,3733,319,7.9
"29149",29,149,2013,4137,3808,329,8
"29149",29,149,2014,4147,3836,311,7.5
"29149",29,149,2015,4164,3900,264,6.3
"29149",29,149,2016,4119,3872,247,6
"29149",29,149,2017,3971,3786,185,4.7
"29151",29,151,1990,6465,6192,273,4.2
"29151",29,151,1991,6586,6267,319,4.8
"29151",29,151,1992,6590,6297,293,4.4
"29151",29,151,1993,6618,6309,309,4.7
"29151",29,151,1994,6869,6602,267,3.9
"29151",29,151,1995,7073,6872,201,2.8
"29151",29,151,1996,7281,7057,224,3.1
"29151",29,151,1997,7578,7336,242,3.2
"29151",29,151,1998,7432,7196,236,3.2
"29151",29,151,1999,7554,7226,328,4.3
"29151",29,151,2000,7362,7067,295,4
"29151",29,151,2001,7466,7100,366,4.9
"29151",29,151,2002,7330,6938,392,5.3
"29151",29,151,2003,7532,7157,375,5
"29151",29,151,2004,7541,7193,348,4.6
"29151",29,151,2005,7502,7150,352,4.7
"29151",29,151,2006,7438,7097,341,4.6
"29151",29,151,2007,7371,7023,348,4.7
"29151",29,151,2008,7408,6952,456,6.2
"29151",29,151,2009,7332,6837,495,6.8
"29151",29,151,2010,7467,6951,516,6.9
"29151",29,151,2011,7424,6965,459,6.2
"29151",29,151,2012,7334,6965,369,5
"29151",29,151,2013,7207,6848,359,5
"29151",29,151,2014,7231,6894,337,4.7
"29151",29,151,2015,7162,6893,269,3.8
"29151",29,151,2016,7233,6987,246,3.4
"29151",29,151,2017,7141,6927,214,3
"29153",29,153,1990,3526,3287,239,6.8
"29153",29,153,1991,3612,3362,250,6.9
"29153",29,153,1992,3693,3450,243,6.6
"29153",29,153,1993,3872,3600,272,7
"29153",29,153,1994,4055,3811,244,6
"29153",29,153,1995,4117,3863,254,6.2
"29153",29,153,1996,4225,3917,308,7.3
"29153",29,153,1997,4368,4083,285,6.5
"29153",29,153,1998,4251,3988,263,6.2
"29153",29,153,1999,4112,3926,186,4.5
"29153",29,153,2000,4433,4236,197,4.4
"29153",29,153,2001,4642,4389,253,5.5
"29153",29,153,2002,4486,4207,279,6.2
"29153",29,153,2003,4526,4259,267,5.9
"29153",29,153,2004,4434,4162,272,6.1
"29153",29,153,2005,4469,4226,243,5.4
"29153",29,153,2006,4461,4253,208,4.7
"29153",29,153,2007,4388,4158,230,5.2
"29153",29,153,2008,4408,4141,267,6.1
"29153",29,153,2009,4504,4138,366,8.1
"29153",29,153,2010,3602,3179,423,11.7
"29153",29,153,2011,3580,3157,423,11.8
"29153",29,153,2012,3595,3230,365,10.2
"29153",29,153,2013,3677,3297,380,10.3
"29153",29,153,2014,3668,3339,329,9
"29153",29,153,2015,3649,3358,291,8
"29153",29,153,2016,3634,3370,264,7.3
"29153",29,153,2017,3527,3319,208,5.9
"29155",29,155,1990,8210,7400,810,9.9
"29155",29,155,1991,8265,7371,894,10.8
"29155",29,155,1992,7934,7016,918,11.6
"29155",29,155,1993,8025,6838,1187,14.8
"29155",29,155,1994,8084,6768,1316,16.3
"29155",29,155,1995,8518,7482,1036,12.2
"29155",29,155,1996,8817,8015,802,9.1
"29155",29,155,1997,9592,8769,823,8.6
"29155",29,155,1998,8660,7859,801,9.2
"29155",29,155,1999,8447,7878,569,6.7
"29155",29,155,2000,8424,7932,492,5.8
"29155",29,155,2001,8486,7857,629,7.4
"29155",29,155,2002,8393,7682,711,8.5
"29155",29,155,2003,8199,7396,803,9.8
"29155",29,155,2004,7964,7266,698,8.8
"29155",29,155,2005,8048,7439,609,7.6
"29155",29,155,2006,8164,7625,539,6.6
"29155",29,155,2007,8130,7594,536,6.6
"29155",29,155,2008,8253,7640,613,7.4
"29155",29,155,2009,8517,7515,1002,11.8
"29155",29,155,2010,7205,6306,899,12.5
"29155",29,155,2011,7193,6355,838,11.7
"29155",29,155,2012,7109,6425,684,9.6
"29155",29,155,2013,7102,6368,734,10.3
"29155",29,155,2014,7104,6443,661,9.3
"29155",29,155,2015,7046,6408,638,9.1
"29155",29,155,2016,7040,6414,626,8.9
"29155",29,155,2017,6474,5984,490,7.6
"29157",29,157,1990,8600,8177,423,4.9
"29157",29,157,1991,9283,8758,525,5.7
"29157",29,157,1992,9527,9070,457,4.8
"29157",29,157,1993,9709,9092,617,6.4
"29157",29,157,1994,9913,9470,443,4.5
"29157",29,157,1995,10296,9863,433,4.2
"29157",29,157,1996,10371,9922,449,4.3
"29157",29,157,1997,10652,10272,380,3.6
"29157",29,157,1998,11129,10832,297,2.7
"29157",29,157,1999,11052,10816,236,2.1
"29157",29,157,2000,10308,10028,280,2.7
"29157",29,157,2001,10363,9972,391,3.8
"29157",29,157,2002,10047,9635,412,4.1
"29157",29,157,2003,10269,9857,412,4
"29157",29,157,2004,10446,10020,426,4.1
"29157",29,157,2005,10434,10016,418,4
"29157",29,157,2006,10506,10140,366,3.5
"29157",29,157,2007,10416,10006,410,3.9
"29157",29,157,2008,10440,9955,485,4.6
"29157",29,157,2009,10593,9846,747,7.1
"29157",29,157,2010,9835,9122,713,7.2
"29157",29,157,2011,9873,9216,657,6.7
"29157",29,157,2012,10008,9495,513,5.1
"29157",29,157,2013,10138,9587,551,5.4
"29157",29,157,2014,10288,9729,559,5.4
"29157",29,157,2015,10213,9783,430,4.2
"29157",29,157,2016,10089,9729,360,3.6
"29157",29,157,2017,9924,9656,268,2.7
"29159",29,159,1990,17908,16635,1273,7.1
"29159",29,159,1991,18210,16847,1363,7.5
"29159",29,159,1992,18530,17050,1480,8
"29159",29,159,1993,19123,17437,1686,8.8
"29159",29,159,1994,19486,18265,1221,6.3
"29159",29,159,1995,20642,19563,1079,5.2
"29159",29,159,1996,21300,20070,1230,5.8
"29159",29,159,1997,22376,21311,1065,4.8
"29159",29,159,1998,22124,21136,988,4.5
"29159",29,159,1999,21924,21080,844,3.8
"29159",29,159,2000,21206,20463,743,3.5
"29159",29,159,2001,21642,20423,1219,5.6
"29159",29,159,2002,20955,19693,1262,6
"29159",29,159,2003,20800,19585,1215,5.8
"29159",29,159,2004,20837,19614,1223,5.9
"29159",29,159,2005,20760,19610,1150,5.5
"29159",29,159,2006,20699,19653,1046,5.1
"29159",29,159,2007,20973,19877,1096,5.2
"29159",29,159,2008,21241,19923,1318,6.2
"29159",29,159,2009,20720,18913,1807,8.7
"29159",29,159,2010,20080,18219,1861,9.3
"29159",29,159,2011,20169,18505,1664,8.3
"29159",29,159,2012,19995,18584,1411,7.1
"29159",29,159,2013,20082,18763,1319,6.6
"29159",29,159,2014,20672,19405,1267,6.1
"29159",29,159,2015,20933,19831,1102,5.3
"29159",29,159,2016,20648,19628,1020,4.9
"29159",29,159,2017,20388,19524,864,4.2
"29161",29,161,1990,17279,16237,1042,6
"29161",29,161,1991,17416,16315,1101,6.3
"29161",29,161,1992,17444,16404,1040,6
"29161",29,161,1993,17697,16520,1177,6.7
"29161",29,161,1994,17959,17173,786,4.4
"29161",29,161,1995,18557,17840,717,3.9
"29161",29,161,1996,19301,18485,816,4.2
"29161",29,161,1997,20026,19210,816,4.1
"29161",29,161,1998,20223,19572,651,3.2
"29161",29,161,1999,20255,19741,514,2.5
"29161",29,161,2000,20170,19447,723,3.6
"29161",29,161,2001,20626,19757,869,4.2
"29161",29,161,2002,21581,20645,936,4.3
"29161",29,161,2003,22304,21316,988,4.4
"29161",29,161,2004,22890,21834,1056,4.6
"29161",29,161,2005,22341,21340,1001,4.5
"29161",29,161,2006,22495,21522,973,4.3
"29161",29,161,2007,21975,20889,1086,4.9
"29161",29,161,2008,22217,20916,1301,5.9
"29161",29,161,2009,22039,20433,1606,7.3
"29161",29,161,2010,19813,18028,1785,9
"29161",29,161,2011,19933,18252,1681,8.4
"29161",29,161,2012,19677,18286,1391,7.1
"29161",29,161,2013,19353,17995,1358,7
"29161",29,161,2014,19451,18194,1257,6.5
"29161",29,161,2015,19574,18533,1041,5.3
"29161",29,161,2016,19527,18599,928,4.8
"29161",29,161,2017,19311,18576,735,3.8
"29163",29,163,1990,7201,6667,534,7.4
"29163",29,163,1991,7143,6593,550,7.7
"29163",29,163,1992,7145,6609,536,7.5
"29163",29,163,1993,7128,6482,646,9.1
"29163",29,163,1994,7324,6805,519,7.1
"29163",29,163,1995,7296,6711,585,8
"29163",29,163,1996,7363,6858,505,6.9
"29163",29,163,1997,7564,7142,422,5.6
"29163",29,163,1998,7979,7574,405,5.1
"29163",29,163,1999,8159,7847,312,3.8
"29163",29,163,2000,8821,8494,327,3.7
"29163",29,163,2001,9075,8631,444,4.9
"29163",29,163,2002,9030,8562,468,5.2
"29163",29,163,2003,8950,8479,471,5.3
"29163",29,163,2004,8984,8489,495,5.5
"29163",29,163,2005,8935,8463,472,5.3
"29163",29,163,2006,8969,8509,460,5.1
"29163",29,163,2007,8885,8438,447,5
"29163",29,163,2008,9208,8680,528,5.7
"29163",29,163,2009,9283,8440,843,9.1
"29163",29,163,2010,8241,7433,808,9.8
"29163",29,163,2011,8208,7524,684,8.3
"29163",29,163,2012,8136,7579,557,6.8
"29163",29,163,2013,8097,7570,527,6.5
"29163",29,163,2014,8152,7689,463,5.7
"29163",29,163,2015,8112,7741,371,4.6
"29163",29,163,2016,8074,7710,364,4.5
"29163",29,163,2017,7829,7556,273,3.5
"29165",29,165,1990,34555,33267,1288,3.7
"29165",29,165,1991,35605,34028,1577,4.4
"29165",29,165,1992,36335,34972,1363,3.8
"29165",29,165,1993,37628,36306,1322,3.5
"29165",29,165,1994,39654,38445,1209,3
"29165",29,165,1995,41342,40173,1169,2.8
"29165",29,165,1996,42143,40990,1153,2.7
"29165",29,165,1997,42690,41561,1129,2.6
"29165",29,165,1998,43537,42459,1078,2.5
"29165",29,165,1999,44294,43446,848,1.9
"29165",29,165,2000,44875,43810,1065,2.4
"29165",29,165,2001,45665,44217,1448,3.2
"29165",29,165,2002,46127,44158,1969,4.3
"29165",29,165,2003,46726,44688,2038,4.4
"29165",29,165,2004,47021,44824,2197,4.7
"29165",29,165,2005,47312,45192,2120,4.5
"29165",29,165,2006,47736,45849,1887,4
"29165",29,165,2007,48683,46764,1919,3.9
"29165",29,165,2008,48640,46299,2341,4.8
"29165",29,165,2009,49871,46031,3840,7.7
"29165",29,165,2010,51580,47591,3989,7.7
"29165",29,165,2011,52035,48433,3602,6.9
"29165",29,165,2012,52486,49603,2883,5.5
"29165",29,165,2013,52743,49755,2988,5.7
"29165",29,165,2014,54025,51265,2760,5.1
"29165",29,165,2015,55457,53127,2330,4.2
"29165",29,165,2016,56764,54709,2055,3.6
"29165",29,165,2017,56864,55058,1806,3.2
"29167",29,167,1990,10000,9334,666,6.7
"29167",29,167,1991,10162,9460,702,6.9
"29167",29,167,1992,10336,9694,642,6.2
"29167",29,167,1993,10542,9911,631,6
"29167",29,167,1994,10908,10441,467,4.3
"29167",29,167,1995,11403,10885,518,4.5
"29167",29,167,1996,11899,11337,562,4.7
"29167",29,167,1997,12342,11799,543,4.4
"29167",29,167,1998,12376,11839,537,4.3
"29167",29,167,1999,12459,12072,387,3.1
"29167",29,167,2000,13079,12656,423,3.2
"29167",29,167,2001,13314,12712,602,4.5
"29167",29,167,2002,13461,12781,680,5.1
"29167",29,167,2003,13775,13044,731,5.3
"29167",29,167,2004,13673,12939,734,5.4
"29167",29,167,2005,13964,13285,679,4.9
"29167",29,167,2006,14309,13677,632,4.4
"29167",29,167,2007,14375,13686,689,4.8
"29167",29,167,2008,14092,13235,857,6.1
"29167",29,167,2009,14171,12758,1413,10
"29167",29,167,2010,14405,12924,1481,10.3
"29167",29,167,2011,14326,12989,1337,9.3
"29167",29,167,2012,14083,12998,1085,7.7
"29167",29,167,2013,13918,12927,991,7.1
"29167",29,167,2014,14123,13227,896,6.3
"29167",29,167,2015,14263,13510,753,5.3
"29167",29,167,2016,14236,13543,693,4.9
"29167",29,167,2017,14117,13555,562,4
"29169",29,169,1990,13061,11741,1320,10.1
"29169",29,169,1991,12986,11897,1089,8.4
"29169",29,169,1992,13028,11740,1288,9.9
"29169",29,169,1993,12672,11294,1378,10.9
"29169",29,169,1994,12241,11259,982,8
"29169",29,169,1995,12375,11496,879,7.1
"29169",29,169,1996,12448,11643,805,6.5
"29169",29,169,1997,12398,11690,708,5.7
"29169",29,169,1998,12342,11645,697,5.6
"29169",29,169,1999,12375,11620,755,6.1
"29169",29,169,2000,15371,14585,786,5.1
"29169",29,169,2001,15787,14890,897,5.7
"29169",29,169,2002,16700,15803,897,5.4
"29169",29,169,2003,17406,16469,937,5.4
"29169",29,169,2004,17620,16604,1016,5.8
"29169",29,169,2005,18145,17186,959,5.3
"29169",29,169,2006,18565,17674,891,4.8
"29169",29,169,2007,18724,17755,969,5.2
"29169",29,169,2008,19672,18544,1128,5.7
"29169",29,169,2009,20861,19370,1491,7.1
"29169",29,169,2010,16707,15240,1467,8.8
"29169",29,169,2011,16671,15222,1449,8.7
"29169",29,169,2012,15884,14591,1293,8.1
"29169",29,169,2013,15626,14387,1239,7.9
"29169",29,169,2014,15233,14129,1104,7.2
"29169",29,169,2015,14895,14025,870,5.8
"29169",29,169,2016,14493,13705,788,5.4
"29169",29,169,2017,14367,13732,635,4.4
"29171",29,171,1990,2045,1970,75,3.7
"29171",29,171,1991,2013,1942,71,3.5
"29171",29,171,1992,1989,1913,76,3.8
"29171",29,171,1993,2034,1954,80,3.9
"29171",29,171,1994,2136,2073,63,2.9
"29171",29,171,1995,2274,2194,80,3.5
"29171",29,171,1996,2330,2227,103,4.4
"29171",29,171,1997,2023,1938,85,4.2
"29171",29,171,1998,1959,1866,93,4.7
"29171",29,171,1999,1981,1916,65,3.3
"29171",29,171,2000,2507,2420,87,3.5
"29171",29,171,2001,2647,2542,105,4
"29171",29,171,2002,2448,2334,114,4.7
"29171",29,171,2003,2528,2380,148,5.9
"29171",29,171,2004,2550,2425,125,4.9
"29171",29,171,2005,2554,2433,121,4.7
"29171",29,171,2006,2557,2431,126,4.9
"29171",29,171,2007,2489,2351,138,5.5
"29171",29,171,2008,2507,2371,136,5.4
"29171",29,171,2009,2495,2313,182,7.3
"29171",29,171,2010,2387,2195,192,8
"29171",29,171,2011,2372,2211,161,6.8
"29171",29,171,2012,2353,2213,140,5.9
"29171",29,171,2013,2450,2305,145,5.9
"29171",29,171,2014,2494,2368,126,5.1
"29171",29,171,2015,2500,2401,99,4
"29171",29,171,2016,2457,2345,112,4.6
"29171",29,171,2017,2405,2312,93,3.9
"29173",29,173,1990,4336,4085,251,5.8
"29173",29,173,1991,4506,4258,248,5.5
"29173",29,173,1992,4621,4387,234,5.1
"29173",29,173,1993,4779,4490,289,6
"29173",29,173,1994,5001,4780,221,4.4
"29173",29,173,1995,5154,4904,250,4.9
"29173",29,173,1996,5268,5033,235,4.5
"29173",29,173,1997,5423,5184,239,4.4
"29173",29,173,1998,5397,5148,249,4.6
"29173",29,173,1999,5534,5333,201,3.6
"29173",29,173,2000,5707,5493,214,3.7
"29173",29,173,2001,5771,5497,274,4.7
"29173",29,173,2002,5672,5373,299,5.3
"29173",29,173,2003,5610,5281,329,5.9
"29173",29,173,2004,5611,5276,335,6
"29173",29,173,2005,5599,5291,308,5.5
"29173",29,173,2006,5636,5360,276,4.9
"29173",29,173,2007,5598,5324,274,4.9
"29173",29,173,2008,5693,5389,304,5.3
"29173",29,173,2009,5602,5111,491,8.8
"29173",29,173,2010,5635,5140,495,8.8
"29173",29,173,2011,5648,5225,423,7.5
"29173",29,173,2012,5631,5271,360,6.4
"29173",29,173,2013,5605,5280,325,5.8
"29173",29,173,2014,5644,5346,298,5.3
"29173",29,173,2015,5673,5433,240,4.2
"29173",29,173,2016,5632,5406,226,4
"29173",29,173,2017,5520,5344,176,3.2
"29175",29,175,1990,10621,10058,563,5.3
"29175",29,175,1991,10392,9501,891,8.6
"29175",29,175,1992,10254,9503,751,7.3
"29175",29,175,1993,10475,9516,959,9.2
"29175",29,175,1994,10454,9749,705,6.7
"29175",29,175,1995,10689,10013,676,6.3
"29175",29,175,1996,10707,10084,623,5.8
"29175",29,175,1997,10783,10152,631,5.9
"29175",29,175,1998,10799,10208,591,5.5
"29175",29,175,1999,11108,10675,433,3.9
"29175",29,175,2000,12327,11839,488,4
"29175",29,175,2001,12396,11751,645,5.2
"29175",29,175,2002,12870,12184,686,5.3
"29175",29,175,2003,13070,12362,708,5.4
"29175",29,175,2004,12991,12277,714,5.5
"29175",29,175,2005,13091,12426,665,5.1
"29175",29,175,2006,13189,12543,646,4.9
"29175",29,175,2007,13122,12418,704,5.4
"29175",29,175,2008,13226,12420,806,6.1
"29175",29,175,2009,13209,11806,1403,10.6
"29175",29,175,2010,10792,9547,1245,11.5
"29175",29,175,2011,10817,9682,1135,10.5
"29175",29,175,2012,10673,9744,929,8.7
"29175",29,175,2013,10533,9672,861,8.2
"29175",29,175,2014,10573,9828,745,7
"29175",29,175,2015,10508,9878,630,6
"29175",29,175,2016,10505,9953,552,5.3
"29175",29,175,2017,10083,9619,464,4.6
"29177",29,177,1990,10428,9654,774,7.4
"29177",29,177,1991,10418,9594,824,7.9
"29177",29,177,1992,10103,9499,604,6
"29177",29,177,1993,10383,9742,641,6.2
"29177",29,177,1994,10561,10010,551,5.2
"29177",29,177,1995,10875,10381,494,4.5
"29177",29,177,1996,11135,10611,524,4.7
"29177",29,177,1997,11389,10816,573,5
"29177",29,177,1998,11547,11022,525,4.5
"29177",29,177,1999,11515,11056,459,4
"29177",29,177,2000,12054,11599,455,3.8
"29177",29,177,2001,11989,11485,504,4.2
"29177",29,177,2002,11898,11318,580,4.9
"29177",29,177,2003,11990,11318,672,5.6
"29177",29,177,2004,11933,11174,759,6.4
"29177",29,177,2005,11787,11145,642,5.4
"29177",29,177,2006,11737,11127,610,5.2
"29177",29,177,2007,11477,10866,611,5.3
"29177",29,177,2008,11336,10615,721,6.4
"29177",29,177,2009,11069,9959,1110,10
"29177",29,177,2010,11572,10383,1189,10.3
"29177",29,177,2011,11438,10376,1062,9.3
"29177",29,177,2012,11313,10383,930,8.2
"29177",29,177,2013,11131,10271,860,7.7
"29177",29,177,2014,11141,10383,758,6.8
"29177",29,177,2015,11167,10556,611,5.5
"29177",29,177,2016,11158,10609,549,4.9
"29177",29,177,2017,11205,10672,533,4.8
"29179",29,179,1990,2705,2507,198,7.3
"29179",29,179,1991,2832,2585,247,8.7
"29179",29,179,1992,2895,2629,266,9.2
"29179",29,179,1993,3079,2793,286,9.3
"29179",29,179,1994,3244,3040,204,6.3
"29179",29,179,1995,3304,3120,184,5.6
"29179",29,179,1996,3296,3096,200,6.1
"29179",29,179,1997,3429,3255,174,5.1
"29179",29,179,1998,3363,3193,170,5.1
"29179",29,179,1999,3230,3087,143,4.4
"29179",29,179,2000,2805,2597,208,7.4
"29179",29,179,2001,2679,2469,210,7.8
"29179",29,179,2002,2553,2343,210,8.2
"29179",29,179,2003,2638,2411,227,8.6
"29179",29,179,2004,2737,2512,225,8.2
"29179",29,179,2005,2592,2390,202,7.8
"29179",29,179,2006,2552,2379,173,6.8
"29179",29,179,2007,2635,2454,181,6.9
"29179",29,179,2008,2688,2491,197,7.3
"29179",29,179,2009,2815,2447,368,13.1
"29179",29,179,2010,2383,2023,360,15.1
"29179",29,179,2011,2319,2013,306,13.2
"29179",29,179,2012,2268,2020,248,10.9
"29179",29,179,2013,2522,2284,238,9.4
"29179",29,179,2014,2693,2469,224,8.3
"29179",29,179,2015,2714,2524,190,7
"29179",29,179,2016,2686,2512,174,6.5
"29179",29,179,2017,3056,2932,124,4.1
"29181",29,181,1990,4219,3909,310,7.3
"29181",29,181,1991,4369,3944,425,9.7
"29181",29,181,1992,4469,4031,438,9.8
"29181",29,181,1993,4760,4214,546,11.5
"29181",29,181,1994,4954,4520,434,8.8
"29181",29,181,1995,5328,4820,508,9.5
"29181",29,181,1996,5411,4933,478,8.8
"29181",29,181,1997,5483,5136,347,6.3
"29181",29,181,1998,5475,5204,271,4.9
"29181",29,181,1999,5464,5228,236,4.3
"29181",29,181,2000,5819,5514,305,5.2
"29181",29,181,2001,6260,5871,389,6.2
"29181",29,181,2002,6113,5722,391,6.4
"29181",29,181,2003,6356,5939,417,6.6
"29181",29,181,2004,6525,6114,411,6.3
"29181",29,181,2005,6602,6209,393,6
"29181",29,181,2006,6654,6274,380,5.7
"29181",29,181,2007,6645,6202,443,6.7
"29181",29,181,2008,6730,6276,454,6.7
"29181",29,181,2009,6771,6134,637,9.4
"29181",29,181,2010,5395,4700,695,12.9
"29181",29,181,2011,5487,4831,656,12
"29181",29,181,2012,5511,4935,576,10.5
"29181",29,181,2013,5554,5040,514,9.3
"29181",29,181,2014,5571,5114,457,8.2
"29181",29,181,2015,5327,4903,424,8
"29181",29,181,2016,5342,4964,378,7.1
"29181",29,181,2017,5134,4840,294,5.7
"29183",29,183,1990,122632,116895,5737,4.7
"29183",29,183,1991,126027,118525,7502,6
"29183",29,183,1992,127404,120689,6715,5.3
"29183",29,183,1993,131511,124907,6604,5
"29183",29,183,1994,137799,132556,5243,3.8
"29183",29,183,1995,145683,140931,4752,3.3
"29183",29,183,1996,151046,146435,4611,3.1
"29183",29,183,1997,152670,148516,4154,2.7
"29183",29,183,1998,156993,152577,4416,2.8
"29183",29,183,1999,160352,157056,3296,2.1
"29183",29,183,2000,165907,161544,4363,2.6
"29183",29,183,2001,171694,165610,6084,3.5
"29183",29,183,2002,176480,169069,7411,4.2
"29183",29,183,2003,180237,172350,7887,4.4
"29183",29,183,2004,182414,174103,8311,4.6
"29183",29,183,2005,186254,178363,7891,4.2
"29183",29,183,2006,190749,183305,7444,3.9
"29183",29,183,2007,192549,184674,7875,4.1
"29183",29,183,2008,193994,183405,10589,5.5
"29183",29,183,2009,196052,179357,16695,8.5
"29183",29,183,2010,205228,188398,16830,8.2
"29183",29,183,2011,206298,192073,14225,6.9
"29183",29,183,2012,205708,194204,11504,5.6
"29183",29,183,2013,207053,196045,11008,5.3
"29183",29,183,2014,212318,202090,10228,4.8
"29183",29,183,2015,217666,209291,8375,3.8
"29183",29,183,2016,221367,213590,7777,3.5
"29183",29,183,2017,219820,213516,6304,2.9
"29185",29,185,1990,3654,3367,287,7.9
"29185",29,185,1991,3569,3311,258,7.2
"29185",29,185,1992,3590,3307,283,7.9
"29185",29,185,1993,3708,3440,268,7.2
"29185",29,185,1994,3699,3457,242,6.5
"29185",29,185,1995,3984,3721,263,6.6
"29185",29,185,1996,4134,3850,284,6.9
"29185",29,185,1997,4002,3755,247,6.2
"29185",29,185,1998,3926,3727,199,5.1
"29185",29,185,1999,3900,3740,160,4.1
"29185",29,185,2000,4455,4272,183,4.1
"29185",29,185,2001,4621,4378,243,5.3
"29185",29,185,2002,4531,4260,271,6
"29185",29,185,2003,4595,4275,320,7
"29185",29,185,2004,4536,4235,301,6.6
"29185",29,185,2005,4327,4070,257,5.9
"29185",29,185,2006,4373,4127,246,5.6
"29185",29,185,2007,4224,3948,276,6.5
"29185",29,185,2008,4252,3951,301,7.1
"29185",29,185,2009,4248,3832,416,9.8
"29185",29,185,2010,4136,3672,464,11.2
"29185",29,185,2011,4023,3617,406,10.1
"29185",29,185,2012,3918,3608,310,7.9
"29185",29,185,2013,3918,3614,304,7.8
"29185",29,185,2014,3991,3685,306,7.7
"29185",29,185,2015,3980,3703,277,7
"29185",29,185,2016,3921,3675,246,6.3
"29185",29,185,2017,3789,3592,197,5.2
"29186",29,186,1990,7956,7512,444,5.6
"29186",29,186,1991,7981,7394,587,7.4
"29186",29,186,1992,8252,7722,530,6.4
"29186",29,186,1993,8417,7749,668,7.9
"29186",29,186,1994,8769,8303,466,5.3
"29186",29,186,1995,9155,8697,458,5
"29186",29,186,1996,8891,8429,462,5.2
"29186",29,186,1997,9180,8792,388,4.2
"29186",29,186,1998,9128,8753,375,4.1
"29186",29,186,1999,8950,8654,296,3.3
"29186",29,186,2000,9626,9303,323,3.4
"29186",29,186,2001,9681,9232,449,4.6
"29186",29,186,2002,9525,9025,500,5.2
"29186",29,186,2003,9645,9148,497,5.2
"29186",29,186,2004,9449,8912,537,5.7
"29186",29,186,2005,9533,9024,509,5.3
"29186",29,186,2006,9860,9407,453,4.6
"29186",29,186,2007,9932,9468,464,4.7
"29186",29,186,2008,10080,9486,594,5.9
"29186",29,186,2009,10107,9157,950,9.4
"29186",29,186,2010,9404,8436,968,10.3
"29186",29,186,2011,9316,8454,862,9.3
"29186",29,186,2012,9034,8375,659,7.3
"29186",29,186,2013,9020,8370,650,7.2
"29186",29,186,2014,9083,8482,601,6.6
"29186",29,186,2015,9064,8580,484,5.3
"29186",29,186,2016,8999,8580,419,4.7
"29186",29,186,2017,8944,8617,327,3.7
"29187",29,187,1990,20486,18430,2056,10
"29187",29,187,1991,20740,18391,2349,11.3
"29187",29,187,1992,20714,18542,2172,10.5
"29187",29,187,1993,21369,18739,2630,12.3
"29187",29,187,1994,21952,19762,2190,10
"29187",29,187,1995,23104,21346,1758,7.6
"29187",29,187,1996,23953,22122,1831,7.6
"29187",29,187,1997,25226,23559,1667,6.6
"29187",29,187,1998,25816,24221,1595,6.2
"29187",29,187,1999,24857,23433,1424,5.7
"29187",29,187,2000,25992,24486,1506,5.8
"29187",29,187,2001,26634,24959,1675,6.3
"29187",29,187,2002,26904,25060,1844,6.9
"29187",29,187,2003,27693,25846,1847,6.7
"29187",29,187,2004,28022,26027,1995,7.1
"29187",29,187,2005,28033,26172,1861,6.6
"29187",29,187,2006,28365,26702,1663,5.9
"29187",29,187,2007,29341,27628,1713,5.8
"29187",29,187,2008,30146,28012,2134,7.1
"29187",29,187,2009,30517,27156,3361,11
"29187",29,187,2010,27272,23931,3341,12.3
"29187",29,187,2011,26794,23899,2895,10.8
"29187",29,187,2012,26004,23694,2310,8.9
"29187",29,187,2013,26293,24046,2247,8.5
"29187",29,187,2014,26333,24325,2008,7.6
"29187",29,187,2015,26416,24808,1608,6.1
"29187",29,187,2016,26268,24819,1449,5.5
"29187",29,187,2017,26250,25087,1163,4.4
"29189",29,189,1990,548298,524237,24061,4.4
"29189",29,189,1991,549791,520870,28921,5.3
"29189",29,189,1992,543770,517556,26214,4.8
"29189",29,189,1993,543345,518791,24554,4.5
"29189",29,189,1994,559300,538237,21063,3.8
"29189",29,189,1995,572371,551824,20547,3.6
"29189",29,189,1996,576847,555999,20848,3.6
"29189",29,189,1997,562930,544905,18025,3.2
"29189",29,189,1998,559055,540778,18277,3.3
"29189",29,189,1999,554505,539455,15050,2.7
"29189",29,189,2000,554013,536744,17269,3.1
"29189",29,189,2001,556592,533966,22626,4.1
"29189",29,189,2002,556350,528985,27365,4.9
"29189",29,189,2003,552250,523010,29240,5.3
"29189",29,189,2004,542856,512256,30600,5.6
"29189",29,189,2005,535866,508163,27703,5.2
"29189",29,189,2006,531639,506604,25035,4.7
"29189",29,189,2007,526028,499911,26117,5
"29189",29,189,2008,518471,487113,31358,6
"29189",29,189,2009,514851,468644,46207,9
"29189",29,189,2010,535129,487371,47758,8.9
"29189",29,189,2011,534224,492327,41897,7.8
"29189",29,189,2012,527539,493385,34154,6.5
"29189",29,189,2013,524367,491621,32746,6.2
"29189",29,189,2014,529604,498809,30795,5.8
"29189",29,189,2015,533812,509108,24704,4.6
"29189",29,189,2016,532225,509783,22442,4.2
"29189",29,189,2017,527507,509429,18078,3.4
"29195",29,195,1990,11568,10709,859,7.4
"29195",29,195,1991,11189,10400,789,7.1
"29195",29,195,1992,10785,9962,823,7.6
"29195",29,195,1993,11202,10463,739,6.6
"29195",29,195,1994,11738,11189,549,4.7
"29195",29,195,1995,12323,11811,512,4.2
"29195",29,195,1996,12528,11973,555,4.4
"29195",29,195,1997,12742,12192,550,4.3
"29195",29,195,1998,12197,11776,421,3.5
"29195",29,195,1999,12096,11784,312,2.6
"29195",29,195,2000,12869,12480,389,3
"29195",29,195,2001,12729,12107,622,4.9
"29195",29,195,2002,11947,11259,688,5.8
"29195",29,195,2003,12122,11476,646,5.3
"29195",29,195,2004,12007,11382,625,5.2
"29195",29,195,2005,12049,11453,596,4.9
"29195",29,195,2006,11984,11439,545,4.5
"29195",29,195,2007,11701,11110,591,5.1
"29195",29,195,2008,11475,10819,656,5.7
"29195",29,195,2009,11858,10935,923,7.8
"29195",29,195,2010,10980,10004,976,8.9
"29195",29,195,2011,11121,10231,890,8
"29195",29,195,2012,11030,10302,728,6.6
"29195",29,195,2013,11092,10428,664,6
"29195",29,195,2014,11250,10619,631,5.6
"29195",29,195,2015,11057,10523,534,4.8
"29195",29,195,2016,10751,10248,503,4.7
"29195",29,195,2017,10445,10063,382,3.7
"29197",29,197,1990,2115,1995,120,5.7
"29197",29,197,1991,2117,1999,118,5.6
"29197",29,197,1992,2206,2110,96,4.4
"29197",29,197,1993,2288,2131,157,6.9
"29197",29,197,1994,2356,2247,109,4.6
"29197",29,197,1995,2511,2395,116,4.6
"29197",29,197,1996,2582,2451,131,5.1
"29197",29,197,1997,2619,2502,117,4.5
"29197",29,197,1998,2487,2386,101,4.1
"29197",29,197,1999,2420,2339,81,3.3
"29197",29,197,2000,2217,2117,100,4.5
"29197",29,197,2001,2243,2117,126,5.6
"29197",29,197,2002,2196,2071,125,5.7
"29197",29,197,2003,2239,2097,142,6.3
"29197",29,197,2004,2223,2086,137,6.2
"29197",29,197,2005,2285,2150,135,5.9
"29197",29,197,2006,2308,2188,120,5.2
"29197",29,197,2007,2165,2041,124,5.7
"29197",29,197,2008,2164,2025,139,6.4
"29197",29,197,2009,2171,1998,173,8
"29197",29,197,2010,1960,1757,203,10.4
"29197",29,197,2011,1908,1734,174,9.1
"29197",29,197,2012,1891,1752,139,7.4
"29197",29,197,2013,1902,1753,149,7.8
"29197",29,197,2014,1891,1751,140,7.4
"29197",29,197,2015,1909,1798,111,5.8
"29197",29,197,2016,1909,1787,122,6.4
"29197",29,197,2017,1873,1780,93,5
"29199",29,199,1990,2157,2094,63,2.9
"29199",29,199,1991,2217,2146,71,3.2
"29199",29,199,1992,2310,2228,82,3.5
"29199",29,199,1993,2290,2193,97,4.2
"29199",29,199,1994,2297,2230,67,2.9
"29199",29,199,1995,2282,2178,104,4.6
"29199",29,199,1996,2247,2128,119,5.3
"29199",29,199,1997,2281,2204,77,3.4
"29199",29,199,1998,2150,2071,79,3.7
"29199",29,199,1999,2222,2159,63,2.8
"29199",29,199,2000,2623,2543,80,3
"29199",29,199,2001,2732,2629,103,3.8
"29199",29,199,2002,2514,2401,113,4.5
"29199",29,199,2003,2459,2351,108,4.4
"29199",29,199,2004,2491,2388,103,4.1
"29199",29,199,2005,2460,2363,97,3.9
"29199",29,199,2006,2481,2375,106,4.3
"29199",29,199,2007,2512,2392,120,4.8
"29199",29,199,2008,2553,2384,169,6.6
"29199",29,199,2009,2494,2296,198,7.9
"29199",29,199,2010,2306,2120,186,8.1
"29199",29,199,2011,2332,2178,154,6.6
"29199",29,199,2012,2347,2229,118,5
"29199",29,199,2013,2375,2248,127,5.3
"29199",29,199,2014,2395,2280,115,4.8
"29199",29,199,2015,2452,2341,111,4.5
"29199",29,199,2016,2458,2356,102,4.1
"29199",29,199,2017,2410,2333,77,3.2
"29201",29,201,1990,18845,17506,1339,7.1
"29201",29,201,1991,18754,17162,1592,8.5
"29201",29,201,1992,18745,17266,1479,7.9
"29201",29,201,1993,19021,17500,1521,8
"29201",29,201,1994,19448,18257,1191,6.1
"29201",29,201,1995,20011,18828,1183,5.9
"29201",29,201,1996,20286,18877,1409,6.9
"29201",29,201,1997,20851,19640,1211,5.8
"29201",29,201,1998,20436,19396,1040,5.1
"29201",29,201,1999,20628,19798,830,4
"29201",29,201,2000,21035,20086,949,4.5
"29201",29,201,2001,20968,19819,1149,5.5
"29201",29,201,2002,20847,19683,1164,5.6
"29201",29,201,2003,20989,19799,1190,5.7
"29201",29,201,2004,20968,19697,1271,6.1
"29201",29,201,2005,20414,19251,1163,5.7
"29201",29,201,2006,20503,19422,1081,5.3
"29201",29,201,2007,19933,18768,1165,5.8
"29201",29,201,2008,19859,18554,1305,6.6
"29201",29,201,2009,20414,18603,1811,8.9
"29201",29,201,2010,19006,17161,1845,9.7
"29201",29,201,2011,19679,17950,1729,8.8
"29201",29,201,2012,19858,18474,1384,7
"29201",29,201,2013,19825,18412,1413,7.1
"29201",29,201,2014,19885,18578,1307,6.6
"29201",29,201,2015,20057,19007,1050,5.2
"29201",29,201,2016,19994,18848,1146,5.7
"29201",29,201,2017,19781,18885,896,4.5
"29203",29,203,1990,3475,3130,345,9.9
"29203",29,203,1991,3571,3212,359,10.1
"29203",29,203,1992,3673,3337,336,9.1
"29203",29,203,1993,3784,3434,350,9.2
"29203",29,203,1994,3897,3621,276,7.1
"29203",29,203,1995,3988,3708,280,7
"29203",29,203,1996,3965,3683,282,7.1
"29203",29,203,1997,4217,3878,339,8
"29203",29,203,1998,4126,3864,262,6.3
"29203",29,203,1999,4042,3835,207,5.1
"29203",29,203,2000,3891,3673,218,5.6
"29203",29,203,2001,4074,3808,266,6.5
"29203",29,203,2002,4038,3764,274,6.8
"29203",29,203,2003,4114,3797,317,7.7
"29203",29,203,2004,4029,3685,344,8.5
"29203",29,203,2005,3810,3530,280,7.3
"29203",29,203,2006,3765,3519,246,6.5
"29203",29,203,2007,3716,3461,255,6.9
"29203",29,203,2008,3726,3433,293,7.9
"29203",29,203,2009,3753,3297,456,12.2
"29203",29,203,2010,3243,2762,481,14.8
"29203",29,203,2011,3134,2722,412,13.1
"29203",29,203,2012,3062,2725,337,11
"29203",29,203,2013,3368,3047,321,9.5
"29203",29,203,2014,3429,3108,321,9.4
"29203",29,203,2015,3338,3066,272,8.1
"29203",29,203,2016,3330,3085,245,7.4
"29203",29,203,2017,3199,3002,197,6.2
"29205",29,205,1990,3150,3017,133,4.2
"29205",29,205,1991,3169,3016,153,4.8
"29205",29,205,1992,3221,3058,163,5.1
"29205",29,205,1993,3220,3006,214,6.6
"29205",29,205,1994,3459,3317,142,4.1
"29205",29,205,1995,3624,3464,160,4.4
"29205",29,205,1996,3719,3585,134,3.6
"29205",29,205,1997,3782,3636,146,3.9
"29205",29,205,1998,3543,3396,147,4.1
"29205",29,205,1999,3493,3298,195,5.6
"29205",29,205,2000,3728,3548,180,4.8
"29205",29,205,2001,3689,3487,202,5.5
"29205",29,205,2002,3250,3070,180,5.5
"29205",29,205,2003,3263,3079,184,5.6
"29205",29,205,2004,3236,3048,188,5.8
"29205",29,205,2005,3205,3038,167,5.2
"29205",29,205,2006,3236,3068,168,5.2
"29205",29,205,2007,3320,3154,166,5
"29205",29,205,2008,3322,3146,176,5.3
"29205",29,205,2009,3303,3011,292,8.8
"29205",29,205,2010,3241,2962,279,8.6
"29205",29,205,2011,3205,2975,230,7.2
"29205",29,205,2012,3126,2938,188,6
"29205",29,205,2013,3062,2891,171,5.6
"29205",29,205,2014,3060,2876,184,6
"29205",29,205,2015,3078,2933,145,4.7
"29205",29,205,2016,3074,2945,129,4.2
"29205",29,205,2017,3047,2941,106,3.5
"29207",29,207,1990,13040,11889,1151,8.8
"29207",29,207,1991,13435,12118,1317,9.8
"29207",29,207,1992,13088,11648,1440,11
"29207",29,207,1993,13228,11776,1452,11
"29207",29,207,1994,13418,12284,1134,8.5
"29207",29,207,1995,14077,12869,1208,8.6
"29207",29,207,1996,14557,13022,1535,10.5
"29207",29,207,1997,14373,13077,1296,9
"29207",29,207,1998,13434,12433,1001,7.5
"29207",29,207,1999,13365,12734,631,4.7
"29207",29,207,2000,15092,14430,662,4.4
"29207",29,207,2001,15456,14554,902,5.8
"29207",29,207,2002,15373,14434,939,6.1
"29207",29,207,2003,15598,14649,949,6.1
"29207",29,207,2004,16010,15047,963,6
"29207",29,207,2005,15970,15051,919,5.8
"29207",29,207,2006,15893,15000,893,5.6
"29207",29,207,2007,15519,14525,994,6.4
"29207",29,207,2008,15408,14246,1162,7.5
"29207",29,207,2009,15183,13735,1448,9.5
"29207",29,207,2010,13607,12186,1421,10.4
"29207",29,207,2011,13700,12326,1374,10
"29207",29,207,2012,13488,12319,1169,8.7
"29207",29,207,2013,13229,12060,1169,8.8
"29207",29,207,2014,13161,12134,1027,7.8
"29207",29,207,2015,13238,12362,876,6.6
"29207",29,207,2016,13316,12461,855,6.4
"29207",29,207,2017,12992,12325,667,5.1
"29209",29,209,1990,9398,8515,883,9.4
"29209",29,209,1991,9771,8761,1010,10.3
"29209",29,209,1992,11461,10374,1087,9.5
"29209",29,209,1993,12842,11411,1431,11.1
"29209",29,209,1994,13833,12532,1301,9.4
"29209",29,209,1995,13825,12307,1518,11
"29209",29,209,1996,14290,12614,1676,11.7
"29209",29,209,1997,13836,12090,1746,12.6
"29209",29,209,1998,14053,12458,1595,11.3
"29209",29,209,1999,13923,12844,1079,7.7
"29209",29,209,2000,14888,13938,950,6.4
"29209",29,209,2001,15281,14096,1185,7.8
"29209",29,209,2002,15479,14152,1327,8.6
"29209",29,209,2003,15896,14572,1324,8.3
"29209",29,209,2004,15868,14517,1351,8.5
"29209",29,209,2005,15855,14591,1264,8
"29209",29,209,2006,16373,15281,1092,6.7
"29209",29,209,2007,16361,15309,1052,6.4
"29209",29,209,2008,16531,15241,1290,7.8
"29209",29,209,2009,16074,14137,1937,12.1
"29209",29,209,2010,14494,12492,2002,13.8
"29209",29,209,2011,14181,12399,1782,12.6
"29209",29,209,2012,13690,12164,1526,11.1
"29209",29,209,2013,13598,12169,1429,10.5
"29209",29,209,2014,13324,12037,1287,9.7
"29209",29,209,2015,13373,12318,1055,7.9
"29209",29,209,2016,13441,12501,940,7
"29209",29,209,2017,13474,12719,755,5.6
"29211",29,211,1990,2774,2673,101,3.6
"29211",29,211,1991,2830,2729,101,3.6
"29211",29,211,1992,2824,2718,106,3.8
"29211",29,211,1993,2704,2560,144,5.3
"29211",29,211,1994,3088,2960,128,4.1
"29211",29,211,1995,3400,3249,151,4.4
"29211",29,211,1996,3512,3358,154,4.4
"29211",29,211,1997,4193,4054,139,3.3
"29211",29,211,1998,4136,4022,114,2.8
"29211",29,211,1999,4053,3974,79,1.9
"29211",29,211,2000,3766,3647,119,3.2
"29211",29,211,2001,4034,3865,169,4.2
"29211",29,211,2002,3683,3496,187,5.1
"29211",29,211,2003,3349,3006,343,10.2
"29211",29,211,2004,3268,3052,216,6.6
"29211",29,211,2005,3228,3048,180,5.6
"29211",29,211,2006,3372,3188,184,5.5
"29211",29,211,2007,3294,3091,203,6.2
"29211",29,211,2008,3510,3308,202,5.8
"29211",29,211,2009,3625,3380,245,6.8
"29211",29,211,2010,2937,2678,259,8.8
"29211",29,211,2011,2837,2600,237,8.4
"29211",29,211,2012,2780,2590,190,6.8
"29211",29,211,2013,2716,2540,176,6.5
"29211",29,211,2014,2742,2562,180,6.6
"29211",29,211,2015,2780,2614,166,6
"29211",29,211,2016,2774,2614,160,5.8
"29211",29,211,2017,2710,2598,112,4.1
"29213",29,213,1990,14748,13196,1552,10.5
"29213",29,213,1991,15684,14015,1669,10.6
"29213",29,213,1992,18799,16985,1814,9.6
"29213",29,213,1993,24144,21943,2201,9.1
"29213",29,213,1994,25462,23428,2034,8
"29213",29,213,1995,27071,24710,2361,8.7
"29213",29,213,1996,27889,25212,2677,9.6
"29213",29,213,1997,29588,26834,2754,9.3
"29213",29,213,1998,30265,27628,2637,8.7
"29213",29,213,1999,29970,28134,1836,6.1
"29213",29,213,2000,23894,22254,1640,6.9
"29213",29,213,2001,24576,22500,2076,8.4
"29213",29,213,2002,24724,22479,2245,9.1
"29213",29,213,2003,25201,22986,2215,8.8
"29213",29,213,2004,25159,22857,2302,9.1
"29213",29,213,2005,25541,23309,2232,8.7
"29213",29,213,2006,26325,24500,1825,6.9
"29213",29,213,2007,27358,25500,1858,6.8
"29213",29,213,2008,28290,26111,2179,7.7
"29213",29,213,2009,28222,24836,3386,12
"29213",29,213,2010,26075,22447,3628,13.9
"29213",29,213,2011,26143,22699,3444,13.2
"29213",29,213,2012,25475,22601,2874,11.3
"29213",29,213,2013,25840,23086,2754,10.7
"29213",29,213,2014,25757,23241,2516,9.8
"29213",29,213,2015,26177,24063,2114,8.1
"29213",29,213,2016,26355,24406,1949,7.4
"29213",29,213,2017,26488,24877,1611,6.1
"29215",29,215,1990,9474,8601,873,9.2
"29215",29,215,1991,9525,8594,931,9.8
"29215",29,215,1992,9193,8206,987,10.7
"29215",29,215,1993,9924,8338,1586,16
"29215",29,215,1994,9746,8613,1133,11.6
"29215",29,215,1995,9675,8764,911,9.4
"29215",29,215,1996,9878,8702,1176,11.9
"29215",29,215,1997,9806,8955,851,8.7
"29215",29,215,1998,9351,8581,770,8.2
"29215",29,215,1999,9139,8362,777,8.5
"29215",29,215,2000,10857,10290,567,5.2
"29215",29,215,2001,11426,10757,669,5.9
"29215",29,215,2002,10872,10164,708,6.5
"29215",29,215,2003,10911,10130,781,7.2
"29215",29,215,2004,10957,10191,766,7
"29215",29,215,2005,10747,10058,689,6.4
"29215",29,215,2006,10723,10145,578,5.4
"29215",29,215,2007,11013,10387,626,5.7
"29215",29,215,2008,11182,10405,777,6.9
"29215",29,215,2009,11160,10133,1027,9.2
"29215",29,215,2010,9841,8758,1083,11
"29215",29,215,2011,9767,8817,950,9.7
"29215",29,215,2012,9649,8859,790,8.2
"29215",29,215,2013,9707,8912,795,8.2
"29215",29,215,2014,9441,8696,745,7.9
"29215",29,215,2015,9409,8783,626,6.7
"29215",29,215,2016,9333,8748,585,6.3
"29215",29,215,2017,9251,8789,462,5
"29217",29,217,1990,8745,8306,439,5
"29217",29,217,1991,8747,8274,473,5.4
"29217",29,217,1992,8365,7899,466,5.6
"29217",29,217,1993,8441,7991,450,5.3
"29217",29,217,1994,8598,8246,352,4.1
"29217",29,217,1995,9097,8700,397,4.4
"29217",29,217,1996,9294,8851,443,4.8
"29217",29,217,1997,9448,9002,446,4.7
"29217",29,217,1998,9230,8865,365,4
"29217",29,217,1999,9101,8844,257,2.8
"29217",29,217,2000,10544,10230,314,3
"29217",29,217,2001,10785,10380,405,3.8
"29217",29,217,2002,10516,9984,532,5.1
"29217",29,217,2003,10505,9992,513,4.9
"29217",29,217,2004,10384,9828,556,5.4
"29217",29,217,2005,10143,9654,489,4.8
"29217",29,217,2006,10176,9730,446,4.4
"29217",29,217,2007,10077,9584,493,4.9
"29217",29,217,2008,9999,9437,562,5.6
"29217",29,217,2009,9358,8626,732,7.8
"29217",29,217,2010,9572,8781,791,8.3
"29217",29,217,2011,9598,8904,694,7.2
"29217",29,217,2012,9622,9059,563,5.9
"29217",29,217,2013,9780,9202,578,5.9
"29217",29,217,2014,9841,9287,554,5.6
"29217",29,217,2015,9823,9324,499,5.1
"29217",29,217,2016,9618,9151,467,4.9
"29217",29,217,2017,9498,9130,368,3.9
"29219",29,219,1990,10039,9300,739,7.4
"29219",29,219,1991,10279,9478,801,7.8
"29219",29,219,1992,10399,9632,767,7.4
"29219",29,219,1993,10645,9911,734,6.9
"29219",29,219,1994,11120,10484,636,5.7
"29219",29,219,1995,11631,11110,521,4.5
"29219",29,219,1996,11973,11402,571,4.8
"29219",29,219,1997,12142,11573,569,4.7
"29219",29,219,1998,12519,11939,580,4.6
"29219",29,219,1999,12796,12373,423,3.3
"29219",29,219,2000,13506,13039,467,3.5
"29219",29,219,2001,13973,13304,669,4.8
"29219",29,219,2002,14371,13609,762,5.3
"29219",29,219,2003,14763,13925,838,5.7
"29219",29,219,2004,14953,14117,836,5.6
"29219",29,219,2005,15347,14523,824,5.4
"29219",29,219,2006,15848,15004,844,5.3
"29219",29,219,2007,16150,15278,872,5.4
"29219",29,219,2008,16538,15302,1236,7.5
"29219",29,219,2009,16736,14841,1895,11.3
"29219",29,219,2010,17262,15364,1898,11
"29219",29,219,2011,17114,15559,1555,9.1
"29219",29,219,2012,16945,15678,1267,7.5
"29219",29,219,2013,16865,15713,1152,6.8
"29219",29,219,2014,17124,16071,1053,6.1
"29219",29,219,2015,17350,16520,830,4.8
"29219",29,219,2016,17516,16783,733,4.2
"29219",29,219,2017,17326,16771,555,3.2
"29221",29,221,1990,8160,7077,1083,13.3
"29221",29,221,1991,8288,7026,1262,15.2
"29221",29,221,1992,8213,7080,1133,13.8
"29221",29,221,1993,8387,7152,1235,14.7
"29221",29,221,1994,8591,7523,1068,12.4
"29221",29,221,1995,8979,8093,886,9.9
"29221",29,221,1996,9374,8400,974,10.4
"29221",29,221,1997,9835,8993,842,8.6
"29221",29,221,1998,10064,9269,795,7.9
"29221",29,221,1999,9707,9018,689,7.1
"29221",29,221,2000,9910,9300,610,6.2
"29221",29,221,2001,9988,9266,722,7.2
"29221",29,221,2002,10132,9268,864,8.5
"29221",29,221,2003,10085,9249,836,8.3
"29221",29,221,2004,10023,9139,884,8.8
"29221",29,221,2005,10006,9134,872,8.7
"29221",29,221,2006,10004,9201,803,8
"29221",29,221,2007,10006,9179,827,8.3
"29221",29,221,2008,10094,9060,1034,10.2
"29221",29,221,2009,10095,8660,1435,14.2
"29221",29,221,2010,10256,8787,1469,14.3
"29221",29,221,2011,10139,8901,1238,12.2
"29221",29,221,2012,9981,8924,1057,10.6
"29221",29,221,2013,10473,9454,1019,9.7
"29221",29,221,2014,10473,9578,895,8.5
"29221",29,221,2015,10528,9820,708,6.7
"29221",29,221,2016,10353,9696,657,6.3
"29221",29,221,2017,10155,9601,554,5.5
"29223",29,223,1990,4568,4033,535,11.7
"29223",29,223,1991,4339,3675,664,15.3
"29223",29,223,1992,4164,3501,663,15.9
"29223",29,223,1993,4117,3230,887,21.5
"29223",29,223,1994,3928,3032,896,22.8
"29223",29,223,1995,3861,3172,689,17.8
"29223",29,223,1996,3757,3232,525,14
"29223",29,223,1997,3593,3185,408,11.4
"29223",29,223,1998,3485,3128,357,10.2
"29223",29,223,1999,3482,3217,265,7.6
"29223",29,223,2000,5498,5190,308,5.6
"29223",29,223,2001,5625,5213,412,7.3
"29223",29,223,2002,5736,5291,445,7.8
"29223",29,223,2003,5801,5363,438,7.6
"29223",29,223,2004,5758,5335,423,7.3
"29223",29,223,2005,5801,5412,389,6.7
"29223",29,223,2006,5745,5382,363,6.3
"29223",29,223,2007,5691,5297,394,6.9
"29223",29,223,2008,5847,5452,395,6.8
"29223",29,223,2009,6034,5486,548,9.1
"29223",29,223,2010,5565,4965,600,10.8
"29223",29,223,2011,5500,4942,558,10.1
"29223",29,223,2012,5329,4848,481,9
"29223",29,223,2013,5639,5174,465,8.2
"29223",29,223,2014,5657,5237,420,7.4
"29223",29,223,2015,5720,5384,336,5.9
"29223",29,223,2016,5665,5362,303,5.3
"29223",29,223,2017,5436,5157,279,5.1
"29225",29,225,1990,11195,10275,920,8.2
"29225",29,225,1991,11275,10458,817,7.2
"29225",29,225,1992,11456,10728,728,6.4
"29225",29,225,1993,11936,11207,729,6.1
"29225",29,225,1994,12491,12005,486,3.9
"29225",29,225,1995,13415,12835,580,4.3
"29225",29,225,1996,14005,13364,641,4.6
"29225",29,225,1997,14220,13473,747,5.3
"29225",29,225,1998,14149,13639,510,3.6
"29225",29,225,1999,14521,14116,405,2.8
"29225",29,225,2000,15107,14560,547,3.6
"29225",29,225,2001,15595,14868,727,4.7
"29225",29,225,2002,15957,15060,897,5.6
"29225",29,225,2003,16146,15352,794,4.9
"29225",29,225,2004,16329,15502,827,5.1
"29225",29,225,2005,16706,15922,784,4.7
"29225",29,225,2006,17078,16353,725,4.2
"29225",29,225,2007,17034,16218,816,4.8
"29225",29,225,2008,16778,15824,954,5.7
"29225",29,225,2009,16798,15175,1623,9.7
"29225",29,225,2010,16383,14660,1723,10.5
"29225",29,225,2011,16180,14736,1444,8.9
"29225",29,225,2012,15944,14812,1132,7.1
"29225",29,225,2013,15913,14839,1074,6.7
"29225",29,225,2014,16313,15328,985,6
"29225",29,225,2015,16657,15811,846,5.1
"29225",29,225,2016,16919,16086,833,4.9
"29225",29,225,2017,16764,16118,646,3.9
"29227",29,227,1990,1006,960,46,4.6
"29227",29,227,1991,996,934,62,6.2
"29227",29,227,1992,969,921,48,5
"29227",29,227,1993,965,907,58,6
"29227",29,227,1994,962,917,45,4.7
"29227",29,227,1995,969,917,52,5.4
"29227",29,227,1996,982,927,55,5.6
"29227",29,227,1997,935,888,47,5
"29227",29,227,1998,895,847,48,5.4
"29227",29,227,1999,854,823,31,3.6
"29227",29,227,2000,1212,1166,46,3.8
"29227",29,227,2001,1309,1262,47,3.6
"29227",29,227,2002,1210,1157,53,4.4
"29227",29,227,2003,1226,1178,48,3.9
"29227",29,227,2004,1194,1141,53,4.4
"29227",29,227,2005,1144,1098,46,4
"29227",29,227,2006,1165,1120,45,3.9
"29227",29,227,2007,1147,1094,53,4.6
"29227",29,227,2008,1146,1083,63,5.5
"29227",29,227,2009,1147,1061,86,7.5
"29227",29,227,2010,1249,1164,85,6.8
"29227",29,227,2011,1241,1170,71,5.7
"29227",29,227,2012,1246,1194,52,4.2
"29227",29,227,2013,1319,1265,54,4.1
"29227",29,227,2014,1295,1243,52,4
"29227",29,227,2015,1219,1179,40,3.3
"29227",29,227,2016,1212,1176,36,3
"29227",29,227,2017,1160,1130,30,2.6
"29229",29,229,1990,7603,6896,707,9.3
"29229",29,229,1991,7360,6539,821,11.2
"29229",29,229,1992,7536,6911,625,8.3
"29229",29,229,1993,7824,7137,687,8.8
"29229",29,229,1994,7712,6784,928,12
"29229",29,229,1995,7812,6853,959,12.3
"29229",29,229,1996,7661,6749,912,11.9
"29229",29,229,1997,7569,6829,740,9.8
"29229",29,229,1998,7121,6627,494,6.9
"29229",29,229,1999,7278,6905,373,5.1
"29229",29,229,2000,8408,8017,391,4.7
"29229",29,229,2001,8593,8046,547,6.4
"29229",29,229,2002,8216,7654,562,6.8
"29229",29,229,2003,8110,7599,511,6.3
"29229",29,229,2004,8333,7778,555,6.7
"29229",29,229,2005,8195,7677,518,6.3
"29229",29,229,2006,8209,7790,419,5.1
"29229",29,229,2007,8087,7603,484,6
"29229",29,229,2008,8211,7617,594,7.2
"29229",29,229,2009,8247,7409,838,10.2
"29229",29,229,2010,7612,6707,905,11.9
"29229",29,229,2011,7605,6859,746,9.8
"29229",29,229,2012,7588,6950,638,8.4
"29229",29,229,2013,7599,6962,637,8.4
"29229",29,229,2014,7648,7091,557,7.3
"29229",29,229,2015,7646,7167,479,6.3
"29229",29,229,2016,7612,7161,451,5.9
"29229",29,229,2017,7539,7163,376,5
"29510",29,510,1990,181189,165976,15213,8.4
"29510",29,510,1991,179532,162891,16641,9.3
"29510",29,510,1992,174381,158721,15660,9
"29510",29,510,1993,170007,155208,14799,8.7
"29510",29,510,1994,169848,156723,13125,7.7
"29510",29,510,1995,170317,157314,13003,7.6
"29510",29,510,1996,167590,154105,13485,8
"29510",29,510,1997,161672,149355,12317,7.6
"29510",29,510,1998,158952,146410,12542,7.9
"29510",29,510,1999,154052,144072,9980,6.5
"29510",29,510,2000,161391,152189,9202,5.7
"29510",29,510,2001,163524,152249,11275,6.9
"29510",29,510,2002,164366,151110,13256,8.1
"29510",29,510,2003,163540,149509,14031,8.6
"29510",29,510,2004,162736,148150,14586,9
"29510",29,510,2005,157506,144748,12758,8.1
"29510",29,510,2006,156927,146090,10837,6.9
"29510",29,510,2007,157604,146435,11169,7.1
"29510",29,510,2008,156914,144629,12285,7.8
"29510",29,510,2009,158443,139938,18505,11.7
"29510",29,510,2010,164915,145959,18956,11.5
"29510",29,510,2011,164340,147357,16983,10.3
"29510",29,510,2012,161177,147450,13727,8.5
"29510",29,510,2013,159822,146476,13346,8.4
"29510",29,510,2014,160220,148092,12128,7.6
"29510",29,510,2015,159788,150091,9697,6.1
"29510",29,510,2016,157567,148965,8602,5.5
"29510",29,510,2017,155752,148881,6871,4.4
"30001",30,1,1990,4313,4104,209,4.8
"30001",30,1,1991,4393,4114,279,6.4
"30001",30,1,1992,4464,4199,265,5.9
"30001",30,1,1993,4611,4365,246,5.3
"30001",30,1,1994,4682,4503,179,3.8
"30001",30,1,1995,4988,4784,204,4.1
"30001",30,1,1996,5002,4796,206,4.1
"30001",30,1,1997,5023,4818,205,4.1
"30001",30,1,1998,5120,4891,229,4.5
"30001",30,1,1999,5078,4833,245,4.8
"30001",30,1,2000,5011,4797,214,4.3
"30001",30,1,2001,5164,4988,176,3.4
"30001",30,1,2002,5136,4948,188,3.7
"30001",30,1,2003,5139,4945,194,3.8
"30001",30,1,2004,5004,4811,193,3.9
"30001",30,1,2005,4956,4777,179,3.6
"30001",30,1,2006,5053,4900,153,3
"30001",30,1,2007,5033,4892,141,2.8
"30001",30,1,2008,5128,4918,210,4.1
"30001",30,1,2009,5161,4903,258,5
"30001",30,1,2010,5010,4713,297,5.9
"30001",30,1,2011,4934,4633,301,6.1
"30001",30,1,2012,4908,4643,265,5.4
"30001",30,1,2013,4840,4612,228,4.7
"30001",30,1,2014,4857,4678,179,3.7
"30001",30,1,2015,4973,4802,171,3.4
"30001",30,1,2016,5069,4901,168,3.3
"30001",30,1,2017,5060,4902,158,3.1
"30003",30,3,1990,4623,4000,623,13.5
"30003",30,3,1991,4695,4172,523,11.1
"30003",30,3,1992,5103,4361,742,14.5
"30003",30,3,1993,4989,4365,624,12.5
"30003",30,3,1994,5154,4488,666,12.9
"30003",30,3,1995,4966,4359,607,12.2
"30003",30,3,1996,5085,4572,513,10.1
"30003",30,3,1997,5116,4636,480,9.4
"30003",30,3,1998,5183,4721,462,8.9
"30003",30,3,1999,5343,4822,521,9.8
"30003",30,3,2000,5437,4906,531,9.8
"30003",30,3,2001,5129,4523,606,11.8
"30003",30,3,2002,4905,4388,517,10.5
"30003",30,3,2003,4923,4354,569,11.6
"30003",30,3,2004,5049,4566,483,9.6
"30003",30,3,2005,5238,4760,478,9.1
"30003",30,3,2006,4999,4655,344,6.9
"30003",30,3,2007,5078,4740,338,6.7
"30003",30,3,2008,5208,4778,430,8.3
"30003",30,3,2009,5223,4727,496,9.5
"30003",30,3,2010,5525,4920,605,11
"30003",30,3,2011,5638,4961,677,12
"30003",30,3,2012,5531,4862,669,12.1
"30003",30,3,2013,5701,4900,801,14.1
"30003",30,3,2014,5584,5025,559,10
"30003",30,3,2015,5542,5171,371,6.7
"30003",30,3,2016,5531,5130,401,7.3
"30003",30,3,2017,5534,4791,743,13.4
"30005",30,5,1990,3056,2815,241,7.9
"30005",30,5,1991,2834,2591,243,8.6
"30005",30,5,1992,2833,2611,222,7.8
"30005",30,5,1993,2785,2544,241,8.7
"30005",30,5,1994,2848,2640,208,7.3
"30005",30,5,1995,2863,2595,268,9.4
"30005",30,5,1996,2913,2623,290,10
"30005",30,5,1997,2838,2548,290,10.2
"30005",30,5,1998,2913,2648,265,9.1
"30005",30,5,1999,2934,2687,247,8.4
"30005",30,5,2000,2968,2800,168,5.7
"30005",30,5,2001,2904,2771,133,4.6
"30005",30,5,2002,2768,2635,133,4.8
"30005",30,5,2003,2747,2617,130,4.7
"30005",30,5,2004,2828,2694,134,4.7
"30005",30,5,2005,2833,2705,128,4.5
"30005",30,5,2006,2812,2716,96,3.4
"30005",30,5,2007,2858,2749,109,3.8
"30005",30,5,2008,2994,2858,136,4.5
"30005",30,5,2009,2880,2732,148,5.1
"30005",30,5,2010,2522,2354,168,6.7
"30005",30,5,2011,2486,2309,177,7.1
"30005",30,5,2012,2486,2327,159,6.4
"30005",30,5,2013,2471,2319,152,6.2
"30005",30,5,2014,2429,2288,141,5.8
"30005",30,5,2015,2393,2273,120,5
"30005",30,5,2016,2368,2260,108,4.6
"30005",30,5,2017,2347,2251,96,4.1
"30007",30,7,1990,1671,1595,76,4.5
"30007",30,7,1991,1733,1650,83,4.8
"30007",30,7,1992,1821,1731,90,4.9
"30007",30,7,1993,1781,1704,77,4.3
"30007",30,7,1994,1840,1765,75,4.1
"30007",30,7,1995,1894,1792,102,5.4
"30007",30,7,1996,1934,1830,104,5.4
"30007",30,7,1997,2055,1974,81,3.9
"30007",30,7,1998,2125,2006,119,5.6
"30007",30,7,1999,2106,1983,123,5.8
"30007",30,7,2000,2230,2126,104,4.7
"30007",30,7,2001,2183,2088,95,4.4
"30007",30,7,2002,2213,2125,88,4
"30007",30,7,2003,2283,2175,108,4.7
"30007",30,7,2004,2270,2168,102,4.5
"30007",30,7,2005,2313,2219,94,4.1
"30007",30,7,2006,2297,2222,75,3.3
"30007",30,7,2007,2371,2294,77,3.2
"30007",30,7,2008,2460,2323,137,5.6
"30007",30,7,2009,2408,2222,186,7.7
"30007",30,7,2010,2508,2322,186,7.4
"30007",30,7,2011,2494,2310,184,7.4
"30007",30,7,2012,2481,2295,186,7.5
"30007",30,7,2013,2508,2348,160,6.4
"30007",30,7,2014,2496,2362,134,5.4
"30007",30,7,2015,2481,2355,126,5.1
"30007",30,7,2016,2549,2424,125,4.9
"30007",30,7,2017,2570,2449,121,4.7
"30009",30,9,1990,3750,3590,160,4.3
"30009",30,9,1991,3792,3548,244,6.4
"30009",30,9,1992,3896,3692,204,5.2
"30009",30,9,1993,3855,3634,221,5.7
"30009",30,9,1994,3992,3758,234,5.9
"30009",30,9,1995,4313,4063,250,5.8
"30009",30,9,1996,4512,4256,256,5.7
"30009",30,9,1997,4602,4335,267,5.8
"30009",30,9,1998,4713,4432,281,6
"30009",30,9,1999,4787,4527,260,5.4
"30009",30,9,2000,4975,4747,228,4.6
"30009",30,9,2001,5041,4834,207,4.1
"30009",30,9,2002,5198,5006,192,3.7
"30009",30,9,2003,5210,5006,204,3.9
"30009",30,9,2004,5267,5042,225,4.3
"30009",30,9,2005,5387,5182,205,3.8
"30009",30,9,2006,5390,5227,163,3
"30009",30,9,2007,5350,5197,153,2.9
"30009",30,9,2008,5313,5084,229,4.3
"30009",30,9,2009,5249,4949,300,5.7
"30009",30,9,2010,5330,4988,342,6.4
"30009",30,9,2011,5292,4988,304,5.7
"30009",30,9,2012,5331,5081,250,4.7
"30009",30,9,2013,5395,5154,241,4.5
"30009",30,9,2014,5379,5169,210,3.9
"30009",30,9,2015,5417,5218,199,3.7
"30009",30,9,2016,5416,5203,213,3.9
"30009",30,9,2017,5411,5212,199,3.7
"30011",30,11,1990,897,880,17,1.9
"30011",30,11,1991,879,860,19,2.2
"30011",30,11,1992,936,921,15,1.6
"30011",30,11,1993,871,848,23,2.6
"30011",30,11,1994,912,888,24,2.6
"30011",30,11,1995,892,876,16,1.8
"30011",30,11,1996,958,943,15,1.6
"30011",30,11,1997,917,897,20,2.2
"30011",30,11,1998,1000,969,31,3.1
"30011",30,11,1999,1064,1038,26,2.4
"30011",30,11,2000,773,744,29,3.8
"30011",30,11,2001,728,705,23,3.2
"30011",30,11,2002,658,637,21,3.2
"30011",30,11,2003,669,648,21,3.1
"30011",30,11,2004,709,685,24,3.4
"30011",30,11,2005,678,651,27,4
"30011",30,11,2006,667,643,24,3.6
"30011",30,11,2007,685,664,21,3.1
"30011",30,11,2008,754,729,25,3.3
"30011",30,11,2009,716,689,27,3.8
"30011",30,11,2010,725,697,28,3.9
"30011",30,11,2011,684,657,27,3.9
"30011",30,11,2012,685,663,22,3.2
"30011",30,11,2013,672,651,21,3.1
"30011",30,11,2014,686,664,22,3.2
"30011",30,11,2015,684,662,22,3.2
"30011",30,11,2016,696,677,19,2.7
"30011",30,11,2017,697,679,18,2.6
"30013",30,13,1990,35986,34034,1952,5.4
"30013",30,13,1991,36263,34106,2157,5.9
"30013",30,13,1992,36495,34228,2267,6.2
"30013",30,13,1993,35643,33429,2214,6.2
"30013",30,13,1994,36336,34486,1850,5.1
"30013",30,13,1995,37378,35422,1956,5.2
"30013",30,13,1996,37256,35476,1780,4.8
"30013",30,13,1997,37629,35642,1987,5.3
"30013",30,13,1998,37927,35858,2069,5.5
"30013",30,13,1999,36785,34786,1999,5.4
"30013",30,13,2000,38200,36240,1960,5.1
"30013",30,13,2001,38244,36535,1709,4.5
"30013",30,13,2002,38055,36457,1598,4.2
"30013",30,13,2003,38361,36653,1708,4.5
"30013",30,13,2004,38661,36934,1727,4.5
"30013",30,13,2005,38950,37279,1671,4.3
"30013",30,13,2006,39435,38102,1333,3.4
"30013",30,13,2007,39577,38199,1378,3.5
"30013",30,13,2008,40401,38519,1882,4.7
"30013",30,13,2009,40611,38410,2201,5.4
"30013",30,13,2010,38447,35996,2451,6.4
"30013",30,13,2011,38333,35882,2451,6.4
"30013",30,13,2012,38376,36245,2131,5.6
"30013",30,13,2013,38386,36422,1964,5.1
"30013",30,13,2014,38215,36570,1645,4.3
"30013",30,13,2015,38241,36697,1544,4
"30013",30,13,2016,37775,36275,1500,4
"30013",30,13,2017,37886,36457,1429,3.8
"30015",30,15,1990,2597,2530,67,2.6
"30015",30,15,1991,2625,2538,87,3.3
"30015",30,15,1992,2634,2564,70,2.7
"30015",30,15,1993,2507,2454,53,2.1
"30015",30,15,1994,2639,2557,82,3.1
"30015",30,15,1995,2668,2580,88,3.3
"30015",30,15,1996,2762,2689,73,2.6
"30015",30,15,1997,2684,2621,63,2.3
"30015",30,15,1998,2817,2729,88,3.1
"30015",30,15,1999,2889,2798,91,3.1
"30015",30,15,2000,2796,2687,109,3.9
"30015",30,15,2001,2715,2619,96,3.5
"30015",30,15,2002,2468,2383,85,3.4
"30015",30,15,2003,2506,2421,85,3.4
"30015",30,15,2004,2609,2517,92,3.5
"30015",30,15,2005,2630,2533,97,3.7
"30015",30,15,2006,2578,2505,73,2.8
"30015",30,15,2007,2517,2438,79,3.1
"30015",30,15,2008,2656,2560,96,3.6
"30015",30,15,2009,2590,2486,104,4
"30015",30,15,2010,2738,2618,120,4.4
"30015",30,15,2011,2652,2531,121,4.6
"30015",30,15,2012,2668,2563,105,3.9
"30015",30,15,2013,2586,2491,95,3.7
"30015",30,15,2014,2587,2503,84,3.2
"30015",30,15,2015,2520,2438,82,3.3
"30015",30,15,2016,2513,2419,94,3.7
"30015",30,15,2017,2500,2418,82,3.3
"30017",30,17,1990,5967,5671,296,5
"30017",30,17,1991,5846,5536,310,5.3
"30017",30,17,1992,5985,5669,316,5.3
"30017",30,17,1993,6062,5752,310,5.1
"30017",30,17,1994,6166,5930,236,3.8
"30017",30,17,1995,6007,5741,266,4.4
"30017",30,17,1996,6017,5734,283,4.7
"30017",30,17,1997,5957,5683,274,4.6
"30017",30,17,1998,6155,5858,297,4.8
"30017",30,17,1999,5986,5719,267,4.5
"30017",30,17,2000,5970,5689,281,4.7
"30017",30,17,2001,5832,5597,235,4
"30017",30,17,2002,5717,5505,212,3.7
"30017",30,17,2003,5692,5471,221,3.9
"30017",30,17,2004,5724,5476,248,4.3
"30017",30,17,2005,5617,5392,225,4
"30017",30,17,2006,5693,5508,185,3.2
"30017",30,17,2007,5760,5567,193,3.4
"30017",30,17,2008,5892,5643,249,4.2
"30017",30,17,2009,5845,5559,286,4.9
"30017",30,17,2010,6400,6110,290,4.5
"30017",30,17,2011,6367,6108,259,4.1
"30017",30,17,2012,6538,6304,234,3.6
"30017",30,17,2013,6632,6409,223,3.4
"30017",30,17,2014,6579,6367,212,3.2
"30017",30,17,2015,6378,6168,210,3.3
"30017",30,17,2016,6236,6016,220,3.5
"30017",30,17,2017,6202,6005,197,3.2
"30019",30,19,1990,1156,1121,35,3
"30019",30,19,1991,1098,1068,30,2.7
"30019",30,19,1992,1114,1089,25,2.2
"30019",30,19,1993,1124,1103,21,1.9
"30019",30,19,1994,1172,1146,26,2.2
"30019",30,19,1995,1225,1192,33,2.7
"30019",30,19,1996,1280,1250,30,2.3
"30019",30,19,1997,1266,1243,23,1.8
"30019",30,19,1998,1313,1277,36,2.7
"30019",30,19,1999,1297,1256,41,3.2
"30019",30,19,2000,972,925,47,4.8
"30019",30,19,2001,920,880,40,4.3
"30019",30,19,2002,880,842,38,4.3
"30019",30,19,2003,825,788,37,4.5
"30019",30,19,2004,813,778,35,4.3
"30019",30,19,2005,780,750,30,3.8
"30019",30,19,2006,758,734,24,3.2
"30019",30,19,2007,768,747,21,2.7
"30019",30,19,2008,803,773,30,3.7
"30019",30,19,2009,780,748,32,4.1
"30019",30,19,2010,946,913,33,3.5
"30019",30,19,2011,943,910,33,3.5
"30019",30,19,2012,941,911,30,3.2
"30019",30,19,2013,932,902,30,3.2
"30019",30,19,2014,950,921,29,3.1
"30019",30,19,2015,942,918,24,2.5
"30019",30,19,2016,935,911,24,2.6
"30019",30,19,2017,915,894,21,2.3
"30021",30,21,1990,4875,4690,185,3.8
"30021",30,21,1991,4764,4573,191,4
"30021",30,21,1992,4758,4571,187,3.9
"30021",30,21,1993,4818,4641,177,3.7
"30021",30,21,1994,4932,4793,139,2.8
"30021",30,21,1995,4822,4647,175,3.6
"30021",30,21,1996,4774,4622,152,3.2
"30021",30,21,1997,4763,4610,153,3.2
"30021",30,21,1998,4918,4715,203,4.1
"30021",30,21,1999,4991,4787,204,4.1
"30021",30,21,2000,4752,4552,200,4.2
"30021",30,21,2001,4456,4297,159,3.6
"30021",30,21,2002,4321,4176,145,3.4
"30021",30,21,2003,4297,4149,148,3.4
"30021",30,21,2004,4266,4085,181,4.2
"30021",30,21,2005,4189,4033,156,3.7
"30021",30,21,2006,4156,4034,122,2.9
"30021",30,21,2007,4255,4135,120,2.8
"30021",30,21,2008,4396,4233,163,3.7
"30021",30,21,2009,4366,4159,207,4.7
"30021",30,21,2010,4513,4323,190,4.2
"30021",30,21,2011,4547,4381,166,3.7
"30021",30,21,2012,4647,4494,153,3.3
"30021",30,21,2013,4807,4655,152,3.2
"30021",30,21,2014,4856,4728,128,2.6
"30021",30,21,2015,4813,4662,151,3.1
"30021",30,21,2016,4601,4424,177,3.8
"30021",30,21,2017,4687,4539,148,3.2
"30023",30,23,1990,4048,3657,391,9.7
"30023",30,23,1991,4043,3609,434,10.7
"30023",30,23,1992,4134,3685,449,10.9
"30023",30,23,1993,4147,3755,392,9.5
"30023",30,23,1994,4172,3846,326,7.8
"30023",30,23,1995,3936,3589,347,8.8
"30023",30,23,1996,3788,3507,281,7.4
"30023",30,23,1997,3756,3516,240,6.4
"30023",30,23,1998,3886,3601,285,7.3
"30023",30,23,1999,3879,3570,309,8
"30023",30,23,2000,4240,3926,314,7.4
"30023",30,23,2001,4236,3957,279,6.6
"30023",30,23,2002,4242,3991,251,5.9
"30023",30,23,2003,3872,3621,251,6.5
"30023",30,23,2004,3920,3654,266,6.8
"30023",30,23,2005,3852,3613,239,6.2
"30023",30,23,2006,3893,3701,192,4.9
"30023",30,23,2007,3901,3715,186,4.8
"30023",30,23,2008,3848,3592,256,6.7
"30023",30,23,2009,3935,3637,298,7.6
"30023",30,23,2010,5181,4864,317,6.1
"30023",30,23,2011,5156,4837,319,6.2
"30023",30,23,2012,5189,4901,288,5.6
"30023",30,23,2013,5209,4952,257,4.9
"30023",30,23,2014,5229,5001,228,4.4
"30023",30,23,2015,5228,5020,208,4
"30023",30,23,2016,5296,5095,201,3.8
"30023",30,23,2017,5134,4951,183,3.6
"30025",30,25,1990,1577,1537,40,2.5
"30025",30,25,1991,1542,1488,54,3.5
"30025",30,25,1992,1539,1489,50,3.2
"30025",30,25,1993,1509,1448,61,4
"30025",30,25,1994,1551,1505,46,3
"30025",30,25,1995,1553,1503,50,3.2
"30025",30,25,1996,1647,1607,40,2.4
"30025",30,25,1997,1669,1614,55,3.3
"30025",30,25,1998,1724,1666,58,3.4
"30025",30,25,1999,1705,1610,95,5.6
"30025",30,25,2000,1542,1483,59,3.8
"30025",30,25,2001,1545,1500,45,2.9
"30025",30,25,2002,1568,1518,50,3.2
"30025",30,25,2003,1545,1497,48,3.1
"30025",30,25,2004,1609,1559,50,3.1
"30025",30,25,2005,1644,1598,46,2.8
"30025",30,25,2006,1767,1732,35,2
"30025",30,25,2007,1741,1706,35,2
"30025",30,25,2008,1823,1775,48,2.6
"30025",30,25,2009,1894,1834,60,3.2
"30025",30,25,2010,1898,1840,58,3.1
"30025",30,25,2011,1952,1901,51,2.6
"30025",30,25,2012,2033,1991,42,2.1
"30025",30,25,2013,2038,1998,40,2
"30025",30,25,2014,2070,2030,40,1.9
"30025",30,25,2015,1967,1921,46,2.3
"30025",30,25,2016,1811,1745,66,3.6
"30025",30,25,2017,1755,1708,47,2.7
"30027",30,27,1990,5873,5557,316,5.4
"30027",30,27,1991,5819,5393,426,7.3
"30027",30,27,1992,5815,5446,369,6.3
"30027",30,27,1993,5701,5385,316,5.5
"30027",30,27,1994,5866,5580,286,4.9
"30027",30,27,1995,5968,5612,356,6
"30027",30,27,1996,6172,5821,351,5.7
"30027",30,27,1997,6187,5821,366,5.9
"30027",30,27,1998,6320,5920,400,6.3
"30027",30,27,1999,6318,5982,336,5.3
"30027",30,27,2000,6105,5773,332,5.4
"30027",30,27,2001,6071,5756,315,5.2
"30027",30,27,2002,5858,5588,270,4.6
"30027",30,27,2003,5759,5469,290,5
"30027",30,27,2004,5837,5521,316,5.4
"30027",30,27,2005,5819,5517,302,5.2
"30027",30,27,2006,5745,5505,240,4.2
"30027",30,27,2007,5862,5630,232,4
"30027",30,27,2008,5950,5666,284,4.8
"30027",30,27,2009,6044,5713,331,5.5
"30027",30,27,2010,6017,5631,386,6.4
"30027",30,27,2011,5906,5546,360,6.1
"30027",30,27,2012,5855,5541,314,5.4
"30027",30,27,2013,5870,5582,288,4.9
"30027",30,27,2014,5732,5486,246,4.3
"30027",30,27,2015,5692,5457,235,4.1
"30027",30,27,2016,5762,5536,226,3.9
"30027",30,27,2017,5789,5555,234,4
"30029",30,29,1990,30452,28148,2304,7.6
"30029",30,29,1991,30957,28193,2764,8.9
"30029",30,29,1992,32265,29632,2633,8.2
"30029",30,29,1993,34202,31762,2440,7.1
"30029",30,29,1994,35156,32716,2440,6.9
"30029",30,29,1995,36301,33463,2838,7.8
"30029",30,29,1996,36927,34196,2731,7.4
"30029",30,29,1997,37375,34623,2752,7.4
"30029",30,29,1998,37797,34845,2952,7.8
"30029",30,29,1999,37340,34690,2650,7.1
"30029",30,29,2000,39210,37069,2141,5.5
"30029",30,29,2001,39911,37804,2107,5.3
"30029",30,29,2002,39966,37942,2024,5.1
"30029",30,29,2003,40571,38169,2402,5.9
"30029",30,29,2004,41756,39312,2444,5.9
"30029",30,29,2005,42837,40729,2108,4.9
"30029",30,29,2006,44224,42504,1720,3.9
"30029",30,29,2007,45734,43927,1807,4
"30029",30,29,2008,46329,43214,3115,6.7
"30029",30,29,2009,44642,39366,5276,11.8
"30029",30,29,2010,43786,38512,5274,12
"30029",30,29,2011,43591,38821,4770,10.9
"30029",30,29,2012,43332,39419,3913,9
"30029",30,29,2013,43843,40469,3374,7.7
"30029",30,29,2014,43684,40862,2822,6.5
"30029",30,29,2015,44753,42194,2559,5.7
"30029",30,29,2016,45929,43364,2565,5.6
"30029",30,29,2017,46773,44321,2452,5.2
"30031",30,31,1990,28811,27442,1369,4.8
"30031",30,31,1991,29979,28397,1582,5.3
"30031",30,31,1992,31671,29993,1678,5.3
"30031",30,31,1993,32958,31479,1479,4.5
"30031",30,31,1994,33271,32489,782,2.4
"30031",30,31,1995,36641,35698,943,2.6
"30031",30,31,1996,38126,37151,975,2.6
"30031",30,31,1997,39116,37962,1154,3
"30031",30,31,1998,40184,38947,1237,3.1
"30031",30,31,1999,41816,40626,1190,2.8
"30031",30,31,2000,41448,39902,1546,3.7
"30031",30,31,2001,41500,40108,1392,3.4
"30031",30,31,2002,42029,40621,1408,3.4
"30031",30,31,2003,42904,41361,1543,3.6
"30031",30,31,2004,44724,43093,1631,3.6
"30031",30,31,2005,46649,45172,1477,3.2
"30031",30,31,2006,49210,48009,1201,2.4
"30031",30,31,2007,50406,49082,1324,2.6
"30031",30,31,2008,50885,48733,2152,4.2
"30031",30,31,2009,48837,45442,3395,7
"30031",30,31,2010,50768,47316,3452,6.8
"30031",30,31,2011,51559,48461,3098,6
"30031",30,31,2012,52488,49805,2683,5.1
"30031",30,31,2013,54783,52526,2257,4.1
"30031",30,31,2014,56763,54782,1981,3.5
"30031",30,31,2015,59360,57576,1784,3
"30031",30,31,2016,62084,60336,1748,2.8
"30031",30,31,2017,64315,62540,1775,2.8
"30033",30,33,1990,892,875,17,1.9
"30033",30,33,1991,890,876,14,1.6
"30033",30,33,1992,925,908,17,1.8
"30033",30,33,1993,874,860,14,1.6
"30033",30,33,1994,933,901,32,3.4
"30033",30,33,1995,895,867,28,3.1
"30033",30,33,1996,938,912,26,2.8
"30033",30,33,1997,901,868,33,3.7
"30033",30,33,1998,961,925,36,3.7
"30033",30,33,1999,1055,1022,33,3.1
"30033",30,33,2000,705,674,31,4.4
"30033",30,33,2001,679,657,22,3.2
"30033",30,33,2002,622,600,22,3.5
"30033",30,33,2003,631,609,22,3.5
"30033",30,33,2004,660,634,26,3.9
"30033",30,33,2005,643,616,27,4.2
"30033",30,33,2006,638,615,23,3.6
"30033",30,33,2007,643,624,19,3
"30033",30,33,2008,657,634,23,3.5
"30033",30,33,2009,652,628,24,3.7
"30033",30,33,2010,763,736,27,3.5
"30033",30,33,2011,777,747,30,3.9
"30033",30,33,2012,768,744,24,3.1
"30033",30,33,2013,761,737,24,3.2
"30033",30,33,2014,746,726,20,2.7
"30033",30,33,2015,761,740,21,2.8
"30033",30,33,2016,763,741,22,2.9
"30033",30,33,2017,770,748,22,2.9
"30035",30,35,1990,5340,4711,629,11.8
"30035",30,35,1991,5396,4795,601,11.1
"30035",30,35,1992,5548,4780,768,13.8
"30035",30,35,1993,5387,4772,615,11.4
"30035",30,35,1994,5568,4896,672,12.1
"30035",30,35,1995,5660,4857,803,14.2
"30035",30,35,1996,5685,4905,780,13.7
"30035",30,35,1997,5639,4863,776,13.8
"30035",30,35,1998,5599,4804,795,14.2
"30035",30,35,1999,5409,4628,781,14.4
"30035",30,35,2000,5707,5228,479,8.4
"30035",30,35,2001,5757,5330,427,7.4
"30035",30,35,2002,5572,5197,375,6.7
"30035",30,35,2003,5735,5282,453,7.9
"30035",30,35,2004,5928,5425,503,8.5
"30035",30,35,2005,5866,5407,459,7.8
"30035",30,35,2006,5981,5575,406,6.8
"30035",30,35,2007,5812,5346,466,8
"30035",30,35,2008,5854,5318,536,9.2
"30035",30,35,2009,5767,5230,537,9.3
"30035",30,35,2010,6260,5648,612,9.8
"30035",30,35,2011,6061,5372,689,11.4
"30035",30,35,2012,6347,5720,627,9.9
"30035",30,35,2013,6341,5701,640,10.1
"30035",30,35,2014,5945,5317,628,10.6
"30035",30,35,2015,5845,5319,526,9
"30035",30,35,2016,5816,5318,498,8.6
"30035",30,35,2017,5741,5284,457,8
"30037",30,37,1990,471,457,14,3
"30037",30,37,1991,461,413,48,10.4
"30037",30,37,1992,485,444,41,8.5
"30037",30,37,1993,472,450,22,4.7
"30037",30,37,1994,501,469,32,6.4
"30037",30,37,1995,490,454,36,7.3
"30037",30,37,1996,503,473,30,6
"30037",30,37,1997,484,453,31,6.4
"30037",30,37,1998,524,490,34,6.5
"30037",30,37,1999,570,538,32,5.6
"30037",30,37,2000,545,515,30,5.5
"30037",30,37,2001,492,469,23,4.7
"30037",30,37,2002,436,415,21,4.8
"30037",30,37,2003,446,418,28,6.3
"30037",30,37,2004,492,461,31,6.3
"30037",30,37,2005,537,511,26,4.8
"30037",30,37,2006,529,509,20,3.8
"30037",30,37,2007,561,539,22,3.9
"30037",30,37,2008,580,551,29,5
"30037",30,37,2009,554,525,29,5.2
"30037",30,37,2010,418,390,28,6.7
"30037",30,37,2011,391,371,20,5.1
"30037",30,37,2012,390,372,18,4.6
"30037",30,37,2013,397,377,20,5
"30037",30,37,2014,391,373,18,4.6
"30037",30,37,2015,379,363,16,4.2
"30037",30,37,2016,379,362,17,4.5
"30037",30,37,2017,380,361,19,5
"30039",30,39,1990,1167,1076,91,7.8
"30039",30,39,1991,1213,1104,109,9
"30039",30,39,1992,1287,1182,105,8.2
"30039",30,39,1993,1304,1204,100,7.7
"30039",30,39,1994,1324,1242,82,6.2
"30039",30,39,1995,1112,1031,81,7.3
"30039",30,39,1996,1138,1075,63,5.5
"30039",30,39,1997,1144,1061,83,7.3
"30039",30,39,1998,1201,1095,106,8.8
"30039",30,39,1999,1214,1122,92,7.6
"30039",30,39,2000,1351,1264,87,6.4
"30039",30,39,2001,1329,1247,82,6.2
"30039",30,39,2002,1288,1214,74,5.7
"30039",30,39,2003,1287,1213,74,5.7
"30039",30,39,2004,1300,1225,75,5.8
"30039",30,39,2005,1233,1159,74,6
"30039",30,39,2006,1246,1190,56,4.5
"30039",30,39,2007,1283,1222,61,4.8
"30039",30,39,2008,1292,1205,87,6.7
"30039",30,39,2009,1252,1122,130,10.4
"30039",30,39,2010,1458,1323,135,9.3
"30039",30,39,2011,1457,1325,132,9.1
"30039",30,39,2012,1473,1353,120,8.1
"30039",30,39,2013,1501,1387,114,7.6
"30039",30,39,2014,1524,1420,104,6.8
"30039",30,39,2015,1557,1460,97,6.2
"30039",30,39,2016,1630,1534,96,5.9
"30039",30,39,2017,1621,1526,95,5.9
"30041",30,41,1990,8415,7959,456,5.4
"30041",30,41,1991,8349,7802,547,6.6
"30041",30,41,1992,8480,7932,548,6.5
"30041",30,41,1993,8605,8073,532,6.2
"30041",30,41,1994,8809,8326,483,5.5
"30041",30,41,1995,9076,8546,530,5.8
"30041",30,41,1996,9056,8618,438,4.8
"30041",30,41,1997,8970,8488,482,5.4
"30041",30,41,1998,9146,8588,558,6.1
"30041",30,41,1999,8866,8344,522,5.9
"30041",30,41,2000,7979,7574,405,5.1
"30041",30,41,2001,7881,7541,340,4.3
"30041",30,41,2002,7845,7527,318,4.1
"30041",30,41,2003,7875,7533,342,4.3
"30041",30,41,2004,8004,7628,376,4.7
"30041",30,41,2005,7854,7499,355,4.5
"30041",30,41,2006,7904,7597,307,3.9
"30041",30,41,2007,8078,7745,333,4.1
"30041",30,41,2008,8233,7816,417,5.1
"30041",30,41,2009,8207,7758,449,5.5
"30041",30,41,2010,7982,7518,464,5.8
"30041",30,41,2011,7986,7486,500,6.3
"30041",30,41,2012,8035,7567,468,5.8
"30041",30,41,2013,7938,7416,522,6.6
"30041",30,41,2014,7816,7364,452,5.8
"30041",30,41,2015,7783,7458,325,4.2
"30041",30,41,2016,7794,7458,336,4.3
"30041",30,41,2017,7835,7537,298,3.8
"30043",30,43,1990,4147,3943,204,4.9
"30043",30,43,1991,4150,3904,246,5.9
"30043",30,43,1992,4181,3960,221,5.3
"30043",30,43,1993,4303,4101,202,4.7
"30043",30,43,1994,4474,4310,164,3.7
"30043",30,43,1995,4685,4475,210,4.5
"30043",30,43,1996,4839,4597,242,5
"30043",30,43,1997,4896,4679,217,4.4
"30043",30,43,1998,5021,4783,238,4.7
"30043",30,43,1999,5044,4816,228,4.5
"30043",30,43,2000,5357,5095,262,4.9
"30043",30,43,2001,5335,5103,232,4.3
"30043",30,43,2002,5347,5121,226,4.2
"30043",30,43,2003,5425,5191,234,4.3
"30043",30,43,2004,5517,5265,252,4.6
"30043",30,43,2005,5598,5361,237,4.2
"30043",30,43,2006,5739,5531,208,3.6
"30043",30,43,2007,5851,5668,183,3.1
"30043",30,43,2008,5996,5719,277,4.6
"30043",30,43,2009,6036,5652,384,6.4
"30043",30,43,2010,5628,5274,354,6.3
"30043",30,43,2011,5619,5267,352,6.3
"30043",30,43,2012,5601,5292,309,5.5
"30043",30,43,2013,5608,5333,275,4.9
"30043",30,43,2014,5620,5361,259,4.6
"30043",30,43,2015,5574,5347,227,4.1
"30043",30,43,2016,5667,5406,261,4.6
"30043",30,43,2017,5645,5402,243,4.3
"30045",30,45,1990,1169,1130,39,3.3
"30045",30,45,1991,1126,1080,46,4.1
"30045",30,45,1992,1144,1091,53,4.6
"30045",30,45,1993,1039,1003,36,3.5
"30045",30,45,1994,1088,1044,44,4
"30045",30,45,1995,1071,1024,47,4.4
"30045",30,45,1996,1112,1066,46,4.1
"30045",30,45,1997,1081,1028,53,4.9
"30045",30,45,1998,1144,1094,50,4.4
"30045",30,45,1999,1212,1158,54,4.5
"30045",30,45,2000,1179,1123,56,4.7
"30045",30,45,2001,1159,1112,47,4.1
"30045",30,45,2002,1074,1022,52,4.8
"30045",30,45,2003,1091,1044,47,4.3
"30045",30,45,2004,1101,1053,48,4.4
"30045",30,45,2005,1072,1021,51,4.8
"30045",30,45,2006,1042,1006,36,3.5
"30045",30,45,2007,1046,1007,39,3.7
"30045",30,45,2008,1108,1059,49,4.4
"30045",30,45,2009,1070,1013,57,5.3
"30045",30,45,2010,1009,944,65,6.4
"30045",30,45,2011,968,908,60,6.2
"30045",30,45,2012,991,939,52,5.2
"30045",30,45,2013,978,930,48,4.9
"30045",30,45,2014,965,924,41,4.2
"30045",30,45,2015,992,958,34,3.4
"30045",30,45,2016,933,901,32,3.4
"30045",30,45,2017,927,893,34,3.7
"30047",30,47,1990,9700,8902,798,8.2
"30047",30,47,1991,9632,8771,861,8.9
"30047",30,47,1992,10102,9206,896,8.9
"30047",30,47,1993,10058,9272,786,7.8
"30047",30,47,1994,10190,9471,719,7.1
"30047",30,47,1995,10429,9625,804,7.7
"30047",30,47,1996,10754,9988,766,7.1
"30047",30,47,1997,10907,10139,768,7
"30047",30,47,1998,11169,10354,815,7.3
"30047",30,47,1999,12207,11435,772,6.3
"30047",30,47,2000,12289,11587,702,5.7
"30047",30,47,2001,11735,10891,844,7.2
"30047",30,47,2002,11505,10751,754,6.6
"30047",30,47,2003,11482,10772,710,6.2
"30047",30,47,2004,11644,10913,731,6.3
"30047",30,47,2005,11573,10900,673,5.8
"30047",30,47,2006,11509,10947,562,4.9
"30047",30,47,2007,11641,11006,635,5.5
"30047",30,47,2008,11678,10797,881,7.5
"30047",30,47,2009,11410,10357,1053,9.2
"30047",30,47,2010,12644,11512,1132,9
"30047",30,47,2011,12553,11409,1144,9.1
"30047",30,47,2012,12437,11480,957,7.7
"30047",30,47,2013,12370,11565,805,6.5
"30047",30,47,2014,12462,11770,692,5.6
"30047",30,47,2015,12677,12044,633,5
"30047",30,47,2016,13072,12453,619,4.7
"30047",30,47,2017,13194,12608,586,4.4
"30049",30,49,1990,25688,24530,1158,4.5
"30049",30,49,1991,25684,24259,1425,5.5
"30049",30,49,1992,26242,24808,1434,5.5
"30049",30,49,1993,26643,25298,1345,5
"30049",30,49,1994,27058,25905,1153,4.3
"30049",30,49,1995,27925,26540,1385,5
"30049",30,49,1996,27785,26514,1271,4.6
"30049",30,49,1997,27962,26574,1388,5
"30049",30,49,1998,27826,26505,1321,4.7
"30049",30,49,1999,27548,26289,1259,4.6
"30049",30,49,2000,31097,29801,1296,4.2
"30049",30,49,2001,30876,29645,1231,4
"30049",30,49,2002,30495,29301,1194,3.9
"30049",30,49,2003,30888,29694,1194,3.9
"30049",30,49,2004,30923,29640,1283,4.1
"30049",30,49,2005,30847,29614,1233,4
"30049",30,49,2006,31787,30763,1024,3.2
"30049",30,49,2007,33292,32281,1011,3
"30049",30,49,2008,34102,32683,1419,4.2
"30049",30,49,2009,33935,32223,1712,5
"30049",30,49,2010,34314,32427,1887,5.5
"30049",30,49,2011,34503,32668,1835,5.3
"30049",30,49,2012,34919,33225,1694,4.9
"30049",30,49,2013,35064,33537,1527,4.4
"30049",30,49,2014,35143,33836,1307,3.7
"30049",30,49,2015,34952,33776,1176,3.4
"30049",30,49,2016,35171,34010,1161,3.3
"30049",30,49,2017,35227,34006,1221,3.5
"30051",30,51,1990,957,940,17,1.8
"30051",30,51,1991,924,906,18,1.9
"30051",30,51,1992,1010,986,24,2.4
"30051",30,51,1993,988,964,24,2.4
"30051",30,51,1994,1029,1001,28,2.7
"30051",30,51,1995,1112,1085,27,2.4
"30051",30,51,1996,1104,1082,22,2
"30051",30,51,1997,1058,1031,27,2.6
"30051",30,51,1998,1143,1105,38,3.3
"30051",30,51,1999,1211,1158,53,4.4
"30051",30,51,2000,960,918,42,4.4
"30051",30,51,2001,882,848,34,3.9
"30051",30,51,2002,833,800,33,4
"30051",30,51,2003,847,812,35,4.1
"30051",30,51,2004,880,842,38,4.3
"30051",30,51,2005,872,831,41,4.7
"30051",30,51,2006,824,798,26,3.2
"30051",30,51,2007,799,776,23,2.9
"30051",30,51,2008,777,744,33,4.2
"30051",30,51,2009,751,719,32,4.3
"30051",30,51,2010,1033,988,45,4.4
"30051",30,51,2011,1018,977,41,4
"30051",30,51,2012,1036,993,43,4.2
"30051",30,51,2013,991,957,34,3.4
"30051",30,51,2014,971,941,30,3.1
"30051",30,51,2015,984,958,26,2.6
"30051",30,51,2016,988,957,31,3.1
"30051",30,51,2017,981,951,30,3.1
"30053",30,53,1990,8383,7355,1028,12.3
"30053",30,53,1991,8351,7008,1343,16.1
"30053",30,53,1992,8041,6895,1146,14.3
"30053",30,53,1993,8101,6848,1253,15.5
"30053",30,53,1994,8310,7035,1275,15.3
"30053",30,53,1995,7475,6401,1074,14.4
"30053",30,53,1996,7196,6349,847,11.8
"30053",30,53,1997,7213,6345,868,12
"30053",30,53,1998,7353,6403,950,12.9
"30053",30,53,1999,6971,6101,870,12.5
"30053",30,53,2000,7875,7192,683,8.7
"30053",30,53,2001,7676,7015,661,8.6
"30053",30,53,2002,7545,6874,671,8.9
"30053",30,53,2003,7693,6752,941,12.2
"30053",30,53,2004,7733,6925,808,10.4
"30053",30,53,2005,7764,7081,683,8.8
"30053",30,53,2006,7722,7193,529,6.9
"30053",30,53,2007,7811,7227,584,7.5
"30053",30,53,2008,7851,7001,850,10.8
"30053",30,53,2009,7891,6727,1164,14.8
"30053",30,53,2010,8429,7167,1262,15
"30053",30,53,2011,8212,6996,1216,14.8
"30053",30,53,2012,8210,7181,1029,12.5
"30053",30,53,2013,8122,7068,1054,13
"30053",30,53,2014,7906,7020,886,11.2
"30053",30,53,2015,7795,7009,786,10.1
"30053",30,53,2016,7925,7211,714,9
"30053",30,53,2017,7875,7206,669,8.5
"30055",30,55,1990,1151,1114,37,3.2
"30055",30,55,1991,1138,1096,42,3.7
"30055",30,55,1992,1223,1183,40,3.3
"30055",30,55,1993,1114,1079,35,3.1
"30055",30,55,1994,1158,1127,31,2.7
"30055",30,55,1995,1179,1144,35,3
"30055",30,55,1996,1204,1162,42,3.5
"30055",30,55,1997,1169,1129,40,3.4
"30055",30,55,1998,1241,1194,47,3.8
"30055",30,55,1999,1288,1240,48,3.7
"30055",30,55,2000,1099,1057,42,3.8
"30055",30,55,2001,1054,1023,31,2.9
"30055",30,55,2002,994,968,26,2.6
"30055",30,55,2003,993,959,34,3.4
"30055",30,55,2004,1019,988,31,3
"30055",30,55,2005,1014,978,36,3.6
"30055",30,55,2006,994,968,26,2.6
"30055",30,55,2007,1000,978,22,2.2
"30055",30,55,2008,1031,1002,29,2.8
"30055",30,55,2009,1016,983,33,3.2
"30055",30,55,2010,1131,1098,33,2.9
"30055",30,55,2011,1098,1065,33,3
"30055",30,55,2012,1089,1057,32,2.9
"30055",30,55,2013,1095,1069,26,2.4
"30055",30,55,2014,1087,1062,25,2.3
"30055",30,55,2015,1060,1037,23,2.2
"30055",30,55,2016,1042,1022,20,1.9
"30055",30,55,2017,1020,998,22,2.2
"30057",30,57,1990,3315,3209,106,3.2
"30057",30,57,1991,3327,3175,152,4.6
"30057",30,57,1992,3346,3186,160,4.8
"30057",30,57,1993,3321,3197,124,3.7
"30057",30,57,1994,3465,3300,165,4.8
"30057",30,57,1995,3538,3368,170,4.8
"30057",30,57,1996,3627,3479,148,4.1
"30057",30,57,1997,3630,3469,161,4.4
"30057",30,57,1998,3735,3575,160,4.3
"30057",30,57,1999,3938,3758,180,4.6
"30057",30,57,2000,3346,3173,173,5.2
"30057",30,57,2001,3336,3188,148,4.4
"30057",30,57,2002,3316,3169,147,4.4
"30057",30,57,2003,3373,3212,161,4.8
"30057",30,57,2004,3598,3441,157,4.4
"30057",30,57,2005,3827,3687,140,3.7
"30057",30,57,2006,4089,3962,127,3.1
"30057",30,57,2007,4446,4319,127,2.9
"30057",30,57,2008,4550,4357,193,4.2
"30057",30,57,2009,4207,3940,267,6.3
"30057",30,57,2010,4155,3840,315,7.6
"30057",30,57,2011,4178,3872,306,7.3
"30057",30,57,2012,4113,3856,257,6.2
"30057",30,57,2013,4161,3932,229,5.5
"30057",30,57,2014,4223,4028,195,4.6
"30057",30,57,2015,4280,4125,155,3.6
"30057",30,57,2016,4411,4244,167,3.8
"30057",30,57,2017,4329,4158,171,4
"30059",30,59,1990,915,882,33,3.6
"30059",30,59,1991,909,866,43,4.7
"30059",30,59,1992,927,879,48,5.2
"30059",30,59,1993,910,857,53,5.8
"30059",30,59,1994,940,890,50,5.3
"30059",30,59,1995,956,900,56,5.9
"30059",30,59,1996,966,918,48,5
"30059",30,59,1997,956,902,54,5.6
"30059",30,59,1998,995,942,53,5.3
"30059",30,59,1999,1062,995,67,6.3
"30059",30,59,2000,990,930,60,6.1
"30059",30,59,2001,949,895,54,5.7
"30059",30,59,2002,885,836,49,5.5
"30059",30,59,2003,914,862,52,5.7
"30059",30,59,2004,932,875,57,6.1
"30059",30,59,2005,942,897,45,4.8
"30059",30,59,2006,904,864,40,4.4
"30059",30,59,2007,901,850,51,5.7
"30059",30,59,2008,891,829,62,7
"30059",30,59,2009,857,784,73,8.5
"30059",30,59,2010,935,860,75,8
"30059",30,59,2011,910,843,67,7.4
"30059",30,59,2012,930,879,51,5.5
"30059",30,59,2013,931,882,49,5.3
"30059",30,59,2014,906,867,39,4.3
"30059",30,59,2015,935,901,34,3.6
"30059",30,59,2016,916,879,37,4
"30059",30,59,2017,915,874,41,4.5
"30061",30,61,1990,1779,1623,156,8.8
"30061",30,61,1991,1778,1590,188,10.6
"30061",30,61,1992,1714,1535,179,10.4
"30061",30,61,1993,1632,1479,153,9.4
"30061",30,61,1994,1684,1514,170,10.1
"30061",30,61,1995,1711,1501,210,12.3
"30061",30,61,1996,1642,1492,150,9.1
"30061",30,61,1997,1672,1517,155,9.3
"30061",30,61,1998,1698,1516,182,10.7
"30061",30,61,1999,1648,1489,159,9.6
"30061",30,61,2000,1884,1758,126,6.7
"30061",30,61,2001,1977,1851,126,6.4
"30061",30,61,2002,1901,1774,127,6.7
"30061",30,61,2003,1888,1755,133,7
"30061",30,61,2004,1925,1800,125,6.5
"30061",30,61,2005,1948,1830,118,6.1
"30061",30,61,2006,1956,1859,97,5
"30061",30,61,2007,1968,1875,93,4.7
"30061",30,61,2008,1896,1759,137,7.2
"30061",30,61,2009,1919,1718,201,10.5
"30061",30,61,2010,1789,1566,223,12.5
"30061",30,61,2011,1791,1574,217,12.1
"30061",30,61,2012,1768,1575,193,10.9
"30061",30,61,2013,1781,1595,186,10.4
"30061",30,61,2014,1743,1584,159,9.1
"30061",30,61,2015,1725,1581,144,8.3
"30061",30,61,2016,1686,1558,128,7.6
"30061",30,61,2017,1680,1553,127,7.6
"30063",30,63,1990,42921,40383,2538,5.9
"30063",30,63,1991,43308,40104,3204,7.4
"30063",30,63,1992,45298,42337,2961,6.5
"30063",30,63,1993,46405,43741,2664,5.7
"30063",30,63,1994,46825,44594,2231,4.8
"30063",30,63,1995,48662,46247,2415,5
"30063",30,63,1996,50247,48215,2032,4
"30063",30,63,1997,51087,48917,2170,4.2
"30063",30,63,1998,51601,49436,2165,4.2
"30063",30,63,1999,52781,50851,1930,3.7
"30063",30,63,2000,54007,51755,2252,4.2
"30063",30,63,2001,54827,52670,2157,3.9
"30063",30,63,2002,55994,53842,2152,3.8
"30063",30,63,2003,56501,54184,2317,4.1
"30063",30,63,2004,57144,54731,2413,4.2
"30063",30,63,2005,57899,55617,2282,3.9
"30063",30,63,2006,58662,56793,1869,3.2
"30063",30,63,2007,59156,57129,2027,3.4
"30063",30,63,2008,59098,56136,2962,5
"30063",30,63,2009,58728,55014,3714,6.3
"30063",30,63,2010,58536,54244,4292,7.3
"30063",30,63,2011,58780,54816,3964,6.7
"30063",30,63,2012,59139,55667,3472,5.9
"30063",30,63,2013,59395,56311,3084,5.2
"30063",30,63,2014,59837,57179,2658,4.4
"30063",30,63,2015,60422,58051,2371,3.9
"30063",30,63,2016,61354,59056,2298,3.7
"30063",30,63,2017,62294,60041,2253,3.6
"30065",30,65,1990,1794,1666,128,7.1
"30065",30,65,1991,1777,1641,136,7.7
"30065",30,65,1992,1798,1666,132,7.3
"30065",30,65,1993,1788,1680,108,6
"30065",30,65,1994,1863,1740,123,6.6
"30065",30,65,1995,1958,1795,163,8.3
"30065",30,65,1996,1948,1789,159,8.2
"30065",30,65,1997,1929,1778,151,7.8
"30065",30,65,1998,1946,1804,142,7.3
"30065",30,65,1999,1815,1664,151,8.3
"30065",30,65,2000,2090,1958,132,6.3
"30065",30,65,2001,2035,1921,114,5.6
"30065",30,65,2002,2057,1932,125,6.1
"30065",30,65,2003,2063,1937,126,6.1
"30065",30,65,2004,2109,1977,132,6.3
"30065",30,65,2005,2088,1971,117,5.6
"30065",30,65,2006,2076,1992,84,4
"30065",30,65,2007,2037,1928,109,5.4
"30065",30,65,2008,2157,2030,127,5.9
"30065",30,65,2009,2438,2276,162,6.6
"30065",30,65,2010,2381,2217,164,6.9
"30065",30,65,2011,2329,2175,154,6.6
"30065",30,65,2012,2416,2286,130,5.4
"30065",30,65,2013,2376,2256,120,5.1
"30065",30,65,2014,2357,2261,96,4.1
"30065",30,65,2015,2405,2302,103,4.3
"30065",30,65,2016,2292,2175,117,5.1
"30065",30,65,2017,2297,2195,102,4.4
"30067",30,67,1990,7736,7320,416,5.4
"30067",30,67,1991,8082,7567,515,6.4
"30067",30,67,1992,8300,7803,497,6
"30067",30,67,1993,9428,9036,392,4.2
"30067",30,67,1994,9748,9349,399,4.1
"30067",30,67,1995,10180,9726,454,4.5
"30067",30,67,1996,10474,9972,502,4.8
"30067",30,67,1997,10399,9871,528,5.1
"30067",30,67,1998,10480,9910,570,5.4
"30067",30,67,1999,10199,9629,570,5.6
"30067",30,67,2000,9023,8544,479,5.3
"30067",30,67,2001,8644,8237,407,4.7
"30067",30,67,2002,8638,8251,387,4.5
"30067",30,67,2003,8538,8123,415,4.9
"30067",30,67,2004,8823,8404,419,4.7
"30067",30,67,2005,9011,8631,380,4.2
"30067",30,67,2006,9235,8930,305,3.3
"30067",30,67,2007,9075,8755,320,3.5
"30067",30,67,2008,9032,8555,477,5.3
"30067",30,67,2009,8594,7907,687,8
"30067",30,67,2010,7890,7199,691,8.8
"30067",30,67,2011,7883,7229,654,8.3
"30067",30,67,2012,8025,7465,560,7
"30067",30,67,2013,8011,7502,509,6.4
"30067",30,67,2014,8051,7600,451,5.6
"30067",30,67,2015,8286,7889,397,4.8
"30067",30,67,2016,8404,8044,360,4.3
"30067",30,67,2017,8631,8284,347,4
"30069",30,69,1990,262,256,6,2.3
"30069",30,69,1991,288,273,15,5.2
"30069",30,69,1992,311,292,19,6.1
"30069",30,69,1993,302,285,17,5.6
"30069",30,69,1994,309,297,12,3.9
"30069",30,69,1995,304,291,13,4.3
"30069",30,69,1996,312,299,13,4.2
"30069",30,69,1997,299,285,14,4.7
"30069",30,69,1998,321,304,17,5.3
"30069",30,69,1999,366,344,22,6
"30069",30,69,2000,251,234,17,6.8
"30069",30,69,2001,221,211,10,4.5
"30069",30,69,2002,197,186,11,5.6
"30069",30,69,2003,204,191,13,6.4
"30069",30,69,2004,221,208,13,5.9
"30069",30,69,2005,227,215,12,5.3
"30069",30,69,2006,225,215,10,4.4
"30069",30,69,2007,235,223,12,5.1
"30069",30,69,2008,249,235,14,5.6
"30069",30,69,2009,236,223,13,5.5
"30069",30,69,2010,299,283,16,5.4
"30069",30,69,2011,280,264,16,5.7
"30069",30,69,2012,299,286,13,4.3
"30069",30,69,2013,294,280,14,4.8
"30069",30,69,2014,283,271,12,4.2
"30069",30,69,2015,284,269,15,5.3
"30069",30,69,2016,277,264,13,4.7
"30069",30,69,2017,277,264,13,4.7
"30071",30,71,1990,2611,2486,125,4.8
"30071",30,71,1991,2468,2352,116,4.7
"30071",30,71,1992,2440,2308,132,5.4
"30071",30,71,1993,2402,2309,93,3.9
"30071",30,71,1994,2484,2400,84,3.4
"30071",30,71,1995,2478,2331,147,5.9
"30071",30,71,1996,2472,2259,213,8.6
"30071",30,71,1997,2373,2211,162,6.8
"30071",30,71,1998,2482,2272,210,8.5
"30071",30,71,1999,2403,2212,191,7.9
"30071",30,71,2000,2317,2209,108,4.7
"30071",30,71,2001,2225,2132,93,4.2
"30071",30,71,2002,2106,2014,92,4.4
"30071",30,71,2003,2122,2026,96,4.5
"30071",30,71,2004,2159,2057,102,4.7
"30071",30,71,2005,2075,1984,91,4.4
"30071",30,71,2006,2068,1989,79,3.8
"30071",30,71,2007,2055,1969,86,4.2
"30071",30,71,2008,2186,2074,112,5.1
"30071",30,71,2009,2237,2111,126,5.6
"30071",30,71,2010,2208,2058,150,6.8
"30071",30,71,2011,2126,1979,147,6.9
"30071",30,71,2012,2060,1937,123,6
"30071",30,71,2013,2057,1936,121,5.9
"30071",30,71,2014,1990,1884,106,5.3
"30071",30,71,2015,1974,1874,100,5.1
"30071",30,71,2016,1935,1832,103,5.3
"30071",30,71,2017,1898,1812,86,4.5
"30073",30,73,1990,2954,2843,111,3.8
"30073",30,73,1991,2906,2798,108,3.7
"30073",30,73,1992,2992,2848,144,4.8
"30073",30,73,1993,2933,2835,98,3.3
"30073",30,73,1994,3048,2941,107,3.5
"30073",30,73,1995,3050,2922,128,4.2
"30073",30,73,1996,3177,3036,141,4.4
"30073",30,73,1997,3158,3032,126,4
"30073",30,73,1998,3331,3159,172,5.2
"30073",30,73,1999,3403,3240,163,4.8
"30073",30,73,2000,2972,2825,147,4.9
"30073",30,73,2001,2884,2760,124,4.3
"30073",30,73,2002,2751,2629,122,4.4
"30073",30,73,2003,2761,2624,137,5
"30073",30,73,2004,2702,2547,155,5.7
"30073",30,73,2005,2724,2584,140,5.1
"30073",30,73,2006,2738,2628,110,4
"30073",30,73,2007,2721,2613,108,4
"30073",30,73,2008,2627,2482,145,5.5
"30073",30,73,2009,2573,2412,161,6.3
"30073",30,73,2010,2953,2780,173,5.9
"30073",30,73,2011,2930,2753,177,6
"30073",30,73,2012,2940,2796,144,4.9
"30073",30,73,2013,2901,2758,143,4.9
"30073",30,73,2014,2836,2697,139,4.9
"30073",30,73,2015,2862,2734,128,4.5
"30073",30,73,2016,2863,2743,120,4.2
"30073",30,73,2017,2760,2653,107,3.9
"30075",30,75,1990,1174,1152,22,1.9
"30075",30,75,1991,1187,1154,33,2.8
"30075",30,75,1992,1213,1178,35,2.9
"30075",30,75,1993,1158,1130,28,2.4
"30075",30,75,1994,1199,1174,25,2.1
"30075",30,75,1995,1164,1138,26,2.2
"30075",30,75,1996,1262,1241,21,1.7
"30075",30,75,1997,1229,1206,23,1.9
"30075",30,75,1998,1292,1248,44,3.4
"30075",30,75,1999,1290,1242,48,3.7
"30075",30,75,2000,999,959,40,4
"30075",30,75,2001,941,912,29,3.1
"30075",30,75,2002,887,855,32,3.6
"30075",30,75,2003,889,852,37,4.2
"30075",30,75,2004,927,887,40,4.3
"30075",30,75,2005,916,880,36,3.9
"30075",30,75,2006,896,867,29,3.2
"30075",30,75,2007,898,869,29,3.2
"30075",30,75,2008,949,915,34,3.6
"30075",30,75,2009,900,864,36,4
"30075",30,75,2010,1044,1005,39,3.7
"30075",30,75,2011,1058,1008,50,4.7
"30075",30,75,2012,1077,1037,40,3.7
"30075",30,75,2013,1124,1087,37,3.3
"30075",30,75,2014,1073,1040,33,3.1
"30075",30,75,2015,1054,1027,27,2.6
"30075",30,75,2016,1067,1042,25,2.3
"30075",30,75,2017,1014,988,26,2.6
"30077",30,77,1990,2658,2528,130,4.9
"30077",30,77,1991,2665,2493,172,6.5
"30077",30,77,1992,2614,2432,182,7
"30077",30,77,1993,2528,2301,227,9
"30077",30,77,1994,2542,2345,197,7.7
"30077",30,77,1995,2388,2206,182,7.6
"30077",30,77,1996,2439,2308,131,5.4
"30077",30,77,1997,2441,2306,135,5.5
"30077",30,77,1998,2498,2365,133,5.3
"30077",30,77,1999,2505,2378,127,5.1
"30077",30,77,2000,2878,2705,173,6
"30077",30,77,2001,2762,2608,154,5.6
"30077",30,77,2002,2758,2589,169,6.1
"30077",30,77,2003,2694,2530,164,6.1
"30077",30,77,2004,2684,2509,175,6.5
"30077",30,77,2005,2667,2496,171,6.4
"30077",30,77,2006,2662,2527,135,5.1
"30077",30,77,2007,2644,2503,141,5.3
"30077",30,77,2008,2757,2545,212,7.7
"30077",30,77,2009,2718,2470,248,9.1
"30077",30,77,2010,2959,2735,224,7.6
"30077",30,77,2011,2990,2761,229,7.7
"30077",30,77,2012,3015,2820,195,6.5
"30077",30,77,2013,2946,2782,164,5.6
"30077",30,77,2014,2931,2784,147,5
"30077",30,77,2015,2955,2824,131,4.4
"30077",30,77,2016,2866,2722,144,5
"30077",30,77,2017,2892,2766,126,4.4
"30079",30,79,1990,673,648,25,3.7
"30079",30,79,1991,658,633,25,3.8
"30079",30,79,1992,697,669,28,4
"30079",30,79,1993,650,624,26,4
"30079",30,79,1994,673,647,26,3.9
"30079",30,79,1995,658,629,29,4.4
"30079",30,79,1996,679,646,33,4.9
"30079",30,79,1997,658,621,37,5.6
"30079",30,79,1998,681,638,43,6.3
"30079",30,79,1999,676,648,28,4.1
"30079",30,79,2000,615,582,33,5.4
"30079",30,79,2001,594,563,31,5.2
"30079",30,79,2002,565,537,28,5
"30079",30,79,2003,539,513,26,4.8
"30079",30,79,2004,567,536,31,5.5
"30079",30,79,2005,553,525,28,5.1
"30079",30,79,2006,549,527,22,4
"30079",30,79,2007,545,526,19,3.5
"30079",30,79,2008,594,569,25,4.2
"30079",30,79,2009,589,565,24,4.1
"30079",30,79,2010,567,538,29,5.1
"30079",30,79,2011,531,502,29,5.5
"30079",30,79,2012,529,506,23,4.3
"30079",30,79,2013,521,497,24,4.6
"30079",30,79,2014,513,491,22,4.3
"30079",30,79,2015,528,506,22,4.2
"30079",30,79,2016,526,509,17,3.2
"30079",30,79,2017,499,481,18,3.6
"30081",30,81,1990,11783,10795,988,8.4
"30081",30,81,1991,12216,10928,1288,10.5
"30081",30,81,1992,13096,11905,1191,9.1
"30081",30,81,1993,13796,12619,1177,8.5
"30081",30,81,1994,14298,13446,852,6
"30081",30,81,1995,15320,14393,927,6.1
"30081",30,81,1996,16095,15115,980,6.1
"30081",30,81,1997,16430,15388,1042,6.3
"30081",30,81,1998,16848,15670,1178,7
"30081",30,81,1999,17370,16311,1059,6.1
"30081",30,81,2000,17050,16108,942,5.5
"30081",30,81,2001,17201,16339,862,5
"30081",30,81,2002,17494,16599,895,5.1
"30081",30,81,2003,17833,16792,1041,5.8
"30081",30,81,2004,18187,17128,1059,5.8
"30081",30,81,2005,18433,17473,960,5.2
"30081",30,81,2006,18645,17855,790,4.2
"30081",30,81,2007,18648,17813,835,4.5
"30081",30,81,2008,18791,17558,1233,6.6
"30081",30,81,2009,18263,16583,1680,9.2
"30081",30,81,2010,18864,17095,1769,9.4
"30081",30,81,2011,18660,16985,1675,9
"30081",30,81,2012,18716,17290,1426,7.6
"30081",30,81,2013,18747,17484,1263,6.7
"30081",30,81,2014,18752,17618,1134,6
"30081",30,81,2015,19190,18190,1000,5.2
"30081",30,81,2016,19556,18621,935,4.8
"30081",30,81,2017,19786,18864,922,4.7
"30083",30,83,1990,5348,5014,334,6.2
"30083",30,83,1991,5332,4950,382,7.2
"30083",30,83,1992,5406,5006,400,7.4
"30083",30,83,1993,5341,4963,378,7.1
"30083",30,83,1994,5453,5148,305,5.6
"30083",30,83,1995,5473,5170,303,5.5
"30083",30,83,1996,5438,5129,309,5.7
"30083",30,83,1997,5482,5196,286,5.2
"30083",30,83,1998,5625,5284,341,6.1
"30083",30,83,1999,5637,5243,394,7
"30083",30,83,2000,4963,4691,272,5.5
"30083",30,83,2001,4828,4602,226,4.7
"30083",30,83,2002,4785,4549,236,4.9
"30083",30,83,2003,4652,4441,211,4.5
"30083",30,83,2004,4894,4712,182,3.7
"30083",30,83,2005,5080,4902,178,3.5
"30083",30,83,2006,5107,4968,139,2.7
"30083",30,83,2007,5436,5305,131,2.4
"30083",30,83,2008,5566,5388,178,3.2
"30083",30,83,2009,5483,5223,260,4.7
"30083",30,83,2010,5763,5545,218,3.8
"30083",30,83,2011,6151,5961,190,3.1
"30083",30,83,2012,6714,6526,188,2.8
"30083",30,83,2013,7070,6885,185,2.6
"30083",30,83,2014,7312,7137,175,2.4
"30083",30,83,2015,6869,6647,222,3.2
"30083",30,83,2016,6209,5901,308,5
"30083",30,83,2017,6058,5830,228,3.8
"30085",30,85,1990,4532,4038,494,10.9
"30085",30,85,1991,4444,3963,481,10.8
"30085",30,85,1992,4404,3873,531,12.1
"30085",30,85,1993,4279,3896,383,9
"30085",30,85,1994,4423,4002,421,9.5
"30085",30,85,1995,4164,3741,423,10.2
"30085",30,85,1996,4064,3651,413,10.2
"30085",30,85,1997,3990,3633,357,8.9
"30085",30,85,1998,4083,3714,369,9
"30085",30,85,1999,4291,3865,426,9.9
"30085",30,85,2000,4253,3942,311,7.3
"30085",30,85,2001,4127,3886,241,5.8
"30085",30,85,2002,4071,3837,234,5.7
"30085",30,85,2003,4123,3874,249,6
"30085",30,85,2004,4112,3833,279,6.8
"30085",30,85,2005,4011,3739,272,6.8
"30085",30,85,2006,3891,3655,236,6.1
"30085",30,85,2007,3855,3614,241,6.3
"30085",30,85,2008,3979,3685,294,7.4
"30085",30,85,2009,4031,3718,313,7.8
"30085",30,85,2010,4583,4268,315,6.9
"30085",30,85,2011,4629,4301,328,7.1
"30085",30,85,2012,4821,4503,318,6.6
"30085",30,85,2013,4921,4650,271,5.5
"30085",30,85,2014,4811,4562,249,5.2
"30085",30,85,2015,4685,4439,246,5.3
"30085",30,85,2016,4683,4434,249,5.3
"30085",30,85,2017,4597,4382,215,4.7
"30087",30,87,1990,4909,4553,356,7.3
"30087",30,87,1991,5170,4794,376,7.3
"30087",30,87,1992,4885,4482,403,8.2
"30087",30,87,1993,4715,4350,365,7.7
"30087",30,87,1994,4819,4470,349,7.2
"30087",30,87,1995,4756,4335,421,8.9
"30087",30,87,1996,4588,4042,546,11.9
"30087",30,87,1997,4620,4221,399,8.6
"30087",30,87,1998,4279,3924,355,8.3
"30087",30,87,1999,4506,4160,346,7.7
"30087",30,87,2000,4266,4007,259,6.1
"30087",30,87,2001,4233,3983,250,5.9
"30087",30,87,2002,4006,3779,227,5.7
"30087",30,87,2003,4307,4069,238,5.5
"30087",30,87,2004,4298,4063,235,5.5
"30087",30,87,2005,4037,3794,243,6
"30087",30,87,2006,3864,3648,216,5.6
"30087",30,87,2007,3922,3718,204,5.2
"30087",30,87,2008,4046,3790,256,6.3
"30087",30,87,2009,4040,3768,272,6.7
"30087",30,87,2010,4358,4054,304,7
"30087",30,87,2011,4445,4121,324,7.3
"30087",30,87,2012,4454,4152,302,6.8
"30087",30,87,2013,4200,3931,269,6.4
"30087",30,87,2014,4167,3931,236,5.7
"30087",30,87,2015,4169,3946,223,5.3
"30087",30,87,2016,4105,3880,225,5.5
"30087",30,87,2017,4035,3826,209,5.2
"30089",30,89,1990,3750,3336,414,11
"30089",30,89,1991,3686,3133,553,15
"30089",30,89,1992,3746,3262,484,12.9
"30089",30,89,1993,3818,3348,470,12.3
"30089",30,89,1994,3898,3445,453,11.6
"30089",30,89,1995,4139,3574,565,13.7
"30089",30,89,1996,4091,3575,516,12.6
"30089",30,89,1997,4062,3629,433,10.7
"30089",30,89,1998,4033,3613,420,10.4
"30089",30,89,1999,4237,3843,394,9.3
"30089",30,89,2000,4398,4083,315,7.2
"30089",30,89,2001,4375,4061,314,7.2
"30089",30,89,2002,4400,4088,312,7.1
"30089",30,89,2003,4543,4210,333,7.3
"30089",30,89,2004,4660,4319,341,7.3
"30089",30,89,2005,4554,4238,316,6.9
"30089",30,89,2006,4659,4413,246,5.3
"30089",30,89,2007,4683,4374,309,6.6
"30089",30,89,2008,4687,4198,489,10.4
"30089",30,89,2009,4536,3830,706,15.6
"30089",30,89,2010,5000,4345,655,13.1
"30089",30,89,2011,4861,4212,649,13.4
"30089",30,89,2012,4795,4244,551,11.5
"30089",30,89,2013,4739,4243,496,10.5
"30089",30,89,2014,4629,4198,431,9.3
"30089",30,89,2015,4696,4306,390,8.3
"30089",30,89,2016,4752,4384,368,7.7
"30089",30,89,2017,4805,4471,334,7
"30091",30,91,1990,2059,1998,61,3
"30091",30,91,1991,2010,1961,49,2.4
"30091",30,91,1992,2138,2084,54,2.5
"30091",30,91,1993,2095,2059,36,1.7
"30091",30,91,1994,2168,2131,37,1.7
"30091",30,91,1995,2099,2040,59,2.8
"30091",30,91,1996,2058,2007,51,2.5
"30091",30,91,1997,2032,1975,57,2.8
"30091",30,91,1998,2142,2042,100,4.7
"30091",30,91,1999,2152,2031,121,5.6
"30091",30,91,2000,2014,1918,96,4.8
"30091",30,91,2001,1910,1833,77,4
"30091",30,91,2002,1831,1758,73,4
"30091",30,91,2003,1808,1732,76,4.2
"30091",30,91,2004,1795,1722,73,4.1
"30091",30,91,2005,1765,1699,66,3.7
"30091",30,91,2006,1714,1662,52,3
"30091",30,91,2007,1731,1684,47,2.7
"30091",30,91,2008,1842,1783,59,3.2
"30091",30,91,2009,1787,1710,77,4.3
"30091",30,91,2010,1819,1752,67,3.7
"30091",30,91,2011,1885,1818,67,3.6
"30091",30,91,2012,2059,1998,61,3
"30091",30,91,2013,2172,2111,61,2.8
"30091",30,91,2014,2125,2069,56,2.6
"30091",30,91,2015,2072,2020,52,2.5
"30091",30,91,2016,1959,1895,64,3.3
"30091",30,91,2017,1898,1846,52,2.7
"30093",30,93,1990,16103,14986,1117,6.9
"30093",30,93,1991,16013,14738,1275,8
"30093",30,93,1992,16469,15169,1300,7.9
"30093",30,93,1993,16672,15546,1126,6.8
"30093",30,93,1994,16960,16044,916,5.4
"30093",30,93,1995,16973,16028,945,5.6
"30093",30,93,1996,17068,16064,1004,5.9
"30093",30,93,1997,17334,16465,869,5
"30093",30,93,1998,17773,16752,1021,5.7
"30093",30,93,1999,17318,16345,973,5.6
"30093",30,93,2000,17143,16114,1029,6
"30093",30,93,2001,16994,16114,880,5.2
"30093",30,93,2002,17014,16160,854,5
"30093",30,93,2003,16974,16098,876,5.2
"30093",30,93,2004,17243,16359,884,5.1
"30093",30,93,2005,17258,16480,778,4.5
"30093",30,93,2006,17291,16641,650,3.8
"30093",30,93,2007,17398,16765,633,3.6
"30093",30,93,2008,17834,16969,865,4.9
"30093",30,93,2009,17242,16157,1085,6.3
"30093",30,93,2010,16952,15846,1106,6.5
"30093",30,93,2011,16956,15838,1118,6.6
"30093",30,93,2012,17215,16170,1045,6.1
"30093",30,93,2013,17176,16237,939,5.5
"30093",30,93,2014,16985,16147,838,4.9
"30093",30,93,2015,17103,16370,733,4.3
"30093",30,93,2016,17180,16445,735,4.3
"30093",30,93,2017,17149,16426,723,4.2
"30095",30,95,1990,3307,3178,129,3.9
"30095",30,95,1991,3198,2929,269,8.4
"30095",30,95,1992,3251,3046,205,6.3
"30095",30,95,1993,3342,3207,135,4
"30095",30,95,1994,3483,3327,156,4.5
"30095",30,95,1995,3768,3589,179,4.8
"30095",30,95,1996,3968,3787,181,4.6
"30095",30,95,1997,4043,3823,220,5.4
"30095",30,95,1998,4156,3959,197,4.7
"30095",30,95,1999,4668,4473,195,4.2
"30095",30,95,2000,4408,4201,207,4.7
"30095",30,95,2001,4632,4460,172,3.7
"30095",30,95,2002,4481,4301,180,4
"30095",30,95,2003,4334,4165,169,3.9
"30095",30,95,2004,4503,4328,175,3.9
"30095",30,95,2005,4386,4232,154,3.5
"30095",30,95,2006,4435,4309,126,2.8
"30095",30,95,2007,4508,4366,142,3.1
"30095",30,95,2008,4614,4409,205,4.4
"30095",30,95,2009,4473,4197,276,6.2
"30095",30,95,2010,4762,4484,278,5.8
"30095",30,95,2011,4824,4573,251,5.2
"30095",30,95,2012,4954,4732,222,4.5
"30095",30,95,2013,5064,4860,204,4
"30095",30,95,2014,4987,4800,187,3.7
"30095",30,95,2015,4922,4738,184,3.7
"30095",30,95,2016,4807,4616,191,4
"30095",30,95,2017,4839,4652,187,3.9
"30097",30,97,1990,1539,1501,38,2.5
"30097",30,97,1991,1540,1480,60,3.9
"30097",30,97,1992,1608,1560,48,3
"30097",30,97,1993,1643,1598,45,2.7
"30097",30,97,1994,1703,1654,49,2.9
"30097",30,97,1995,1687,1628,59,3.5
"30097",30,97,1996,1712,1662,50,2.9
"30097",30,97,1997,1711,1647,64,3.7
"30097",30,97,1998,1773,1694,79,4.5
"30097",30,97,1999,1785,1724,61,3.4
"30097",30,97,2000,1984,1918,66,3.3
"30097",30,97,2001,2039,1978,61,3
"30097",30,97,2002,2136,2072,64,3
"30097",30,97,2003,2271,2213,58,2.6
"30097",30,97,2004,2640,2578,62,2.3
"30097",30,97,2005,2744,2684,60,2.2
"30097",30,97,2006,2816,2767,49,1.7
"30097",30,97,2007,2920,2866,54,1.8
"30097",30,97,2008,2877,2799,78,2.7
"30097",30,97,2009,2422,2310,112,4.6
"30097",30,97,2010,1738,1643,95,5.5
"30097",30,97,2011,1703,1623,80,4.7
"30097",30,97,2012,1747,1679,68,3.9
"30097",30,97,2013,1769,1703,66,3.7
"30097",30,97,2014,1778,1715,63,3.5
"30097",30,97,2015,1786,1736,50,2.8
"30097",30,97,2016,1795,1740,55,3.1
"30097",30,97,2017,1788,1732,56,3.1
"30099",30,99,1990,2966,2878,88,3
"30099",30,99,1991,2932,2814,118,4
"30099",30,99,1992,2885,2792,93,3.2
"30099",30,99,1993,2776,2711,65,2.3
"30099",30,99,1994,2894,2813,81,2.8
"30099",30,99,1995,3040,2941,99,3.3
"30099",30,99,1996,3149,3042,107,3.4
"30099",30,99,1997,3072,2983,89,2.9
"30099",30,99,1998,3250,3126,124,3.8
"30099",30,99,1999,3445,3321,124,3.6
"30099",30,99,2000,2970,2835,135,4.5
"30099",30,99,2001,2918,2804,114,3.9
"30099",30,99,2002,2902,2793,109,3.8
"30099",30,99,2003,2938,2821,117,4
"30099",30,99,2004,2984,2860,124,4.2
"30099",30,99,2005,3006,2895,111,3.7
"30099",30,99,2006,3024,2929,95,3.1
"30099",30,99,2007,3063,2968,95,3.1
"30099",30,99,2008,3112,2980,132,4.2
"30099",30,99,2009,3024,2874,150,5
"30099",30,99,2010,3030,2849,181,6
"30099",30,99,2011,2941,2774,167,5.7
"30099",30,99,2012,2940,2797,143,4.9
"30099",30,99,2013,2953,2826,127,4.3
"30099",30,99,2014,2876,2768,108,3.8
"30099",30,99,2015,2886,2775,111,3.8
"30099",30,99,2016,2827,2725,102,3.6
"30099",30,99,2017,2778,2668,110,4
"30101",30,101,1990,2644,2563,81,3.1
"30101",30,101,1991,2599,2491,108,4.2
"30101",30,101,1992,2738,2637,101,3.7
"30101",30,101,1993,2786,2683,103,3.7
"30101",30,101,1994,2881,2772,109,3.8
"30101",30,101,1995,2820,2674,146,5.2
"30101",30,101,1996,2826,2719,107,3.8
"30101",30,101,1997,2781,2688,93,3.3
"30101",30,101,1998,2852,2748,104,3.6
"30101",30,101,1999,2940,2827,113,3.8
"30101",30,101,2000,2519,2412,107,4.2
"30101",30,101,2001,2424,2338,86,3.5
"30101",30,101,2002,2346,2264,82,3.5
"30101",30,101,2003,2527,2437,90,3.6
"30101",30,101,2004,2573,2481,92,3.6
"30101",30,101,2005,2536,2449,87,3.4
"30101",30,101,2006,2479,2410,69,2.8
"30101",30,101,2007,2454,2392,62,2.5
"30101",30,101,2008,2601,2515,86,3.3
"30101",30,101,2009,2523,2414,109,4.3
"30101",30,101,2010,2448,2336,112,4.6
"30101",30,101,2011,2387,2276,111,4.7
"30101",30,101,2012,2501,2395,106,4.2
"30101",30,101,2013,2387,2295,92,3.9
"30101",30,101,2014,2343,2272,71,3
"30101",30,101,2015,2295,2217,78,3.4
"30101",30,101,2016,2224,2147,77,3.5
"30101",30,101,2017,2156,2089,67,3.1
"30103",30,103,1990,480,463,17,3.5
"30103",30,103,1991,486,468,18,3.7
"30103",30,103,1992,540,507,33,6.1
"30103",30,103,1993,457,439,18,3.9
"30103",30,103,1994,473,459,14,3
"30103",30,103,1995,434,419,15,3.5
"30103",30,103,1996,445,429,16,3.6
"30103",30,103,1997,434,417,17,3.9
"30103",30,103,1998,473,448,25,5.3
"30103",30,103,1999,501,480,21,4.2
"30103",30,103,2000,456,434,22,4.8
"30103",30,103,2001,439,424,15,3.4
"30103",30,103,2002,400,384,16,4
"30103",30,103,2003,432,416,16,3.7
"30103",30,103,2004,417,397,20,4.8
"30103",30,103,2005,407,390,17,4.2
"30103",30,103,2006,396,383,13,3.3
"30103",30,103,2007,405,392,13,3.2
"30103",30,103,2008,406,389,17,4.2
"30103",30,103,2009,401,380,21,5.2
"30103",30,103,2010,398,377,21,5.3
"30103",30,103,2011,378,357,21,5.6
"30103",30,103,2012,379,360,19,5
"30103",30,103,2013,355,339,16,4.5
"30103",30,103,2014,346,332,14,4
"30103",30,103,2015,357,339,18,5
"30103",30,103,2016,353,338,15,4.2
"30103",30,103,2017,345,332,13,3.8
"30105",30,105,1990,4169,3987,182,4.4
"30105",30,105,1991,4204,3985,219,5.2
"30105",30,105,1992,4244,4015,229,5.4
"30105",30,105,1993,4162,3973,189,4.5
"30105",30,105,1994,4275,4111,164,3.8
"30105",30,105,1995,4267,4085,182,4.3
"30105",30,105,1996,4408,4215,193,4.4
"30105",30,105,1997,4348,4170,178,4.1
"30105",30,105,1998,4426,4234,192,4.3
"30105",30,105,1999,4278,4078,200,4.7
"30105",30,105,2000,3838,3661,177,4.6
"30105",30,105,2001,3702,3548,154,4.2
"30105",30,105,2002,3683,3536,147,4
"30105",30,105,2003,3791,3634,157,4.1
"30105",30,105,2004,3735,3568,167,4.5
"30105",30,105,2005,3628,3475,153,4.2
"30105",30,105,2006,3577,3459,118,3.3
"30105",30,105,2007,3637,3511,126,3.5
"30105",30,105,2008,3656,3498,158,4.3
"30105",30,105,2009,3588,3400,188,5.2
"30105",30,105,2010,3910,3719,191,4.9
"30105",30,105,2011,3937,3752,185,4.7
"30105",30,105,2012,4024,3857,167,4.2
"30105",30,105,2013,4244,4083,161,3.8
"30105",30,105,2014,4355,4223,132,3
"30105",30,105,2015,4383,4246,137,3.1
"30105",30,105,2016,4401,4252,149,3.4
"30105",30,105,2017,4188,4051,137,3.3
"30107",30,107,1990,1129,1083,46,4.1
"30107",30,107,1991,1123,1062,61,5.4
"30107",30,107,1992,1180,1138,42,3.6
"30107",30,107,1993,1144,1095,49,4.3
"30107",30,107,1994,1189,1138,51,4.3
"30107",30,107,1995,1306,1242,64,4.9
"30107",30,107,1996,1363,1304,59,4.3
"30107",30,107,1997,1350,1290,60,4.4
"30107",30,107,1998,1367,1274,93,6.8
"30107",30,107,1999,1258,1182,76,6
"30107",30,107,2000,1120,1064,56,5
"30107",30,107,2001,1086,1042,44,4.1
"30107",30,107,2002,1009,958,51,5.1
"30107",30,107,2003,1016,968,48,4.7
"30107",30,107,2004,1049,1000,49,4.7
"30107",30,107,2005,1023,979,44,4.3
"30107",30,107,2006,1009,979,30,3
"30107",30,107,2007,1038,1003,35,3.4
"30107",30,107,2008,1098,1053,45,4.1
"30107",30,107,2009,1044,984,60,5.7
"30107",30,107,2010,861,793,68,7.9
"30107",30,107,2011,837,770,67,8
"30107",30,107,2012,838,785,53,6.3
"30107",30,107,2013,824,773,51,6.2
"30107",30,107,2014,781,742,39,5
"30107",30,107,2015,787,744,43,5.5
"30107",30,107,2016,796,756,40,5
"30107",30,107,2017,781,747,34,4.4
"30109",30,109,1990,529,512,17,3.2
"30109",30,109,1991,522,489,33,6.3
"30109",30,109,1992,536,506,30,5.6
"30109",30,109,1993,554,534,20,3.6
"30109",30,109,1994,585,552,33,5.6
"30109",30,109,1995,572,547,25,4.4
"30109",30,109,1996,572,550,22,3.8
"30109",30,109,1997,564,544,20,3.5
"30109",30,109,1998,600,563,37,6.2
"30109",30,109,1999,584,560,24,4.1
"30109",30,109,2000,549,524,25,4.6
"30109",30,109,2001,517,499,18,3.5
"30109",30,109,2002,504,485,19,3.8
"30109",30,109,2003,502,481,21,4.2
"30109",30,109,2004,515,495,20,3.9
"30109",30,109,2005,493,475,18,3.7
"30109",30,109,2006,497,483,14,2.8
"30109",30,109,2007,515,501,14,2.7
"30109",30,109,2008,533,514,19,3.6
"30109",30,109,2009,574,547,27,4.7
"30109",30,109,2010,529,507,22,4.2
"30109",30,109,2011,526,504,22,4.2
"30109",30,109,2012,561,543,18,3.2
"30109",30,109,2013,558,539,19,3.4
"30109",30,109,2014,549,533,16,2.9
"30109",30,109,2015,545,527,18,3.3
"30109",30,109,2016,512,492,20,3.9
"30109",30,109,2017,492,476,16,3.3
"30111",30,111,1990,61969,58862,3107,5
"30111",30,111,1991,62438,59124,3314,5.3
"30111",30,111,1992,64563,61020,3543,5.5
"30111",30,111,1993,65155,62013,3142,4.8
"30111",30,111,1994,66874,64115,2759,4.1
"30111",30,111,1995,67788,64657,3131,4.6
"30111",30,111,1996,67753,64711,3042,4.5
"30111",30,111,1997,68260,65175,3085,4.5
"30111",30,111,1998,69240,66232,3008,4.3
"30111",30,111,1999,70405,67538,2867,4.1
"30111",30,111,2000,71223,68198,3025,4.2
"30111",30,111,2001,71814,69208,2606,3.6
"30111",30,111,2002,74555,71916,2639,3.5
"30111",30,111,2003,75259,72484,2775,3.7
"30111",30,111,2004,76635,73715,2920,3.8
"30111",30,111,2005,78579,75801,2778,3.5
"30111",30,111,2006,79565,77278,2287,2.9
"30111",30,111,2007,81465,79262,2203,2.7
"30111",30,111,2008,82535,79407,3128,3.8
"30111",30,111,2009,81872,77821,4051,4.9
"30111",30,111,2010,76415,71920,4495,5.9
"30111",30,111,2011,77147,72938,4209,5.5
"30111",30,111,2012,78680,75067,3613,4.6
"30111",30,111,2013,79268,75831,3437,4.3
"30111",30,111,2014,79298,76349,2949,3.7
"30111",30,111,2015,80651,77979,2672,3.3
"30111",30,111,2016,81129,78211,2918,3.6
"30111",30,111,2017,81485,78627,2858,3.5
"31001",31,1,1990,15024,14757,267,1.8
"31001",31,1,1991,15155,14844,311,2.1
"31001",31,1,1992,15459,15170,289,1.9
"31001",31,1,1993,15470,15197,273,1.8
"31001",31,1,1994,15798,15549,249,1.6
"31001",31,1,1995,15886,15650,236,1.5
"31001",31,1,1996,16079,15790,289,1.8
"31001",31,1,1997,15947,15651,296,1.9
"31001",31,1,1998,15944,15619,325,2
"31001",31,1,1999,16078,15728,350,2.2
"31001",31,1,2000,17249,16804,445,2.6
"31001",31,1,2001,17101,16578,523,3.1
"31001",31,1,2002,16962,16357,605,3.6
"31001",31,1,2003,16792,16106,686,4.1
"31001",31,1,2004,16997,16353,644,3.8
"31001",31,1,2005,17027,16449,578,3.4
"31001",31,1,2006,16764,16274,490,2.9
"31001",31,1,2007,17374,16903,471,2.7
"31001",31,1,2008,17708,17164,544,3.1
"31001",31,1,2009,17593,16704,889,5.1
"31001",31,1,2010,16494,15713,781,4.7
"31001",31,1,2011,16487,15777,710,4.3
"31001",31,1,2012,16887,16242,645,3.8
"31001",31,1,2013,16963,16346,617,3.6
"31001",31,1,2014,16708,16144,564,3.4
"31001",31,1,2015,16611,16091,520,3.1
"31001",31,1,2016,16628,16105,523,3.1
"31001",31,1,2017,16548,16034,514,3.1
"31003",31,3,1990,3400,3336,64,1.9
"31003",31,3,1991,3377,3306,71,2.1
"31003",31,3,1992,3325,3241,84,2.5
"31003",31,3,1993,3267,3174,93,2.8
"31003",31,3,1994,3344,3221,123,3.7
"31003",31,3,1995,3315,3190,125,3.8
"31003",31,3,1996,3197,3068,129,4
"31003",31,3,1997,3010,2914,96,3.2
"31003",31,3,1998,3031,2926,105,3.5
"31003",31,3,1999,3165,3054,111,3.5
"31003",31,3,2000,3980,3869,111,2.8
"31003",31,3,2001,3875,3753,122,3.1
"31003",31,3,2002,3916,3795,121,3.1
"31003",31,3,2003,3985,3854,131,3.3
"31003",31,3,2004,3930,3799,131,3.3
"31003",31,3,2005,3859,3729,130,3.4
"31003",31,3,2006,3759,3652,107,2.8
"31003",31,3,2007,3631,3528,103,2.8
"31003",31,3,2008,3649,3540,109,3
"31003",31,3,2009,3738,3599,139,3.7
"31003",31,3,2010,3526,3400,126,3.6
"31003",31,3,2011,3598,3467,131,3.6
"31003",31,3,2012,3581,3464,117,3.3
"31003",31,3,2013,3619,3503,116,3.2
"31003",31,3,2014,3589,3492,97,2.7
"31003",31,3,2015,3595,3503,92,2.6
"31003",31,3,2016,3587,3493,94,2.6
"31003",31,3,2017,3531,3443,88,2.5
"31005",31,5,1990,235,231,4,1.7
"31005",31,5,1991,222,217,5,2.3
"31005",31,5,1992,224,219,5,2.2
"31005",31,5,1993,222,219,3,1.4
"31005",31,5,1994,228,223,5,2.2
"31005",31,5,1995,211,203,8,3.8
"31005",31,5,1996,210,204,6,2.9
"31005",31,5,1997,214,208,6,2.8
"31005",31,5,1998,207,203,4,1.9
"31005",31,5,1999,201,197,4,2
"31005",31,5,2000,272,266,6,2.2
"31005",31,5,2001,275,266,9,3.3
"31005",31,5,2002,243,232,11,4.5
"31005",31,5,2003,248,235,13,5.2
"31005",31,5,2004,237,227,10,4.2
"31005",31,5,2005,257,247,10,3.9
"31005",31,5,2006,254,245,9,3.5
"31005",31,5,2007,238,229,9,3.8
"31005",31,5,2008,242,233,9,3.7
"31005",31,5,2009,242,228,14,5.8
"31005",31,5,2010,226,208,18,8
"31005",31,5,2011,231,217,14,6.1
"31005",31,5,2012,230,215,15,6.5
"31005",31,5,2013,221,204,17,7.7
"31005",31,5,2014,224,212,12,5.4
"31005",31,5,2015,224,214,10,4.5
"31005",31,5,2016,227,214,13,5.7
"31005",31,5,2017,223,211,12,5.4
"31007",31,7,1990,423,418,5,1.2
"31007",31,7,1991,408,401,7,1.7
"31007",31,7,1992,421,414,7,1.7
"31007",31,7,1993,423,418,5,1.2
"31007",31,7,1994,429,418,11,2.6
"31007",31,7,1995,421,407,14,3.3
"31007",31,7,1996,433,425,8,1.8
"31007",31,7,1997,437,430,7,1.6
"31007",31,7,1998,447,436,11,2.5
"31007",31,7,1999,432,421,11,2.5
"31007",31,7,2000,428,415,13,3
"31007",31,7,2001,419,410,9,2.1
"31007",31,7,2002,397,386,11,2.8
"31007",31,7,2003,398,388,10,2.5
"31007",31,7,2004,409,395,14,3.4
"31007",31,7,2005,388,377,11,2.8
"31007",31,7,2006,418,408,10,2.4
"31007",31,7,2007,403,395,8,2
"31007",31,7,2008,401,391,10,2.5
"31007",31,7,2009,352,340,12,3.4
"31007",31,7,2010,413,395,18,4.4
"31007",31,7,2011,433,413,20,4.6
"31007",31,7,2012,438,418,20,4.6
"31007",31,7,2013,437,417,20,4.6
"31007",31,7,2014,436,420,16,3.7
"31007",31,7,2015,440,425,15,3.4
"31007",31,7,2016,416,402,14,3.4
"31007",31,7,2017,397,382,15,3.8
"31009",31,9,1990,381,374,7,1.8
"31009",31,9,1991,383,369,14,3.7
"31009",31,9,1992,366,352,14,3.8
"31009",31,9,1993,342,327,15,4.4
"31009",31,9,1994,342,328,14,4.1
"31009",31,9,1995,367,355,12,3.3
"31009",31,9,1996,362,348,14,3.9
"31009",31,9,1997,331,324,7,2.1
"31009",31,9,1998,366,358,8,2.2
"31009",31,9,1999,392,383,9,2.3
"31009",31,9,2000,319,308,11,3.4
"31009",31,9,2001,315,307,8,2.5
"31009",31,9,2002,289,279,10,3.5
"31009",31,9,2003,296,286,10,3.4
"31009",31,9,2004,285,275,10,3.5
"31009",31,9,2005,285,274,11,3.9
"31009",31,9,2006,270,262,8,3
"31009",31,9,2007,238,229,9,3.8
"31009",31,9,2008,244,232,12,4.9
"31009",31,9,2009,261,247,14,5.4
"31009",31,9,2010,258,245,13,5
"31009",31,9,2011,280,265,15,5.4
"31009",31,9,2012,284,269,15,5.3
"31009",31,9,2013,272,258,14,5.1
"31009",31,9,2014,275,263,12,4.4
"31009",31,9,2015,268,256,12,4.5
"31009",31,9,2016,265,253,12,4.5
"31009",31,9,2017,262,251,11,4.2
"31011",31,11,1990,3053,3020,33,1.1
"31011",31,11,1991,3019,2980,39,1.3
"31011",31,11,1992,2999,2937,62,2.1
"31011",31,11,1993,2920,2867,53,1.8
"31011",31,11,1994,2895,2844,51,1.8
"31011",31,11,1995,2936,2878,58,2
"31011",31,11,1996,2966,2890,76,2.6
"31011",31,11,1997,2828,2776,52,1.8
"31011",31,11,1998,2899,2831,68,2.3
"31011",31,11,1999,3006,2926,80,2.7
"31011",31,11,2000,3228,3148,80,2.5
"31011",31,11,2001,3200,3100,100,3.1
"31011",31,11,2002,3249,3151,98,3
"31011",31,11,2003,3270,3166,104,3.2
"31011",31,11,2004,3219,3116,103,3.2
"31011",31,11,2005,3166,3058,108,3.4
"31011",31,11,2006,3164,3083,81,2.6
"31011",31,11,2007,3169,3092,77,2.4
"31011",31,11,2008,3255,3170,85,2.6
"31011",31,11,2009,3342,3228,114,3.4
"31011",31,11,2010,2959,2855,104,3.5
"31011",31,11,2011,3041,2930,111,3.7
"31011",31,11,2012,3042,2948,94,3.1
"31011",31,11,2013,3060,2960,100,3.3
"31011",31,11,2014,3022,2943,79,2.6
"31011",31,11,2015,3011,2937,74,2.5
"31011",31,11,2016,2999,2920,79,2.6
"31011",31,11,2017,2914,2842,72,2.5
"31013",31,13,1990,6331,6139,192,3
"31013",31,13,1991,6199,5965,234,3.8
"31013",31,13,1992,6209,6000,209,3.4
"31013",31,13,1993,6256,6051,205,3.3
"31013",31,13,1994,6243,6005,238,3.8
"31013",31,13,1995,6335,6050,285,4.5
"31013",31,13,1996,6186,5843,343,5.5
"31013",31,13,1997,6409,6088,321,5
"31013",31,13,1998,6659,6340,319,4.8
"31013",31,13,1999,6621,6306,315,4.8
"31013",31,13,2000,6422,6170,252,3.9
"31013",31,13,2001,5813,5559,254,4.4
"31013",31,13,2002,5702,5433,269,4.7
"31013",31,13,2003,5659,5392,267,4.7
"31013",31,13,2004,5586,5362,224,4
"31013",31,13,2005,5614,5392,222,4
"31013",31,13,2006,5527,5358,169,3.1
"31013",31,13,2007,5613,5433,180,3.2
"31013",31,13,2008,5630,5420,210,3.7
"31013",31,13,2009,5641,5269,372,6.6
"31013",31,13,2010,5852,5561,291,5
"31013",31,13,2011,5981,5728,253,4.2
"31013",31,13,2012,5977,5737,240,4
"31013",31,13,2013,5988,5757,231,3.9
"31013",31,13,2014,5741,5561,180,3.1
"31013",31,13,2015,5660,5490,170,3
"31013",31,13,2016,5635,5431,204,3.6
"31013",31,13,2017,5566,5384,182,3.3
"31015",31,15,1990,1201,1183,18,1.5
"31015",31,15,1991,1213,1195,18,1.5
"31015",31,15,1992,1218,1196,22,1.8
"31015",31,15,1993,1198,1159,39,3.3
"31015",31,15,1994,1229,1193,36,2.9
"31015",31,15,1995,1232,1203,29,2.4
"31015",31,15,1996,1201,1174,27,2.2
"31015",31,15,1997,1145,1115,30,2.6
"31015",31,15,1998,1111,1083,28,2.5
"31015",31,15,1999,1152,1112,40,3.5
"31015",31,15,2000,1255,1218,37,2.9
"31015",31,15,2001,1237,1194,43,3.5
"31015",31,15,2002,1262,1218,44,3.5
"31015",31,15,2003,1286,1247,39,3
"31015",31,15,2004,1198,1160,38,3.2
"31015",31,15,2005,1134,1093,41,3.6
"31015",31,15,2006,1118,1082,36,3.2
"31015",31,15,2007,1075,1043,32,3
"31015",31,15,2008,1110,1074,36,3.2
"31015",31,15,2009,1132,1088,44,3.9
"31015",31,15,2010,1107,1064,43,3.9
"31015",31,15,2011,1149,1105,44,3.8
"31015",31,15,2012,1147,1102,45,3.9
"31015",31,15,2013,1130,1090,40,3.5
"31015",31,15,2014,1099,1063,36,3.3
"31015",31,15,2015,1089,1060,29,2.7
"31015",31,15,2016,1097,1064,33,3
"31015",31,15,2017,1078,1042,36,3.3
"31017",31,17,1990,1662,1639,23,1.4
"31017",31,17,1991,1704,1659,45,2.6
"31017",31,17,1992,1766,1711,55,3.1
"31017",31,17,1993,1790,1728,62,3.5
"31017",31,17,1994,1868,1803,65,3.5
"31017",31,17,1995,1888,1813,75,4
"31017",31,17,1996,1790,1711,79,4.4
"31017",31,17,1997,1776,1726,50,2.8
"31017",31,17,1998,1769,1719,50,2.8
"31017",31,17,1999,1807,1735,72,4
"31017",31,17,2000,1920,1857,63,3.3
"31017",31,17,2001,1895,1830,65,3.4
"31017",31,17,2002,1898,1832,66,3.5
"31017",31,17,2003,1911,1837,74,3.9
"31017",31,17,2004,1916,1852,64,3.3
"31017",31,17,2005,1923,1861,62,3.2
"31017",31,17,2006,1903,1848,55,2.9
"31017",31,17,2007,1813,1765,48,2.6
"31017",31,17,2008,1847,1798,49,2.7
"31017",31,17,2009,1839,1782,57,3.1
"31017",31,17,2010,1461,1393,68,4.7
"31017",31,17,2011,1464,1397,67,4.6
"31017",31,17,2012,1453,1394,59,4.1
"31017",31,17,2013,1437,1381,56,3.9
"31017",31,17,2014,1419,1370,49,3.5
"31017",31,17,2015,1394,1342,52,3.7
"31017",31,17,2016,1378,1327,51,3.7
"31017",31,17,2017,1387,1342,45,3.2
"31019",31,19,1990,20764,20253,511,2.5
"31019",31,19,1991,21099,20514,585,2.8
"31019",31,19,1992,22206,21587,619,2.8
"31019",31,19,1993,22827,22262,565,2.5
"31019",31,19,1994,23775,23172,603,2.5
"31019",31,19,1995,23813,23197,616,2.6
"31019",31,19,1996,24078,23437,641,2.7
"31019",31,19,1997,24347,23746,601,2.5
"31019",31,19,1998,24497,23835,662,2.7
"31019",31,19,1999,25257,24466,791,3.1
"31019",31,19,2000,24905,24331,574,2.3
"31019",31,19,2001,25082,24484,598,2.4
"31019",31,19,2002,26103,25438,665,2.5
"31019",31,19,2003,26425,25697,728,2.8
"31019",31,19,2004,26767,25994,773,2.9
"31019",31,19,2005,27034,26283,751,2.8
"31019",31,19,2006,27455,26831,624,2.3
"31019",31,19,2007,28042,27414,628,2.2
"31019",31,19,2008,27875,27178,697,2.5
"31019",31,19,2009,27704,26703,1001,3.6
"31019",31,19,2010,26386,25429,957,3.6
"31019",31,19,2011,26864,25922,942,3.5
"31019",31,19,2012,27306,26405,901,3.3
"31019",31,19,2013,27441,26553,888,3.2
"31019",31,19,2014,27465,26707,758,2.8
"31019",31,19,2015,27134,26472,662,2.4
"31019",31,19,2016,27171,26488,683,2.5
"31019",31,19,2017,27050,26392,658,2.4
"31021",31,21,1990,3542,3442,100,2.8
"31021",31,21,1991,3572,3444,128,3.6
"31021",31,21,1992,3516,3371,145,4.1
"31021",31,21,1993,3631,3489,142,3.9
"31021",31,21,1994,3695,3556,139,3.8
"31021",31,21,1995,3618,3477,141,3.9
"31021",31,21,1996,3536,3391,145,4.1
"31021",31,21,1997,3600,3478,122,3.4
"31021",31,21,1998,3612,3483,129,3.6
"31021",31,21,1999,3566,3408,158,4.4
"31021",31,21,2000,4130,3977,153,3.7
"31021",31,21,2001,4081,3926,155,3.8
"31021",31,21,2002,4054,3861,193,4.8
"31021",31,21,2003,4045,3839,206,5.1
"31021",31,21,2004,3958,3753,205,5.2
"31021",31,21,2005,3874,3683,191,4.9
"31021",31,21,2006,3894,3734,160,4.1
"31021",31,21,2007,3910,3754,156,4
"31021",31,21,2008,3963,3797,166,4.2
"31021",31,21,2009,3998,3776,222,5.6
"31021",31,21,2010,3641,3425,216,5.9
"31021",31,21,2011,3638,3429,209,5.7
"31021",31,21,2012,3678,3504,174,4.7
"31021",31,21,2013,3658,3492,166,4.5
"31021",31,21,2014,3580,3440,140,3.9
"31021",31,21,2015,3609,3478,131,3.6
"31021",31,21,2016,3540,3409,131,3.7
"31021",31,21,2017,3477,3348,129,3.7
"31023",31,23,1990,4049,3962,87,2.1
"31023",31,23,1991,4038,3916,122,3
"31023",31,23,1992,4064,3944,120,3
"31023",31,23,1993,4031,3907,124,3.1
"31023",31,23,1994,4210,4108,102,2.4
"31023",31,23,1995,4377,4265,112,2.6
"31023",31,23,1996,4316,4204,112,2.6
"31023",31,23,1997,4234,4132,102,2.4
"31023",31,23,1998,4273,4153,120,2.8
"31023",31,23,1999,4324,4200,124,2.9
"31023",31,23,2000,4702,4569,133,2.8
"31023",31,23,2001,4706,4553,153,3.3
"31023",31,23,2002,4644,4456,188,4
"31023",31,23,2003,4690,4490,200,4.3
"31023",31,23,2004,4729,4534,195,4.1
"31023",31,23,2005,4695,4524,171,3.6
"31023",31,23,2006,4730,4601,129,2.7
"31023",31,23,2007,4831,4709,122,2.5
"31023",31,23,2008,4911,4769,142,2.9
"31023",31,23,2009,4750,4551,199,4.2
"31023",31,23,2010,4651,4469,182,3.9
"31023",31,23,2011,4745,4566,179,3.8
"31023",31,23,2012,4744,4586,158,3.3
"31023",31,23,2013,4791,4629,162,3.4
"31023",31,23,2014,4825,4682,143,3
"31023",31,23,2015,4738,4606,132,2.8
"31023",31,23,2016,4619,4470,149,3.2
"31023",31,23,2017,4544,4418,126,2.8
"31025",31,25,1990,10610,10295,315,3
"31025",31,25,1991,10674,10307,367,3.4
"31025",31,25,1992,10873,10502,371,3.4
"31025",31,25,1993,11091,10728,363,3.3
"31025",31,25,1994,11504,11172,332,2.9
"31025",31,25,1995,11886,11546,340,2.9
"31025",31,25,1996,12348,11983,365,3
"31025",31,25,1997,12666,12334,332,2.6
"31025",31,25,1998,13023,12717,306,2.3
"31025",31,25,1999,13211,12892,319,2.4
"31025",31,25,2000,13555,13177,378,2.8
"31025",31,25,2001,13638,13201,437,3.2
"31025",31,25,2002,13695,13204,491,3.6
"31025",31,25,2003,13870,13313,557,4
"31025",31,25,2004,14004,13430,574,4.1
"31025",31,25,2005,14017,13440,577,4.1
"31025",31,25,2006,13988,13516,472,3.4
"31025",31,25,2007,13876,13417,459,3.3
"31025",31,25,2008,13990,13471,519,3.7
"31025",31,25,2009,13741,13025,716,5.2
"31025",31,25,2010,13404,12649,755,5.6
"31025",31,25,2011,13380,12679,701,5.2
"31025",31,25,2012,13313,12694,619,4.6
"31025",31,25,2013,13321,12743,578,4.3
"31025",31,25,2014,13230,12737,493,3.7
"31025",31,25,2015,13069,12635,434,3.3
"31025",31,25,2016,13122,12679,443,3.4
"31025",31,25,2017,13144,12729,415,3.2
"31027",31,27,1990,4790,4719,71,1.5
"31027",31,27,1991,4928,4833,95,1.9
"31027",31,27,1992,4970,4882,88,1.8
"31027",31,27,1993,4897,4796,101,2.1
"31027",31,27,1994,5234,5122,112,2.1
"31027",31,27,1995,5207,5094,113,2.2
"31027",31,27,1996,5098,4990,108,2.1
"31027",31,27,1997,4820,4719,101,2.1
"31027",31,27,1998,4817,4687,130,2.7
"31027",31,27,1999,4737,4609,128,2.7
"31027",31,27,2000,5040,4915,125,2.5
"31027",31,27,2001,5016,4890,126,2.5
"31027",31,27,2002,5070,4939,131,2.6
"31027",31,27,2003,5032,4875,157,3.1
"31027",31,27,2004,5078,4933,145,2.9
"31027",31,27,2005,4989,4853,136,2.7
"31027",31,27,2006,4908,4794,114,2.3
"31027",31,27,2007,4776,4660,116,2.4
"31027",31,27,2008,4829,4707,122,2.5
"31027",31,27,2009,4844,4668,176,3.6
"31027",31,27,2010,4627,4462,165,3.6
"31027",31,27,2011,4709,4554,155,3.3
"31027",31,27,2012,4741,4603,138,2.9
"31027",31,27,2013,4733,4593,140,3
"31027",31,27,2014,4665,4557,108,2.3
"31027",31,27,2015,4642,4531,111,2.4
"31027",31,27,2016,4562,4445,117,2.6
"31027",31,27,2017,4452,4351,101,2.3
"31029",31,29,1990,1928,1908,20,1
"31029",31,29,1991,1968,1931,37,1.9
"31029",31,29,1992,1924,1885,39,2
"31029",31,29,1993,1908,1862,46,2.4
"31029",31,29,1994,1950,1908,42,2.2
"31029",31,29,1995,2014,1971,43,2.1
"31029",31,29,1996,1998,1955,43,2.2
"31029",31,29,1997,1911,1881,30,1.6
"31029",31,29,1998,1927,1890,37,1.9
"31029",31,29,1999,1982,1941,41,2.1
"31029",31,29,2000,2117,2067,50,2.4
"31029",31,29,2001,2077,2026,51,2.5
"31029",31,29,2002,2094,2041,53,2.5
"31029",31,29,2003,2223,2164,59,2.7
"31029",31,29,2004,2186,2123,63,2.9
"31029",31,29,2005,2140,2080,60,2.8
"31029",31,29,2006,2099,2048,51,2.4
"31029",31,29,2007,1996,1947,49,2.5
"31029",31,29,2008,1991,1938,53,2.7
"31029",31,29,2009,2082,2022,60,2.9
"31029",31,29,2010,2293,2229,64,2.8
"31029",31,29,2011,2346,2289,57,2.4
"31029",31,29,2012,2374,2317,57,2.4
"31029",31,29,2013,2406,2349,57,2.4
"31029",31,29,2014,2346,2298,48,2
"31029",31,29,2015,2338,2293,45,1.9
"31029",31,29,2016,2288,2241,47,2.1
"31029",31,29,2017,2287,2244,43,1.9
"31031",31,31,1990,3150,3102,48,1.5
"31031",31,31,1991,3257,3210,47,1.4
"31031",31,31,1992,3257,3194,63,1.9
"31031",31,31,1993,3294,3227,67,2
"31031",31,31,1994,3417,3342,75,2.2
"31031",31,31,1995,3494,3418,76,2.2
"31031",31,31,1996,3427,3335,92,2.7
"31031",31,31,1997,3315,3230,85,2.6
"31031",31,31,1998,3327,3249,78,2.3
"31031",31,31,1999,3485,3408,77,2.2
"31031",31,31,2000,3523,3433,90,2.6
"31031",31,31,2001,3538,3459,79,2.2
"31031",31,31,2002,3554,3456,98,2.8
"31031",31,31,2003,3696,3598,98,2.7
"31031",31,31,2004,3740,3650,90,2.4
"31031",31,31,2005,3693,3606,87,2.4
"31031",31,31,2006,3620,3539,81,2.2
"31031",31,31,2007,3389,3313,76,2.2
"31031",31,31,2008,3403,3323,80,2.4
"31031",31,31,2009,3490,3399,91,2.6
"31031",31,31,2010,3385,3285,100,3
"31031",31,31,2011,3453,3348,105,3
"31031",31,31,2012,3482,3382,100,2.9
"31031",31,31,2013,3490,3394,96,2.8
"31031",31,31,2014,3413,3329,84,2.5
"31031",31,31,2015,3450,3370,80,2.3
"31031",31,31,2016,3466,3387,79,2.3
"31031",31,31,2017,3381,3302,79,2.3
"31033",31,33,1990,4979,4892,87,1.7
"31033",31,33,1991,5032,4940,92,1.8
"31033",31,33,1992,4839,4740,99,2
"31033",31,33,1993,5066,4952,114,2.3
"31033",31,33,1994,5197,5071,126,2.4
"31033",31,33,1995,5170,5057,113,2.2
"31033",31,33,1996,5151,5033,118,2.3
"31033",31,33,1997,5043,4949,94,1.9
"31033",31,33,1998,5225,5118,107,2
"31033",31,33,1999,5462,5324,138,2.5
"31033",31,33,2000,5655,5524,131,2.3
"31033",31,33,2001,5916,5771,145,2.5
"31033",31,33,2002,4864,4707,157,3.2
"31033",31,33,2003,4945,4784,161,3.3
"31033",31,33,2004,5079,4922,157,3.1
"31033",31,33,2005,5277,5126,151,2.9
"31033",31,33,2006,5204,5080,124,2.4
"31033",31,33,2007,5242,5116,126,2.4
"31033",31,33,2008,5238,5090,148,2.8
"31033",31,33,2009,5175,4945,230,4.4
"31033",31,33,2010,5558,5356,202,3.6
"31033",31,33,2011,5684,5511,173,3
"31033",31,33,2012,5789,5628,161,2.8
"31033",31,33,2013,5819,5655,164,2.8
"31033",31,33,2014,5744,5619,125,2.2
"31033",31,33,2015,5747,5622,125,2.2
"31033",31,33,2016,5443,5289,154,2.8
"31033",31,33,2017,5127,4977,150,2.9
"31035",31,35,1990,3292,3235,57,1.7
"31035",31,35,1991,3289,3228,61,1.9
"31035",31,35,1992,3429,3359,70,2
"31035",31,35,1993,3418,3348,70,2
"31035",31,35,1994,3518,3455,63,1.8
"31035",31,35,1995,3517,3446,71,2
"31035",31,35,1996,3562,3486,76,2.1
"31035",31,35,1997,3508,3433,75,2.1
"31035",31,35,1998,3526,3453,73,2.1
"31035",31,35,1999,3556,3472,84,2.4
"31035",31,35,2000,3641,3535,106,2.9
"31035",31,35,2001,3494,3383,111,3.2
"31035",31,35,2002,3427,3300,127,3.7
"31035",31,35,2003,3317,3192,125,3.8
"31035",31,35,2004,3285,3170,115,3.5
"31035",31,35,2005,3241,3122,119,3.7
"31035",31,35,2006,3095,3001,94,3
"31035",31,35,2007,3111,3025,86,2.8
"31035",31,35,2008,3119,3019,100,3.2
"31035",31,35,2009,3033,2901,132,4.4
"31035",31,35,2010,3433,3286,147,4.3
"31035",31,35,2011,3483,3339,144,4.1
"31035",31,35,2012,3486,3356,130,3.7
"31035",31,35,2013,3503,3383,120,3.4
"31035",31,35,2014,3459,3346,113,3.3
"31035",31,35,2015,3374,3275,99,2.9
"31035",31,35,2016,3317,3213,104,3.1
"31035",31,35,2017,3259,3158,101,3.1
"31037",31,37,1990,4384,4322,62,1.4
"31037",31,37,1991,4528,4441,87,1.9
"31037",31,37,1992,4653,4584,69,1.5
"31037",31,37,1993,4705,4615,90,1.9
"31037",31,37,1994,4725,4643,82,1.7
"31037",31,37,1995,4822,4726,96,2
"31037",31,37,1996,4845,4743,102,2.1
"31037",31,37,1997,5026,4931,95,1.9
"31037",31,37,1998,5093,4958,135,2.7
"31037",31,37,1999,4954,4834,120,2.4
"31037",31,37,2000,5683,5561,122,2.1
"31037",31,37,2001,5818,5671,147,2.5
"31037",31,37,2002,5953,5780,173,2.9
"31037",31,37,2003,6086,5899,187,3.1
"31037",31,37,2004,5950,5764,186,3.1
"31037",31,37,2005,5848,5684,164,2.8
"31037",31,37,2006,5699,5566,133,2.3
"31037",31,37,2007,5646,5522,124,2.2
"31037",31,37,2008,5628,5480,148,2.6
"31037",31,37,2009,5783,5568,215,3.7
"31037",31,37,2010,5659,5436,223,3.9
"31037",31,37,2011,5684,5464,220,3.9
"31037",31,37,2012,5664,5463,201,3.5
"31037",31,37,2013,5626,5428,198,3.5
"31037",31,37,2014,5618,5451,167,3
"31037",31,37,2015,5550,5405,145,2.6
"31037",31,37,2016,5541,5384,157,2.8
"31037",31,37,2017,5546,5413,133,2.4
"31039",31,39,1990,5046,4993,53,1.1
"31039",31,39,1991,5112,5037,75,1.5
"31039",31,39,1992,5073,4962,111,2.2
"31039",31,39,1993,5147,5045,102,2
"31039",31,39,1994,5350,5231,119,2.2
"31039",31,39,1995,5425,5309,116,2.1
"31039",31,39,1996,5309,5179,130,2.4
"31039",31,39,1997,5163,5070,93,1.8
"31039",31,39,1998,5253,5157,96,1.8
"31039",31,39,1999,5447,5333,114,2.1
"31039",31,39,2000,5679,5550,129,2.3
"31039",31,39,2001,5633,5502,131,2.3
"31039",31,39,2002,5548,5406,142,2.6
"31039",31,39,2003,5608,5456,152,2.7
"31039",31,39,2004,5538,5378,160,2.9
"31039",31,39,2005,5352,5191,161,3
"31039",31,39,2006,5059,4904,155,3.1
"31039",31,39,2007,4995,4860,135,2.7
"31039",31,39,2008,4938,4794,144,2.9
"31039",31,39,2009,4991,4801,190,3.8
"31039",31,39,2010,4863,4685,178,3.7
"31039",31,39,2011,4924,4756,168,3.4
"31039",31,39,2012,4915,4763,152,3.1
"31039",31,39,2013,4961,4811,150,3
"31039",31,39,2014,4947,4817,130,2.6
"31039",31,39,2015,4839,4710,129,2.7
"31039",31,39,2016,4708,4572,136,2.9
"31039",31,39,2017,4714,4586,128,2.7
"31041",31,41,1990,5836,5746,90,1.5
"31041",31,41,1991,5808,5694,114,2
"31041",31,41,1992,5745,5593,152,2.6
"31041",31,41,1993,5788,5647,141,2.4
"31041",31,41,1994,5823,5686,137,2.4
"31041",31,41,1995,5788,5654,134,2.3
"31041",31,41,1996,5711,5570,141,2.5
"31041",31,41,1997,5578,5462,116,2.1
"31041",31,41,1998,5514,5411,103,1.9
"31041",31,41,1999,5588,5463,125,2.2
"31041",31,41,2000,6194,6036,158,2.6
"31041",31,41,2001,6418,6263,155,2.4
"31041",31,41,2002,6467,6298,169,2.6
"31041",31,41,2003,6372,6190,182,2.9
"31041",31,41,2004,6220,6030,190,3.1
"31041",31,41,2005,6228,6048,180,2.9
"31041",31,41,2006,6131,5984,147,2.4
"31041",31,41,2007,6005,5877,128,2.1
"31041",31,41,2008,6060,5914,146,2.4
"31041",31,41,2009,6196,5991,205,3.3
"31041",31,41,2010,5986,5766,220,3.7
"31041",31,41,2011,6048,5842,206,3.4
"31041",31,41,2012,6109,5934,175,2.9
"31041",31,41,2013,6162,5991,171,2.8
"31041",31,41,2014,6131,5982,149,2.4
"31041",31,41,2015,6284,6144,140,2.2
"31041",31,41,2016,6341,6192,149,2.3
"31041",31,41,2017,6335,6198,137,2.2
"31043",31,43,1990,8772,8472,300,3.4
"31043",31,43,1991,8897,8572,325,3.7
"31043",31,43,1992,9089,8800,289,3.2
"31043",31,43,1993,9428,9196,232,2.5
"31043",31,43,1994,9696,9421,275,2.8
"31043",31,43,1995,10045,9781,264,2.6
"31043",31,43,1996,10271,9946,325,3.2
"31043",31,43,1997,10453,10117,336,3.2
"31043",31,43,1998,10563,10260,303,2.9
"31043",31,43,1999,10483,10186,297,2.8
"31043",31,43,2000,10860,10508,352,3.2
"31043",31,43,2001,10886,10551,335,3.1
"31043",31,43,2002,10748,10282,466,4.3
"31043",31,43,2003,10699,10196,503,4.7
"31043",31,43,2004,10577,10108,469,4.4
"31043",31,43,2005,10531,10032,499,4.7
"31043",31,43,2006,10609,10179,430,4.1
"31043",31,43,2007,10928,10490,438,4
"31043",31,43,2008,11003,10545,458,4.2
"31043",31,43,2009,11152,10478,674,6
"31043",31,43,2010,11299,10470,829,7.3
"31043",31,43,2011,11014,10366,648,5.9
"31043",31,43,2012,11197,10550,647,5.8
"31043",31,43,2013,11215,10688,527,4.7
"31043",31,43,2014,11042,10630,412,3.7
"31043",31,43,2015,10994,10605,389,3.5
"31043",31,43,2016,10890,10436,454,4.2
"31043",31,43,2017,10648,10215,433,4.1
"31045",31,45,1990,4185,4030,155,3.7
"31045",31,45,1991,4171,4025,146,3.5
"31045",31,45,1992,4282,4140,142,3.3
"31045",31,45,1993,4512,4355,157,3.5
"31045",31,45,1994,4569,4413,156,3.4
"31045",31,45,1995,4551,4389,162,3.6
"31045",31,45,1996,4554,4370,184,4
"31045",31,45,1997,4291,4144,147,3.4
"31045",31,45,1998,4727,4563,164,3.5
"31045",31,45,1999,4740,4549,191,4
"31045",31,45,2000,5062,4909,153,3
"31045",31,45,2001,4874,4733,141,2.9
"31045",31,45,2002,5027,4879,148,2.9
"31045",31,45,2003,4741,4585,156,3.3
"31045",31,45,2004,4751,4598,153,3.2
"31045",31,45,2005,4758,4604,154,3.2
"31045",31,45,2006,4661,4528,133,2.9
"31045",31,45,2007,4802,4671,131,2.7
"31045",31,45,2008,4826,4685,141,2.9
"31045",31,45,2009,4769,4559,210,4.4
"31045",31,45,2010,5499,5281,218,4
"31045",31,45,2011,5473,5261,212,3.9
"31045",31,45,2012,5415,5218,197,3.6
"31045",31,45,2013,5429,5234,195,3.6
"31045",31,45,2014,5281,5126,155,2.9
"31045",31,45,2015,5250,5114,136,2.6
"31045",31,45,2016,5205,5051,154,3
"31045",31,45,2017,5158,5016,142,2.8
"31047",31,47,1990,10625,10324,301,2.8
"31047",31,47,1991,12182,11850,332,2.7
"31047",31,47,1992,12681,12237,444,3.5
"31047",31,47,1993,13064,12663,401,3.1
"31047",31,47,1994,13164,12739,425,3.2
"31047",31,47,1995,13514,13071,443,3.3
"31047",31,47,1996,13542,13108,434,3.2
"31047",31,47,1997,13497,13139,358,2.7
"31047",31,47,1998,13188,12818,370,2.8
"31047",31,47,1999,13419,13023,396,3
"31047",31,47,2000,12340,11962,378,3.1
"31047",31,47,2001,12211,11775,436,3.6
"31047",31,47,2002,12329,11850,479,3.9
"31047",31,47,2003,12540,12024,516,4.1
"31047",31,47,2004,12528,12001,527,4.2
"31047",31,47,2005,12294,11758,536,4.4
"31047",31,47,2006,12401,12005,396,3.2
"31047",31,47,2007,12349,11973,376,3
"31047",31,47,2008,12461,11960,501,4
"31047",31,47,2009,12630,12046,584,4.6
"31047",31,47,2010,13210,12559,651,4.9
"31047",31,47,2011,13190,12531,659,5
"31047",31,47,2012,13279,12698,581,4.4
"31047",31,47,2013,13275,12769,506,3.8
"31047",31,47,2014,13325,12863,462,3.5
"31047",31,47,2015,13062,12648,414,3.2
"31047",31,47,2016,12943,12558,385,3
"31047",31,47,2017,12855,12488,367,2.9
"31049",31,49,1990,1087,1069,18,1.7
"31049",31,49,1991,1055,1033,22,2.1
"31049",31,49,1992,1088,1059,29,2.7
"31049",31,49,1993,1107,1086,21,1.9
"31049",31,49,1994,1048,1020,28,2.7
"31049",31,49,1995,1023,988,35,3.4
"31049",31,49,1996,1043,1017,26,2.5
"31049",31,49,1997,968,946,22,2.3
"31049",31,49,1998,906,880,26,2.9
"31049",31,49,1999,906,874,32,3.5
"31049",31,49,2000,1175,1140,35,3
"31049",31,49,2001,1136,1105,31,2.7
"31049",31,49,2002,1121,1092,29,2.6
"31049",31,49,2003,1169,1134,35,3
"31049",31,49,2004,1079,1047,32,3
"31049",31,49,2005,1090,1056,34,3.1
"31049",31,49,2006,1069,1040,29,2.7
"31049",31,49,2007,1050,1020,30,2.9
"31049",31,49,2008,1054,1023,31,2.9
"31049",31,49,2009,1070,1028,42,3.9
"31049",31,49,2010,1031,991,40,3.9
"31049",31,49,2011,1068,1031,37,3.5
"31049",31,49,2012,1192,1153,39,3.3
"31049",31,49,2013,1134,1096,38,3.4
"31049",31,49,2014,1090,1060,30,2.8
"31049",31,49,2015,1074,1047,27,2.5
"31049",31,49,2016,1060,1032,28,2.6
"31049",31,49,2017,1034,1007,27,2.6
"31051",31,51,1990,2977,2915,62,2.1
"31051",31,51,1991,3116,3044,72,2.3
"31051",31,51,1992,3066,2988,78,2.5
"31051",31,51,1993,2986,2892,94,3.1
"31051",31,51,1994,2856,2775,81,2.8
"31051",31,51,1995,2854,2789,65,2.3
"31051",31,51,1996,2621,2550,71,2.7
"31051",31,51,1997,2559,2491,68,2.7
"31051",31,51,1998,2504,2436,68,2.7
"31051",31,51,1999,2513,2443,70,2.8
"31051",31,51,2000,3342,3256,86,2.6
"31051",31,51,2001,3290,3209,81,2.5
"31051",31,51,2002,3197,3101,96,3
"31051",31,51,2003,3143,3029,114,3.6
"31051",31,51,2004,3110,3001,109,3.5
"31051",31,51,2005,3144,3020,124,3.9
"31051",31,51,2006,3134,3036,98,3.1
"31051",31,51,2007,3313,3209,104,3.1
"31051",31,51,2008,3382,3274,108,3.2
"31051",31,51,2009,3332,3176,156,4.7
"31051",31,51,2010,3115,2966,149,4.8
"31051",31,51,2011,3161,3017,144,4.6
"31051",31,51,2012,3141,3011,130,4.1
"31051",31,51,2013,3123,3006,117,3.7
"31051",31,51,2014,3055,2962,93,3
"31051",31,51,2015,3082,2980,102,3.3
"31051",31,51,2016,3064,2962,102,3.3
"31051",31,51,2017,2989,2894,95,3.2
"31053",31,53,1990,17630,17099,531,3
"31053",31,53,1991,17832,17258,574,3.2
"31053",31,53,1992,17964,17369,595,3.3
"31053",31,53,1993,17874,17281,593,3.3
"31053",31,53,1994,18563,18011,552,3
"31053",31,53,1995,18912,18364,548,2.9
"31053",31,53,1996,19211,18645,566,2.9
"31053",31,53,1997,19587,19028,559,2.9
"31053",31,53,1998,19734,19162,572,2.9
"31053",31,53,1999,19712,19145,567,2.9
"31053",31,53,2000,19768,19151,617,3.1
"31053",31,53,2001,19698,18946,752,3.8
"31053",31,53,2002,19523,18669,854,4.4
"31053",31,53,2003,19524,18600,924,4.7
"31053",31,53,2004,19791,18882,909,4.6
"31053",31,53,2005,19680,18817,863,4.4
"31053",31,53,2006,19648,18963,685,3.5
"31053",31,53,2007,19826,19194,632,3.2
"31053",31,53,2008,20006,19306,700,3.5
"31053",31,53,2009,19884,18882,1002,5
"31053",31,53,2010,18851,17855,996,5.3
"31053",31,53,2011,19131,18190,941,4.9
"31053",31,53,2012,19272,18400,872,4.5
"31053",31,53,2013,19259,18449,810,4.2
"31053",31,53,2014,19210,18511,699,3.6
"31053",31,53,2015,19093,18471,622,3.3
"31053",31,53,2016,19097,18509,588,3.1
"31053",31,53,2017,19279,18737,542,2.8
"31055",31,55,1990,227028,221000,6028,2.7
"31055",31,55,1991,227837,220929,6908,3
"31055",31,55,1992,229983,222470,7513,3.3
"31055",31,55,1993,235656,228339,7317,3.1
"31055",31,55,1994,241741,234612,7129,2.9
"31055",31,55,1995,247074,240070,7004,2.8
"31055",31,55,1996,252220,245188,7032,2.8
"31055",31,55,1997,256488,249639,6849,2.7
"31055",31,55,1998,259538,252991,6547,2.5
"31055",31,55,1999,261663,254438,7225,2.8
"31055",31,55,2000,258571,250752,7819,3
"31055",31,55,2001,260138,250988,9150,3.5
"31055",31,55,2002,261768,250512,11256,4.3
"31055",31,55,2003,263051,251038,12013,4.6
"31055",31,55,2004,264598,252793,11805,4.5
"31055",31,55,2005,266086,254196,11890,4.5
"31055",31,55,2006,265341,256013,9328,3.5
"31055",31,55,2007,269973,260826,9147,3.4
"31055",31,55,2008,274208,264071,10137,3.7
"31055",31,55,2009,274796,260623,14173,5.2
"31055",31,55,2010,279280,264986,14294,5.1
"31055",31,55,2011,282043,268236,13807,4.9
"31055",31,55,2012,285676,272913,12763,4.5
"31055",31,55,2013,286568,274688,11880,4.1
"31055",31,55,2014,286332,275960,10372,3.6
"31055",31,55,2015,286727,277240,9487,3.3
"31055",31,55,2016,287522,277952,9570,3.3
"31055",31,55,2017,288566,279395,9171,3.2
"31057",31,57,1990,1258,1248,10,.8
"31057",31,57,1991,1278,1263,15,1.2
"31057",31,57,1992,1242,1223,19,1.5
"31057",31,57,1993,1256,1237,19,1.5
"31057",31,57,1994,1215,1185,30,2.5
"31057",31,57,1995,1220,1186,34,2.8
"31057",31,57,1996,1168,1144,24,2.1
"31057",31,57,1997,1127,1111,16,1.4
"31057",31,57,1998,1097,1079,18,1.6
"31057",31,57,1999,1103,1081,22,2
"31057",31,57,2000,1209,1182,27,2.2
"31057",31,57,2001,1226,1197,29,2.4
"31057",31,57,2002,1228,1183,45,3.7
"31057",31,57,2003,1217,1178,39,3.2
"31057",31,57,2004,1172,1129,43,3.7
"31057",31,57,2005,1111,1065,46,4.1
"31057",31,57,2006,1034,1001,33,3.2
"31057",31,57,2007,1016,990,26,2.6
"31057",31,57,2008,1035,1005,30,2.9
"31057",31,57,2009,1066,1024,42,3.9
"31057",31,57,2010,1216,1178,38,3.1
"31057",31,57,2011,1275,1238,37,2.9
"31057",31,57,2012,1282,1244,38,3
"31057",31,57,2013,1304,1268,36,2.8
"31057",31,57,2014,1276,1247,29,2.3
"31057",31,57,2015,1197,1172,25,2.1
"31057",31,57,2016,1194,1168,26,2.2
"31057",31,57,2017,1185,1157,28,2.4
"31059",31,59,1990,3409,3370,39,1.1
"31059",31,59,1991,3380,3317,63,1.9
"31059",31,59,1992,3379,3313,66,2
"31059",31,59,1993,3283,3208,75,2.3
"31059",31,59,1994,3317,3253,64,1.9
"31059",31,59,1995,3357,3289,68,2
"31059",31,59,1996,3370,3309,61,1.8
"31059",31,59,1997,3189,3126,63,2
"31059",31,59,1998,3111,3055,56,1.8
"31059",31,59,1999,3217,3140,77,2.4
"31059",31,59,2000,3517,3425,92,2.6
"31059",31,59,2001,3443,3340,103,3
"31059",31,59,2002,3440,3321,119,3.5
"31059",31,59,2003,3450,3322,128,3.7
"31059",31,59,2004,3365,3245,120,3.6
"31059",31,59,2005,3356,3249,107,3.2
"31059",31,59,2006,3303,3214,89,2.7
"31059",31,59,2007,3173,3093,80,2.5
"31059",31,59,2008,3180,3086,94,3
"31059",31,59,2009,3198,3068,130,4.1
"31059",31,59,2010,3240,3119,121,3.7
"31059",31,59,2011,3324,3209,115,3.5
"31059",31,59,2012,3320,3212,108,3.3
"31059",31,59,2013,3306,3207,99,3
"31059",31,59,2014,3243,3165,78,2.4
"31059",31,59,2015,3208,3113,95,3
"31059",31,59,2016,3178,3090,88,2.8
"31059",31,59,2017,3120,3041,79,2.5
"31061",31,61,1990,1724,1704,20,1.2
"31061",31,61,1991,1716,1690,26,1.5
"31061",31,61,1992,1715,1674,41,2.4
"31061",31,61,1993,1627,1590,37,2.3
"31061",31,61,1994,1733,1693,40,2.3
"31061",31,61,1995,1751,1720,31,1.8
"31061",31,61,1996,1720,1684,36,2.1
"31061",31,61,1997,1621,1593,28,1.7
"31061",31,61,1998,1634,1593,41,2.5
"31061",31,61,1999,1652,1609,43,2.6
"31061",31,61,2000,1814,1765,49,2.7
"31061",31,61,2001,1834,1779,55,3
"31061",31,61,2002,1888,1821,67,3.5
"31061",31,61,2003,1971,1908,63,3.2
"31061",31,61,2004,1936,1873,63,3.3
"31061",31,61,2005,1893,1829,64,3.4
"31061",31,61,2006,1852,1794,58,3.1
"31061",31,61,2007,1797,1747,50,2.8
"31061",31,61,2008,1777,1723,54,3
"31061",31,61,2009,1787,1718,69,3.9
"31061",31,61,2010,1634,1563,71,4.3
"31061",31,61,2011,1671,1601,70,4.2
"31061",31,61,2012,1644,1584,60,3.6
"31061",31,61,2013,1600,1544,56,3.5
"31061",31,61,2014,1575,1525,50,3.2
"31061",31,61,2015,1511,1475,36,2.4
"31061",31,61,2016,1498,1453,45,3
"31061",31,61,2017,1476,1431,45,3
"31063",31,63,1990,1573,1553,20,1.3
"31063",31,63,1991,1497,1473,24,1.6
"31063",31,63,1992,1502,1470,32,2.1
"31063",31,63,1993,1536,1507,29,1.9
"31063",31,63,1994,1585,1559,26,1.6
"31063",31,63,1995,1639,1594,45,2.7
"31063",31,63,1996,1575,1529,46,2.9
"31063",31,63,1997,1536,1492,44,2.9
"31063",31,63,1998,1540,1499,41,2.7
"31063",31,63,1999,1549,1506,43,2.8
"31063",31,63,2000,1743,1700,43,2.5
"31063",31,63,2001,1796,1755,41,2.3
"31063",31,63,2002,1804,1761,43,2.4
"31063",31,63,2003,1814,1763,51,2.8
"31063",31,63,2004,1779,1728,51,2.9
"31063",31,63,2005,1783,1739,44,2.5
"31063",31,63,2006,1768,1729,39,2.2
"31063",31,63,2007,1660,1622,38,2.3
"31063",31,63,2008,1628,1583,45,2.8
"31063",31,63,2009,1655,1603,52,3.1
"31063",31,63,2010,1596,1536,60,3.8
"31063",31,63,2011,1602,1545,57,3.6
"31063",31,63,2012,1613,1561,52,3.2
"31063",31,63,2013,1598,1544,54,3.4
"31063",31,63,2014,1550,1507,43,2.8
"31063",31,63,2015,1532,1495,37,2.4
"31063",31,63,2016,1568,1523,45,2.9
"31063",31,63,2017,1555,1515,40,2.6
"31065",31,65,1990,2483,2435,48,1.9
"31065",31,65,1991,2507,2472,35,1.4
"31065",31,65,1992,2539,2498,41,1.6
"31065",31,65,1993,2574,2524,50,1.9
"31065",31,65,1994,2661,2612,49,1.8
"31065",31,65,1995,2680,2617,63,2.4
"31065",31,65,1996,2609,2540,69,2.6
"31065",31,65,1997,2541,2488,53,2.1
"31065",31,65,1998,2563,2519,44,1.7
"31065",31,65,1999,2546,2477,69,2.7
"31065",31,65,2000,2641,2567,74,2.8
"31065",31,65,2001,2574,2505,69,2.7
"31065",31,65,2002,2568,2485,83,3.2
"31065",31,65,2003,2562,2476,86,3.4
"31065",31,65,2004,2545,2459,86,3.4
"31065",31,65,2005,2547,2453,94,3.7
"31065",31,65,2006,2476,2402,74,3
"31065",31,65,2007,2469,2395,74,3
"31065",31,65,2008,2517,2443,74,2.9
"31065",31,65,2009,2562,2468,94,3.7
"31065",31,65,2010,2661,2571,90,3.4
"31065",31,65,2011,2712,2613,99,3.7
"31065",31,65,2012,2688,2593,95,3.5
"31065",31,65,2013,2732,2636,96,3.5
"31065",31,65,2014,2708,2630,78,2.9
"31065",31,65,2015,2728,2656,72,2.6
"31065",31,65,2016,2710,2634,76,2.8
"31065",31,65,2017,2662,2597,65,2.4
"31067",31,67,1990,11460,11244,216,1.9
"31067",31,67,1991,11790,11558,232,2
"31067",31,67,1992,11697,11424,273,2.3
"31067",31,67,1993,12054,11786,268,2.2
"31067",31,67,1994,11858,11562,296,2.5
"31067",31,67,1995,11963,11688,275,2.3
"31067",31,67,1996,12396,12119,277,2.2
"31067",31,67,1997,12591,12337,254,2
"31067",31,67,1998,12747,12500,247,1.9
"31067",31,67,1999,12581,12214,367,2.9
"31067",31,67,2000,12622,12239,383,3
"31067",31,67,2001,12838,12446,392,3.1
"31067",31,67,2002,12948,12467,481,3.7
"31067",31,67,2003,12899,12353,546,4.2
"31067",31,67,2004,12898,12331,567,4.4
"31067",31,67,2005,12833,12264,569,4.4
"31067",31,67,2006,12666,12191,475,3.8
"31067",31,67,2007,12510,12062,448,3.6
"31067",31,67,2008,12233,11660,573,4.7
"31067",31,67,2009,12015,11265,750,6.2
"31067",31,67,2010,11408,10752,656,5.8
"31067",31,67,2011,11191,10544,647,5.8
"31067",31,67,2012,11179,10624,555,5
"31067",31,67,2013,11128,10617,511,4.6
"31067",31,67,2014,11081,10623,458,4.1
"31067",31,67,2015,11045,10645,400,3.6
"31067",31,67,2016,11034,10669,365,3.3
"31067",31,67,2017,10886,10503,383,3.5
"31069",31,69,1990,1204,1183,21,1.7
"31069",31,69,1991,1152,1133,19,1.6
"31069",31,69,1992,1117,1097,20,1.8
"31069",31,69,1993,1086,1067,19,1.7
"31069",31,69,1994,1148,1129,19,1.7
"31069",31,69,1995,1112,1065,47,4.2
"31069",31,69,1996,1108,1085,23,2.1
"31069",31,69,1997,1094,1076,18,1.6
"31069",31,69,1998,1064,1040,24,2.3
"31069",31,69,1999,1122,1095,27,2.4
"31069",31,69,2000,1217,1185,32,2.6
"31069",31,69,2001,1116,1079,37,3.3
"31069",31,69,2002,1111,1073,38,3.4
"31069",31,69,2003,1154,1110,44,3.8
"31069",31,69,2004,1083,1043,40,3.7
"31069",31,69,2005,1056,1025,31,2.9
"31069",31,69,2006,1015,985,30,3
"31069",31,69,2007,936,911,25,2.7
"31069",31,69,2008,948,920,28,3
"31069",31,69,2009,962,921,41,4.3
"31069",31,69,2010,1266,1214,52,4.1
"31069",31,69,2011,1260,1215,45,3.6
"31069",31,69,2012,1262,1221,41,3.2
"31069",31,69,2013,1237,1202,35,2.8
"31069",31,69,2014,1192,1158,34,2.9
"31069",31,69,2015,1196,1167,29,2.4
"31069",31,69,2016,1185,1146,39,3.3
"31069",31,69,2017,1190,1157,33,2.8
"31071",31,71,1990,1089,1064,25,2.3
"31071",31,71,1991,1073,1040,33,3.1
"31071",31,71,1992,1059,1021,38,3.6
"31071",31,71,1993,1075,1046,29,2.7
"31071",31,71,1994,1103,1074,29,2.6
"31071",31,71,1995,1073,1045,28,2.6
"31071",31,71,1996,1077,1052,25,2.3
"31071",31,71,1997,1034,1007,27,2.6
"31071",31,71,1998,1037,1010,27,2.6
"31071",31,71,1999,1013,992,21,2.1
"31071",31,71,2000,1017,991,26,2.6
"31071",31,71,2001,1030,1002,28,2.7
"31071",31,71,2002,1051,1021,30,2.9
"31071",31,71,2003,1060,1023,37,3.5
"31071",31,71,2004,1074,1039,35,3.3
"31071",31,71,2005,1068,1036,32,3
"31071",31,71,2006,1050,1023,27,2.6
"31071",31,71,2007,1037,1011,26,2.5
"31071",31,71,2008,1054,1027,27,2.6
"31071",31,71,2009,1086,1054,32,2.9
"31071",31,71,2010,1202,1165,37,3.1
"31071",31,71,2011,1206,1165,41,3.4
"31071",31,71,2012,1220,1183,37,3
"31071",31,71,2013,1231,1193,38,3.1
"31071",31,71,2014,1201,1170,31,2.6
"31071",31,71,2015,1194,1165,29,2.4
"31071",31,71,2016,1154,1125,29,2.5
"31071",31,71,2017,1150,1121,29,2.5
"31073",31,73,1990,1057,1041,16,1.5
"31073",31,73,1991,1209,1192,17,1.4
"31073",31,73,1992,1215,1190,25,2.1
"31073",31,73,1993,1237,1212,25,2
"31073",31,73,1994,1229,1202,27,2.2
"31073",31,73,1995,1337,1304,33,2.5
"31073",31,73,1996,1351,1324,27,2
"31073",31,73,1997,1363,1344,19,1.4
"31073",31,73,1998,1365,1344,21,1.5
"31073",31,73,1999,1341,1318,23,1.7
"31073",31,73,2000,1142,1112,30,2.6
"31073",31,73,2001,1093,1060,33,3
"31073",31,73,2002,1099,1066,33,3
"31073",31,73,2003,1116,1079,37,3.3
"31073",31,73,2004,1102,1060,42,3.8
"31073",31,73,2005,1058,1021,37,3.5
"31073",31,73,2006,1036,1006,30,2.9
"31073",31,73,2007,1043,1010,33,3.2
"31073",31,73,2008,1022,989,33,3.2
"31073",31,73,2009,976,938,38,3.9
"31073",31,73,2010,1147,1106,41,3.6
"31073",31,73,2011,1130,1090,40,3.5
"31073",31,73,2012,1145,1111,34,3
"31073",31,73,2013,1166,1126,40,3.4
"31073",31,73,2014,1135,1101,34,3
"31073",31,73,2015,1075,1048,27,2.5
"31073",31,73,2016,1054,1027,27,2.6
"31073",31,73,2017,1037,1010,27,2.6
"31075",31,75,1990,388,386,2,.5
"31075",31,75,1991,391,383,8,2
"31075",31,75,1992,387,382,5,1.3
"31075",31,75,1993,386,382,4,1
"31075",31,75,1994,401,395,6,1.5
"31075",31,75,1995,388,381,7,1.8
"31075",31,75,1996,378,370,8,2.1
"31075",31,75,1997,379,373,6,1.6
"31075",31,75,1998,371,364,7,1.9
"31075",31,75,1999,359,351,8,2.2
"31075",31,75,2000,439,429,10,2.3
"31075",31,75,2001,431,420,11,2.6
"31075",31,75,2002,415,404,11,2.7
"31075",31,75,2003,434,422,12,2.8
"31075",31,75,2004,418,407,11,2.6
"31075",31,75,2005,424,413,11,2.6
"31075",31,75,2006,411,402,9,2.2
"31075",31,75,2007,385,375,10,2.6
"31075",31,75,2008,373,362,11,2.9
"31075",31,75,2009,368,355,13,3.5
"31075",31,75,2010,421,405,16,3.8
"31075",31,75,2011,454,439,15,3.3
"31075",31,75,2012,439,424,15,3.4
"31075",31,75,2013,420,406,14,3.3
"31075",31,75,2014,428,418,10,2.3
"31075",31,75,2015,435,425,10,2.3
"31075",31,75,2016,452,442,10,2.2
"31075",31,75,2017,438,428,10,2.3
"31077",31,77,1990,1491,1463,28,1.9
"31077",31,77,1991,1523,1488,35,2.3
"31077",31,77,1992,1510,1459,51,3.4
"31077",31,77,1993,1457,1415,42,2.9
"31077",31,77,1994,1529,1479,50,3.3
"31077",31,77,1995,1563,1513,50,3.2
"31077",31,77,1996,1552,1496,56,3.6
"31077",31,77,1997,1500,1456,44,2.9
"31077",31,77,1998,1536,1491,45,2.9
"31077",31,77,1999,1426,1374,52,3.6
"31077",31,77,2000,1404,1363,41,2.9
"31077",31,77,2001,1393,1351,42,3
"31077",31,77,2002,1416,1366,50,3.5
"31077",31,77,2003,1455,1404,51,3.5
"31077",31,77,2004,1444,1389,55,3.8
"31077",31,77,2005,1386,1336,50,3.6
"31077",31,77,2006,1339,1299,40,3
"31077",31,77,2007,1278,1244,34,2.7
"31077",31,77,2008,1303,1265,38,2.9
"31077",31,77,2009,1331,1284,47,3.5
"31077",31,77,2010,1360,1311,49,3.6
"31077",31,77,2011,1361,1308,53,3.9
"31077",31,77,2012,1299,1252,47,3.6
"31077",31,77,2013,1302,1256,46,3.5
"31077",31,77,2014,1271,1230,41,3.2
"31077",31,77,2015,1249,1210,39,3.1
"31077",31,77,2016,1232,1194,38,3.1
"31077",31,77,2017,1214,1176,38,3.1
"31079",31,79,1990,27206,26633,573,2.1
"31079",31,79,1991,27991,27257,734,2.6
"31079",31,79,1992,28746,27967,779,2.7
"31079",31,79,1993,29640,28955,685,2.3
"31079",31,79,1994,30349,29695,654,2.2
"31079",31,79,1995,30704,30040,664,2.2
"31079",31,79,1996,31022,30231,791,2.5
"31079",31,79,1997,31198,30506,692,2.2
"31079",31,79,1998,31653,30841,812,2.6
"31079",31,79,1999,31605,30565,1040,3.3
"31079",31,79,2000,28887,28034,853,3
"31079",31,79,2001,28793,27847,946,3.3
"31079",31,79,2002,28910,27783,1127,3.9
"31079",31,79,2003,29424,28136,1288,4.4
"31079",31,79,2004,29977,28539,1438,4.8
"31079",31,79,2005,30130,28977,1153,3.8
"31079",31,79,2006,30397,29451,946,3.1
"31079",31,79,2007,30960,30101,859,2.8
"31079",31,79,2008,31742,30752,990,3.1
"31079",31,79,2009,32175,30812,1363,4.2
"31079",31,79,2010,31519,30054,1465,4.6
"31079",31,79,2011,32013,30581,1432,4.5
"31079",31,79,2012,32657,31357,1300,4
"31079",31,79,2013,32586,31376,1210,3.7
"31079",31,79,2014,32380,31117,1263,3.9
"31079",31,79,2015,31591,30346,1245,3.9
"31079",31,79,2016,31356,30202,1154,3.7
"31079",31,79,2017,31452,30368,1084,3.4
"31081",31,81,1990,4676,4612,64,1.4
"31081",31,81,1991,4820,4736,84,1.7
"31081",31,81,1992,4941,4853,88,1.8
"31081",31,81,1993,5105,5019,86,1.7
"31081",31,81,1994,5221,5147,74,1.4
"31081",31,81,1995,5250,5173,77,1.5
"31081",31,81,1996,5306,5219,87,1.6
"31081",31,81,1997,5448,5366,82,1.5
"31081",31,81,1998,5508,5410,98,1.8
"31081",31,81,1999,5539,5422,117,2.1
"31081",31,81,2000,5136,5015,121,2.4
"31081",31,81,2001,4952,4827,125,2.5
"31081",31,81,2002,5274,5117,157,3
"31081",31,81,2003,5309,5113,196,3.7
"31081",31,81,2004,5326,5159,167,3.1
"31081",31,81,2005,5439,5292,147,2.7
"31081",31,81,2006,5421,5299,122,2.3
"31081",31,81,2007,5640,5515,125,2.2
"31081",31,81,2008,5883,5740,143,2.4
"31081",31,81,2009,5532,5352,180,3.3
"31081",31,81,2010,4806,4625,181,3.8
"31081",31,81,2011,4833,4650,183,3.8
"31081",31,81,2012,4844,4682,162,3.3
"31081",31,81,2013,4853,4698,155,3.2
"31081",31,81,2014,4760,4617,143,3
"31081",31,81,2015,4672,4537,135,2.9
"31081",31,81,2016,4645,4515,130,2.8
"31081",31,81,2017,4638,4521,117,2.5
"31083",31,83,1990,1848,1821,27,1.5
"31083",31,83,1991,1765,1739,26,1.5
"31083",31,83,1992,1796,1752,44,2.4
"31083",31,83,1993,1765,1726,39,2.2
"31083",31,83,1994,1765,1738,27,1.5
"31083",31,83,1995,1827,1793,34,1.9
"31083",31,83,1996,1836,1786,50,2.7
"31083",31,83,1997,1812,1774,38,2.1
"31083",31,83,1998,1759,1715,44,2.5
"31083",31,83,1999,1767,1715,52,2.9
"31083",31,83,2000,1923,1873,50,2.6
"31083",31,83,2001,1956,1904,52,2.7
"31083",31,83,2002,1902,1845,57,3
"31083",31,83,2003,1891,1830,61,3.2
"31083",31,83,2004,1839,1781,58,3.2
"31083",31,83,2005,1793,1736,57,3.2
"31083",31,83,2006,1790,1744,46,2.6
"31083",31,83,2007,1812,1765,47,2.6
"31083",31,83,2008,1842,1785,57,3.1
"31083",31,83,2009,1873,1804,69,3.7
"31083",31,83,2010,1893,1832,61,3.2
"31083",31,83,2011,1894,1832,62,3.3
"31083",31,83,2012,1878,1817,61,3.2
"31083",31,83,2013,1863,1805,58,3.1
"31083",31,83,2014,1801,1754,47,2.6
"31083",31,83,2015,1786,1748,38,2.1
"31083",31,83,2016,1754,1710,44,2.5
"31083",31,83,2017,1751,1706,45,2.6
"31085",31,85,1990,519,514,5,1
"31085",31,85,1991,500,491,9,1.8
"31085",31,85,1992,538,527,11,2
"31085",31,85,1993,504,490,14,2.8
"31085",31,85,1994,528,514,14,2.7
"31085",31,85,1995,535,516,19,3.6
"31085",31,85,1996,524,503,21,4
"31085",31,85,1997,520,502,18,3.5
"31085",31,85,1998,505,484,21,4.2
"31085",31,85,1999,480,462,18,3.8
"31085",31,85,2000,585,565,20,3.4
"31085",31,85,2001,598,581,17,2.8
"31085",31,85,2002,580,562,18,3.1
"31085",31,85,2003,574,553,21,3.7
"31085",31,85,2004,554,533,21,3.8
"31085",31,85,2005,514,496,18,3.5
"31085",31,85,2006,496,480,16,3.2
"31085",31,85,2007,460,444,16,3.5
"31085",31,85,2008,478,460,18,3.8
"31085",31,85,2009,493,473,20,4.1
"31085",31,85,2010,640,618,22,3.4
"31085",31,85,2011,679,658,21,3.1
"31085",31,85,2012,664,644,20,3
"31085",31,85,2013,648,626,22,3.4
"31085",31,85,2014,627,609,18,2.9
"31085",31,85,2015,616,602,14,2.3
"31085",31,85,2016,589,575,14,2.4
"31085",31,85,2017,569,555,14,2.5
"31087",31,87,1990,1665,1632,33,2
"31087",31,87,1991,1644,1608,36,2.2
"31087",31,87,1992,1633,1595,38,2.3
"31087",31,87,1993,1655,1615,40,2.4
"31087",31,87,1994,1637,1589,48,2.9
"31087",31,87,1995,1659,1611,48,2.9
"31087",31,87,1996,1614,1570,44,2.7
"31087",31,87,1997,1605,1560,45,2.8
"31087",31,87,1998,1616,1570,46,2.8
"31087",31,87,1999,1612,1574,38,2.4
"31087",31,87,2000,1540,1499,41,2.7
"31087",31,87,2001,1517,1463,54,3.6
"31087",31,87,2002,1506,1458,48,3.2
"31087",31,87,2003,1520,1461,59,3.9
"31087",31,87,2004,1528,1469,59,3.9
"31087",31,87,2005,1488,1433,55,3.7
"31087",31,87,2006,1484,1432,52,3.5
"31087",31,87,2007,1442,1403,39,2.7
"31087",31,87,2008,1472,1422,50,3.4
"31087",31,87,2009,1491,1409,82,5.5
"31087",31,87,2010,1400,1328,72,5.1
"31087",31,87,2011,1376,1309,67,4.9
"31087",31,87,2012,1359,1303,56,4.1
"31087",31,87,2013,1363,1308,55,4
"31087",31,87,2014,1340,1294,46,3.4
"31087",31,87,2015,1321,1278,43,3.3
"31087",31,87,2016,1303,1256,47,3.6
"31087",31,87,2017,1225,1183,42,3.4
"31089",31,89,1990,6014,5923,91,1.5
"31089",31,89,1991,6101,5982,119,2
"31089",31,89,1992,6063,5907,156,2.6
"31089",31,89,1993,6393,6215,178,2.8
"31089",31,89,1994,6613,6450,163,2.5
"31089",31,89,1995,6582,6405,177,2.7
"31089",31,89,1996,6576,6376,200,3
"31089",31,89,1997,6419,6247,172,2.7
"31089",31,89,1998,6468,6284,184,2.8
"31089",31,89,1999,6829,6631,198,2.9
"31089",31,89,2000,6262,6097,165,2.6
"31089",31,89,2001,6204,6012,192,3.1
"31089",31,89,2002,6208,6027,181,2.9
"31089",31,89,2003,6365,6169,196,3.1
"31089",31,89,2004,6276,6087,189,3
"31089",31,89,2005,6218,6028,190,3.1
"31089",31,89,2006,6157,5989,168,2.7
"31089",31,89,2007,6038,5883,155,2.6
"31089",31,89,2008,6138,5973,165,2.7
"31089",31,89,2009,6240,6046,194,3.1
"31089",31,89,2010,5832,5621,211,3.6
"31089",31,89,2011,5941,5737,204,3.4
"31089",31,89,2012,5972,5781,191,3.2
"31089",31,89,2013,6014,5825,189,3.1
"31089",31,89,2014,5918,5761,157,2.7
"31089",31,89,2015,5867,5727,140,2.4
"31089",31,89,2016,5849,5704,145,2.5
"31089",31,89,2017,5738,5597,141,2.5
"31091",31,91,1990,374,368,6,1.6
"31091",31,91,1991,367,360,7,1.9
"31091",31,91,1992,375,366,9,2.4
"31091",31,91,1993,410,401,9,2.2
"31091",31,91,1994,413,399,14,3.4
"31091",31,91,1995,438,423,15,3.4
"31091",31,91,1996,428,415,13,3
"31091",31,91,1997,396,384,12,3
"31091",31,91,1998,394,383,11,2.8
"31091",31,91,1999,436,425,11,2.5
"31091",31,91,2000,451,436,15,3.3
"31091",31,91,2001,436,421,15,3.4
"31091",31,91,2002,416,402,14,3.4
"31091",31,91,2003,418,404,14,3.3
"31091",31,91,2004,429,415,14,3.3
"31091",31,91,2005,451,436,15,3.3
"31091",31,91,2006,500,486,14,2.8
"31091",31,91,2007,465,452,13,2.8
"31091",31,91,2008,415,397,18,4.3
"31091",31,91,2009,412,391,21,5.1
"31091",31,91,2010,410,389,21,5.1
"31091",31,91,2011,447,426,21,4.7
"31091",31,91,2012,438,418,20,4.6
"31091",31,91,2013,436,415,21,4.8
"31091",31,91,2014,423,405,18,4.3
"31091",31,91,2015,405,388,17,4.2
"31091",31,91,2016,391,377,14,3.6
"31091",31,91,2017,399,384,15,3.8
"31093",31,93,1990,3009,2946,63,2.1
"31093",31,93,1991,3108,3031,77,2.5
"31093",31,93,1992,3231,3148,83,2.6
"31093",31,93,1993,3307,3229,78,2.4
"31093",31,93,1994,3370,3286,84,2.5
"31093",31,93,1995,3432,3350,82,2.4
"31093",31,93,1996,3484,3386,98,2.8
"31093",31,93,1997,3507,3422,85,2.4
"31093",31,93,1998,3572,3480,92,2.6
"31093",31,93,1999,3586,3469,117,3.3
"31093",31,93,2000,3555,3463,92,2.6
"31093",31,93,2001,3519,3414,105,3
"31093",31,93,2002,3524,3398,126,3.6
"31093",31,93,2003,3634,3480,154,4.2
"31093",31,93,2004,3682,3531,151,4.1
"31093",31,93,2005,3688,3556,132,3.6
"31093",31,93,2006,3707,3601,106,2.9
"31093",31,93,2007,3708,3606,102,2.8
"31093",31,93,2008,3739,3624,115,3.1
"31093",31,93,2009,3615,3482,133,3.7
"31093",31,93,2010,3346,3198,148,4.4
"31093",31,93,2011,3395,3257,138,4.1
"31093",31,93,2012,3423,3299,124,3.6
"31093",31,93,2013,3425,3299,126,3.7
"31093",31,93,2014,3364,3239,125,3.7
"31093",31,93,2015,3309,3188,121,3.7
"31093",31,93,2016,3294,3185,109,3.3
"31093",31,93,2017,3291,3190,101,3.1
"31095",31,95,1990,4280,4204,76,1.8
"31095",31,95,1991,4245,4162,83,2
"31095",31,95,1992,4303,4202,101,2.3
"31095",31,95,1993,4381,4271,110,2.5
"31095",31,95,1994,4364,4253,111,2.5
"31095",31,95,1995,4247,4147,100,2.4
"31095",31,95,1996,4320,4226,94,2.2
"31095",31,95,1997,3989,3918,71,1.8
"31095",31,95,1998,4038,3951,87,2.2
"31095",31,95,1999,4119,3997,122,3
"31095",31,95,2000,4373,4233,140,3.2
"31095",31,95,2001,4318,4122,196,4.5
"31095",31,95,2002,4347,4152,195,4.5
"31095",31,95,2003,4274,4092,182,4.3
"31095",31,95,2004,4351,4168,183,4.2
"31095",31,95,2005,4364,4196,168,3.8
"31095",31,95,2006,4375,4233,142,3.2
"31095",31,95,2007,4576,4451,125,2.7
"31095",31,95,2008,4321,4154,167,3.9
"31095",31,95,2009,4300,4093,207,4.8
"31095",31,95,2010,4251,4050,201,4.7
"31095",31,95,2011,4375,4186,189,4.3
"31095",31,95,2012,4321,4158,163,3.8
"31095",31,95,2013,4346,4185,161,3.7
"31095",31,95,2014,4297,4166,131,3
"31095",31,95,2015,4274,4158,116,2.7
"31095",31,95,2016,4213,4112,101,2.4
"31095",31,95,2017,4166,4064,102,2.4
"31097",31,97,1990,2333,2265,68,2.9
"31097",31,97,1991,2328,2275,53,2.3
"31097",31,97,1992,2356,2291,65,2.8
"31097",31,97,1993,2401,2335,66,2.7
"31097",31,97,1994,2380,2317,63,2.6
"31097",31,97,1995,2337,2265,72,3.1
"31097",31,97,1996,2233,2147,86,3.9
"31097",31,97,1997,2038,1920,118,5.8
"31097",31,97,1998,1892,1778,114,6
"31097",31,97,1999,2237,2148,89,4
"31097",31,97,2000,2506,2351,155,6.2
"31097",31,97,2001,2625,2546,79,3
"31097",31,97,2002,2887,2802,85,2.9
"31097",31,97,2003,3039,2948,91,3
"31097",31,97,2004,3104,2996,108,3.5
"31097",31,97,2005,3140,3027,113,3.6
"31097",31,97,2006,3214,3115,99,3.1
"31097",31,97,2007,2874,2790,84,2.9
"31097",31,97,2008,2938,2845,93,3.2
"31097",31,97,2009,3032,2905,127,4.2
"31097",31,97,2010,2343,2234,109,4.7
"31097",31,97,2011,2215,2108,107,4.8
"31097",31,97,2012,2193,2098,95,4.3
"31097",31,97,2013,2186,2091,95,4.3
"31097",31,97,2014,2168,2085,83,3.8
"31097",31,97,2015,2124,2054,70,3.3
"31097",31,97,2016,2088,2022,66,3.2
"31097",31,97,2017,2060,1990,70,3.4
"31099",31,99,1990,3262,3203,59,1.8
"31099",31,99,1991,3223,3163,60,1.9
"31099",31,99,1992,3372,3310,62,1.8
"31099",31,99,1993,3415,3358,57,1.7
"31099",31,99,1994,3539,3475,64,1.8
"31099",31,99,1995,3519,3456,63,1.8
"31099",31,99,1996,3554,3489,65,1.8
"31099",31,99,1997,3605,3547,58,1.6
"31099",31,99,1998,3699,3632,67,1.8
"31099",31,99,1999,3828,3743,85,2.2
"31099",31,99,2000,3741,3664,77,2.1
"31099",31,99,2001,3761,3672,89,2.4
"31099",31,99,2002,3857,3751,106,2.7
"31099",31,99,2003,3891,3786,105,2.7
"31099",31,99,2004,3910,3798,112,2.9
"31099",31,99,2005,3891,3781,110,2.8
"31099",31,99,2006,3875,3785,90,2.3
"31099",31,99,2007,3808,3724,84,2.2
"31099",31,99,2008,3693,3592,101,2.7
"31099",31,99,2009,3626,3485,141,3.9
"31099",31,99,2010,3796,3663,133,3.5
"31099",31,99,2011,3904,3778,126,3.2
"31099",31,99,2012,3934,3821,113,2.9
"31099",31,99,2013,3905,3795,110,2.8
"31099",31,99,2014,3846,3751,95,2.5
"31099",31,99,2015,3792,3708,84,2.2
"31099",31,99,2016,3734,3646,88,2.4
"31099",31,99,2017,3740,3657,83,2.2
"31101",31,101,1990,4661,4520,141,3
"31101",31,101,1991,4518,4387,131,2.9
"31101",31,101,1992,4388,4266,122,2.8
"31101",31,101,1993,4371,4238,133,3
"31101",31,101,1994,4599,4463,136,3
"31101",31,101,1995,4551,4422,129,2.8
"31101",31,101,1996,4642,4465,177,3.8
"31101",31,101,1997,4564,4455,109,2.4
"31101",31,101,1998,4535,4406,129,2.8
"31101",31,101,1999,4666,4533,133,2.9
"31101",31,101,2000,4875,4742,133,2.7
"31101",31,101,2001,4990,4845,145,2.9
"31101",31,101,2002,5049,4887,162,3.2
"31101",31,101,2003,4989,4821,168,3.4
"31101",31,101,2004,4842,4683,159,3.3
"31101",31,101,2005,4783,4628,155,3.2
"31101",31,101,2006,4740,4617,123,2.6
"31101",31,101,2007,4662,4544,118,2.5
"31101",31,101,2008,4550,4420,130,2.9
"31101",31,101,2009,4470,4269,201,4.5
"31101",31,101,2010,4585,4390,195,4.3
"31101",31,101,2011,4655,4465,190,4.1
"31101",31,101,2012,4664,4491,173,3.7
"31101",31,101,2013,4713,4543,170,3.6
"31101",31,101,2014,4663,4529,134,2.9
"31101",31,101,2015,4684,4559,125,2.7
"31101",31,101,2016,4609,4475,134,2.9
"31101",31,101,2017,4553,4415,138,3
"31103",31,103,1990,517,510,7,1.4
"31103",31,103,1991,503,493,10,2
"31103",31,103,1992,497,485,12,2.4
"31103",31,103,1993,498,482,16,3.2
"31103",31,103,1994,524,509,15,2.9
"31103",31,103,1995,517,493,24,4.6
"31103",31,103,1996,483,464,19,3.9
"31103",31,103,1997,455,443,12,2.6
"31103",31,103,1998,447,438,9,2
"31103",31,103,1999,483,470,13,2.7
"31103",31,103,2000,499,487,12,2.4
"31103",31,103,2001,443,432,11,2.5
"31103",31,103,2002,443,426,17,3.8
"31103",31,103,2003,460,445,15,3.3
"31103",31,103,2004,438,424,14,3.2
"31103",31,103,2005,435,420,15,3.4
"31103",31,103,2006,427,414,13,3
"31103",31,103,2007,379,365,14,3.7
"31103",31,103,2008,375,357,18,4.8
"31103",31,103,2009,398,379,19,4.8
"31103",31,103,2010,568,548,20,3.5
"31103",31,103,2011,602,584,18,3
"31103",31,103,2012,607,588,19,3.1
"31103",31,103,2013,611,591,20,3.3
"31103",31,103,2014,619,602,17,2.7
"31103",31,103,2015,660,646,14,2.1
"31103",31,103,2016,619,606,13,2.1
"31103",31,103,2017,605,590,15,2.5
"31105",31,105,1990,1991,1966,25,1.3
"31105",31,105,1991,2054,2020,34,1.7
"31105",31,105,1992,2101,2047,54,2.6
"31105",31,105,1993,2127,2073,54,2.5
"31105",31,105,1994,2236,2180,56,2.5
"31105",31,105,1995,2146,2093,53,2.5
"31105",31,105,1996,1993,1949,44,2.2
"31105",31,105,1997,2005,1965,40,2
"31105",31,105,1998,2004,1964,40,2
"31105",31,105,1999,1983,1946,37,1.9
"31105",31,105,2000,2198,2144,54,2.5
"31105",31,105,2001,2203,2148,55,2.5
"31105",31,105,2002,2111,2056,55,2.6
"31105",31,105,2003,2121,2062,59,2.8
"31105",31,105,2004,2169,2106,63,2.9
"31105",31,105,2005,2138,2075,63,2.9
"31105",31,105,2006,2020,1965,55,2.7
"31105",31,105,2007,1974,1919,55,2.8
"31105",31,105,2008,1940,1875,65,3.4
"31105",31,105,2009,1923,1831,92,4.8
"31105",31,105,2010,2124,2024,100,4.7
"31105",31,105,2011,2181,2102,79,3.6
"31105",31,105,2012,2223,2150,73,3.3
"31105",31,105,2013,2199,2126,73,3.3
"31105",31,105,2014,2226,2170,56,2.5
"31105",31,105,2015,2051,1978,73,3.6
"31105",31,105,2016,1968,1888,80,4.1
"31105",31,105,2017,1957,1901,56,2.9
"31107",31,107,1990,4314,4208,106,2.5
"31107",31,107,1991,4373,4241,132,3
"31107",31,107,1992,4423,4289,134,3
"31107",31,107,1993,4504,4369,135,3
"31107",31,107,1994,4661,4520,141,3
"31107",31,107,1995,4679,4502,177,3.8
"31107",31,107,1996,4801,4627,174,3.6
"31107",31,107,1997,4741,4583,158,3.3
"31107",31,107,1998,4762,4610,152,3.2
"31107",31,107,1999,4876,4707,169,3.5
"31107",31,107,2000,4814,4632,182,3.8
"31107",31,107,2001,4690,4517,173,3.7
"31107",31,107,2002,4786,4624,162,3.4
"31107",31,107,2003,4975,4803,172,3.5
"31107",31,107,2004,4946,4773,173,3.5
"31107",31,107,2005,4887,4720,167,3.4
"31107",31,107,2006,4804,4658,146,3
"31107",31,107,2007,4712,4573,139,2.9
"31107",31,107,2008,4667,4519,148,3.2
"31107",31,107,2009,4859,4686,173,3.6
"31107",31,107,2010,4751,4554,197,4.1
"31107",31,107,2011,4762,4577,185,3.9
"31107",31,107,2012,4791,4630,161,3.4
"31107",31,107,2013,4808,4638,170,3.5
"31107",31,107,2014,4730,4583,147,3.1
"31107",31,107,2015,4717,4566,151,3.2
"31107",31,107,2016,4712,4567,145,3.1
"31107",31,107,2017,4691,4528,163,3.5
"31109",31,109,1990,124364,121662,2702,2.2
"31109",31,109,1991,126041,123033,3008,2.4
"31109",31,109,1992,128656,125335,3321,2.6
"31109",31,109,1993,131091,127944,3147,2.4
"31109",31,109,1994,133741,130785,2956,2.2
"31109",31,109,1995,137009,133920,3089,2.3
"31109",31,109,1996,141594,138231,3363,2.4
"31109",31,109,1997,143637,140562,3075,2.1
"31109",31,109,1998,145213,142137,3076,2.1
"31109",31,109,1999,146554,143138,3416,2.3
"31109",31,109,2000,148280,144779,3501,2.4
"31109",31,109,2001,151530,147481,4049,2.7
"31109",31,109,2002,151376,146551,4825,3.2
"31109",31,109,2003,153762,148183,5579,3.6
"31109",31,109,2004,155096,149733,5363,3.5
"31109",31,109,2005,156012,150504,5508,3.5
"31109",31,109,2006,155780,151362,4418,2.8
"31109",31,109,2007,157366,152970,4396,2.8
"31109",31,109,2008,159845,154953,4892,3.1
"31109",31,109,2009,160713,153785,6928,4.3
"31109",31,109,2010,162567,155716,6851,4.2
"31109",31,109,2011,164156,157591,6565,4
"31109",31,109,2012,167607,161556,6051,3.6
"31109",31,109,2013,168939,163096,5843,3.5
"31109",31,109,2014,167883,162879,5004,3
"31109",31,109,2015,167490,163068,4422,2.6
"31109",31,109,2016,168745,164048,4697,2.8
"31109",31,109,2017,168999,164538,4461,2.6
"31111",31,111,1990,16264,15814,450,2.8
"31111",31,111,1991,16956,16456,500,2.9
"31111",31,111,1992,17432,16871,561,3.2
"31111",31,111,1993,17367,16701,666,3.8
"31111",31,111,1994,17859,17210,649,3.6
"31111",31,111,1995,18321,17556,765,4.2
"31111",31,111,1996,17656,16981,675,3.8
"31111",31,111,1997,18070,17423,647,3.6
"31111",31,111,1998,18715,18077,638,3.4
"31111",31,111,1999,17675,17102,573,3.2
"31111",31,111,2000,18390,17803,587,3.2
"31111",31,111,2001,19581,18956,625,3.2
"31111",31,111,2002,19872,19218,654,3.3
"31111",31,111,2003,20461,19741,720,3.5
"31111",31,111,2004,20898,20172,726,3.5
"31111",31,111,2005,21077,20346,731,3.5
"31111",31,111,2006,21171,20575,596,2.8
"31111",31,111,2007,21756,21182,574,2.6
"31111",31,111,2008,21981,21332,649,3
"31111",31,111,2009,21821,20949,872,4
"31111",31,111,2010,19401,18524,877,4.5
"31111",31,111,2011,19422,18571,851,4.4
"31111",31,111,2012,19276,18517,759,3.9
"31111",31,111,2013,19247,18518,729,3.8
"31111",31,111,2014,18720,18112,608,3.2
"31111",31,111,2015,18535,17998,537,2.9
"31111",31,111,2016,18678,18102,576,3.1
"31111",31,111,2017,18518,17957,561,3
"31113",31,113,1990,419,413,6,1.4
"31113",31,113,1991,431,423,8,1.9
"31113",31,113,1992,436,428,8,1.8
"31113",31,113,1993,447,440,7,1.6
"31113",31,113,1994,455,443,12,2.6
"31113",31,113,1995,454,443,11,2.4
"31113",31,113,1996,451,439,12,2.7
"31113",31,113,1997,465,453,12,2.6
"31113",31,113,1998,472,462,10,2.1
"31113",31,113,1999,448,439,9,2
"31113",31,113,2000,418,408,10,2.4
"31113",31,113,2001,444,433,11,2.5
"31113",31,113,2002,442,431,11,2.5
"31113",31,113,2003,429,417,12,2.8
"31113",31,113,2004,439,426,13,3
"31113",31,113,2005,447,436,11,2.5
"31113",31,113,2006,452,442,10,2.2
"31113",31,113,2007,471,458,13,2.8
"31113",31,113,2008,464,454,10,2.2
"31113",31,113,2009,458,444,14,3.1
"31113",31,113,2010,492,470,22,4.5
"31113",31,113,2011,509,491,18,3.5
"31113",31,113,2012,506,490,16,3.2
"31113",31,113,2013,503,487,16,3.2
"31113",31,113,2014,494,479,15,3
"31113",31,113,2015,492,478,14,2.8
"31113",31,113,2016,483,469,14,2.9
"31113",31,113,2017,469,456,13,2.8
"31115",31,115,1990,349,342,7,2
"31115",31,115,1991,463,455,8,1.7
"31115",31,115,1992,459,449,10,2.2
"31115",31,115,1993,425,415,10,2.4
"31115",31,115,1994,465,457,8,1.7
"31115",31,115,1995,474,464,10,2.1
"31115",31,115,1996,463,452,11,2.4
"31115",31,115,1997,408,401,7,1.7
"31115",31,115,1998,384,374,10,2.6
"31115",31,115,1999,408,399,9,2.2
"31115",31,115,2000,335,327,8,2.4
"31115",31,115,2001,342,332,10,2.9
"31115",31,115,2002,335,323,12,3.6
"31115",31,115,2003,358,344,14,3.9
"31115",31,115,2004,348,334,14,4
"31115",31,115,2005,339,324,15,4.4
"31115",31,115,2006,354,341,13,3.7
"31115",31,115,2007,333,319,14,4.2
"31115",31,115,2008,339,326,13,3.8
"31115",31,115,2009,336,319,17,5.1
"31115",31,115,2010,368,347,21,5.7
"31115",31,115,2011,378,360,18,4.8
"31115",31,115,2012,392,377,15,3.8
"31115",31,115,2013,378,361,17,4.5
"31115",31,115,2014,380,366,14,3.7
"31115",31,115,2015,379,365,14,3.7
"31115",31,115,2016,395,381,14,3.5
"31115",31,115,2017,392,380,12,3.1
"31117",31,117,1990,293,290,3,1
"31117",31,117,1991,303,298,5,1.7
"31117",31,117,1992,298,292,6,2
"31117",31,117,1993,300,296,4,1.3
"31117",31,117,1994,318,310,8,2.5
"31117",31,117,1995,323,317,6,1.9
"31117",31,117,1996,321,311,10,3.1
"31117",31,117,1997,322,317,5,1.6
"31117",31,117,1998,328,324,4,1.2
"31117",31,117,1999,302,299,3,1
"31117",31,117,2000,273,268,5,1.8
"31117",31,117,2001,292,287,5,1.7
"31117",31,117,2002,305,300,5,1.6
"31117",31,117,2003,306,297,9,2.9
"31117",31,117,2004,303,298,5,1.7
"31117",31,117,2005,291,285,6,2.1
"31117",31,117,2006,287,281,6,2.1
"31117",31,117,2007,300,294,6,2
"31117",31,117,2008,310,303,7,2.3
"31117",31,117,2009,292,281,11,3.8
"31117",31,117,2010,353,343,10,2.8
"31117",31,117,2011,366,357,9,2.5
"31117",31,117,2012,361,348,13,3.6
"31117",31,117,2013,372,358,14,3.8
"31117",31,117,2014,438,428,10,2.3
"31117",31,117,2015,461,452,9,2
"31117",31,117,2016,463,452,11,2.4
"31117",31,117,2017,447,437,10,2.2
"31119",31,119,1990,17226,16873,353,2
"31119",31,119,1991,17355,16944,411,2.4
"31119",31,119,1992,17561,17109,452,2.6
"31119",31,119,1993,18785,18268,517,2.8
"31119",31,119,1994,19380,18894,486,2.5
"31119",31,119,1995,20034,19531,503,2.5
"31119",31,119,1996,20323,19784,539,2.7
"31119",31,119,1997,20562,20042,520,2.5
"31119",31,119,1998,20786,19977,809,3.9
"31119",31,119,1999,20208,19359,849,4.2
"31119",31,119,2000,19275,18644,631,3.3
"31119",31,119,2001,19168,18486,682,3.6
"31119",31,119,2002,19147,18398,749,3.9
"31119",31,119,2003,20431,19613,818,4
"31119",31,119,2004,20551,19750,801,3.9
"31119",31,119,2005,20302,19483,819,4
"31119",31,119,2006,19289,18569,720,3.7
"31119",31,119,2007,18819,18225,594,3.2
"31119",31,119,2008,18856,18229,627,3.3
"31119",31,119,2009,18935,18113,822,4.3
"31119",31,119,2010,18950,18151,799,4.2
"31119",31,119,2011,19091,18314,777,4.1
"31119",31,119,2012,19209,18500,709,3.7
"31119",31,119,2013,19357,18681,676,3.5
"31119",31,119,2014,19474,18900,574,2.9
"31119",31,119,2015,19206,18680,526,2.7
"31119",31,119,2016,19126,18598,528,2.8
"31119",31,119,2017,19116,18612,504,2.6
"31121",31,121,1990,4238,4161,77,1.8
"31121",31,121,1991,4324,4230,94,2.2
"31121",31,121,1992,4466,4373,93,2.1
"31121",31,121,1993,4558,4473,85,1.9
"31121",31,121,1994,4620,4536,84,1.8
"31121",31,121,1995,4643,4557,86,1.9
"31121",31,121,1996,4668,4570,98,2.1
"31121",31,121,1997,4690,4605,85,1.8
"31121",31,121,1998,4686,4588,98,2.1
"31121",31,121,1999,4645,4537,108,2.3
"31121",31,121,2000,4287,4172,115,2.7
"31121",31,121,2001,4216,4092,124,2.9
"31121",31,121,2002,4230,4073,157,3.7
"31121",31,121,2003,4270,4097,173,4.1
"31121",31,121,2004,4301,4124,177,4.1
"31121",31,121,2005,4290,4133,157,3.7
"31121",31,121,2006,4262,4109,153,3.6
"31121",31,121,2007,4174,4054,120,2.9
"31121",31,121,2008,4222,4091,131,3.1
"31121",31,121,2009,4178,4004,174,4.2
"31121",31,121,2010,4199,4010,189,4.5
"31121",31,121,2011,4174,3996,178,4.3
"31121",31,121,2012,4232,4077,155,3.7
"31121",31,121,2013,4210,4054,156,3.7
"31121",31,121,2014,4112,3956,156,3.8
"31121",31,121,2015,4026,3876,150,3.7
"31121",31,121,2016,4027,3881,146,3.6
"31121",31,121,2017,3998,3886,112,2.8
"31123",31,123,1990,2687,2599,88,3.3
"31123",31,123,1991,2742,2653,89,3.2
"31123",31,123,1992,2757,2639,118,4.3
"31123",31,123,1993,2744,2621,123,4.5
"31123",31,123,1994,2848,2726,122,4.3
"31123",31,123,1995,2787,2660,127,4.6
"31123",31,123,1996,2938,2827,111,3.8
"31123",31,123,1997,2828,2728,100,3.5
"31123",31,123,1998,2747,2645,102,3.7
"31123",31,123,1999,2783,2674,109,3.9
"31123",31,123,2000,2798,2701,97,3.5
"31123",31,123,2001,2808,2718,90,3.2
"31123",31,123,2002,2839,2722,117,4.1
"31123",31,123,2003,2833,2722,111,3.9
"31123",31,123,2004,2812,2719,93,3.3
"31123",31,123,2005,2813,2726,87,3.1
"31123",31,123,2006,2797,2724,73,2.6
"31123",31,123,2007,2778,2705,73,2.6
"31123",31,123,2008,2882,2792,90,3.1
"31123",31,123,2009,2863,2742,121,4.2
"31123",31,123,2010,2650,2542,108,4.1
"31123",31,123,2011,2658,2568,90,3.4
"31123",31,123,2012,2703,2617,86,3.2
"31123",31,123,2013,2756,2667,89,3.2
"31123",31,123,2014,2680,2599,81,3
"31123",31,123,2015,2650,2574,76,2.9
"31123",31,123,2016,2643,2559,84,3.2
"31123",31,123,2017,2608,2532,76,2.9
"31125",31,125,1990,2009,1974,35,1.7
"31125",31,125,1991,2039,1995,44,2.2
"31125",31,125,1992,2023,1975,48,2.4
"31125",31,125,1993,1964,1908,56,2.9
"31125",31,125,1994,1957,1911,46,2.4
"31125",31,125,1995,1948,1897,51,2.6
"31125",31,125,1996,1840,1791,49,2.7
"31125",31,125,1997,1773,1733,40,2.3
"31125",31,125,1998,1738,1691,47,2.7
"31125",31,125,1999,1729,1673,56,3.2
"31125",31,125,2000,2063,2001,62,3
"31125",31,125,2001,2069,1997,72,3.5
"31125",31,125,2002,2079,1988,91,4.4
"31125",31,125,2003,2092,1984,108,5.2
"31125",31,125,2004,2020,1930,90,4.5
"31125",31,125,2005,2026,1948,78,3.8
"31125",31,125,2006,2010,1952,58,2.9
"31125",31,125,2007,2020,1970,50,2.5
"31125",31,125,2008,2056,1995,61,3
"31125",31,125,2009,2150,2079,71,3.3
"31125",31,125,2010,1980,1903,77,3.9
"31125",31,125,2011,2063,1987,76,3.7
"31125",31,125,2012,2099,2029,70,3.3
"31125",31,125,2013,2079,2012,67,3.2
"31125",31,125,2014,2070,2014,56,2.7
"31125",31,125,2015,2065,2014,51,2.5
"31125",31,125,2016,1996,1941,55,2.8
"31125",31,125,2017,2011,1961,50,2.5
"31127",31,127,1990,3564,3422,142,4
"31127",31,127,1991,3571,3411,160,4.5
"31127",31,127,1992,3523,3350,173,4.9
"31127",31,127,1993,3899,3740,159,4.1
"31127",31,127,1994,3803,3643,160,4.2
"31127",31,127,1995,4008,3861,147,3.7
"31127",31,127,1996,3931,3745,186,4.7
"31127",31,127,1997,3823,3643,180,4.7
"31127",31,127,1998,4162,3970,192,4.6
"31127",31,127,1999,4004,3828,176,4.4
"31127",31,127,2000,3775,3624,151,4
"31127",31,127,2001,3825,3690,135,3.5
"31127",31,127,2002,3649,3492,157,4.3
"31127",31,127,2003,3564,3412,152,4.3
"31127",31,127,2004,3500,3343,157,4.5
"31127",31,127,2005,3564,3404,160,4.5
"31127",31,127,2006,3551,3407,144,4.1
"31127",31,127,2007,3505,3371,134,3.8
"31127",31,127,2008,3414,3256,158,4.6
"31127",31,127,2009,3433,3253,180,5.2
"31127",31,127,2010,3851,3646,205,5.3
"31127",31,127,2011,3961,3764,197,5
"31127",31,127,2012,3886,3698,188,4.8
"31127",31,127,2013,3824,3633,191,5
"31127",31,127,2014,3723,3580,143,3.8
"31127",31,127,2015,3689,3554,135,3.7
"31127",31,127,2016,3610,3479,131,3.6
"31127",31,127,2017,3579,3439,140,3.9
"31129",31,129,1990,2576,2546,30,1.2
"31129",31,129,1991,2541,2502,39,1.5
"31129",31,129,1992,2482,2438,44,1.8
"31129",31,129,1993,2480,2428,52,2.1
"31129",31,129,1994,2522,2469,53,2.1
"31129",31,129,1995,2469,2404,65,2.6
"31129",31,129,1996,2395,2337,58,2.4
"31129",31,129,1997,2350,2307,43,1.8
"31129",31,129,1998,2291,2241,50,2.2
"31129",31,129,1999,2304,2255,49,2.1
"31129",31,129,2000,2579,2511,68,2.6
"31129",31,129,2001,2485,2413,72,2.9
"31129",31,129,2002,2477,2403,74,3
"31129",31,129,2003,2512,2435,77,3.1
"31129",31,129,2004,2442,2364,78,3.2
"31129",31,129,2005,2416,2336,80,3.3
"31129",31,129,2006,2338,2274,64,2.7
"31129",31,129,2007,2240,2181,59,2.6
"31129",31,129,2008,2254,2188,66,2.9
"31129",31,129,2009,2313,2208,105,4.5
"31129",31,129,2010,2441,2341,100,4.1
"31129",31,129,2011,2496,2406,90,3.6
"31129",31,129,2012,2477,2391,86,3.5
"31129",31,129,2013,2458,2379,79,3.2
"31129",31,129,2014,2403,2335,68,2.8
"31129",31,129,2015,2381,2320,61,2.6
"31129",31,129,2016,2363,2294,69,2.9
"31129",31,129,2017,2348,2286,62,2.6
"31131",31,131,1990,7191,7001,190,2.6
"31131",31,131,1991,7208,6986,222,3.1
"31131",31,131,1992,7356,7092,264,3.6
"31131",31,131,1993,7409,7167,242,3.3
"31131",31,131,1994,7617,7367,250,3.3
"31131",31,131,1995,7746,7504,242,3.1
"31131",31,131,1996,7623,7378,245,3.2
"31131",31,131,1997,7909,7664,245,3.1
"31131",31,131,1998,7853,7628,225,2.9
"31131",31,131,1999,7824,7586,238,3
"31131",31,131,2000,8324,8062,262,3.1
"31131",31,131,2001,8369,8086,283,3.4
"31131",31,131,2002,8546,8218,328,3.8
"31131",31,131,2003,8763,8410,353,4
"31131",31,131,2004,8779,8423,356,4.1
"31131",31,131,2005,8783,8435,348,4
"31131",31,131,2006,8728,8444,284,3.3
"31131",31,131,2007,8949,8681,268,3
"31131",31,131,2008,9071,8752,319,3.5
"31131",31,131,2009,8951,8506,445,5
"31131",31,131,2010,8476,8048,428,5
"31131",31,131,2011,8555,8121,434,5.1
"31131",31,131,2012,8512,8128,384,4.5
"31131",31,131,2013,8438,8078,360,4.3
"31131",31,131,2014,8239,7934,305,3.7
"31131",31,131,2015,8199,7928,271,3.3
"31131",31,131,2016,8247,7966,281,3.4
"31131",31,131,2017,8110,7838,272,3.4
"31133",31,133,1990,1582,1540,42,2.7
"31133",31,133,1991,1587,1554,33,2.1
"31133",31,133,1992,1497,1464,33,2.2
"31133",31,133,1993,1505,1463,42,2.8
"31133",31,133,1994,1535,1495,40,2.6
"31133",31,133,1995,1500,1446,54,3.6
"31133",31,133,1996,1461,1411,50,3.4
"31133",31,133,1997,1492,1442,50,3.4
"31133",31,133,1998,1532,1488,44,2.9
"31133",31,133,1999,1648,1600,48,2.9
"31133",31,133,2000,1638,1580,58,3.5
"31133",31,133,2001,1673,1616,57,3.4
"31133",31,133,2002,1640,1580,60,3.7
"31133",31,133,2003,1670,1602,68,4.1
"31133",31,133,2004,1662,1601,61,3.7
"31133",31,133,2005,1633,1574,59,3.6
"31133",31,133,2006,1622,1572,50,3.1
"31133",31,133,2007,1587,1540,47,3
"31133",31,133,2008,1566,1513,53,3.4
"31133",31,133,2009,1546,1489,57,3.7
"31133",31,133,2010,1586,1523,63,4
"31133",31,133,2011,1653,1591,62,3.8
"31133",31,133,2012,1640,1586,54,3.3
"31133",31,133,2013,1685,1632,53,3.1
"31133",31,133,2014,1652,1606,46,2.8
"31133",31,133,2015,1672,1629,43,2.6
"31133",31,133,2016,1650,1613,37,2.2
"31133",31,133,2017,1497,1451,46,3.1
"31135",31,135,1990,1472,1455,17,1.2
"31135",31,135,1991,1411,1382,29,2.1
"31135",31,135,1992,1455,1420,35,2.4
"31135",31,135,1993,1418,1384,34,2.4
"31135",31,135,1994,1451,1417,34,2.3
"31135",31,135,1995,1524,1486,38,2.5
"31135",31,135,1996,1520,1482,38,2.5
"31135",31,135,1997,1524,1486,38,2.5
"31135",31,135,1998,1499,1461,38,2.5
"31135",31,135,1999,1538,1498,40,2.6
"31135",31,135,2000,1646,1609,37,2.2
"31135",31,135,2001,1669,1632,37,2.2
"31135",31,135,2002,1701,1659,42,2.5
"31135",31,135,2003,1664,1621,43,2.6
"31135",31,135,2004,1654,1612,42,2.5
"31135",31,135,2005,1587,1547,40,2.5
"31135",31,135,2006,1582,1547,35,2.2
"31135",31,135,2007,1577,1539,38,2.4
"31135",31,135,2008,1677,1636,41,2.4
"31135",31,135,2009,1705,1654,51,3
"31135",31,135,2010,1769,1710,59,3.3
"31135",31,135,2011,1803,1751,52,2.9
"31135",31,135,2012,1830,1781,49,2.7
"31135",31,135,2013,1823,1776,47,2.6
"31135",31,135,2014,1851,1812,39,2.1
"31135",31,135,2015,1835,1801,34,1.9
"31135",31,135,2016,1816,1777,39,2.1
"31135",31,135,2017,1794,1759,35,2
"31137",31,137,1990,5092,5034,58,1.1
"31137",31,137,1991,5168,5096,72,1.4
"31137",31,137,1992,5223,5151,72,1.4
"31137",31,137,1993,5186,5120,66,1.3
"31137",31,137,1994,5363,5282,81,1.5
"31137",31,137,1995,5398,5302,96,1.8
"31137",31,137,1996,5417,5306,111,2
"31137",31,137,1997,5244,5143,101,1.9
"31137",31,137,1998,5130,5016,114,2.2
"31137",31,137,1999,5084,4976,108,2.1
"31137",31,137,2000,5368,5249,119,2.2
"31137",31,137,2001,5378,5239,139,2.6
"31137",31,137,2002,5364,5210,154,2.9
"31137",31,137,2003,5381,5217,164,3
"31137",31,137,2004,5258,5087,171,3.3
"31137",31,137,2005,5230,5082,148,2.8
"31137",31,137,2006,5175,5057,118,2.3
"31137",31,137,2007,5101,4985,116,2.3
"31137",31,137,2008,5152,5027,125,2.4
"31137",31,137,2009,5212,5027,185,3.5
"31137",31,137,2010,4958,4781,177,3.6
"31137",31,137,2011,5013,4830,183,3.7
"31137",31,137,2012,5049,4897,152,3
"31137",31,137,2013,5093,4942,151,3
"31137",31,137,2014,5050,4919,131,2.6
"31137",31,137,2015,4992,4873,119,2.4
"31137",31,137,2016,4921,4797,124,2.5
"31137",31,137,2017,4908,4793,115,2.3
"31139",31,139,1990,3634,3567,67,1.8
"31139",31,139,1991,3675,3589,86,2.3
"31139",31,139,1992,3639,3563,76,2.1
"31139",31,139,1993,3867,3777,90,2.3
"31139",31,139,1994,3970,3888,82,2.1
"31139",31,139,1995,4046,3952,94,2.3
"31139",31,139,1996,4082,3982,100,2.4
"31139",31,139,1997,4116,4027,89,2.2
"31139",31,139,1998,4166,4068,98,2.4
"31139",31,139,1999,4100,3978,122,3
"31139",31,139,2000,4216,4106,110,2.6
"31139",31,139,2001,4117,3995,122,3
"31139",31,139,2002,4052,3907,145,3.6
"31139",31,139,2003,4326,4175,151,3.5
"31139",31,139,2004,4303,4159,144,3.3
"31139",31,139,2005,4266,4116,150,3.5
"31139",31,139,2006,4047,3928,119,2.9
"31139",31,139,2007,3954,3836,118,3
"31139",31,139,2008,3940,3822,118,3
"31139",31,139,2009,3873,3720,153,4
"31139",31,139,2010,4175,4022,153,3.7
"31139",31,139,2011,4212,4063,149,3.5
"31139",31,139,2012,4197,4057,140,3.3
"31139",31,139,2013,4223,4082,141,3.3
"31139",31,139,2014,4237,4115,122,2.9
"31139",31,139,2015,4167,4061,106,2.5
"31139",31,139,2016,4138,4029,109,2.6
"31139",31,139,2017,4104,3993,111,2.7
"31141",31,141,1990,15639,15356,283,1.8
"31141",31,141,1991,15853,15461,392,2.5
"31141",31,141,1992,16134,15740,394,2.4
"31141",31,141,1993,16922,16524,398,2.4
"31141",31,141,1994,17647,17250,397,2.2
"31141",31,141,1995,17695,17265,430,2.4
"31141",31,141,1996,18023,17540,483,2.7
"31141",31,141,1997,17934,17530,404,2.3
"31141",31,141,1998,17907,17298,609,3.4
"31141",31,141,1999,17534,16938,596,3.4
"31141",31,141,2000,17469,16984,485,2.8
"31141",31,141,2001,17439,16828,611,3.5
"31141",31,141,2002,17185,16448,737,4.3
"31141",31,141,2003,16916,16117,799,4.7
"31141",31,141,2004,16884,16163,721,4.3
"31141",31,141,2005,17132,16500,632,3.7
"31141",31,141,2006,17596,17103,493,2.8
"31141",31,141,2007,18401,17953,448,2.4
"31141",31,141,2008,18398,17854,544,3
"31141",31,141,2009,18361,17611,750,4.1
"31141",31,141,2010,17655,16910,745,4.2
"31141",31,141,2011,17825,17083,742,4.2
"31141",31,141,2012,18047,17387,660,3.7
"31141",31,141,2013,17752,17136,616,3.5
"31141",31,141,2014,17305,16789,516,3
"31141",31,141,2015,17141,16630,511,3
"31141",31,141,2016,16944,16353,591,3.5
"31141",31,141,2017,17160,16667,493,2.9
"31143",31,143,1990,2701,2671,30,1.1
"31143",31,143,1991,2638,2590,48,1.8
"31143",31,143,1992,2608,2563,45,1.7
"31143",31,143,1993,2547,2492,55,2.2
"31143",31,143,1994,2610,2555,55,2.1
"31143",31,143,1995,2623,2570,53,2
"31143",31,143,1996,2493,2443,50,2
"31143",31,143,1997,2385,2345,40,1.7
"31143",31,143,1998,2370,2321,49,2.1
"31143",31,143,1999,2394,2346,48,2
"31143",31,143,2000,3039,2970,69,2.3
"31143",31,143,2001,3055,2972,83,2.7
"31143",31,143,2002,3046,2950,96,3.2
"31143",31,143,2003,3054,2945,109,3.6
"31143",31,143,2004,3043,2938,105,3.5
"31143",31,143,2005,3050,2951,99,3.2
"31143",31,143,2006,3045,2961,84,2.8
"31143",31,143,2007,2967,2884,83,2.8
"31143",31,143,2008,3034,2948,86,2.8
"31143",31,143,2009,3048,2934,114,3.7
"31143",31,143,2010,2958,2839,119,4
"31143",31,143,2011,3000,2897,103,3.4
"31143",31,143,2012,2993,2901,92,3.1
"31143",31,143,2013,3001,2899,102,3.4
"31143",31,143,2014,2961,2866,95,3.2
"31143",31,143,2015,2909,2835,74,2.5
"31143",31,143,2016,2876,2800,76,2.6
"31143",31,143,2017,2864,2796,68,2.4
"31145",31,145,1990,5835,5719,116,2
"31145",31,145,1991,5742,5627,115,2
"31145",31,145,1992,5873,5715,158,2.7
"31145",31,145,1993,6001,5851,150,2.5
"31145",31,145,1994,6014,5864,150,2.5
"31145",31,145,1995,6149,5980,169,2.7
"31145",31,145,1996,6133,5958,175,2.9
"31145",31,145,1997,6006,5864,142,2.4
"31145",31,145,1998,5942,5777,165,2.8
"31145",31,145,1999,6120,5955,165,2.7
"31145",31,145,2000,6187,6025,162,2.6
"31145",31,145,2001,6033,5875,158,2.6
"31145",31,145,2002,6068,5888,180,3
"31145",31,145,2003,6078,5873,205,3.4
"31145",31,145,2004,6068,5858,210,3.5
"31145",31,145,2005,6018,5809,209,3.5
"31145",31,145,2006,5949,5788,161,2.7
"31145",31,145,2007,5921,5772,149,2.5
"31145",31,145,2008,6020,5846,174,2.9
"31145",31,145,2009,6099,5825,274,4.5
"31145",31,145,2010,6216,5989,227,3.7
"31145",31,145,2011,6287,6069,218,3.5
"31145",31,145,2012,6357,6150,207,3.3
"31145",31,145,2013,6439,6249,190,3
"31145",31,145,2014,6284,6123,161,2.6
"31145",31,145,2015,6102,5941,161,2.6
"31145",31,145,2016,5965,5796,169,2.8
"31145",31,145,2017,5805,5658,147,2.5
"31147",31,147,1990,4450,4314,136,3.1
"31147",31,147,1991,4620,4409,211,4.6
"31147",31,147,1992,4690,4496,194,4.1
"31147",31,147,1993,4792,4614,178,3.7
"31147",31,147,1994,4707,4519,188,4
"31147",31,147,1995,4730,4542,188,4
"31147",31,147,1996,4700,4486,214,4.6
"31147",31,147,1997,4592,4394,198,4.3
"31147",31,147,1998,4467,4234,233,5.2
"31147",31,147,1999,4455,4205,250,5.6
"31147",31,147,2000,4726,4488,238,5
"31147",31,147,2001,4704,4482,222,4.7
"31147",31,147,2002,4554,4292,262,5.8
"31147",31,147,2003,4512,4256,256,5.7
"31147",31,147,2004,4431,4213,218,4.9
"31147",31,147,2005,4390,4192,198,4.5
"31147",31,147,2006,4361,4182,179,4.1
"31147",31,147,2007,4272,4097,175,4.1
"31147",31,147,2008,4218,4032,186,4.4
"31147",31,147,2009,4219,3964,255,6
"31147",31,147,2010,4328,4058,270,6.2
"31147",31,147,2011,4405,4139,266,6
"31147",31,147,2012,4408,4182,226,5.1
"31147",31,147,2013,4365,4170,195,4.5
"31147",31,147,2014,4275,4119,156,3.6
"31147",31,147,2015,4300,4162,138,3.2
"31147",31,147,2016,4230,4093,137,3.2
"31147",31,147,2017,4203,4065,138,3.3
"31149",31,149,1990,1030,1008,22,2.1
"31149",31,149,1991,990,963,27,2.7
"31149",31,149,1992,1001,976,25,2.5
"31149",31,149,1993,971,938,33,3.4
"31149",31,149,1994,982,942,40,4.1
"31149",31,149,1995,967,933,34,3.5
"31149",31,149,1996,948,915,33,3.5
"31149",31,149,1997,902,878,24,2.7
"31149",31,149,1998,914,883,31,3.4
"31149",31,149,1999,897,860,37,4.1
"31149",31,149,2000,1013,985,28,2.8
"31149",31,149,2001,998,967,31,3.1
"31149",31,149,2002,1025,997,28,2.7
"31149",31,149,2003,1031,992,39,3.8
"31149",31,149,2004,968,936,32,3.3
"31149",31,149,2005,937,909,28,3
"31149",31,149,2006,950,928,22,2.3
"31149",31,149,2007,877,854,23,2.6
"31149",31,149,2008,848,824,24,2.8
"31149",31,149,2009,878,852,26,3
"31149",31,149,2010,891,866,25,2.8
"31149",31,149,2011,899,875,24,2.7
"31149",31,149,2012,880,858,22,2.5
"31149",31,149,2013,887,859,28,3.2
"31149",31,149,2014,883,860,23,2.6
"31149",31,149,2015,859,836,23,2.7
"31149",31,149,2016,889,866,23,2.6
"31149",31,149,2017,887,864,23,2.6
"31151",31,151,1990,6395,6278,117,1.8
"31151",31,151,1991,6577,6478,99,1.5
"31151",31,151,1992,6760,6652,108,1.6
"31151",31,151,1993,6870,6762,108,1.6
"31151",31,151,1994,7164,7052,112,1.6
"31151",31,151,1995,7196,7085,111,1.5
"31151",31,151,1996,7117,6995,122,1.7
"31151",31,151,1997,7112,6993,119,1.7
"31151",31,151,1998,7055,6944,111,1.6
"31151",31,151,1999,7184,7044,140,1.9
"31151",31,151,2000,7635,7436,199,2.6
"31151",31,151,2001,7929,7702,227,2.9
"31151",31,151,2002,8116,7876,240,3
"31151",31,151,2003,8218,7948,270,3.3
"31151",31,151,2004,8242,7967,275,3.3
"31151",31,151,2005,8322,8044,278,3.3
"31151",31,151,2006,8176,7952,224,2.7
"31151",31,151,2007,8315,8094,221,2.7
"31151",31,151,2008,8402,8115,287,3.4
"31151",31,151,2009,8342,7961,381,4.6
"31151",31,151,2010,7287,6946,341,4.7
"31151",31,151,2011,7344,6998,346,4.7
"31151",31,151,2012,7364,7044,320,4.3
"31151",31,151,2013,7400,7085,315,4.3
"31151",31,151,2014,7230,6981,249,3.4
"31151",31,151,2015,7278,7065,213,2.9
"31151",31,151,2016,7338,7111,227,3.1
"31151",31,151,2017,7333,7107,226,3.1
"31153",31,153,1990,48939,47919,1020,2.1
"31153",31,153,1991,49866,48654,1212,2.4
"31153",31,153,1992,50564,49161,1403,2.8
"31153",31,153,1993,51339,49938,1401,2.7
"31153",31,153,1994,53696,52360,1336,2.5
"31153",31,153,1995,55873,54612,1261,2.3
"31153",31,153,1996,58294,57029,1265,2.2
"31153",31,153,1997,60128,58973,1155,1.9
"31153",31,153,1998,61400,60328,1072,1.7
"31153",31,153,1999,62659,61363,1296,2.1
"31153",31,153,2000,65950,64442,1508,2.3
"31153",31,153,2001,67380,65616,1764,2.6
"31153",31,153,2002,68647,66531,2116,3.1
"31153",31,153,2003,69654,67434,2220,3.2
"31153",31,153,2004,71465,69077,2388,3.3
"31153",31,153,2005,72972,70497,2475,3.4
"31153",31,153,2006,74097,71915,2182,2.9
"31153",31,153,2007,76803,74562,2241,2.9
"31153",31,153,2008,79249,76687,2562,3.2
"31153",31,153,2009,79677,75978,3699,4.6
"31153",31,153,2010,84923,81145,3778,4.4
"31153",31,153,2011,86350,82692,3658,4.2
"31153",31,153,2012,88075,84673,3402,3.9
"31153",31,153,2013,89279,86071,3208,3.6
"31153",31,153,2014,89768,86988,2780,3.1
"31153",31,153,2015,90635,88088,2547,2.8
"31153",31,153,2016,91897,89213,2684,2.9
"31153",31,153,2017,92240,89675,2565,2.8
"31155",31,155,1990,9267,9060,207,2.2
"31155",31,155,1991,9688,9422,266,2.7
"31155",31,155,1992,10187,9899,288,2.8
"31155",31,155,1993,10435,10165,270,2.6
"31155",31,155,1994,10515,10242,273,2.6
"31155",31,155,1995,10725,10414,311,2.9
"31155",31,155,1996,10556,10247,309,2.9
"31155",31,155,1997,10434,10156,278,2.7
"31155",31,155,1998,10611,10349,262,2.5
"31155",31,155,1999,10282,9995,287,2.8
"31155",31,155,2000,11066,10753,313,2.8
"31155",31,155,2001,11113,10759,354,3.2
"31155",31,155,2002,11000,10606,394,3.6
"31155",31,155,2003,11032,10608,424,3.8
"31155",31,155,2004,11070,10666,404,3.6
"31155",31,155,2005,11153,10715,438,3.9
"31155",31,155,2006,10958,10622,336,3.1
"31155",31,155,2007,10958,10619,339,3.1
"31155",31,155,2008,10969,10574,395,3.6
"31155",31,155,2009,10825,10281,544,5
"31155",31,155,2010,11179,10643,536,4.8
"31155",31,155,2011,11202,10688,514,4.6
"31155",31,155,2012,11191,10717,474,4.2
"31155",31,155,2013,11178,10727,451,4
"31155",31,155,2014,11012,10629,383,3.5
"31155",31,155,2015,10926,10590,336,3.1
"31155",31,155,2016,10855,10521,334,3.1
"31155",31,155,2017,10858,10554,304,2.8
"31157",31,157,1990,17787,17094,693,3.9
"31157",31,157,1991,18047,17302,745,4.1
"31157",31,157,1992,18486,17673,813,4.4
"31157",31,157,1993,18637,17822,815,4.4
"31157",31,157,1994,18567,17729,838,4.5
"31157",31,157,1995,18334,17475,859,4.7
"31157",31,157,1996,18464,17591,873,4.7
"31157",31,157,1997,18327,17561,766,4.2
"31157",31,157,1998,18340,17545,795,4.3
"31157",31,157,1999,18689,17905,784,4.2
"31157",31,157,2000,18775,18019,756,4
"31157",31,157,2001,18656,17900,756,4.1
"31157",31,157,2002,18786,17959,827,4.4
"31157",31,157,2003,18943,18002,941,5
"31157",31,157,2004,19262,18430,832,4.3
"31157",31,157,2005,19081,18283,798,4.2
"31157",31,157,2006,19026,18389,637,3.3
"31157",31,157,2007,19485,18909,576,3
"31157",31,157,2008,19525,18802,723,3.7
"31157",31,157,2009,19690,18677,1013,5.1
"31157",31,157,2010,19200,18144,1056,5.5
"31157",31,157,2011,19209,18245,964,5
"31157",31,157,2012,19236,18334,902,4.7
"31157",31,157,2013,19161,18356,805,4.2
"31157",31,157,2014,18742,18063,679,3.6
"31157",31,157,2015,18659,18028,631,3.4
"31157",31,157,2016,18813,18153,660,3.5
"31157",31,157,2017,18352,17724,628,3.4
"31159",31,159,1990,8424,8243,181,2.1
"31159",31,159,1991,8823,8613,210,2.4
"31159",31,159,1992,8874,8643,231,2.6
"31159",31,159,1993,8972,8771,201,2.2
"31159",31,159,1994,9185,8976,209,2.3
"31159",31,159,1995,9522,9309,213,2.2
"31159",31,159,1996,9212,8957,255,2.8
"31159",31,159,1997,9338,9129,209,2.2
"31159",31,159,1998,9370,9138,232,2.5
"31159",31,159,1999,9371,9124,247,2.6
"31159",31,159,2000,9191,8975,216,2.4
"31159",31,159,2001,9398,9138,260,2.8
"31159",31,159,2002,9226,8953,273,3
"31159",31,159,2003,9191,8894,297,3.2
"31159",31,159,2004,9314,9033,281,3
"31159",31,159,2005,9252,8960,292,3.2
"31159",31,159,2006,9234,8983,251,2.7
"31159",31,159,2007,8893,8650,243,2.7
"31159",31,159,2008,9068,8774,294,3.2
"31159",31,159,2009,8840,8478,362,4.1
"31159",31,159,2010,8765,8414,351,4
"31159",31,159,2011,8767,8430,337,3.8
"31159",31,159,2012,8957,8642,315,3.5
"31159",31,159,2013,9023,8690,333,3.7
"31159",31,159,2014,8840,8569,271,3.1
"31159",31,159,2015,8696,8443,253,2.9
"31159",31,159,2016,8738,8487,251,2.9
"31159",31,159,2017,8719,8487,232,2.7
"31161",31,161,1990,3133,3076,57,1.8
"31161",31,161,1991,3105,3036,69,2.2
"31161",31,161,1992,3023,2951,72,2.4
"31161",31,161,1993,2992,2926,66,2.2
"31161",31,161,1994,3055,2980,75,2.5
"31161",31,161,1995,3069,2990,79,2.6
"31161",31,161,1996,3075,2985,90,2.9
"31161",31,161,1997,3030,2929,101,3.3
"31161",31,161,1998,2908,2827,81,2.8
"31161",31,161,1999,2935,2847,88,3
"31161",31,161,2000,3295,3198,97,2.9
"31161",31,161,2001,3200,3113,87,2.7
"31161",31,161,2002,3242,3154,88,2.7
"31161",31,161,2003,3415,3326,89,2.6
"31161",31,161,2004,3286,3192,94,2.9
"31161",31,161,2005,3224,3137,87,2.7
"31161",31,161,2006,3238,3152,86,2.7
"31161",31,161,2007,3108,3025,83,2.7
"31161",31,161,2008,3061,2977,84,2.7
"31161",31,161,2009,3116,2994,122,3.9
"31161",31,161,2010,2821,2721,100,3.5
"31161",31,161,2011,2831,2730,101,3.6
"31161",31,161,2012,2807,2707,100,3.6
"31161",31,161,2013,2801,2710,91,3.2
"31161",31,161,2014,2779,2706,73,2.6
"31161",31,161,2015,2730,2656,74,2.7
"31161",31,161,2016,2733,2655,78,2.9
"31161",31,161,2017,2685,2614,71,2.6
"31163",31,163,1990,1710,1660,50,2.9
"31163",31,163,1991,1608,1552,56,3.5
"31163",31,163,1992,1627,1579,48,3
"31163",31,163,1993,1538,1494,44,2.9
"31163",31,163,1994,1604,1551,53,3.3
"31163",31,163,1995,1660,1609,51,3.1
"31163",31,163,1996,1617,1569,48,3
"31163",31,163,1997,1548,1511,37,2.4
"31163",31,163,1998,1496,1456,40,2.7
"31163",31,163,1999,1487,1443,44,3
"31163",31,163,2000,1783,1733,50,2.8
"31163",31,163,2001,1833,1784,49,2.7
"31163",31,163,2002,1874,1819,55,2.9
"31163",31,163,2003,1855,1796,59,3.2
"31163",31,163,2004,1895,1829,66,3.5
"31163",31,163,2005,1911,1838,73,3.8
"31163",31,163,2006,1878,1825,53,2.8
"31163",31,163,2007,1909,1858,51,2.7
"31163",31,163,2008,1935,1882,53,2.7
"31163",31,163,2009,2007,1943,64,3.2
"31163",31,163,2010,1730,1660,70,4
"31163",31,163,2011,1759,1683,76,4.3
"31163",31,163,2012,1751,1685,66,3.8
"31163",31,163,2013,1740,1682,58,3.3
"31163",31,163,2014,1726,1669,57,3.3
"31163",31,163,2015,1709,1659,50,2.9
"31163",31,163,2016,1714,1659,55,3.2
"31163",31,163,2017,1668,1620,48,2.9
"31165",31,165,1990,792,784,8,1
"31165",31,165,1991,791,782,9,1.1
"31165",31,165,1992,807,796,11,1.4
"31165",31,165,1993,822,809,13,1.6
"31165",31,165,1994,819,806,13,1.6
"31165",31,165,1995,828,812,16,1.9
"31165",31,165,1996,785,773,12,1.5
"31165",31,165,1997,794,783,11,1.4
"31165",31,165,1998,783,773,10,1.3
"31165",31,165,1999,774,759,15,1.9
"31165",31,165,2000,802,787,15,1.9
"31165",31,165,2001,793,777,16,2
"31165",31,165,2002,789,769,20,2.5
"31165",31,165,2003,800,776,24,3
"31165",31,165,2004,809,788,21,2.6
"31165",31,165,2005,772,750,22,2.8
"31165",31,165,2006,746,725,21,2.8
"31165",31,165,2007,707,687,20,2.8
"31165",31,165,2008,716,692,24,3.4
"31165",31,165,2009,735,710,25,3.4
"31165",31,165,2010,835,804,31,3.7
"31165",31,165,2011,844,815,29,3.4
"31165",31,165,2012,841,811,30,3.6
"31165",31,165,2013,806,779,27,3.3
"31165",31,165,2014,806,786,20,2.5
"31165",31,165,2015,788,768,20,2.5
"31165",31,165,2016,782,761,21,2.7
"31165",31,165,2017,765,742,23,3
"31167",31,167,1990,3075,3029,46,1.5
"31167",31,167,1991,3091,3026,65,2.1
"31167",31,167,1992,3066,2987,79,2.6
"31167",31,167,1993,3210,3129,81,2.5
"31167",31,167,1994,3306,3220,86,2.6
"31167",31,167,1995,3384,3302,82,2.4
"31167",31,167,1996,3384,3304,80,2.4
"31167",31,167,1997,3408,3331,77,2.3
"31167",31,167,1998,3471,3371,100,2.9
"31167",31,167,1999,3333,3230,103,3.1
"31167",31,167,2000,3533,3442,91,2.6
"31167",31,167,2001,3450,3357,93,2.7
"31167",31,167,2002,3483,3376,107,3.1
"31167",31,167,2003,3754,3632,122,3.2
"31167",31,167,2004,3780,3661,119,3.1
"31167",31,167,2005,3740,3624,116,3.1
"31167",31,167,2006,3605,3494,111,3.1
"31167",31,167,2007,3554,3449,105,3
"31167",31,167,2008,3513,3416,97,2.8
"31167",31,167,2009,3490,3346,144,4.1
"31167",31,167,2010,3584,3438,146,4.1
"31167",31,167,2011,3628,3493,135,3.7
"31167",31,167,2012,3675,3547,128,3.5
"31167",31,167,2013,3693,3570,123,3.3
"31167",31,167,2014,3574,3474,100,2.8
"31167",31,167,2015,3504,3415,89,2.5
"31167",31,167,2016,3435,3345,90,2.6
"31167",31,167,2017,3445,3348,97,2.8
"31169",31,169,1990,3167,3135,32,1
"31169",31,169,1991,3209,3163,46,1.4
"31169",31,169,1992,3200,3135,65,2
"31169",31,169,1993,3217,3150,67,2.1
"31169",31,169,1994,3266,3215,51,1.6
"31169",31,169,1995,3331,3262,69,2.1
"31169",31,169,1996,3274,3209,65,2
"31169",31,169,1997,3213,3154,59,1.8
"31169",31,169,1998,3262,3201,61,1.9
"31169",31,169,1999,3355,3284,71,2.1
"31169",31,169,2000,3162,3081,81,2.6
"31169",31,169,2001,3039,2939,100,3.3
"31169",31,169,2002,2974,2873,101,3.4
"31169",31,169,2003,3014,2920,94,3.1
"31169",31,169,2004,3038,2942,96,3.2
"31169",31,169,2005,2985,2894,91,3
"31169",31,169,2006,2899,2825,74,2.6
"31169",31,169,2007,2863,2787,76,2.7
"31169",31,169,2008,2819,2728,91,3.2
"31169",31,169,2009,2799,2680,119,4.3
"31169",31,169,2010,2803,2697,106,3.8
"31169",31,169,2011,2926,2830,96,3.3
"31169",31,169,2012,3008,2916,92,3.1
"31169",31,169,2013,3058,2973,85,2.8
"31169",31,169,2014,3030,2953,77,2.5
"31169",31,169,2015,2967,2897,70,2.4
"31169",31,169,2016,2898,2827,71,2.4
"31169",31,169,2017,2848,2784,64,2.2
"31171",31,171,1990,407,393,14,3.4
"31171",31,171,1991,422,404,18,4.3
"31171",31,171,1992,406,390,16,3.9
"31171",31,171,1993,416,393,23,5.5
"31171",31,171,1994,429,409,20,4.7
"31171",31,171,1995,473,446,27,5.7
"31171",31,171,1996,483,449,34,7
"31171",31,171,1997,460,430,30,6.5
"31171",31,171,1998,462,443,19,4.1
"31171",31,171,1999,485,458,27,5.6
"31171",31,171,2000,416,395,21,5
"31171",31,171,2001,407,385,22,5.4
"31171",31,171,2002,413,396,17,4.1
"31171",31,171,2003,422,404,18,4.3
"31171",31,171,2004,426,413,13,3.1
"31171",31,171,2005,414,399,15,3.6
"31171",31,171,2006,393,380,13,3.3
"31171",31,171,2007,378,364,14,3.7
"31171",31,171,2008,373,358,15,4
"31171",31,171,2009,359,343,16,4.5
"31171",31,171,2010,396,377,19,4.8
"31171",31,171,2011,426,404,22,5.2
"31171",31,171,2012,428,411,17,4
"31171",31,171,2013,455,437,18,4
"31171",31,171,2014,428,413,15,3.5
"31171",31,171,2015,435,422,13,3
"31171",31,171,2016,448,433,15,3.3
"31171",31,171,2017,441,427,14,3.2
"31173",31,173,1990,2607,2428,179,6.9
"31173",31,173,1991,2559,2343,216,8.4
"31173",31,173,1992,2583,2378,205,7.9
"31173",31,173,1993,2583,2393,190,7.4
"31173",31,173,1994,2780,2598,182,6.5
"31173",31,173,1995,2875,2684,191,6.6
"31173",31,173,1996,2907,2674,233,8
"31173",31,173,1997,2887,2660,227,7.9
"31173",31,173,1998,2999,2737,262,8.7
"31173",31,173,1999,2898,2582,316,10.9
"31173",31,173,2000,2840,2642,198,7
"31173",31,173,2001,2751,2582,169,6.1
"31173",31,173,2002,2818,2621,197,7
"31173",31,173,2003,2909,2692,217,7.5
"31173",31,173,2004,2954,2724,230,7.8
"31173",31,173,2005,3002,2768,234,7.8
"31173",31,173,2006,3006,2800,206,6.9
"31173",31,173,2007,2988,2793,195,6.5
"31173",31,173,2008,2995,2793,202,6.7
"31173",31,173,2009,3160,2828,332,10.5
"31173",31,173,2010,3054,2762,292,9.6
"31173",31,173,2011,3122,2804,318,10.2
"31173",31,173,2012,3146,2872,274,8.7
"31173",31,173,2013,3105,2867,238,7.7
"31173",31,173,2014,3020,2836,184,6.1
"31173",31,173,2015,2970,2812,158,5.3
"31173",31,173,2016,2975,2830,145,4.9
"31173",31,173,2017,2988,2839,149,5
"31175",31,175,1990,2771,2719,52,1.9
"31175",31,175,1991,2811,2754,57,2
"31175",31,175,1992,2765,2705,60,2.2
"31175",31,175,1993,2734,2670,64,2.3
"31175",31,175,1994,2809,2740,69,2.5
"31175",31,175,1995,2772,2714,58,2.1
"31175",31,175,1996,2688,2632,56,2.1
"31175",31,175,1997,2582,2529,53,2.1
"31175",31,175,1998,2518,2456,62,2.5
"31175",31,175,1999,2530,2467,63,2.5
"31175",31,175,2000,2426,2361,65,2.7
"31175",31,175,2001,2372,2298,74,3.1
"31175",31,175,2002,2540,2468,72,2.8
"31175",31,175,2003,2601,2513,88,3.4
"31175",31,175,2004,2560,2475,85,3.3
"31175",31,175,2005,2510,2423,87,3.5
"31175",31,175,2006,2564,2500,64,2.5
"31175",31,175,2007,2572,2511,61,2.4
"31175",31,175,2008,2577,2505,72,2.8
"31175",31,175,2009,2572,2487,85,3.3
"31175",31,175,2010,2143,2048,95,4.4
"31175",31,175,2011,2149,2063,86,4
"31175",31,175,2012,2152,2077,75,3.5
"31175",31,175,2013,2143,2072,71,3.3
"31175",31,175,2014,2117,2053,64,3
"31175",31,175,2015,2063,2005,58,2.8
"31175",31,175,2016,2089,2030,59,2.8
"31175",31,175,2017,2100,2044,56,2.7
"31177",31,177,1990,9136,8925,211,2.3
"31177",31,177,1991,9133,8882,251,2.7
"31177",31,177,1992,9211,8986,225,2.4
"31177",31,177,1993,9574,9346,228,2.4
"31177",31,177,1994,9868,9656,212,2.1
"31177",31,177,1995,10195,9981,214,2.1
"31177",31,177,1996,10490,10287,203,1.9
"31177",31,177,1997,10735,10542,193,1.8
"31177",31,177,1998,11009,10799,210,1.9
"31177",31,177,1999,11115,10884,231,2.1
"31177",31,177,2000,10879,10615,264,2.4
"31177",31,177,2001,11045,10736,309,2.8
"31177",31,177,2002,11052,10734,318,2.9
"31177",31,177,2003,11110,10766,344,3.1
"31177",31,177,2004,11094,10735,359,3.2
"31177",31,177,2005,11168,10798,370,3.3
"31177",31,177,2006,11233,10911,322,2.9
"31177",31,177,2007,11268,10948,320,2.8
"31177",31,177,2008,11256,10903,353,3.1
"31177",31,177,2009,11045,10537,508,4.6
"31177",31,177,2010,11232,10716,516,4.6
"31177",31,177,2011,11240,10751,489,4.4
"31177",31,177,2012,11230,10806,424,3.8
"31177",31,177,2013,11140,10731,409,3.7
"31177",31,177,2014,11038,10682,356,3.2
"31177",31,177,2015,10935,10607,328,3
"31177",31,177,2016,11087,10732,355,3.2
"31177",31,177,2017,11113,10770,343,3.1
"31179",31,179,1990,4751,4630,121,2.5
"31179",31,179,1991,5259,5117,142,2.7
"31179",31,179,1992,5527,5371,156,2.8
"31179",31,179,1993,5640,5481,159,2.8
"31179",31,179,1994,6031,5854,177,2.9
"31179",31,179,1995,5952,5776,176,3
"31179",31,179,1996,5747,5557,190,3.3
"31179",31,179,1997,5735,5569,166,2.9
"31179",31,179,1998,5922,5728,194,3.3
"31179",31,179,1999,6483,6257,226,3.5
"31179",31,179,2000,5703,5556,147,2.6
"31179",31,179,2001,5501,5350,151,2.7
"31179",31,179,2002,5464,5309,155,2.8
"31179",31,179,2003,5475,5318,157,2.9
"31179",31,179,2004,5525,5359,166,3
"31179",31,179,2005,5474,5309,165,3
"31179",31,179,2006,5451,5312,139,2.5
"31179",31,179,2007,5304,5169,135,2.5
"31179",31,179,2008,5201,5051,150,2.9
"31179",31,179,2009,5190,4987,203,3.9
"31179",31,179,2010,5671,5456,215,3.8
"31179",31,179,2011,5608,5414,194,3.5
"31179",31,179,2012,5727,5543,184,3.2
"31179",31,179,2013,5689,5509,180,3.2
"31179",31,179,2014,5564,5408,156,2.8
"31179",31,179,2015,5539,5398,141,2.5
"31179",31,179,2016,5615,5465,150,2.7
"31179",31,179,2017,5635,5497,138,2.4
"31181",31,181,1990,1808,1780,28,1.5
"31181",31,181,1991,1797,1766,31,1.7
"31181",31,181,1992,1839,1806,33,1.8
"31181",31,181,1993,1827,1790,37,2
"31181",31,181,1994,1872,1834,38,2
"31181",31,181,1995,1851,1817,34,1.8
"31181",31,181,1996,1832,1795,37,2
"31181",31,181,1997,1810,1771,39,2.2
"31181",31,181,1998,1824,1784,40,2.2
"31181",31,181,1999,1806,1765,41,2.3
"31181",31,181,2000,1963,1909,54,2.8
"31181",31,181,2001,2012,1955,57,2.8
"31181",31,181,2002,2028,1957,71,3.5
"31181",31,181,2003,2046,1973,73,3.6
"31181",31,181,2004,2034,1950,84,4.1
"31181",31,181,2005,2011,1939,72,3.6
"31181",31,181,2006,1990,1939,51,2.6
"31181",31,181,2007,1803,1744,59,3.3
"31181",31,181,2008,1790,1730,60,3.4
"31181",31,181,2009,1813,1743,70,3.9
"31181",31,181,2010,1705,1623,82,4.8
"31181",31,181,2011,1736,1656,80,4.6
"31181",31,181,2012,1747,1683,64,3.7
"31181",31,181,2013,1748,1680,68,3.9
"31181",31,181,2014,1727,1669,58,3.4
"31181",31,181,2015,1725,1664,61,3.5
"31181",31,181,2016,1709,1655,54,3.2
"31181",31,181,2017,1669,1619,50,3
"31183",31,183,1990,451,446,5,1.1
"31183",31,183,1991,442,435,7,1.6
"31183",31,183,1992,446,437,9,2
"31183",31,183,1993,433,422,11,2.5
"31183",31,183,1994,423,410,13,3.1
"31183",31,183,1995,439,424,15,3.4
"31183",31,183,1996,365,352,13,3.6
"31183",31,183,1997,337,332,5,1.5
"31183",31,183,1998,341,335,6,1.8
"31183",31,183,1999,416,402,14,3.4
"31183",31,183,2000,499,487,12,2.4
"31183",31,183,2001,516,504,12,2.3
"31183",31,183,2002,504,493,11,2.2
"31183",31,183,2003,499,485,14,2.8
"31183",31,183,2004,489,476,13,2.7
"31183",31,183,2005,472,459,13,2.8
"31183",31,183,2006,452,441,11,2.4
"31183",31,183,2007,417,405,12,2.9
"31183",31,183,2008,486,475,11,2.3
"31183",31,183,2009,462,445,17,3.7
"31183",31,183,2010,515,495,20,3.9
"31183",31,183,2011,524,507,17,3.2
"31183",31,183,2012,523,505,18,3.4
"31183",31,183,2013,525,508,17,3.2
"31183",31,183,2014,559,543,16,2.9
"31183",31,183,2015,562,549,13,2.3
"31183",31,183,2016,565,553,12,2.1
"31183",31,183,2017,565,552,13,2.3
"31185",31,185,1990,7599,7460,139,1.8
"31185",31,185,1991,8288,8150,138,1.7
"31185",31,185,1992,7860,7740,120,1.5
"31185",31,185,1993,8119,7975,144,1.8
"31185",31,185,1994,8759,8627,132,1.5
"31185",31,185,1995,8793,8667,126,1.4
"31185",31,185,1996,8732,8584,148,1.7
"31185",31,185,1997,8986,8881,105,1.2
"31185",31,185,1998,9285,9153,132,1.4
"31185",31,185,1999,9295,9158,137,1.5
"31185",31,185,2000,7844,7649,195,2.5
"31185",31,185,2001,7622,7416,206,2.7
"31185",31,185,2002,7477,7255,222,3
"31185",31,185,2003,7883,7622,261,3.3
"31185",31,185,2004,8055,7801,254,3.2
"31185",31,185,2005,8438,8200,238,2.8
"31185",31,185,2006,8489,8281,208,2.5
"31185",31,185,2007,7648,7440,208,2.7
"31185",31,185,2008,7050,6789,261,3.7
"31185",31,185,2009,7078,6733,345,4.9
"31185",31,185,2010,7411,7067,344,4.6
"31185",31,185,2011,7515,7189,326,4.3
"31185",31,185,2012,7601,7320,281,3.7
"31185",31,185,2013,7507,7237,270,3.6
"31185",31,185,2014,7393,7158,235,3.2
"31185",31,185,2015,7339,7126,213,2.9
"31185",31,185,2016,7312,7113,199,2.7
"31185",31,185,2017,7281,7094,187,2.6
"32001",32,1,1990,7773,7281,492,6.3
"32001",32,1,1991,7869,7343,526,6.7
"32001",32,1,1992,8315,7668,647,7.8
"32001",32,1,1993,8631,7895,736,8.5
"32001",32,1,1994,8892,8162,730,8.2
"32001",32,1,1995,8938,8302,636,7.1
"32001",32,1,1996,9619,8973,646,6.7
"32001",32,1,1997,9685,9118,567,5.9
"32001",32,1,1998,10230,9591,639,6.2
"32001",32,1,1999,9998,9216,782,7.8
"32001",32,1,2000,12018,11318,700,5.8
"32001",32,1,2001,11941,11200,741,6.2
"32001",32,1,2002,12365,11740,625,5.1
"32001",32,1,2003,12163,11606,557,4.6
"32001",32,1,2004,12077,11581,496,4.1
"32001",32,1,2005,12421,11938,483,3.9
"32001",32,1,2006,12789,12255,534,4.2
"32001",32,1,2007,13152,12585,567,4.3
"32001",32,1,2008,13493,12687,806,6
"32001",32,1,2009,13505,12340,1165,8.6
"32001",32,1,2010,11199,9814,1385,12.4
"32001",32,1,2011,11319,9915,1404,12.4
"32001",32,1,2012,11092,9868,1224,11
"32001",32,1,2013,11223,10187,1036,9.2
"32001",32,1,2014,10886,10060,826,7.6
"32001",32,1,2015,10616,9885,731,6.9
"32001",32,1,2016,10750,10169,581,5.4
"32001",32,1,2017,10782,10306,476,4.4
"32003",32,3,1990,416540,397738,18802,4.5
"32003",32,3,1991,443278,416645,26633,6
"32003",32,3,1992,461336,430649,30687,6.7
"32003",32,3,1993,489718,456199,33519,6.8
"32003",32,3,1994,527969,495389,32580,6.2
"32003",32,3,1995,552579,521786,30793,5.6
"32003",32,3,1996,591569,562418,29151,4.9
"32003",32,3,1997,631697,604672,27025,4.3
"32003",32,3,1998,664172,637114,27058,4.1
"32003",32,3,1999,704213,676433,27780,3.9
"32003",32,3,2000,730308,698877,31431,4.3
"32003",32,3,2001,767224,725947,41277,5.4
"32003",32,3,2002,782858,737054,45804,5.9
"32003",32,3,2003,801220,759476,41744,5.2
"32003",32,3,2004,829072,793008,36064,4.3
"32003",32,3,2005,869251,833919,35332,4.1
"32003",32,3,2006,917900,881109,36791,4
"32003",32,3,2007,951064,908308,42756,4.5
"32003",32,3,2008,980238,915147,65091,6.6
"32003",32,3,2009,967672,856495,111177,11.5
"32003",32,3,2010,984004,848573,135431,13.8
"32003",32,3,2011,995119,863498,131621,13.2
"32003",32,3,2012,999472,886972,112500,11.3
"32003",32,3,2013,1004312,906943,97369,9.7
"32003",32,3,2014,1019491,938018,81473,8
"32003",32,3,2015,1038703,967633,71070,6.8
"32003",32,3,2016,1050639,988963,61676,5.9
"32003",32,3,2017,1072593,1016396,56197,5.2
"32005",32,5,1990,14919,14184,735,4.9
"32005",32,5,1991,15570,14691,879,5.6
"32005",32,5,1992,16074,15022,1052,6.5
"32005",32,5,1993,16695,15494,1201,7.2
"32005",32,5,1994,16999,15736,1263,7.4
"32005",32,5,1995,17722,16638,1084,6.1
"32005",32,5,1996,17759,16634,1125,6.3
"32005",32,5,1997,18050,16988,1062,5.9
"32005",32,5,1998,18295,17377,918,5
"32005",32,5,1999,19233,18400,833,4.3
"32005",32,5,2000,21804,20968,836,3.8
"32005",32,5,2001,21857,20848,1009,4.6
"32005",32,5,2002,21943,20848,1095,5
"32005",32,5,2003,22070,20993,1077,4.9
"32005",32,5,2004,22197,21265,932,4.2
"32005",32,5,2005,21997,21014,983,4.5
"32005",32,5,2006,22270,21256,1014,4.6
"32005",32,5,2007,22599,21503,1096,4.8
"32005",32,5,2008,22620,20948,1672,7.4
"32005",32,5,2009,22325,19748,2577,11.5
"32005",32,5,2010,23087,19910,3177,13.8
"32005",32,5,2011,23178,20109,3069,13.2
"32005",32,5,2012,22763,20154,2609,11.5
"32005",32,5,2013,22740,20550,2190,9.6
"32005",32,5,2014,22382,20596,1786,8
"32005",32,5,2015,22496,20982,1514,6.7
"32005",32,5,2016,22437,21175,1262,5.6
"32005",32,5,2017,22769,21676,1093,4.8
"32007",32,7,1990,17735,16885,850,4.8
"32007",32,7,1991,18319,17437,882,4.8
"32007",32,7,1992,19513,18382,1131,5.8
"32007",32,7,1993,20308,18999,1309,6.4
"32007",32,7,1994,20818,19533,1285,6.2
"32007",32,7,1995,20923,19663,1260,6
"32007",32,7,1996,22062,20965,1097,5
"32007",32,7,1997,22456,21410,1046,4.7
"32007",32,7,1998,22338,21079,1259,5.6
"32007",32,7,1999,21756,20723,1033,4.7
"32007",32,7,2000,24312,23422,890,3.7
"32007",32,7,2001,23755,22610,1145,4.8
"32007",32,7,2002,23378,22310,1068,4.6
"32007",32,7,2003,22799,21780,1019,4.5
"32007",32,7,2004,22921,22067,854,3.7
"32007",32,7,2005,23526,22696,830,3.5
"32007",32,7,2006,24686,23840,846,3.4
"32007",32,7,2007,26420,25555,865,3.3
"32007",32,7,2008,26742,25605,1137,4.3
"32007",32,7,2009,27396,25679,1717,6.3
"32007",32,7,2010,26898,24828,2070,7.7
"32007",32,7,2011,28174,26136,2038,7.2
"32007",32,7,2012,29205,27355,1850,6.3
"32007",32,7,2013,28863,27076,1787,6.2
"32007",32,7,2014,28218,26646,1572,5.6
"32007",32,7,2015,26947,25564,1383,5.1
"32007",32,7,2016,27155,25941,1214,4.5
"32007",32,7,2017,27304,26295,1009,3.7
"32009",32,9,1990,626,590,36,5.8
"32009",32,9,1991,700,671,29,4.1
"32009",32,9,1992,748,688,60,8
"32009",32,9,1993,762,684,78,10.2
"32009",32,9,1994,789,733,56,7.1
"32009",32,9,1995,614,566,48,7.8
"32009",32,9,1996,567,526,41,7.2
"32009",32,9,1997,612,578,34,5.6
"32009",32,9,1998,586,529,57,9.7
"32009",32,9,1999,656,591,65,9.9
"32009",32,9,2000,511,470,41,8
"32009",32,9,2001,517,479,38,7.4
"32009",32,9,2002,489,455,34,7
"32009",32,9,2003,468,448,20,4.3
"32009",32,9,2004,450,427,23,5.1
"32009",32,9,2005,458,437,21,4.6
"32009",32,9,2006,468,449,19,4.1
"32009",32,9,2007,473,458,15,3.2
"32009",32,9,2008,486,462,24,4.9
"32009",32,9,2009,489,455,34,7
"32009",32,9,2010,414,376,38,9.2
"32009",32,9,2011,416,383,33,7.9
"32009",32,9,2012,476,443,33,6.9
"32009",32,9,2013,543,517,26,4.8
"32009",32,9,2014,533,509,24,4.5
"32009",32,9,2015,530,507,23,4.3
"32009",32,9,2016,526,502,24,4.6
"32009",32,9,2017,524,504,20,3.8
"32011",32,11,1990,850,804,46,5.4
"32011",32,11,1991,878,839,39,4.4
"32011",32,11,1992,864,815,49,5.7
"32011",32,11,1993,813,754,59,7.3
"32011",32,11,1994,783,697,86,11
"32011",32,11,1995,788,717,71,9
"32011",32,11,1996,851,791,60,7.1
"32011",32,11,1997,976,917,59,6
"32011",32,11,1998,1015,960,55,5.4
"32011",32,11,1999,926,890,36,3.9
"32011",32,11,2000,797,773,24,3
"32011",32,11,2001,777,746,31,4
"32011",32,11,2002,772,736,36,4.7
"32011",32,11,2003,705,667,38,5.4
"32011",32,11,2004,671,644,27,4
"32011",32,11,2005,672,650,22,3.3
"32011",32,11,2006,710,684,26,3.7
"32011",32,11,2007,809,775,34,4.2
"32011",32,11,2008,854,810,44,5.2
"32011",32,11,2009,895,836,59,6.6
"32011",32,11,2010,1029,949,80,7.8
"32011",32,11,2011,1072,998,74,6.9
"32011",32,11,2012,1104,1037,67,6.1
"32011",32,11,2013,1093,1027,66,6
"32011",32,11,2014,1035,974,61,5.9
"32011",32,11,2015,1003,944,59,5.9
"32011",32,11,2016,995,949,46,4.6
"32011",32,11,2017,1049,1017,32,3.1
"32013",32,13,1990,6809,6453,356,5.2
"32013",32,13,1991,7520,7160,360,4.8
"32013",32,13,1992,7826,7382,444,5.7
"32013",32,13,1993,8163,7720,443,5.4
"32013",32,13,1994,8075,7637,438,5.4
"32013",32,13,1995,8448,8070,378,4.5
"32013",32,13,1996,8920,8581,339,3.8
"32013",32,13,1997,9329,8926,403,4.3
"32013",32,13,1998,8939,8362,577,6.5
"32013",32,13,1999,8399,7907,492,5.9
"32013",32,13,2000,7821,7463,358,4.6
"32013",32,13,2001,7592,7173,419,5.5
"32013",32,13,2002,7434,7026,408,5.5
"32013",32,13,2003,7406,7047,359,4.8
"32013",32,13,2004,7571,7283,288,3.8
"32013",32,13,2005,7791,7511,280,3.6
"32013",32,13,2006,8074,7782,292,3.6
"32013",32,13,2007,7959,7675,284,3.6
"32013",32,13,2008,8156,7754,402,4.9
"32013",32,13,2009,8583,7957,626,7.3
"32013",32,13,2010,8346,7622,724,8.7
"32013",32,13,2011,8738,8054,684,7.8
"32013",32,13,2012,9096,8494,602,6.6
"32013",32,13,2013,9360,8778,582,6.2
"32013",32,13,2014,8965,8407,558,6.2
"32013",32,13,2015,8467,7974,493,5.8
"32013",32,13,2016,8373,7928,445,5.3
"32013",32,13,2017,8303,7956,347,4.2
"32015",32,15,1990,3093,2895,198,6.4
"32015",32,15,1991,3055,2878,177,5.8
"32015",32,15,1992,3204,2951,253,7.9
"32015",32,15,1993,3101,2749,352,11.4
"32015",32,15,1994,3068,2720,348,11.3
"32015",32,15,1995,3057,2770,287,9.4
"32015",32,15,1996,3249,2986,263,8.1
"32015",32,15,1997,3258,3018,240,7.4
"32015",32,15,1998,3084,2771,313,10.1
"32015",32,15,1999,2733,2501,232,8.5
"32015",32,15,2000,2859,2704,155,5.4
"32015",32,15,2001,2727,2541,186,6.8
"32015",32,15,2002,2626,2465,161,6.1
"32015",32,15,2003,2456,2330,126,5.1
"32015",32,15,2004,2445,2345,100,4.1
"32015",32,15,2005,2702,2604,98,3.6
"32015",32,15,2006,2771,2664,107,3.9
"32015",32,15,2007,3386,3277,109,3.2
"32015",32,15,2008,3646,3487,159,4.4
"32015",32,15,2009,4008,3775,233,5.8
"32015",32,15,2010,3070,2777,293,9.5
"32015",32,15,2011,3219,2936,283,8.8
"32015",32,15,2012,3434,3181,253,7.4
"32015",32,15,2013,3552,3293,259,7.3
"32015",32,15,2014,3373,3150,223,6.6
"32015",32,15,2015,3282,3064,218,6.6
"32015",32,15,2016,3175,2978,197,6.2
"32015",32,15,2017,3171,3027,144,4.5
"32017",32,17,1990,1493,1394,99,6.6
"32017",32,17,1991,1504,1383,121,8
"32017",32,17,1992,1507,1363,144,9.6
"32017",32,17,1993,1451,1282,169,11.6
"32017",32,17,1994,1420,1255,165,11.6
"32017",32,17,1995,1305,1145,160,12.3
"32017",32,17,1996,1213,1070,143,11.8
"32017",32,17,1997,1211,1110,101,8.3
"32017",32,17,1998,1197,1125,72,6
"32017",32,17,1999,1109,1048,61,5.5
"32017",32,17,2000,1661,1584,77,4.6
"32017",32,17,2001,1766,1671,95,5.4
"32017",32,17,2002,1787,1701,86,4.8
"32017",32,17,2003,1595,1512,83,5.2
"32017",32,17,2004,1574,1493,81,5.1
"32017",32,17,2005,1563,1485,78,5
"32017",32,17,2006,1610,1537,73,4.5
"32017",32,17,2007,1722,1650,72,4.2
"32017",32,17,2008,1834,1732,102,5.6
"32017",32,17,2009,1677,1528,149,8.9
"32017",32,17,2010,2018,1805,213,10.6
"32017",32,17,2011,2069,1838,231,11.2
"32017",32,17,2012,2098,1878,220,10.5
"32017",32,17,2013,2047,1852,195,9.5
"32017",32,17,2014,1940,1795,145,7.5
"32017",32,17,2015,1971,1852,119,6
"32017",32,17,2016,2038,1932,106,5.2
"32017",32,17,2017,2053,1957,96,4.7
"32019",32,19,1990,9354,8788,566,6.1
"32019",32,19,1991,9719,9010,709,7.3
"32019",32,19,1992,10089,9128,961,9.5
"32019",32,19,1993,10573,9505,1068,10.1
"32019",32,19,1994,10919,9870,1049,9.6
"32019",32,19,1995,11516,10563,953,8.3
"32019",32,19,1996,11889,10936,953,8
"32019",32,19,1997,12469,11566,903,7.2
"32019",32,19,1998,13136,12171,965,7.3
"32019",32,19,1999,14216,13173,1043,7.3
"32019",32,19,2000,17975,16998,977,5.4
"32019",32,19,2001,19201,18102,1099,5.7
"32019",32,19,2002,19874,18733,1141,5.7
"32019",32,19,2003,19946,18851,1095,5.5
"32019",32,19,2004,19389,18347,1042,5.4
"32019",32,19,2005,20354,19209,1145,5.6
"32019",32,19,2006,21234,19971,1263,5.9
"32019",32,19,2007,22279,20853,1426,6.4
"32019",32,19,2008,22626,20412,2214,9.8
"32019",32,19,2009,22900,19364,3536,15.4
"32019",32,19,2010,22998,18976,4022,17.5
"32019",32,19,2011,23013,19165,3848,16.7
"32019",32,19,2012,22495,19170,3325,14.8
"32019",32,19,2013,22800,19944,2856,12.5
"32019",32,19,2014,22891,20557,2334,10.2
"32019",32,19,2015,21895,19857,2038,9.3
"32019",32,19,2016,21867,20257,1610,7.4
"32019",32,19,2017,22090,20774,1316,6
"32021",32,21,1990,2940,2769,171,5.8
"32021",32,21,1991,2985,2822,163,5.5
"32021",32,21,1992,3255,3084,171,5.3
"32021",32,21,1993,3123,2850,273,8.7
"32021",32,21,1994,3013,2698,315,10.5
"32021",32,21,1995,2867,2647,220,7.7
"32021",32,21,1996,2765,2573,192,6.9
"32021",32,21,1997,2634,2466,168,6.4
"32021",32,21,1998,2568,2396,172,6.7
"32021",32,21,1999,2134,1972,162,7.6
"32021",32,21,2000,2355,2173,182,7.7
"32021",32,21,2001,2140,1982,158,7.4
"32021",32,21,2002,2183,2054,129,5.9
"32021",32,21,2003,2138,2016,122,5.7
"32021",32,21,2004,2123,2012,111,5.2
"32021",32,21,2005,2088,1970,118,5.7
"32021",32,21,2006,2056,1918,138,6.7
"32021",32,21,2007,2236,2097,139,6.2
"32021",32,21,2008,2393,2214,179,7.5
"32021",32,21,2009,2351,2148,203,8.6
"32021",32,21,2010,2334,1999,335,14.4
"32021",32,21,2011,2229,1917,312,14
"32021",32,21,2012,1910,1651,259,13.6
"32021",32,21,2013,1817,1586,231,12.7
"32021",32,21,2014,1659,1473,186,11.2
"32021",32,21,2015,1617,1451,166,10.3
"32021",32,21,2016,1992,1863,129,6.5
"32021",32,21,2017,1996,1887,109,5.5
"32023",32,23,1990,9146,8834,312,3.4
"32023",32,23,1991,9378,8989,389,4.1
"32023",32,23,1992,9824,9259,565,5.8
"32023",32,23,1993,10540,9802,738,7
"32023",32,23,1994,11880,11207,673,5.7
"32023",32,23,1995,12511,11943,568,4.5
"32023",32,23,1996,13170,12525,645,4.9
"32023",32,23,1997,14380,13770,610,4.2
"32023",32,23,1998,15214,14604,610,4
"32023",32,23,1999,16059,15336,723,4.5
"32023",32,23,2000,14093,13196,897,6.4
"32023",32,23,2001,14527,13402,1125,7.7
"32023",32,23,2002,15002,13904,1098,7.3
"32023",32,23,2003,14967,13879,1088,7.3
"32023",32,23,2004,15415,14516,899,5.8
"32023",32,23,2005,16313,15416,897,5.5
"32023",32,23,2006,17175,16228,947,5.5
"32023",32,23,2007,17812,16655,1157,6.5
"32023",32,23,2008,17622,15907,1715,9.7
"32023",32,23,2009,17784,15320,2464,13.9
"32023",32,23,2010,16686,13797,2889,17.3
"32023",32,23,2011,16826,13997,2829,16.8
"32023",32,23,2012,16635,14227,2408,14.5
"32023",32,23,2013,16524,14537,1987,12
"32023",32,23,2014,16319,14747,1572,9.6
"32023",32,23,2015,16184,14777,1407,8.7
"32023",32,23,2016,16235,15049,1186,7.3
"32023",32,23,2017,16403,15356,1047,6.4
"32027",32,27,1990,2011,1918,93,4.6
"32027",32,27,1991,2066,1978,88,4.3
"32027",32,27,1992,2176,2040,136,6.3
"32027",32,27,1993,2110,1981,129,6.1
"32027",32,27,1994,2092,1942,150,7.2
"32027",32,27,1995,2171,2052,119,5.5
"32027",32,27,1996,2446,2326,120,4.9
"32027",32,27,1997,2594,2483,111,4.3
"32027",32,27,1998,2607,2516,91,3.5
"32027",32,27,1999,2361,2280,81,3.4
"32027",32,27,2000,2564,2458,106,4.1
"32027",32,27,2001,2586,2463,123,4.8
"32027",32,27,2002,2612,2487,125,4.8
"32027",32,27,2003,2529,2404,125,4.9
"32027",32,27,2004,2507,2401,106,4.2
"32027",32,27,2005,2422,2306,116,4.8
"32027",32,27,2006,2442,2322,120,4.9
"32027",32,27,2007,2492,2368,124,5
"32027",32,27,2008,2520,2344,176,7
"32027",32,27,2009,2598,2345,253,9.7
"32027",32,27,2010,2396,2142,254,10.6
"32027",32,27,2011,2471,2204,267,10.8
"32027",32,27,2012,2606,2354,252,9.7
"32027",32,27,2013,2685,2450,235,8.8
"32027",32,27,2014,2604,2417,187,7.2
"32027",32,27,2015,2511,2341,170,6.8
"32027",32,27,2016,2541,2394,147,5.8
"32027",32,27,2017,2645,2526,119,4.5
"32029",32,29,1990,1432,1400,32,2.2
"32029",32,29,1991,1436,1393,43,3
"32029",32,29,1992,1383,1325,58,4.2
"32029",32,29,1993,1431,1355,76,5.3
"32029",32,29,1994,1474,1401,73,5
"32029",32,29,1995,1541,1480,61,4
"32029",32,29,1996,1580,1510,70,4.4
"32029",32,29,1997,1595,1535,60,3.8
"32029",32,29,1998,1588,1522,66,4.2
"32029",32,29,1999,1656,1598,58,3.5
"32029",32,29,2000,2004,1944,60,3
"32029",32,29,2001,2031,1955,76,3.7
"32029",32,29,2002,1972,1895,77,3.9
"32029",32,29,2003,1991,1924,67,3.4
"32029",32,29,2004,2078,2011,67,3.2
"32029",32,29,2005,2266,2169,97,4.3
"32029",32,29,2006,2349,2251,98,4.2
"32029",32,29,2007,2396,2278,118,4.9
"32029",32,29,2008,2462,2292,170,6.9
"32029",32,29,2009,2469,2178,291,11.8
"32029",32,29,2010,2013,1676,337,16.7
"32029",32,29,2011,1974,1664,310,15.7
"32029",32,29,2012,1917,1662,255,13.3
"32029",32,29,2013,1894,1674,220,11.6
"32029",32,29,2014,1849,1680,169,9.1
"32029",32,29,2015,1873,1734,139,7.4
"32029",32,29,2016,1910,1789,121,6.3
"32029",32,29,2017,1969,1871,98,5
"32031",32,31,1990,150253,142939,7314,4.9
"32031",32,31,1991,153496,145427,8069,5.3
"32031",32,31,1992,160397,150415,9982,6.2
"32031",32,31,1993,165539,155728,9811,5.9
"32031",32,31,1994,168038,159202,8836,5.3
"32031",32,31,1995,172128,163706,8422,4.9
"32031",32,31,1996,176370,168368,8002,4.5
"32031",32,31,1997,181495,174354,7141,3.9
"32031",32,31,1998,186499,179543,6956,3.7
"32031",32,31,1999,187139,180870,6269,3.3
"32031",32,31,2000,195569,188813,6756,3.5
"32031",32,31,2001,202510,193740,8770,4.3
"32031",32,31,2002,203150,193205,9945,4.9
"32031",32,31,2003,203657,194591,9066,4.5
"32031",32,31,2004,206046,197902,8144,4
"32031",32,31,2005,208503,200280,8223,3.9
"32031",32,31,2006,216723,208382,8341,3.8
"32031",32,31,2007,222441,212915,9526,4.3
"32031",32,31,2008,224365,209131,15234,6.8
"32031",32,31,2009,220834,196311,24523,11.1
"32031",32,31,2010,220825,192289,28536,12.9
"32031",32,31,2011,221688,193787,27901,12.6
"32031",32,31,2012,221156,196768,24388,11
"32031",32,31,2013,221375,200386,20989,9.5
"32031",32,31,2014,222734,205844,16890,7.6
"32031",32,31,2015,225943,211811,14132,6.3
"32031",32,31,2016,230332,218723,11609,5
"32031",32,31,2017,239119,229118,10001,4.2
"32033",32,33,1990,4040,3781,259,6.4
"32033",32,33,1991,3855,3502,353,9.2
"32033",32,33,1992,3729,3365,364,9.8
"32033",32,33,1993,3619,3172,447,12.4
"32033",32,33,1994,3698,3318,380,10.3
"32033",32,33,1995,4294,4012,282,6.6
"32033",32,33,1996,4181,3870,311,7.4
"32033",32,33,1997,4033,3782,251,6.2
"32033",32,33,1998,3794,3576,218,5.7
"32033",32,33,1999,3451,3333,118,3.4
"32033",32,33,2000,3784,3637,147,3.9
"32033",32,33,2001,3683,3516,167,4.5
"32033",32,33,2002,3839,3683,156,4.1
"32033",32,33,2003,3691,3545,146,4
"32033",32,33,2004,3945,3802,143,3.6
"32033",32,33,2005,4305,4138,167,3.9
"32033",32,33,2006,4473,4309,164,3.7
"32033",32,33,2007,4749,4576,173,3.6
"32033",32,33,2008,4793,4568,225,4.7
"32033",32,33,2009,4954,4610,344,6.9
"32033",32,33,2010,4563,4142,421,9.2
"32033",32,33,2011,5099,4656,443,8.7
"32033",32,33,2012,5014,4627,387,7.7
"32033",32,33,2013,4941,4583,358,7.2
"32033",32,33,2014,4891,4596,295,6
"32033",32,33,2015,4823,4566,257,5.3
"32033",32,33,2016,4585,4375,210,4.6
"32033",32,33,2017,4572,4388,184,4
"32510",32,510,1990,20908,19691,1217,5.8
"32510",32,510,1991,21120,19615,1505,7.1
"32510",32,510,1992,21667,19691,1976,9.1
"32510",32,510,1993,22318,20076,2242,10
"32510",32,510,1994,22110,20351,1759,8
"32510",32,510,1995,22715,21132,1583,7
"32510",32,510,1996,23140,21364,1776,7.7
"32510",32,510,1997,23308,21803,1505,6.5
"32510",32,510,1998,23478,22152,1326,5.6
"32510",32,510,1999,24261,23377,884,3.6
"32510",32,510,2000,26590,25665,925,3.5
"32510",32,510,2001,27248,25888,1360,5
"32510",32,510,2002,27386,25826,1560,5.7
"32510",32,510,2003,27242,25721,1521,5.6
"32510",32,510,2004,27156,25842,1314,4.8
"32510",32,510,2005,27201,25967,1234,4.5
"32510",32,510,2006,27589,26331,1258,4.6
"32510",32,510,2007,28410,27047,1363,4.8
"32510",32,510,2008,28725,26688,2037,7.1
"32510",32,510,2009,28861,25671,3190,11.1
"32510",32,510,2010,26700,23100,3600,13.5
"32510",32,510,2011,26513,23008,3505,13.2
"32510",32,510,2012,25911,22870,3041,11.7
"32510",32,510,2013,25390,22741,2649,10.4
"32510",32,510,2014,24990,22825,2165,8.7
"32510",32,510,2015,24877,23080,1797,7.2
"32510",32,510,2016,24792,23276,1516,6.1
"32510",32,510,2017,25610,24316,1294,5.1
"33001",33,1,1990,26626,24998,1628,6.1
"33001",33,1,1991,26519,24363,2156,8.1
"33001",33,1,1992,26340,24271,2069,7.9
"33001",33,1,1993,26539,24822,1717,6.5
"33001",33,1,1994,27590,26329,1261,4.6
"33001",33,1,1995,27624,26602,1022,3.7
"33001",33,1,1996,28341,27276,1065,3.8
"33001",33,1,1997,29286,28379,907,3.1
"33001",33,1,1998,30353,29608,745,2.5
"33001",33,1,1999,30010,29292,718,2.4
"33001",33,1,2000,30953,30197,756,2.4
"33001",33,1,2001,31389,30453,936,3
"33001",33,1,2002,31665,30440,1225,3.9
"33001",33,1,2003,31544,30323,1221,3.9
"33001",33,1,2004,31674,30569,1105,3.5
"33001",33,1,2005,31920,30856,1064,3.3
"33001",33,1,2006,32515,31439,1076,3.3
"33001",33,1,2007,32409,31253,1156,3.6
"33001",33,1,2008,32647,31312,1335,4.1
"33001",33,1,2009,32539,30370,2169,6.7
"33001",33,1,2010,32260,30205,2055,6.4
"33001",33,1,2011,32049,30285,1764,5.5
"33001",33,1,2012,32057,30320,1737,5.4
"33001",33,1,2013,31992,30389,1603,5
"33001",33,1,2014,31558,30242,1316,4.2
"33001",33,1,2015,31461,30413,1048,3.3
"33001",33,1,2016,31177,30292,885,2.8
"33001",33,1,2017,30857,30044,813,2.6
"33003",33,3,1990,19330,18361,969,5
"33003",33,3,1991,18895,17652,1243,6.6
"33003",33,3,1992,18817,17649,1168,6.2
"33003",33,3,1993,18942,17951,991,5.2
"33003",33,3,1994,19580,18781,799,4.1
"33003",33,3,1995,19860,19130,730,3.7
"33003",33,3,1996,20879,20025,854,4.1
"33003",33,3,1997,21284,20565,719,3.4
"33003",33,3,1998,21830,21280,550,2.5
"33003",33,3,1999,21369,20830,539,2.5
"33003",33,3,2000,23642,23010,632,2.7
"33003",33,3,2001,23917,23176,741,3.1
"33003",33,3,2002,24243,23377,866,3.6
"33003",33,3,2003,24407,23544,863,3.5
"33003",33,3,2004,24790,23998,792,3.2
"33003",33,3,2005,24953,24111,842,3.4
"33003",33,3,2006,25329,24507,822,3.2
"33003",33,3,2007,25496,24620,876,3.4
"33003",33,3,2008,25911,24980,931,3.6
"33003",33,3,2009,25862,24415,1447,5.6
"33003",33,3,2010,24940,23526,1414,5.7
"33003",33,3,2011,24764,23415,1349,5.4
"33003",33,3,2012,24673,23373,1300,5.3
"33003",33,3,2013,24429,23228,1201,4.9
"33003",33,3,2014,24131,23116,1015,4.2
"33003",33,3,2015,23694,22872,822,3.5
"33003",33,3,2016,23514,22819,695,3
"33003",33,3,2017,23352,22737,615,2.6
"33005",33,5,1990,38414,36712,1702,4.4
"33005",33,5,1991,38302,36026,2276,5.9
"33005",33,5,1992,38261,36023,2238,5.8
"33005",33,5,1993,38432,36560,1872,4.9
"33005",33,5,1994,38976,37403,1573,4
"33005",33,5,1995,38985,37647,1338,3.4
"33005",33,5,1996,38593,37305,1288,3.3
"33005",33,5,1997,37778,36404,1374,3.6
"33005",33,5,1998,38959,37803,1156,3
"33005",33,5,1999,38750,37703,1047,2.7
"33005",33,5,2000,39905,38861,1044,2.6
"33005",33,5,2001,40172,38966,1206,3
"33005",33,5,2002,40336,38920,1416,3.5
"33005",33,5,2003,40090,38673,1417,3.5
"33005",33,5,2004,40902,39536,1366,3.3
"33005",33,5,2005,41895,40566,1329,3.2
"33005",33,5,2006,42483,41112,1371,3.2
"33005",33,5,2007,42088,40597,1491,3.5
"33005",33,5,2008,42151,40610,1541,3.7
"33005",33,5,2009,42039,39631,2408,5.7
"33005",33,5,2010,42623,40262,2361,5.5
"33005",33,5,2011,42545,40409,2136,5
"33005",33,5,2012,42615,40450,2165,5.1
"33005",33,5,2013,41946,39959,1987,4.7
"33005",33,5,2014,41949,40256,1693,4
"33005",33,5,2015,41366,40057,1309,3.2
"33005",33,5,2016,41126,39998,1128,2.7
"33005",33,5,2017,40461,39416,1045,2.6
"33007",33,7,1990,17301,16172,1129,6.5
"33007",33,7,1991,17550,16073,1477,8.4
"33007",33,7,1992,17612,15776,1836,10.4
"33007",33,7,1993,17385,15806,1579,9.1
"33007",33,7,1994,17193,15997,1196,7
"33007",33,7,1995,16839,15766,1073,6.4
"33007",33,7,1996,16858,15753,1105,6.6
"33007",33,7,1997,16595,15720,875,5.3
"33007",33,7,1998,17100,16435,665,3.9
"33007",33,7,1999,16702,16016,686,4.1
"33007",33,7,2000,17134,16512,622,3.6
"33007",33,7,2001,17071,16171,900,5.3
"33007",33,7,2002,16787,15674,1113,6.6
"33007",33,7,2003,16511,15656,855,5.2
"33007",33,7,2004,16504,15758,746,4.5
"33007",33,7,2005,16662,15980,682,4.1
"33007",33,7,2006,16820,16122,698,4.1
"33007",33,7,2007,16698,15928,770,4.6
"33007",33,7,2008,16507,15653,854,5.2
"33007",33,7,2009,16387,15086,1301,7.9
"33007",33,7,2010,16587,15367,1220,7.4
"33007",33,7,2011,16347,15156,1191,7.3
"33007",33,7,2012,16095,14904,1191,7.4
"33007",33,7,2013,15929,14960,969,6.1
"33007",33,7,2014,15126,14266,860,5.7
"33007",33,7,2015,14755,14111,644,4.4
"33007",33,7,2016,14546,13997,549,3.8
"33007",33,7,2017,14376,13883,493,3.4
"33009",33,9,1990,40125,37935,2190,5.5
"33009",33,9,1991,40610,37743,2867,7.1
"33009",33,9,1992,40134,37820,2314,5.8
"33009",33,9,1993,40110,38115,1995,5
"33009",33,9,1994,41504,40196,1308,3.2
"33009",33,9,1995,42167,40867,1300,3.1
"33009",33,9,1996,41253,39871,1382,3.4
"33009",33,9,1997,42408,41269,1139,2.7
"33009",33,9,1998,43333,42400,933,2.2
"33009",33,9,1999,43981,43154,827,1.9
"33009",33,9,2000,44855,43799,1056,2.4
"33009",33,9,2001,45007,43795,1212,2.7
"33009",33,9,2002,45439,44107,1332,2.9
"33009",33,9,2003,45671,44295,1376,3
"33009",33,9,2004,46393,45108,1285,2.8
"33009",33,9,2005,46776,45453,1323,2.8
"33009",33,9,2006,47854,46483,1371,2.9
"33009",33,9,2007,48284,46858,1426,3
"33009",33,9,2008,48793,47257,1536,3.1
"33009",33,9,2009,48888,46380,2508,5.1
"33009",33,9,2010,48323,46004,2319,4.8
"33009",33,9,2011,48735,46563,2172,4.5
"33009",33,9,2012,48731,46564,2167,4.4
"33009",33,9,2013,48367,46323,2044,4.2
"33009",33,9,2014,48384,46716,1668,3.4
"33009",33,9,2015,48443,47113,1330,2.7
"33009",33,9,2016,48421,47276,1145,2.4
"33009",33,9,2017,48495,47437,1058,2.2
"33011",33,11,1990,198174,187396,10778,5.4
"33011",33,11,1991,189834,176335,13499,7.1
"33011",33,11,1992,189976,176078,13898,7.3
"33011",33,11,1993,190040,178002,12038,6.3
"33011",33,11,1994,188902,179265,9637,5.1
"33011",33,11,1995,191641,183618,8023,4.2
"33011",33,11,1996,194544,187516,7028,3.6
"33011",33,11,1997,199623,193722,5901,3
"33011",33,11,1998,203210,197908,5302,2.6
"33011",33,11,1999,206157,200553,5604,2.7
"33011",33,11,2000,212572,207152,5420,2.5
"33011",33,11,2001,216244,208619,7625,3.5
"33011",33,11,2002,216674,206322,10352,4.8
"33011",33,11,2003,219658,209646,10012,4.6
"33011",33,11,2004,223189,214535,8654,3.9
"33011",33,11,2005,226188,217986,8202,3.6
"33011",33,11,2006,226541,218494,8047,3.6
"33011",33,11,2007,228214,220129,8085,3.5
"33011",33,11,2008,228996,220158,8838,3.9
"33011",33,11,2009,229684,214833,14851,6.5
"33011",33,11,2010,226154,212243,13911,6.2
"33011",33,11,2011,225078,212339,12739,5.7
"33011",33,11,2012,226905,213782,13123,5.8
"33011",33,11,2013,227768,215531,12237,5.4
"33011",33,11,2014,228249,217991,10258,4.5
"33011",33,11,2015,228760,220595,8165,3.6
"33011",33,11,2016,230435,223465,6970,3
"33011",33,11,2017,231152,224597,6555,2.8
"33013",33,13,1990,60276,57132,3144,5.2
"33013",33,13,1991,65570,61147,4423,6.7
"33013",33,13,1992,66163,62089,4074,6.2
"33013",33,13,1993,66507,63485,3022,4.5
"33013",33,13,1994,70026,67647,2379,3.4
"33013",33,13,1995,71099,69125,1974,2.8
"33013",33,13,1996,71050,69063,1987,2.8
"33013",33,13,1997,72127,70175,1952,2.7
"33013",33,13,1998,74421,72715,1706,2.3
"33013",33,13,1999,74827,73250,1577,2.1
"33013",33,13,2000,74785,73010,1775,2.4
"33013",33,13,2001,76063,73897,2166,2.8
"33013",33,13,2002,77022,74390,2632,3.4
"33013",33,13,2003,77336,74603,2733,3.5
"33013",33,13,2004,77129,74695,2434,3.2
"33013",33,13,2005,78128,75672,2456,3.1
"33013",33,13,2006,79556,77069,2487,3.1
"33013",33,13,2007,80318,77657,2661,3.3
"33013",33,13,2008,81100,78144,2956,3.6
"33013",33,13,2009,81726,77115,4611,5.6
"33013",33,13,2010,81399,77047,4352,5.3
"33013",33,13,2011,81097,77105,3992,4.9
"33013",33,13,2012,81159,77144,4015,4.9
"33013",33,13,2013,80880,77141,3739,4.6
"33013",33,13,2014,80758,77669,3089,3.8
"33013",33,13,2015,80956,78464,2492,3.1
"33013",33,13,2016,81380,79301,2079,2.6
"33013",33,13,2017,81116,79203,1913,2.4
"33015",33,15,1990,142113,133272,8841,6.2
"33015",33,15,1991,138990,127969,11021,7.9
"33015",33,15,1992,140584,128854,11730,8.3
"33015",33,15,1993,142498,132080,10418,7.3
"33015",33,15,1994,143704,135305,8399,5.8
"33015",33,15,1995,145382,138583,6799,4.7
"33015",33,15,1996,148557,141779,6778,4.6
"33015",33,15,1997,151233,145138,6095,4
"33015",33,15,1998,153587,148196,5391,3.5
"33015",33,15,1999,164247,159002,5245,3.2
"33015",33,15,2000,160555,155772,4783,3
"33015",33,15,2001,163719,157155,6564,4
"33015",33,15,2002,165148,156129,9019,5.5
"33015",33,15,2003,166414,157694,8720,5.2
"33015",33,15,2004,168375,160630,7745,4.6
"33015",33,15,2005,170876,163836,7040,4.1
"33015",33,15,2006,171538,165095,6443,3.8
"33015",33,15,2007,173675,167110,6565,3.8
"33015",33,15,2008,174270,166876,7394,4.2
"33015",33,15,2009,174577,163078,11499,6.6
"33015",33,15,2010,172363,162062,10301,6
"33015",33,15,2011,172121,162478,9643,5.6
"33015",33,15,2012,174766,164606,10160,5.8
"33015",33,15,2013,175732,166176,9556,5.4
"33015",33,15,2014,176327,168191,8136,4.6
"33015",33,15,2015,177990,171595,6395,3.6
"33015",33,15,2016,180485,175021,5464,3
"33015",33,15,2017,181322,176081,5241,2.9
"33017",33,17,1990,57153,53766,3387,5.9
"33017",33,17,1991,58081,53770,4311,7.4
"33017",33,17,1992,56788,52744,4044,7.1
"33017",33,17,1993,57352,54120,3232,5.6
"33017",33,17,1994,56873,54584,2289,4
"33017",33,17,1995,56828,54646,2182,3.8
"33017",33,17,1996,57153,54902,2251,3.9
"33017",33,17,1997,57885,55930,1955,3.4
"33017",33,17,1998,57646,56059,1587,2.8
"33017",33,17,1999,57718,56326,1392,2.4
"33017",33,17,2000,61812,60154,1658,2.7
"33017",33,17,2001,62519,60483,2036,3.3
"33017",33,17,2002,63503,60744,2759,4.3
"33017",33,17,2003,64896,62327,2569,4
"33017",33,17,2004,65955,63731,2224,3.4
"33017",33,17,2005,66513,64272,2241,3.4
"33017",33,17,2006,66852,64741,2111,3.2
"33017",33,17,2007,68206,65980,2226,3.3
"33017",33,17,2008,69672,67148,2524,3.6
"33017",33,17,2009,69746,65425,4321,6.2
"33017",33,17,2010,69570,65627,3943,5.7
"33017",33,17,2011,69614,65927,3687,5.3
"33017",33,17,2012,70054,66264,3790,5.4
"33017",33,17,2013,70151,66729,3422,4.9
"33017",33,17,2014,70493,67676,2817,4
"33017",33,17,2015,70939,68727,2212,3.1
"33017",33,17,2016,71932,70097,1835,2.6
"33017",33,17,2017,72363,70660,1703,2.4
"33019",33,19,1990,20579,19272,1307,6.4
"33019",33,19,1991,19948,18378,1570,7.9
"33019",33,19,1992,19452,18118,1334,6.9
"33019",33,19,1993,19673,18647,1026,5.2
"33019",33,19,1994,20565,19822,743,3.6
"33019",33,19,1995,20768,20170,598,2.9
"33019",33,19,1996,20918,20333,585,2.8
"33019",33,19,1997,21005,20365,640,3
"33019",33,19,1998,21208,20650,558,2.6
"33019",33,19,1999,21423,20836,587,2.7
"33019",33,19,2000,21692,21155,537,2.5
"33019",33,19,2001,21653,21065,588,2.7
"33019",33,19,2002,21460,20780,680,3.2
"33019",33,19,2003,20994,20269,725,3.5
"33019",33,19,2004,21273,20590,683,3.2
"33019",33,19,2005,21942,21296,646,2.9
"33019",33,19,2006,22371,21717,654,2.9
"33019",33,19,2007,22548,21875,673,3
"33019",33,19,2008,22749,21977,772,3.4
"33019",33,19,2009,22798,21487,1311,5.8
"33019",33,19,2010,24038,22792,1246,5.2
"33019",33,19,2011,23952,22855,1097,4.6
"33019",33,19,2012,24042,22963,1079,4.5
"33019",33,19,2013,24092,23100,992,4.1
"33019",33,19,2014,23692,22857,835,3.5
"33019",33,19,2015,23577,22930,647,2.7
"33019",33,19,2016,23436,22890,546,2.3
"33019",33,19,2017,23057,22550,507,2.2
"34001",34,1,1990,122312,114769,7543,6.2
"34001",34,1,1991,124064,113191,10873,8.8
"34001",34,1,1992,123730,111078,12652,10.2
"34001",34,1,1993,122274,110610,11664,9.5
"34001",34,1,1994,122933,112201,10732,8.7
"34001",34,1,1995,125536,114791,10745,8.6
"34001",34,1,1996,128733,118048,10685,8.3
"34001",34,1,1997,131049,121137,9912,7.6
"34001",34,1,1998,130317,120228,10089,7.7
"34001",34,1,1999,130365,121146,9219,7.1
"34001",34,1,2000,128823,122783,6040,4.7
"34001",34,1,2001,129230,123129,6101,4.7
"34001",34,1,2002,131104,123275,7829,6
"34001",34,1,2003,132292,124072,8220,6.2
"34001",34,1,2004,134116,126693,7423,5.5
"34001",34,1,2005,136314,129021,7293,5.4
"34001",34,1,2006,138555,130556,7999,5.8
"34001",34,1,2007,135104,127177,7927,5.9
"34001",34,1,2008,135738,126475,9263,6.8
"34001",34,1,2009,137079,120781,16298,11.9
"34001",34,1,2010,140705,123437,17268,12.3
"34001",34,1,2011,139712,122239,17473,12.5
"34001",34,1,2012,140844,122973,17871,12.7
"34001",34,1,2013,137755,121676,16079,11.7
"34001",34,1,2014,133083,119063,14020,10.5
"34001",34,1,2015,127902,115665,12237,9.6
"34001",34,1,2016,124322,115119,9203,7.4
"34001",34,1,2017,121102,112399,8703,7.2
"34003",34,3,1990,444418,427269,17149,3.9
"34003",34,3,1991,442048,418438,23610,5.3
"34003",34,3,1992,433587,402494,31093,7.2
"34003",34,3,1993,429816,400582,29234,6.8
"34003",34,3,1994,431977,405163,26814,6.2
"34003",34,3,1995,437231,411953,25278,5.8
"34003",34,3,1996,445221,421816,23405,5.3
"34003",34,3,1997,450971,430898,20073,4.5
"34003",34,3,1998,449742,433507,16235,3.6
"34003",34,3,1999,449535,433162,16373,3.6
"34003",34,3,2000,468371,453532,14839,3.2
"34003",34,3,2001,465449,448100,17349,3.7
"34003",34,3,2002,463722,440386,23336,5
"34003",34,3,2003,463347,439897,23450,5.1
"34003",34,3,2004,461732,442672,19060,4.1
"34003",34,3,2005,465823,448415,17408,3.7
"34003",34,3,2006,471181,452733,18448,3.9
"34003",34,3,2007,471472,455223,16249,3.4
"34003",34,3,2008,478208,457226,20982,4.4
"34003",34,3,2009,481104,443640,37464,7.8
"34003",34,3,2010,478642,440196,38446,8
"34003",34,3,2011,481389,444264,37125,7.7
"34003",34,3,2012,484170,446933,37237,7.7
"34003",34,3,2013,480543,448133,32410,6.7
"34003",34,3,2014,481267,455068,26199,5.4
"34003",34,3,2015,483915,461124,22791,4.7
"34003",34,3,2016,484248,463959,20289,4.2
"34003",34,3,2017,483324,464527,18797,3.9
"34005",34,5,1990,207010,197471,9539,4.6
"34005",34,5,1991,210552,197511,13041,6.2
"34005",34,5,1992,208260,192194,16066,7.7
"34005",34,5,1993,203148,190600,12548,6.2
"34005",34,5,1994,205961,195016,10945,5.3
"34005",34,5,1995,212984,202361,10623,5
"34005",34,5,1996,221285,210843,10442,4.7
"34005",34,5,1997,226052,217209,8843,3.9
"34005",34,5,1998,227574,219895,7679,3.4
"34005",34,5,1999,229243,221719,7524,3.3
"34005",34,5,2000,221069,214177,6892,3.1
"34005",34,5,2001,221834,213995,7839,3.5
"34005",34,5,2002,228538,217515,11023,4.8
"34005",34,5,2003,230703,219602,11101,4.8
"34005",34,5,2004,234422,224900,9522,4.1
"34005",34,5,2005,237927,228749,9178,3.9
"34005",34,5,2006,240366,230329,10037,4.2
"34005",34,5,2007,237634,228511,9123,3.8
"34005",34,5,2008,239461,227696,11765,4.9
"34005",34,5,2009,241989,221585,20404,8.4
"34005",34,5,2010,237039,215736,21303,9
"34005",34,5,2011,235904,215373,20531,8.7
"34005",34,5,2012,236400,215939,20461,8.7
"34005",34,5,2013,234288,216371,17917,7.6
"34005",34,5,2014,230681,215869,14812,6.4
"34005",34,5,2015,232623,220189,12434,5.3
"34005",34,5,2016,233255,222869,10386,4.5
"34005",34,5,2017,234179,224582,9597,4.1
"34007",34,7,1990,253118,238219,14899,5.9
"34007",34,7,1991,260549,240504,20045,7.7
"34007",34,7,1992,258186,234548,23638,9.2
"34007",34,7,1993,250879,232112,18767,7.5
"34007",34,7,1994,252683,235577,17106,6.8
"34007",34,7,1995,255240,238835,16405,6.4
"34007",34,7,1996,258614,243105,15509,6
"34007",34,7,1997,261889,248789,13100,5
"34007",34,7,1998,261624,249907,11717,4.5
"34007",34,7,1999,261478,249481,11997,4.6
"34007",34,7,2000,253927,244044,9883,3.9
"34007",34,7,2001,251911,241009,10902,4.3
"34007",34,7,2002,257000,241969,15031,5.8
"34007",34,7,2003,256605,241129,15476,6
"34007",34,7,2004,259165,245803,13362,5.2
"34007",34,7,2005,262726,250121,12605,4.8
"34007",34,7,2006,265339,251306,14033,5.3
"34007",34,7,2007,262569,249877,12692,4.8
"34007",34,7,2008,267190,251420,15770,5.9
"34007",34,7,2009,271508,244631,26877,9.9
"34007",34,7,2010,264713,235749,28964,10.9
"34007",34,7,2011,263061,234525,28536,10.8
"34007",34,7,2012,262892,234738,28154,10.7
"34007",34,7,2013,259529,235269,24260,9.3
"34007",34,7,2014,254073,234520,19553,7.7
"34007",34,7,2015,255390,238892,16498,6.5
"34007",34,7,2016,256005,241947,14058,5.5
"34007",34,7,2017,256929,243835,13094,5.1
"34009",34,9,1990,44418,41005,3413,7.7
"34009",34,9,1991,45124,40512,4612,10.2
"34009",34,9,1992,45705,39740,5965,13.1
"34009",34,9,1993,45298,39291,6007,13.3
"34009",34,9,1994,45743,39944,5799,12.7
"34009",34,9,1995,46330,40718,5612,12.1
"34009",34,9,1996,47133,41572,5561,11.8
"34009",34,9,1997,47707,42405,5302,11.1
"34009",34,9,1998,46702,41811,4891,10.5
"34009",34,9,1999,46441,41845,4596,9.9
"34009",34,9,2000,55469,51897,3572,6.4
"34009",34,9,2001,55112,51454,3658,6.6
"34009",34,9,2002,55335,50941,4394,7.9
"34009",34,9,2003,55722,51250,4472,8
"34009",34,9,2004,57017,53150,3867,6.8
"34009",34,9,2005,57700,53895,3805,6.6
"34009",34,9,2006,57588,53574,4014,7
"34009",34,9,2007,56472,52765,3707,6.6
"34009",34,9,2008,56560,52091,4469,7.9
"34009",34,9,2009,57950,51453,6497,11.2
"34009",34,9,2010,50068,43042,7026,14
"34009",34,9,2011,49460,42109,7351,14.9
"34009",34,9,2012,49813,42104,7709,15.5
"34009",34,9,2013,49208,42168,7040,14.3
"34009",34,9,2014,48925,42938,5987,12.2
"34009",34,9,2015,48534,43143,5391,11.1
"34009",34,9,2016,47222,42584,4638,9.8
"34009",34,9,2017,47088,42780,4308,9.1
"34011",34,11,1990,65539,60632,4907,7.5
"34011",34,11,1991,66827,60121,6706,10
"34011",34,11,1992,66235,58252,7983,12.1
"34011",34,11,1993,63903,56555,7348,11.5
"34011",34,11,1994,64574,57797,6777,10.5
"34011",34,11,1995,65250,58850,6400,9.8
"34011",34,11,1996,65882,59393,6489,9.8
"34011",34,11,1997,66552,60720,5832,8.8
"34011",34,11,1998,66430,60518,5912,8.9
"34011",34,11,1999,66273,60764,5509,8.3
"34011",34,11,2000,65461,61646,3815,5.8
"34011",34,11,2001,64946,60738,4208,6.5
"34011",34,11,2002,66370,61368,5002,7.5
"34011",34,11,2003,66586,61344,5242,7.9
"34011",34,11,2004,68307,63850,4457,6.5
"34011",34,11,2005,69082,64663,4419,6.4
"34011",34,11,2006,69235,64368,4867,7
"34011",34,11,2007,68174,63719,4455,6.5
"34011",34,11,2008,69048,63611,5437,7.9
"34011",34,11,2009,70842,61969,8873,12.5
"34011",34,11,2010,72603,63172,9431,13
"34011",34,11,2011,71870,62557,9313,13
"34011",34,11,2012,71365,61992,9373,13.1
"34011",34,11,2013,69660,61473,8187,11.8
"34011",34,11,2014,68160,61406,6754,9.9
"34011",34,11,2015,68117,62100,6017,8.8
"34011",34,11,2016,67131,62109,5022,7.5
"34011",34,11,2017,66406,61789,4617,7
"34013",34,13,1990,394690,369998,24692,6.3
"34013",34,13,1991,381190,350205,30985,8.1
"34013",34,13,1992,387749,349255,38494,9.9
"34013",34,13,1993,377012,341997,35015,9.3
"34013",34,13,1994,373666,342783,30883,8.3
"34013",34,13,1995,375296,346456,28840,7.7
"34013",34,13,1996,377306,348101,29205,7.7
"34013",34,13,1997,377526,352267,25259,6.7
"34013",34,13,1998,372031,351293,20738,5.6
"34013",34,13,1999,375247,354206,21041,5.6
"34013",34,13,2000,365491,349001,16490,4.5
"34013",34,13,2001,364711,345299,19412,5.3
"34013",34,13,2002,369274,342684,26590,7.2
"34013",34,13,2003,367727,341078,26649,7.2
"34013",34,13,2004,362557,340464,22093,6.1
"34013",34,13,2005,360801,340502,20299,5.6
"34013",34,13,2006,362670,341287,21383,5.9
"34013",34,13,2007,361575,342249,19326,5.3
"34013",34,13,2008,365516,341987,23529,6.4
"34013",34,13,2009,367513,329542,37971,10.3
"34013",34,13,2010,382086,340642,41444,10.8
"34013",34,13,2011,382993,341544,41449,10.8
"34013",34,13,2012,384068,342784,41284,10.7
"34013",34,13,2013,379663,342824,36839,9.7
"34013",34,13,2014,376766,346558,30208,8
"34013",34,13,2015,375066,349110,25956,6.9
"34013",34,13,2016,372531,350142,22389,6
"34013",34,13,2017,370503,349489,21014,5.7
"34015",34,15,1990,119312,112613,6699,5.6
"34015",34,15,1991,124193,114896,9297,7.5
"34015",34,15,1992,123488,112725,10763,8.7
"34015",34,15,1993,121368,112473,8895,7.3
"34015",34,15,1994,124164,115800,8364,6.7
"34015",34,15,1995,126085,117836,8249,6.5
"34015",34,15,1996,128999,121048,7951,6.2
"34015",34,15,1997,131435,124839,6596,5
"34015",34,15,1998,132585,126585,6000,4.5
"34015",34,15,1999,133815,127931,5884,4.4
"34015",34,15,2000,134657,129764,4893,3.6
"34015",34,15,2001,134778,129456,5322,3.9
"34015",34,15,2002,138982,131717,7265,5.2
"34015",34,15,2003,140946,133355,7591,5.4
"34015",34,15,2004,144501,137783,6718,4.6
"34015",34,15,2005,148091,141602,6489,4.4
"34015",34,15,2006,152501,145254,7247,4.8
"34015",34,15,2007,153893,147255,6638,4.3
"34015",34,15,2008,156573,148257,8316,5.3
"34015",34,15,2009,159879,145105,14774,9.2
"34015",34,15,2010,152539,136891,15648,10.3
"34015",34,15,2011,152043,136576,15467,10.2
"34015",34,15,2012,152205,136848,15357,10.1
"34015",34,15,2013,151160,137619,13541,9
"34015",34,15,2014,148892,137973,10919,7.3
"34015",34,15,2015,149930,140845,9085,6.1
"34015",34,15,2016,150906,143281,7625,5.1
"34015",34,15,2017,151568,144412,7156,4.7
"34017",34,17,1990,286781,265946,20835,7.3
"34017",34,17,1991,287000,262116,24884,8.7
"34017",34,17,1992,282861,251436,31425,11.1
"34017",34,17,1993,279870,251357,28513,10.2
"34017",34,17,1994,284744,258148,26596,9.3
"34017",34,17,1995,288194,261300,26894,9.3
"34017",34,17,1996,291852,265092,26760,9.2
"34017",34,17,1997,290644,267395,23249,8
"34017",34,17,1998,287829,267019,20810,7.2
"34017",34,17,1999,287896,267345,20551,7.1
"34017",34,17,2000,297250,282845,14405,4.8
"34017",34,17,2001,295819,279414,16405,5.5
"34017",34,17,2002,294514,272037,22477,7.6
"34017",34,17,2003,291065,269663,21402,7.4
"34017",34,17,2004,286674,269375,17299,6
"34017",34,17,2005,287475,271796,15679,5.5
"34017",34,17,2006,288996,272886,16110,5.6
"34017",34,17,2007,290029,275553,14476,5
"34017",34,17,2008,294030,275774,18256,6.2
"34017",34,17,2009,300162,268583,31579,10.5
"34017",34,17,2010,352687,318935,33752,9.6
"34017",34,17,2011,357120,324421,32699,9.2
"34017",34,17,2012,360321,328249,32072,8.9
"34017",34,17,2013,358829,330530,28299,7.9
"34017",34,17,2014,360027,337098,22929,6.4
"34017",34,17,2015,362284,342752,19532,5.4
"34017",34,17,2016,363241,346230,17011,4.7
"34017",34,17,2017,362646,346777,15869,4.4
"34019",34,19,1990,58978,57391,1587,2.7
"34019",34,19,1991,60226,57952,2274,3.8
"34019",34,19,1992,60983,57930,3053,5
"34019",34,19,1993,61466,58724,2742,4.5
"34019",34,19,1994,62807,60455,2352,3.7
"34019",34,19,1995,63883,61848,2035,3.2
"34019",34,19,1996,66883,64819,2064,3.1
"34019",34,19,1997,69204,67501,1703,2.5
"34019",34,19,1998,69805,68287,1518,2.2
"34019",34,19,1999,71693,70236,1457,2
"34019",34,19,2000,67840,66247,1593,2.3
"34019",34,19,2001,68536,66628,1908,2.8
"34019",34,19,2002,69785,66914,2871,4.1
"34019",34,19,2003,70296,67293,3003,4.3
"34019",34,19,2004,70332,67956,2376,3.4
"34019",34,19,2005,71103,68878,2225,3.1
"34019",34,19,2006,72102,69670,2432,3.4
"34019",34,19,2007,72048,69995,2053,2.8
"34019",34,19,2008,72965,70260,2705,3.7
"34019",34,19,2009,73220,68321,4899,6.7
"34019",34,19,2010,68291,63242,5049,7.4
"34019",34,19,2011,67746,63067,4679,6.9
"34019",34,19,2012,67526,62900,4626,6.9
"34019",34,19,2013,66532,62636,3896,5.9
"34019",34,19,2014,65910,62697,3213,4.9
"34019",34,19,2015,65534,62747,2787,4.3
"34019",34,19,2016,65022,62571,2451,3.8
"34019",34,19,2017,64722,62437,2285,3.5
"34021",34,21,1990,170294,162754,7540,4.4
"34021",34,21,1991,173389,163634,9755,5.6
"34021",34,21,1992,172332,161074,11258,6.5
"34021",34,21,1993,169872,159919,9953,5.9
"34021",34,21,1994,170154,161058,9096,5.3
"34021",34,21,1995,170960,161688,9272,5.4
"34021",34,21,1996,172134,162482,9652,5.6
"34021",34,21,1997,173187,165084,8103,4.7
"34021",34,21,1998,170753,163758,6995,4.1
"34021",34,21,1999,175052,168345,6707,3.8
"34021",34,21,2000,179928,174028,5900,3.3
"34021",34,21,2001,182076,175290,6786,3.7
"34021",34,21,2002,185688,175918,9770,5.3
"34021",34,21,2003,186864,177229,9635,5.2
"34021",34,21,2004,189063,181116,7947,4.2
"34021",34,21,2005,193721,186136,7585,3.9
"34021",34,21,2006,195577,187145,8432,4.3
"34021",34,21,2007,196360,188835,7525,3.8
"34021",34,21,2008,202109,192541,9568,4.7
"34021",34,21,2009,205540,189945,15595,7.6
"34021",34,21,2010,192648,176545,16103,8.4
"34021",34,21,2011,193382,177364,16018,8.3
"34021",34,21,2012,194086,178037,16049,8.3
"34021",34,21,2013,193679,179551,14128,7.3
"34021",34,21,2014,195547,184035,11512,5.9
"34021",34,21,2015,198447,188505,9942,5
"34021",34,21,2016,199400,190708,8692,4.4
"34021",34,21,2017,198846,190683,8163,4.1
"34023",34,23,1990,369842,353361,16481,4.5
"34023",34,23,1991,377427,355657,21770,5.8
"34023",34,23,1992,378894,350407,28487,7.5
"34023",34,23,1993,377054,351150,25904,6.9
"34023",34,23,1994,381360,359267,22093,5.8
"34023",34,23,1995,389026,367606,21420,5.5
"34023",34,23,1996,399506,378848,20658,5.2
"34023",34,23,1997,410243,392703,17540,4.3
"34023",34,23,1998,408590,393441,15149,3.7
"34023",34,23,1999,415823,400604,15219,3.7
"34023",34,23,2000,400922,387461,13461,3.4
"34023",34,23,2001,404653,388454,16199,4
"34023",34,23,2002,411362,388343,23019,5.6
"34023",34,23,2003,409562,386982,22580,5.5
"34023",34,23,2004,409573,391154,18419,4.5
"34023",34,23,2005,414728,397205,17523,4.2
"34023",34,23,2006,420036,401589,18447,4.4
"34023",34,23,2007,420390,404171,16219,3.9
"34023",34,23,2008,425519,404623,20896,4.9
"34023",34,23,2009,427779,391374,36405,8.5
"34023",34,23,2010,424531,386570,37961,8.9
"34023",34,23,2011,427282,390022,37260,8.7
"34023",34,23,2012,431701,394536,37165,8.6
"34023",34,23,2013,432108,399543,32565,7.5
"34023",34,23,2014,436315,409691,26624,6.1
"34023",34,23,2015,440742,418062,22680,5.1
"34023",34,23,2016,442068,422500,19568,4.4
"34023",34,23,2017,442313,424201,18112,4.1
"34025",34,25,1990,285172,273412,11760,4.1
"34025",34,25,1991,290301,273419,16882,5.8
"34025",34,25,1992,289938,268680,21258,7.3
"34025",34,25,1993,292423,273927,18496,6.3
"34025",34,25,1994,297507,280392,17115,5.8
"34025",34,25,1995,302673,286245,16428,5.4
"34025",34,25,1996,310297,294048,16249,5.2
"34025",34,25,1997,313791,299643,14148,4.5
"34025",34,25,1998,310564,298130,12434,4
"34025",34,25,1999,314500,302209,12291,3.9
"34025",34,25,2000,317914,307639,10275,3.2
"34025",34,25,2001,319461,307451,12010,3.8
"34025",34,25,2002,323900,306893,17007,5.3
"34025",34,25,2003,322552,305095,17457,5.4
"34025",34,25,2004,321317,307048,14269,4.4
"34025",34,25,2005,323151,309920,13231,4.1
"34025",34,25,2006,327654,314026,13628,4.2
"34025",34,25,2007,331122,318729,12393,3.7
"34025",34,25,2008,335057,319101,15956,4.8
"34025",34,25,2009,336864,308808,28056,8.3
"34025",34,25,2010,330468,301595,28873,8.7
"34025",34,25,2011,330174,301902,28272,8.6
"34025",34,25,2012,331636,302734,28902,8.7
"34025",34,25,2013,328741,304012,24729,7.5
"34025",34,25,2014,328722,308800,19922,6.1
"34025",34,25,2015,329935,312901,17034,5.2
"34025",34,25,2016,330855,316142,14713,4.4
"34025",34,25,2017,330689,317076,13613,4.1
"34027",34,27,1990,246592,238693,7899,3.2
"34027",34,27,1991,239566,227957,11609,4.8
"34027",34,27,1992,244927,229705,15222,6.2
"34027",34,27,1993,242187,228231,13956,5.8
"34027",34,27,1994,246171,233937,12234,5
"34027",34,27,1995,251428,240557,10871,4.3
"34027",34,27,1996,256429,246275,10154,4
"34027",34,27,1997,262280,253502,8778,3.3
"34027",34,27,1998,263457,256183,7274,2.8
"34027",34,27,1999,268534,261196,7338,2.7
"34027",34,27,2000,260858,253914,6944,2.7
"34027",34,27,2001,260412,251963,8449,3.2
"34027",34,27,2002,264023,251933,12090,4.6
"34027",34,27,2003,265061,252952,12109,4.6
"34027",34,27,2004,264848,255329,9519,3.6
"34027",34,27,2005,267019,258297,8722,3.3
"34027",34,27,2006,271011,261872,9139,3.4
"34027",34,27,2007,271713,263489,8224,3
"34027",34,27,2008,275403,264632,10771,3.9
"34027",34,27,2009,275319,255852,19467,7.1
"34027",34,27,2010,264830,245198,19632,7.4
"34027",34,27,2011,265514,246757,18757,7.1
"34027",34,27,2012,267429,248396,19033,7.1
"34027",34,27,2013,264811,248460,16351,6.2
"34027",34,27,2014,262574,249376,13198,5
"34027",34,27,2015,262029,250565,11464,4.4
"34027",34,27,2016,261143,250925,10218,3.9
"34027",34,27,2017,259911,250447,9464,3.6
"34029",34,29,1990,190053,180468,9585,5
"34029",34,29,1991,193802,180540,13262,6.8
"34029",34,29,1992,192619,176779,15840,8.2
"34029",34,29,1993,195308,181483,13825,7.1
"34029",34,29,1994,199477,186362,13115,6.6
"34029",34,29,1995,204633,191940,12693,6.2
"34029",34,29,1996,211637,198715,12922,6.1
"34029",34,29,1997,215642,203841,11801,5.5
"34029",34,29,1998,214150,203915,10235,4.8
"34029",34,29,1999,216762,207014,9748,4.5
"34029",34,29,2000,231928,223264,8664,3.7
"34029",34,29,2001,235470,225784,9686,4.1
"34029",34,29,2002,242110,228926,13184,5.4
"34029",34,29,2003,244048,229840,14208,5.8
"34029",34,29,2004,245409,233198,12211,5
"34029",34,29,2005,248890,237282,11608,4.7
"34029",34,29,2006,255188,242397,12791,5
"34029",34,29,2007,256510,244810,11700,4.6
"34029",34,29,2008,261749,246504,15245,5.8
"34029",34,29,2009,265145,239849,25296,9.5
"34029",34,29,2010,264646,237500,27146,10.3
"34029",34,29,2011,266297,238593,27704,10.4
"34029",34,29,2012,268795,240271,28524,10.6
"34029",34,29,2013,266921,242166,24755,9.3
"34029",34,29,2014,267076,247388,19688,7.4
"34029",34,29,2015,268497,251911,16586,6.2
"34029",34,29,2016,271477,257324,14153,5.2
"34029",34,29,2017,271129,258063,13066,4.8
"34031",34,31,1990,235755,220815,14940,6.3
"34031",34,31,1991,235187,216030,19157,8.1
"34031",34,31,1992,231257,207031,24226,10.5
"34031",34,31,1993,229925,206580,23345,10.2
"34031",34,31,1994,230920,209319,21601,9.4
"34031",34,31,1995,233137,213081,20056,8.6
"34031",34,31,1996,236717,217246,19471,8.2
"34031",34,31,1997,237785,221276,16509,6.9
"34031",34,31,1998,235702,222024,13678,5.8
"34031",34,31,1999,236746,222090,14656,6.2
"34031",34,31,2000,235907,225034,10873,4.6
"34031",34,31,2001,235267,222637,12630,5.4
"34031",34,31,2002,235505,218974,16531,7
"34031",34,31,2003,235805,218576,17229,7.3
"34031",34,31,2004,233370,219231,14139,6.1
"34031",34,31,2005,234831,221929,12902,5.5
"34031",34,31,2006,236210,222817,13393,5.7
"34031",34,31,2007,236506,223853,12653,5.3
"34031",34,31,2008,240502,224531,15971,6.6
"34031",34,31,2009,245108,218128,26980,11
"34031",34,31,2010,253221,224458,28763,11.4
"34031",34,31,2011,253500,225581,27919,11
"34031",34,31,2012,253746,225649,28097,11.1
"34031",34,31,2013,250545,225521,25024,10
"34031",34,31,2014,248896,228359,20537,8.3
"34031",34,31,2015,248816,231177,17639,7.1
"34031",34,31,2016,246315,231089,15226,6.2
"34031",34,31,2017,245454,231482,13972,5.7
"34033",34,33,1990,31344,29697,1647,5.3
"34033",34,33,1991,32114,29819,2295,7.1
"34033",34,33,1992,31655,28999,2656,8.4
"34033",34,33,1993,30871,28661,2210,7.2
"34033",34,33,1994,31004,28910,2094,6.8
"34033",34,33,1995,31552,29493,2059,6.5
"34033",34,33,1996,32881,30518,2363,7.2
"34033",34,33,1997,32767,30868,1899,5.8
"34033",34,33,1998,32556,30894,1662,5.1
"34033",34,33,1999,32225,30723,1502,4.7
"34033",34,33,2000,31505,30281,1224,3.9
"34033",34,33,2001,30793,29435,1358,4.4
"34033",34,33,2002,31017,29212,1805,5.8
"34033",34,33,2003,30307,28490,1817,6
"34033",34,33,2004,30695,29113,1582,5.2
"34033",34,33,2005,31234,29715,1519,4.9
"34033",34,33,2006,31536,29932,1604,5.1
"34033",34,33,2007,31279,29729,1550,5
"34033",34,33,2008,31586,29651,1935,6.1
"34033",34,33,2009,31792,28417,3375,10.6
"34033",34,33,2010,32124,28379,3745,11.7
"34033",34,33,2011,32402,28630,3772,11.6
"34033",34,33,2012,32174,28371,3803,11.8
"34033",34,33,2013,31745,28426,3319,10.5
"34033",34,33,2014,31292,28627,2665,8.5
"34033",34,33,2015,31080,28792,2288,7.4
"34033",34,33,2016,30318,28376,1942,6.4
"34033",34,33,2017,29891,28061,1830,6.1
"34035",34,35,1990,138479,134438,4041,2.9
"34035",34,35,1991,142395,136790,5605,3.9
"34035",34,35,1992,143488,136132,7356,5.1
"34035",34,35,1993,145803,138620,7183,4.9
"34035",34,35,1994,149996,143488,6508,4.3
"34035",34,35,1995,153950,148134,5816,3.8
"34035",34,35,1996,160154,154688,5466,3.4
"34035",34,35,1997,167175,162455,4720,2.8
"34035",34,35,1998,169583,165318,4265,2.5
"34035",34,35,1999,174651,170525,4126,2.4
"34035",34,35,2000,165405,161100,4305,2.6
"34035",34,35,2001,167313,161909,5404,3.2
"34035",34,35,2002,170716,162628,8088,4.7
"34035",34,35,2003,170535,162699,7836,4.6
"34035",34,35,2004,171606,165327,6279,3.7
"34035",34,35,2005,174544,168578,5966,3.4
"34035",34,35,2006,179540,173281,6259,3.5
"34035",34,35,2007,179245,173688,5557,3.1
"34035",34,35,2008,181589,174322,7267,4
"34035",34,35,2009,182709,169460,13249,7.3
"34035",34,35,2010,173474,160296,13178,7.6
"34035",34,35,2011,174366,161485,12881,7.4
"34035",34,35,2012,175889,162789,13100,7.4
"34035",34,35,2013,174575,163484,11091,6.4
"34035",34,35,2014,174019,164932,9087,5.2
"34035",34,35,2015,174324,166357,7967,4.6
"34035",34,35,2016,174096,167006,7090,4.1
"34035",34,35,2017,173325,166730,6595,3.8
"34037",34,37,1990,71894,68897,2997,4.2
"34037",34,37,1991,70467,66206,4261,6
"34037",34,37,1992,72776,67035,5741,7.9
"34037",34,37,1993,72013,66774,5239,7.3
"34037",34,37,1994,72865,68240,4625,6.3
"34037",34,37,1995,74442,70164,4278,5.7
"34037",34,37,1996,75731,71735,3996,5.3
"34037",34,37,1997,76707,73312,3395,4.4
"34037",34,37,1998,76770,74013,2757,3.6
"34037",34,37,1999,78177,75539,2638,3.4
"34037",34,37,2000,79409,77055,2354,3
"34037",34,37,2001,79952,77042,2910,3.6
"34037",34,37,2002,81456,77459,3997,4.9
"34037",34,37,2003,82395,78133,4262,5.2
"34037",34,37,2004,82333,78796,3537,4.3
"34037",34,37,2005,82976,79727,3249,3.9
"34037",34,37,2006,84041,80543,3498,4.2
"34037",34,37,2007,84106,80801,3305,3.9
"34037",34,37,2008,85205,81001,4204,4.9
"34037",34,37,2009,85607,78265,7342,8.6
"34037",34,37,2010,82251,74494,7757,9.4
"34037",34,37,2011,81765,74204,7561,9.2
"34037",34,37,2012,81238,73912,7326,9
"34037",34,37,2013,79345,73038,6307,7.9
"34037",34,37,2014,77688,72695,4993,6.4
"34037",34,37,2015,76640,72454,4186,5.5
"34037",34,37,2016,75713,72137,3576,4.7
"34037",34,37,2017,75277,71981,3296,4.4
"34039",34,39,1990,270617,256129,14488,5.4
"34039",34,39,1991,261631,243455,18176,6.9
"34039",34,39,1992,266198,243167,23031,8.7
"34039",34,39,1993,260668,239386,21282,8.2
"34039",34,39,1994,261237,242450,18787,7.2
"34039",34,39,1995,263903,246636,17267,6.5
"34039",34,39,1996,266882,250108,16774,6.3
"34039",34,39,1997,269642,254781,14861,5.5
"34039",34,39,1998,268075,255293,12782,4.8
"34039",34,39,1999,270481,257674,12807,4.7
"34039",34,39,2000,264337,254040,10297,3.9
"34039",34,39,2001,264533,252422,12111,4.6
"34039",34,39,2002,268151,251193,16958,6.3
"34039",34,39,2003,267073,250237,16836,6.3
"34039",34,39,2004,264425,250645,13780,5.2
"34039",34,39,2005,264877,252218,12659,4.8
"34039",34,39,2006,267378,254202,13176,4.9
"34039",34,39,2007,267086,255096,11990,4.5
"34039",34,39,2008,271250,256002,15248,5.6
"34039",34,39,2009,273986,248517,25469,9.3
"34039",34,39,2010,279174,252557,26617,9.5
"34039",34,39,2011,280560,253851,26709,9.5
"34039",34,39,2012,283086,256312,26774,9.5
"34039",34,39,2013,281154,257582,23572,8.4
"34039",34,39,2014,280005,260538,19467,7
"34039",34,39,2015,280235,263283,16952,6
"34039",34,39,2016,278562,264157,14405,5.2
"34039",34,39,2017,276968,263748,13220,4.8
"34041",34,41,1990,48839,46751,2088,4.3
"34041",34,41,1991,47770,44865,2905,6.1
"34041",34,41,1992,49039,45250,3789,7.7
"34041",34,41,1993,48218,44803,3415,7.1
"34041",34,41,1994,48791,45704,3087,6.3
"34041",34,41,1995,49833,46985,2848,5.7
"34041",34,41,1996,50945,48157,2788,5.5
"34041",34,41,1997,51518,49149,2369,4.6
"34041",34,41,1998,51582,49514,2068,4
"34041",34,41,1999,52950,50807,2143,4
"34041",34,41,2000,55600,53965,1635,2.9
"34041",34,41,2001,56572,54617,1955,3.5
"34041",34,41,2002,57690,54892,2798,4.9
"34041",34,41,2003,57664,54772,2892,5
"34041",34,41,2004,57710,55229,2481,4.3
"34041",34,41,2005,58567,56249,2318,4
"34041",34,41,2006,59176,56718,2458,4.2
"34041",34,41,2007,58513,56291,2222,3.8
"34041",34,41,2008,59175,56261,2914,4.9
"34041",34,41,2009,59551,54346,5205,8.7
"34041",34,41,2010,58593,52822,5771,9.8
"34041",34,41,2011,58736,53402,5334,9.1
"34041",34,41,2012,58651,53520,5131,8.7
"34041",34,41,2013,57771,53347,4424,7.7
"34041",34,41,2014,57261,53635,3626,6.3
"34041",34,41,2015,57192,54121,3071,5.4
"34041",34,41,2016,56957,54343,2614,4.6
"34041",34,41,2017,56567,54211,2356,4.2
"35001",35,1,1990,252509,238846,13663,5.4
"35001",35,1,1991,254368,239887,14481,5.7
"35001",35,1,1992,259590,246487,13103,5
"35001",35,1,1993,270072,253120,16952,6.3
"35001",35,1,1994,275881,263425,12456,4.5
"35001",35,1,1995,282176,270318,11858,4.2
"35001",35,1,1996,285625,271979,13646,4.8
"35001",35,1,1997,288358,275888,12470,4.3
"35001",35,1,1998,290204,277584,12620,4.3
"35001",35,1,1999,290762,279703,11059,3.8
"35001",35,1,2000,287292,275836,11456,4
"35001",35,1,2001,290898,278762,12136,4.2
"35001",35,1,2002,294256,279753,14503,4.9
"35001",35,1,2003,296480,280961,15519,5.2
"35001",35,1,2004,301259,286255,15004,5
"35001",35,1,2005,305757,291412,14345,4.7
"35001",35,1,2006,310792,298859,11933,3.8
"35001",35,1,2007,312319,301166,11153,3.6
"35001",35,1,2008,313468,299763,13705,4.4
"35001",35,1,2009,310124,286763,23361,7.5
"35001",35,1,2010,326594,301358,25236,7.7
"35001",35,1,2011,323703,300392,23311,7.2
"35001",35,1,2012,321012,299201,21811,6.8
"35001",35,1,2013,319638,298965,20673,6.5
"35001",35,1,2014,320453,300552,19901,6.2
"35001",35,1,2015,320916,302038,18878,5.9
"35001",35,1,2016,323896,305053,18843,5.8
"35001",35,1,2017,326340,308474,17866,5.5
"35003",35,3,1990,1245,1058,187,15
"35003",35,3,1991,1175,1017,158,13.4
"35003",35,3,1992,1175,1044,131,11.1
"35003",35,3,1993,1183,1056,127,10.7
"35003",35,3,1994,1290,1117,173,13.4
"35003",35,3,1995,1199,1056,143,11.9
"35003",35,3,1996,1243,1071,172,13.8
"35003",35,3,1997,1224,1082,142,11.6
"35003",35,3,1998,1179,1040,139,11.8
"35003",35,3,1999,1148,1037,111,9.7
"35003",35,3,2000,1446,1350,96,6.6
"35003",35,3,2001,1507,1415,92,6.1
"35003",35,3,2002,1426,1337,89,6.2
"35003",35,3,2003,1487,1375,112,7.5
"35003",35,3,2004,1443,1338,105,7.3
"35003",35,3,2005,1442,1346,96,6.7
"35003",35,3,2006,1449,1371,78,5.4
"35003",35,3,2007,1505,1432,73,4.9
"35003",35,3,2008,1536,1454,82,5.3
"35003",35,3,2009,1578,1433,145,9.2
"35003",35,3,2010,1216,1070,146,12
"35003",35,3,2011,1161,1032,129,11.1
"35003",35,3,2012,1247,1128,119,9.5
"35003",35,3,2013,1240,1130,110,8.9
"35003",35,3,2014,1188,1089,99,8.3
"35003",35,3,2015,1187,1088,99,8.3
"35003",35,3,2016,1194,1097,97,8.1
"35003",35,3,2017,1154,1074,80,6.9
"35005",35,5,1990,25793,24362,1431,5.5
"35005",35,5,1991,25446,22778,2668,10.5
"35005",35,5,1992,25184,22273,2911,11.6
"35005",35,5,1993,24626,22877,1749,7.1
"35005",35,5,1994,25836,23960,1876,7.3
"35005",35,5,1995,25611,23452,2159,8.4
"35005",35,5,1996,25968,23732,2236,8.6
"35005",35,5,1997,25855,24088,1767,6.8
"35005",35,5,1998,26740,24165,2575,9.6
"35005",35,5,1999,25793,23672,2121,8.2
"35005",35,5,2000,25619,24192,1427,5.6
"35005",35,5,2001,25741,24299,1442,5.6
"35005",35,5,2002,25737,24062,1675,6.5
"35005",35,5,2003,25859,23966,1893,7.3
"35005",35,5,2004,25691,23988,1703,6.6
"35005",35,5,2005,26115,24612,1503,5.8
"35005",35,5,2006,26640,25468,1172,4.4
"35005",35,5,2007,26808,25763,1045,3.9
"35005",35,5,2008,26833,25669,1164,4.3
"35005",35,5,2009,27308,25402,1906,7
"35005",35,5,2010,28042,25927,2115,7.5
"35005",35,5,2011,27596,25732,1864,6.8
"35005",35,5,2012,26971,25219,1752,6.5
"35005",35,5,2013,26633,24960,1673,6.3
"35005",35,5,2014,27106,25447,1659,6.1
"35005",35,5,2015,27594,25858,1736,6.3
"35005",35,5,2016,27792,25925,1867,6.7
"35005",35,5,2017,27274,25517,1757,6.4
"35006",35,6,1990,9195,7998,1197,13
"35006",35,6,1991,9231,7966,1265,13.7
"35006",35,6,1992,9427,8177,1250,13.3
"35006",35,6,1993,8891,7812,1079,12.1
"35006",35,6,1994,10138,9097,1041,10.3
"35006",35,6,1995,10392,9325,1067,10.3
"35006",35,6,1996,10582,9159,1423,13.4
"35006",35,6,1997,10647,9509,1138,10.7
"35006",35,6,1998,11440,10453,987,8.6
"35006",35,6,1999,11138,10264,874,7.8
"35006",35,6,2000,9898,9225,673,6.8
"35006",35,6,2001,10127,9505,622,6.1
"35006",35,6,2002,10868,10171,697,6.4
"35006",35,6,2003,11852,11114,738,6.2
"35006",35,6,2004,12324,11616,708,5.7
"35006",35,6,2005,12217,11538,679,5.6
"35006",35,6,2006,12093,11542,551,4.6
"35006",35,6,2007,11968,11463,505,4.2
"35006",35,6,2008,12357,11786,571,4.6
"35006",35,6,2009,12336,11492,844,6.8
"35006",35,6,2010,9327,8431,896,9.6
"35006",35,6,2011,9275,8397,878,9.5
"35006",35,6,2012,9290,8493,797,8.6
"35006",35,6,2013,9105,8330,775,8.5
"35006",35,6,2014,9072,8295,777,8.6
"35006",35,6,2015,9228,8491,737,8
"35006",35,6,2016,9222,8465,757,8.2
"35006",35,6,2017,9081,8368,713,7.9
"35007",35,7,1990,6105,5534,571,9.4
"35007",35,7,1991,5984,5419,565,9.4
"35007",35,7,1992,6178,5589,589,9.5
"35007",35,7,1993,6337,5850,487,7.7
"35007",35,7,1994,6584,6115,469,7.1
"35007",35,7,1995,6468,5953,515,8
"35007",35,7,1996,6474,5736,738,11.4
"35007",35,7,1997,6390,5912,478,7.5
"35007",35,7,1998,6618,6198,420,6.3
"35007",35,7,1999,6790,6420,370,5.4
"35007",35,7,2000,6925,6579,346,5
"35007",35,7,2001,6942,6584,358,5.2
"35007",35,7,2002,6953,6577,376,5.4
"35007",35,7,2003,7165,6718,447,6.2
"35007",35,7,2004,6998,6596,402,5.7
"35007",35,7,2005,6825,6466,359,5.3
"35007",35,7,2006,6535,6250,285,4.4
"35007",35,7,2007,6560,6328,232,3.5
"35007",35,7,2008,6623,6332,291,4.4
"35007",35,7,2009,6606,6103,503,7.6
"35007",35,7,2010,6363,5830,533,8.4
"35007",35,7,2011,6319,5806,513,8.1
"35007",35,7,2012,6129,5649,480,7.8
"35007",35,7,2013,6173,5735,438,7.1
"35007",35,7,2014,6153,5766,387,6.3
"35007",35,7,2015,6012,5652,360,6
"35007",35,7,2016,5778,5430,348,6
"35007",35,7,2017,5663,5321,342,6
"35009",35,9,1990,17811,16762,1049,5.9
"35009",35,9,1991,18442,17392,1050,5.7
"35009",35,9,1992,19299,18190,1109,5.7
"35009",35,9,1993,19145,18011,1134,5.9
"35009",35,9,1994,19679,18574,1105,5.6
"35009",35,9,1995,19628,18558,1070,5.5
"35009",35,9,1996,20127,18919,1208,6
"35009",35,9,1997,20377,19261,1116,5.5
"35009",35,9,1998,19990,19102,888,4.4
"35009",35,9,1999,19743,18931,812,4.1
"35009",35,9,2000,18616,17753,863,4.6
"35009",35,9,2001,18893,18083,810,4.3
"35009",35,9,2002,19418,18495,923,4.8
"35009",35,9,2003,20001,19112,889,4.4
"35009",35,9,2004,20313,19452,861,4.2
"35009",35,9,2005,20728,19868,860,4.1
"35009",35,9,2006,20954,20234,720,3.4
"35009",35,9,2007,20964,20368,596,2.8
"35009",35,9,2008,21017,20352,665,3.2
"35009",35,9,2009,21360,20395,965,4.5
"35009",35,9,2010,21586,20428,1158,5.4
"35009",35,9,2011,21478,20388,1090,5.1
"35009",35,9,2012,21579,20510,1069,5
"35009",35,9,2013,21427,20330,1097,5.1
"35009",35,9,2014,21696,20596,1100,5.1
"35009",35,9,2015,21806,20743,1063,4.9
"35009",35,9,2016,21777,20675,1102,5.1
"35009",35,9,2017,22018,20952,1066,4.8
"35011",35,11,1990,909,863,46,5.1
"35011",35,11,1991,923,854,69,7.5
"35011",35,11,1992,910,849,61,6.7
"35011",35,11,1993,939,885,54,5.8
"35011",35,11,1994,891,861,30,3.4
"35011",35,11,1995,892,863,29,3.3
"35011",35,11,1996,954,909,45,4.7
"35011",35,11,1997,949,909,40,4.2
"35011",35,11,1998,1033,975,58,5.6
"35011",35,11,1999,1025,982,43,4.2
"35011",35,11,2000,957,912,45,4.7
"35011",35,11,2001,963,915,48,5
"35011",35,11,2002,885,840,45,5.1
"35011",35,11,2003,905,833,72,8
"35011",35,11,2004,918,855,63,6.9
"35011",35,11,2005,835,787,48,5.7
"35011",35,11,2006,808,774,34,4.2
"35011",35,11,2007,779,749,30,3.9
"35011",35,11,2008,806,773,33,4.1
"35011",35,11,2009,829,786,43,5.2
"35011",35,11,2010,833,783,50,6
"35011",35,11,2011,818,776,42,5.1
"35011",35,11,2012,822,787,35,4.3
"35011",35,11,2013,809,772,37,4.6
"35011",35,11,2014,841,801,40,4.8
"35011",35,11,2015,847,804,43,5.1
"35011",35,11,2016,825,786,39,4.7
"35011",35,11,2017,840,802,38,4.5
"35013",35,13,1990,60301,55581,4720,7.8
"35013",35,13,1991,60078,55179,4899,8.2
"35013",35,13,1992,61379,56468,4911,8
"35013",35,13,1993,62033,57232,4801,7.7
"35013",35,13,1994,62921,57357,5564,8.8
"35013",35,13,1995,64596,58817,5779,8.9
"35013",35,13,1996,66304,60079,6225,9.4
"35013",35,13,1997,67107,61338,5769,8.6
"35013",35,13,1998,68455,62712,5743,8.4
"35013",35,13,1999,70860,65269,5591,7.9
"35013",35,13,2000,75909,71282,4627,6.1
"35013",35,13,2001,76778,72121,4657,6.1
"35013",35,13,2002,79390,74431,4959,6.2
"35013",35,13,2003,81929,76633,5296,6.5
"35013",35,13,2004,82582,77517,5065,6.1
"35013",35,13,2005,85089,80297,4792,5.6
"35013",35,13,2006,85792,81800,3992,4.7
"35013",35,13,2007,86938,83322,3616,4.2
"35013",35,13,2008,88893,84680,4213,4.7
"35013",35,13,2009,90210,83592,6618,7.3
"35013",35,13,2010,93597,86337,7260,7.8
"35013",35,13,2011,93392,86338,7054,7.6
"35013",35,13,2012,93767,86906,6861,7.3
"35013",35,13,2013,93721,86715,7006,7.5
"35013",35,13,2014,93976,87120,6856,7.3
"35013",35,13,2015,93919,87061,6858,7.3
"35013",35,13,2016,94788,87987,6801,7.2
"35013",35,13,2017,93805,87360,6445,6.9
"35015",35,15,1990,21599,20156,1443,6.7
"35015",35,15,1991,22579,21062,1517,6.7
"35015",35,15,1992,23135,21357,1778,7.7
"35015",35,15,1993,23365,21343,2022,8.7
"35015",35,15,1994,23600,21474,2126,9
"35015",35,15,1995,22953,21095,1858,8.1
"35015",35,15,1996,23051,21349,1702,7.4
"35015",35,15,1997,23658,22169,1489,6.3
"35015",35,15,1998,24368,22704,1664,6.8
"35015",35,15,1999,23988,22069,1919,8
"35015",35,15,2000,23109,21806,1303,5.6
"35015",35,15,2001,23404,22238,1166,5
"35015",35,15,2002,23970,22566,1404,5.9
"35015",35,15,2003,24205,22767,1438,5.9
"35015",35,15,2004,24193,22865,1328,5.5
"35015",35,15,2005,24586,23453,1133,4.6
"35015",35,15,2006,25144,24252,892,3.5
"35015",35,15,2007,26054,25280,774,3
"35015",35,15,2008,27311,26480,831,3
"35015",35,15,2009,28005,26361,1644,5.9
"35015",35,15,2010,25658,24015,1643,6.4
"35015",35,15,2011,26492,25144,1348,5.1
"35015",35,15,2012,26831,25576,1255,4.7
"35015",35,15,2013,27668,26399,1269,4.6
"35015",35,15,2014,29052,27764,1288,4.4
"35015",35,15,2015,29685,28226,1459,4.9
"35015",35,15,2016,28441,26590,1851,6.5
"35015",35,15,2017,28871,27348,1523,5.3
"35017",35,17,1990,11543,10508,1035,9
"35017",35,17,1991,11311,10392,919,8.1
"35017",35,17,1992,11221,9979,1242,11.1
"35017",35,17,1993,11512,10532,980,8.5
"35017",35,17,1994,11816,10928,888,7.5
"35017",35,17,1995,12229,11308,921,7.5
"35017",35,17,1996,12858,11926,932,7.2
"35017",35,17,1997,13069,12199,870,6.7
"35017",35,17,1998,13077,12188,889,6.8
"35017",35,17,1999,12830,11740,1090,8.5
"35017",35,17,2000,12764,12026,738,5.8
"35017",35,17,2001,13016,12199,817,6.3
"35017",35,17,2002,12745,11483,1262,9.9
"35017",35,17,2003,11934,10718,1216,10.2
"35017",35,17,2004,11866,10875,991,8.4
"35017",35,17,2005,11998,11283,715,6
"35017",35,17,2006,12231,11709,522,4.3
"35017",35,17,2007,12230,11762,468,3.8
"35017",35,17,2008,12374,11761,613,5
"35017",35,17,2009,11840,10327,1513,12.8
"35017",35,17,2010,12349,11156,1193,9.7
"35017",35,17,2011,12775,11845,930,7.3
"35017",35,17,2012,13006,12141,865,6.7
"35017",35,17,2013,12842,11973,869,6.8
"35017",35,17,2014,12521,11694,827,6.6
"35017",35,17,2015,12417,11614,803,6.5
"35017",35,17,2016,12353,11556,797,6.5
"35017",35,17,2017,12154,11405,749,6.2
"35019",35,19,1990,1739,1531,208,12
"35019",35,19,1991,1792,1596,196,10.9
"35019",35,19,1992,1774,1559,215,12.1
"35019",35,19,1993,1817,1600,217,11.9
"35019",35,19,1994,1987,1758,229,11.5
"35019",35,19,1995,1899,1681,218,11.5
"35019",35,19,1996,1877,1641,236,12.6
"35019",35,19,1997,1925,1697,228,11.8
"35019",35,19,1998,1885,1696,189,10
"35019",35,19,1999,1882,1730,152,8.1
"35019",35,19,2000,1780,1651,129,7.2
"35019",35,19,2001,1668,1537,131,7.9
"35019",35,19,2002,1709,1577,132,7.7
"35019",35,19,2003,1671,1541,130,7.8
"35019",35,19,2004,1697,1580,117,6.9
"35019",35,19,2005,1730,1602,128,7.4
"35019",35,19,2006,1866,1767,99,5.3
"35019",35,19,2007,1791,1686,105,5.9
"35019",35,19,2008,1727,1621,106,6.1
"35019",35,19,2009,1782,1642,140,7.9
"35019",35,19,2010,1652,1485,167,10.1
"35019",35,19,2011,1656,1481,175,10.6
"35019",35,19,2012,1646,1481,165,10
"35019",35,19,2013,1632,1490,142,8.7
"35019",35,19,2014,1615,1491,124,7.7
"35019",35,19,2015,1627,1512,115,7.1
"35019",35,19,2016,1676,1568,108,6.4
"35019",35,19,2017,1636,1531,105,6.4
"35021",35,21,1990,457,416,41,9
"35021",35,21,1991,463,435,28,6
"35021",35,21,1992,458,435,23,5
"35021",35,21,1993,459,437,22,4.8
"35021",35,21,1994,443,413,30,6.8
"35021",35,21,1995,446,421,25,5.6
"35021",35,21,1996,444,425,19,4.3
"35021",35,21,1997,464,435,29,6.3
"35021",35,21,1998,440,416,24,5.5
"35021",35,21,1999,427,413,14,3.3
"35021",35,21,2000,412,395,17,4.1
"35021",35,21,2001,393,376,17,4.3
"35021",35,21,2002,421,404,17,4
"35021",35,21,2003,437,413,24,5.5
"35021",35,21,2004,388,368,20,5.2
"35021",35,21,2005,379,363,16,4.2
"35021",35,21,2006,364,349,15,4.1
"35021",35,21,2007,389,378,11,2.8
"35021",35,21,2008,398,386,12,3
"35021",35,21,2009,387,368,19,4.9
"35021",35,21,2010,295,277,18,6.1
"35021",35,21,2011,297,278,19,6.4
"35021",35,21,2012,293,274,19,6.5
"35021",35,21,2013,284,269,15,5.3
"35021",35,21,2014,318,302,16,5
"35021",35,21,2015,284,260,24,8.5
"35021",35,21,2016,275,256,19,6.9
"35021",35,21,2017,275,257,18,6.5
"35023",35,23,1990,2597,2425,172,6.6
"35023",35,23,1991,2681,2548,133,5
"35023",35,23,1992,2747,2590,157,5.7
"35023",35,23,1993,2861,2690,171,6
"35023",35,23,1994,3285,3080,205,6.2
"35023",35,23,1995,2710,2567,143,5.3
"35023",35,23,1996,2615,2461,154,5.9
"35023",35,23,1997,2601,2484,117,4.5
"35023",35,23,1998,2665,2529,136,5.1
"35023",35,23,1999,2501,2262,239,9.6
"35023",35,23,2000,2614,2436,178,6.8
"35023",35,23,2001,2568,2414,154,6
"35023",35,23,2002,2391,2284,107,4.5
"35023",35,23,2003,2392,2270,122,5.1
"35023",35,23,2004,2380,2241,139,5.8
"35023",35,23,2005,2451,2329,122,5
"35023",35,23,2006,2436,2349,87,3.6
"35023",35,23,2007,2518,2442,76,3
"35023",35,23,2008,2620,2507,113,4.3
"35023",35,23,2009,2679,2459,220,8.2
"35023",35,23,2010,2300,2105,195,8.5
"35023",35,23,2011,2285,2112,173,7.6
"35023",35,23,2012,2338,2166,172,7.4
"35023",35,23,2013,2174,2010,164,7.5
"35023",35,23,2014,2148,1995,153,7.1
"35023",35,23,2015,2127,1995,132,6.2
"35023",35,23,2016,2183,2062,121,5.5
"35023",35,23,2017,2107,1998,109,5.2
"35025",35,25,1990,23742,22617,1125,4.7
"35025",35,25,1991,24147,23041,1106,4.6
"35025",35,25,1992,24655,23059,1596,6.5
"35025",35,25,1993,24565,23200,1365,5.6
"35025",35,25,1994,24191,22467,1724,7.1
"35025",35,25,1995,24163,22794,1369,5.7
"35025",35,25,1996,24473,23016,1457,6
"35025",35,25,1997,24992,23795,1197,4.8
"35025",35,25,1998,25085,23652,1433,5.7
"35025",35,25,1999,24462,22200,2262,9.2
"35025",35,25,2000,22489,21315,1174,5.2
"35025",35,25,2001,23600,22590,1010,4.3
"35025",35,25,2002,23382,22121,1261,5.4
"35025",35,25,2003,23972,22718,1254,5.2
"35025",35,25,2004,24519,23356,1163,4.7
"35025",35,25,2005,25780,24721,1059,4.1
"35025",35,25,2006,26605,25780,825,3.1
"35025",35,25,2007,27686,26999,687,2.5
"35025",35,25,2008,29278,28442,836,2.9
"35025",35,25,2009,28329,26092,2237,7.9
"35025",35,25,2010,26301,24223,2078,7.9
"35025",35,25,2011,27249,25729,1520,5.6
"35025",35,25,2012,28325,26988,1337,4.7
"35025",35,25,2013,29310,27998,1312,4.5
"35025",35,25,2014,30719,29369,1350,4.4
"35025",35,25,2015,29783,27941,1842,6.2
"35025",35,25,2016,27500,24962,2538,9.2
"35025",35,25,2017,27554,25744,1810,6.6
"35027",35,27,1990,6022,5673,349,5.8
"35027",35,27,1991,6166,5727,439,7.1
"35027",35,27,1992,6436,5982,454,7.1
"35027",35,27,1993,6577,6197,380,5.8
"35027",35,27,1994,7041,6629,412,5.9
"35027",35,27,1995,6933,6302,631,9.1
"35027",35,27,1996,6892,6334,558,8.1
"35027",35,27,1997,7268,6815,453,6.2
"35027",35,27,1998,7598,7237,361,4.8
"35027",35,27,1999,7566,7256,310,4.1
"35027",35,27,2000,9584,9180,404,4.2
"35027",35,27,2001,9733,9322,411,4.2
"35027",35,27,2002,10312,9894,418,4.1
"35027",35,27,2003,10867,10402,465,4.3
"35027",35,27,2004,11056,10593,463,4.2
"35027",35,27,2005,10809,10328,481,4.4
"35027",35,27,2006,10506,10097,409,3.9
"35027",35,27,2007,10883,10547,336,3.1
"35027",35,27,2008,11049,10657,392,3.5
"35027",35,27,2009,10885,10249,636,5.8
"35027",35,27,2010,9386,8682,704,7.5
"35027",35,27,2011,9110,8493,617,6.8
"35027",35,27,2012,8964,8379,585,6.5
"35027",35,27,2013,8804,8237,567,6.4
"35027",35,27,2014,8808,8278,530,6
"35027",35,27,2015,8655,8157,498,5.8
"35027",35,27,2016,8566,8056,510,6
"35027",35,27,2017,8657,8179,478,5.5
"35028",35,28,1990,10832,10668,164,1.5
"35028",35,28,1991,10880,10721,159,1.5
"35028",35,28,1992,10913,10754,159,1.5
"35028",35,28,1993,11098,10969,129,1.2
"35028",35,28,1994,10953,10816,137,1.3
"35028",35,28,1995,10849,10623,226,2.1
"35028",35,28,1996,10426,10135,291,2.8
"35028",35,28,1997,10254,10071,183,1.8
"35028",35,28,1998,10377,10190,187,1.8
"35028",35,28,1999,10385,10224,161,1.6
"35028",35,28,2000,10431,10113,318,3
"35028",35,28,2001,10355,10089,266,2.6
"35028",35,28,2002,10923,10665,258,2.4
"35028",35,28,2003,11331,11028,303,2.7
"35028",35,28,2004,11461,11153,308,2.7
"35028",35,28,2005,11523,11212,311,2.7
"35028",35,28,2006,11107,10839,268,2.4
"35028",35,28,2007,10485,10257,228,2.2
"35028",35,28,2008,9998,9698,300,3
"35028",35,28,2009,9889,9567,322,3.3
"35028",35,28,2010,9460,9113,347,3.7
"35028",35,28,2011,9277,8949,328,3.5
"35028",35,28,2012,8999,8649,350,3.9
"35028",35,28,2013,8621,8257,364,4.2
"35028",35,28,2014,8461,8112,349,4.1
"35028",35,28,2015,8466,8125,341,4
"35028",35,28,2016,8719,8349,370,4.2
"35028",35,28,2017,9056,8715,341,3.8
"35029",35,29,1990,7554,6583,971,12.9
"35029",35,29,1991,8087,6884,1203,14.9
"35029",35,29,1992,8811,7368,1443,16.4
"35029",35,29,1993,8971,7591,1380,15.4
"35029",35,29,1994,9568,7571,1997,20.9
"35029",35,29,1995,10687,8052,2635,24.7
"35029",35,29,1996,11212,8288,2924,26.1
"35029",35,29,1997,11383,8499,2884,25.3
"35029",35,29,1998,11548,8546,3002,26
"35029",35,29,1999,11307,8651,2656,23.5
"35029",35,29,2000,10664,9011,1653,15.5
"35029",35,29,2001,10704,8932,1772,16.6
"35029",35,29,2002,11171,9495,1676,15
"35029",35,29,2003,12128,10196,1932,15.9
"35029",35,29,2004,12036,10172,1864,15.5
"35029",35,29,2005,12566,10941,1625,12.9
"35029",35,29,2006,12323,10991,1332,10.8
"35029",35,29,2007,12315,11067,1248,10.1
"35029",35,29,2008,12332,10838,1494,12.1
"35029",35,29,2009,12436,10255,2181,17.5
"35029",35,29,2010,11677,9327,2350,20.1
"35029",35,29,2011,11495,9169,2326,20.2
"35029",35,29,2012,11461,9171,2290,20
"35029",35,29,2013,11300,9151,2149,19
"35029",35,29,2014,11374,9316,2058,18.1
"35029",35,29,2015,10993,9092,1901,17.3
"35029",35,29,2016,10690,9137,1553,14.5
"35029",35,29,2017,10454,8979,1475,14.1
"35031",35,31,1990,22719,20837,1882,8.3
"35031",35,31,1991,22841,20712,2129,9.3
"35031",35,31,1992,23553,21656,1897,8.1
"35031",35,31,1993,24397,22712,1685,6.9
"35031",35,31,1994,24653,22547,2106,8.5
"35031",35,31,1995,25064,22886,2178,8.7
"35031",35,31,1996,24781,22325,2456,9.9
"35031",35,31,1997,24655,22481,2174,8.8
"35031",35,31,1998,25337,23277,2060,8.1
"35031",35,31,1999,25295,23514,1781,7
"35031",35,31,2000,24393,22796,1597,6.5
"35031",35,31,2001,24710,23188,1522,6.2
"35031",35,31,2002,25458,23890,1568,6.2
"35031",35,31,2003,26445,24630,1815,6.9
"35031",35,31,2004,26819,24980,1839,6.9
"35031",35,31,2005,26949,25159,1790,6.6
"35031",35,31,2006,26616,25136,1480,5.6
"35031",35,31,2007,26725,25483,1242,4.6
"35031",35,31,2008,26668,25192,1476,5.5
"35031",35,31,2009,27078,24822,2256,8.3
"35031",35,31,2010,25440,22929,2511,9.9
"35031",35,31,2011,24976,22496,2480,9.9
"35031",35,31,2012,24915,22523,2392,9.6
"35031",35,31,2013,24305,21847,2458,10.1
"35031",35,31,2014,23951,21524,2427,10.1
"35031",35,31,2015,24194,21833,2361,9.8
"35031",35,31,2016,24176,21911,2265,9.4
"35031",35,31,2017,24237,22130,2107,8.7
"35033",35,33,1990,1516,1212,304,20.1
"35033",35,33,1991,1552,1163,389,25.1
"35033",35,33,1992,1554,1187,367,23.6
"35033",35,33,1993,1598,1276,322,20.2
"35033",35,33,1994,1667,1344,323,19.4
"35033",35,33,1995,1733,1363,370,21.4
"35033",35,33,1996,1723,1375,348,20.2
"35033",35,33,1997,1724,1382,342,19.8
"35033",35,33,1998,1753,1418,335,19.1
"35033",35,33,1999,1744,1452,292,16.7
"35033",35,33,2000,1955,1750,205,10.5
"35033",35,33,2001,2004,1808,196,9.8
"35033",35,33,2002,2067,1855,212,10.3
"35033",35,33,2003,2113,1886,227,10.7
"35033",35,33,2004,2116,1887,229,10.8
"35033",35,33,2005,2068,1836,232,11.2
"35033",35,33,2006,2005,1830,175,8.7
"35033",35,33,2007,2018,1859,159,7.9
"35033",35,33,2008,2027,1852,175,8.6
"35033",35,33,2009,2045,1783,262,12.8
"35033",35,33,2010,2434,2134,300,12.3
"35033",35,33,2011,2379,2085,294,12.4
"35033",35,33,2012,2316,2061,255,11
"35033",35,33,2013,2254,1991,263,11.7
"35033",35,33,2014,2266,2016,250,11
"35033",35,33,2015,2260,2041,219,9.7
"35033",35,33,2016,2217,2024,193,8.7
"35033",35,33,2017,2184,2012,172,7.9
"35035",35,35,1990,20001,18575,1426,7.1
"35035",35,35,1991,20015,18319,1696,8.5
"35035",35,35,1992,20092,18337,1755,8.7
"35035",35,35,1993,19335,17823,1512,7.8
"35035",35,35,1994,20079,18536,1543,7.7
"35035",35,35,1995,20670,19233,1437,7
"35035",35,35,1996,20924,19200,1724,8.2
"35035",35,35,1997,20907,19433,1474,7.1
"35035",35,35,1998,20419,19203,1216,6
"35035",35,35,1999,20824,19813,1011,4.9
"35035",35,35,2000,24214,22933,1281,5.3
"35035",35,35,2001,24386,23081,1305,5.4
"35035",35,35,2002,24860,23448,1412,5.7
"35035",35,35,2003,25474,23932,1542,6.1
"35035",35,35,2004,26674,25319,1355,5.1
"35035",35,35,2005,26815,25497,1318,4.9
"35035",35,35,2006,26045,24947,1098,4.2
"35035",35,35,2007,25992,25003,989,3.8
"35035",35,35,2008,25888,24753,1135,4.4
"35035",35,35,2009,25939,24189,1750,6.7
"35035",35,35,2010,24984,23170,1814,7.3
"35035",35,35,2011,24688,23004,1684,6.8
"35035",35,35,2012,25049,23419,1630,6.5
"35035",35,35,2013,25244,23635,1609,6.4
"35035",35,35,2014,24754,23204,1550,6.3
"35035",35,35,2015,24895,23357,1538,6.2
"35035",35,35,2016,25253,23723,1530,6.1
"35035",35,35,2017,24778,23265,1513,6.1
"35037",35,37,1990,4937,4584,353,7.2
"35037",35,37,1991,4920,4597,323,6.6
"35037",35,37,1992,4829,4534,295,6.1
"35037",35,37,1993,4906,4620,286,5.8
"35037",35,37,1994,4937,4638,299,6.1
"35037",35,37,1995,4660,4380,280,6
"35037",35,37,1996,4617,4343,274,5.9
"35037",35,37,1997,4568,4290,278,6.1
"35037",35,37,1998,4631,4408,223,4.8
"35037",35,37,1999,4594,4420,174,3.8
"35037",35,37,2000,4413,4196,217,4.9
"35037",35,37,2001,4162,3939,223,5.4
"35037",35,37,2002,4016,3797,219,5.5
"35037",35,37,2003,3973,3712,261,6.6
"35037",35,37,2004,3960,3720,240,6.1
"35037",35,37,2005,3953,3743,210,5.3
"35037",35,37,2006,3942,3760,182,4.6
"35037",35,37,2007,3839,3665,174,4.5
"35037",35,37,2008,3927,3734,193,4.9
"35037",35,37,2009,3960,3691,269,6.8
"35037",35,37,2010,3501,3171,330,9.4
"35037",35,37,2011,3391,3065,326,9.6
"35037",35,37,2012,3389,3115,274,8.1
"35037",35,37,2013,3305,3065,240,7.3
"35037",35,37,2014,3304,3087,217,6.6
"35037",35,37,2015,3257,3026,231,7.1
"35037",35,37,2016,3182,2966,216,6.8
"35037",35,37,2017,3211,3011,200,6.2
"35039",35,39,1990,15384,13289,2095,13.6
"35039",35,39,1991,15818,13510,2308,14.6
"35039",35,39,1992,15458,13117,2341,15.1
"35039",35,39,1993,16131,14122,2009,12.5
"35039",35,39,1994,16948,15088,1860,11
"35039",35,39,1995,17603,15414,2189,12.4
"35039",35,39,1996,18361,15850,2511,13.7
"35039",35,39,1997,18910,16863,2047,10.8
"35039",35,39,1998,19192,17495,1697,8.8
"35039",35,39,1999,19776,18348,1428,7.2
"35039",35,39,2000,18828,17682,1146,6.1
"35039",35,39,2001,19200,18041,1159,6
"35039",35,39,2002,19771,18479,1292,6.5
"35039",35,39,2003,20270,18920,1350,6.7
"35039",35,39,2004,20739,19395,1344,6.5
"35039",35,39,2005,20903,19649,1254,6
"35039",35,39,2006,20700,19670,1030,5
"35039",35,39,2007,20310,19345,965,4.8
"35039",35,39,2008,20475,19358,1117,5.5
"35039",35,39,2009,20196,18656,1540,7.6
"35039",35,39,2010,18005,16358,1647,9.1
"35039",35,39,2011,17254,15654,1600,9.3
"35039",35,39,2012,16860,15291,1569,9.3
"35039",35,39,2013,16644,15053,1591,9.6
"35039",35,39,2014,16514,15065,1449,8.8
"35039",35,39,2015,16522,15199,1323,8
"35039",35,39,2016,16615,15372,1243,7.5
"35039",35,39,2017,16708,15632,1076,6.4
"35041",35,41,1990,7181,6732,449,6.3
"35041",35,41,1991,7312,6892,420,5.7
"35041",35,41,1992,7355,6980,375,5.1
"35041",35,41,1993,6792,6467,325,4.8
"35041",35,41,1994,7654,7267,387,5.1
"35041",35,41,1995,7501,7084,417,5.6
"35041",35,41,1996,7539,7105,434,5.8
"35041",35,41,1997,7504,7181,323,4.3
"35041",35,41,1998,7714,7456,258,3.3
"35041",35,41,1999,7614,7357,257,3.4
"35041",35,41,2000,7978,7628,350,4.4
"35041",35,41,2001,8442,8110,332,3.9
"35041",35,41,2002,9088,8710,378,4.2
"35041",35,41,2003,9382,9010,372,4
"35041",35,41,2004,9481,9133,348,3.7
"35041",35,41,2005,9461,9102,359,3.8
"35041",35,41,2006,9334,9044,290,3.1
"35041",35,41,2007,9512,9244,268,2.8
"35041",35,41,2008,9474,9179,295,3.1
"35041",35,41,2009,9312,8864,448,4.8
"35041",35,41,2010,8409,7883,526,6.3
"35041",35,41,2011,8327,7850,477,5.7
"35041",35,41,2012,8344,7878,466,5.6
"35041",35,41,2013,8342,7877,465,5.6
"35041",35,41,2014,8127,7676,451,5.5
"35041",35,41,2015,8007,7575,432,5.4
"35041",35,41,2016,7996,7540,456,5.7
"35041",35,41,2017,7937,7518,419,5.3
"35043",35,43,1990,29719,28058,1661,5.6
"35043",35,43,1991,30476,28671,1805,5.9
"35043",35,43,1992,31755,30043,1712,5.4
"35043",35,43,1993,33791,31936,1855,5.5
"35043",35,43,1994,36081,34386,1695,4.7
"35043",35,43,1995,38187,36496,1691,4.4
"35043",35,43,1996,40026,38100,1926,4.8
"35043",35,43,1997,41647,39854,1793,4.3
"35043",35,43,1998,43329,41185,2144,4.9
"35043",35,43,1999,44415,42643,1772,4
"35043",35,43,2000,43280,41448,1832,4.2
"35043",35,43,2001,44535,42479,2056,4.6
"35043",35,43,2002,45921,43186,2735,6
"35043",35,43,2003,46855,44021,2834,6
"35043",35,43,2004,48139,45484,2655,5.5
"35043",35,43,2005,50173,47553,2620,5.2
"35043",35,43,2006,52932,50664,2268,4.3
"35043",35,43,2007,54017,51700,2317,4.3
"35043",35,43,2008,55815,52902,2913,5.2
"35043",35,43,2009,56336,51535,4801,8.5
"35043",35,43,2010,60901,55793,5108,8.4
"35043",35,43,2011,60822,55935,4887,8
"35043",35,43,2012,60524,55816,4708,7.8
"35043",35,43,2013,60574,56064,4510,7.4
"35043",35,43,2014,61217,56835,4382,7.2
"35043",35,43,2015,61805,57709,4096,6.6
"35043",35,43,2016,63545,59355,4190,6.6
"35043",35,43,2017,63918,59972,3946,6.2
"35045",35,45,1990,38996,35637,3359,8.6
"35045",35,45,1991,41889,37843,4046,9.7
"35045",35,45,1992,43651,38614,5037,11.5
"35045",35,45,1993,43444,39175,4269,9.8
"35045",35,45,1994,45556,40995,4561,10
"35045",35,45,1995,47814,42779,5035,10.5
"35045",35,45,1996,49115,43404,5711,11.6
"35045",35,45,1997,49781,44880,4901,9.8
"35045",35,45,1998,50467,46387,4080,8.1
"35045",35,45,1999,50052,46290,3762,7.5
"35045",35,45,2000,49296,46477,2819,5.7
"35045",35,45,2001,50484,47780,2704,5.4
"35045",35,45,2002,51233,48081,3152,6.2
"35045",35,45,2003,51719,48244,3475,6.7
"35045",35,45,2004,53051,49938,3113,5.9
"35045",35,45,2005,54461,51561,2900,5.3
"35045",35,45,2006,55362,52987,2375,4.3
"35045",35,45,2007,55637,53758,1879,3.4
"35045",35,45,2008,57112,54864,2248,3.9
"35045",35,45,2009,56398,51952,4446,7.9
"35045",35,45,2010,54860,49713,5147,9.4
"35045",35,45,2011,55028,50701,4327,7.9
"35045",35,45,2012,55309,51384,3925,7.1
"35045",35,45,2013,54546,50846,3700,6.8
"35045",35,45,2014,55332,51799,3533,6.4
"35045",35,45,2015,55383,51574,3809,6.9
"35045",35,45,2016,53764,49042,4722,8.8
"35045",35,45,2017,53194,49349,3845,7.2
"35047",35,47,1990,10974,9830,1144,10.4
"35047",35,47,1991,10890,9650,1240,11.4
"35047",35,47,1992,11098,9861,1237,11.1
"35047",35,47,1993,11583,10558,1025,8.8
"35047",35,47,1994,12189,11249,940,7.7
"35047",35,47,1995,12461,11382,1079,8.7
"35047",35,47,1996,12636,11111,1525,12.1
"35047",35,47,1997,12517,11221,1296,10.4
"35047",35,47,1998,12321,11312,1009,8.2
"35047",35,47,1999,12068,11234,834,6.9
"35047",35,47,2000,12489,11767,722,5.8
"35047",35,47,2001,12706,11943,763,6
"35047",35,47,2002,13381,12550,831,6.2
"35047",35,47,2003,13618,12761,857,6.3
"35047",35,47,2004,13620,12741,879,6.5
"35047",35,47,2005,13377,12552,825,6.2
"35047",35,47,2006,13382,12742,640,4.8
"35047",35,47,2007,13342,12784,558,4.2
"35047",35,47,2008,13314,12655,659,4.9
"35047",35,47,2009,13294,12317,977,7.3
"35047",35,47,2010,11204,10131,1073,9.6
"35047",35,47,2011,11097,10043,1054,9.5
"35047",35,47,2012,11103,10115,988,8.9
"35047",35,47,2013,11093,10166,927,8.4
"35047",35,47,2014,11003,10107,896,8.1
"35047",35,47,2015,11041,10195,846,7.7
"35047",35,47,2016,10994,10148,846,7.7
"35047",35,47,2017,10852,10045,807,7.4
"35049",35,49,1990,55112,53298,1814,3.3
"35049",35,49,1991,57196,55083,2113,3.7
"35049",35,49,1992,59343,56948,2395,4
"35049",35,49,1993,61248,59071,2177,3.6
"35049",35,49,1994,62178,59827,2351,3.8
"35049",35,49,1995,63606,60772,2834,4.5
"35049",35,49,1996,63389,60301,3088,4.9
"35049",35,49,1997,63839,61167,2672,4.2
"35049",35,49,1998,64646,62381,2265,3.5
"35049",35,49,1999,65115,63282,1833,2.8
"35049",35,49,2000,70244,67714,2530,3.6
"35049",35,49,2001,70826,68272,2554,3.6
"35049",35,49,2002,71984,69164,2820,3.9
"35049",35,49,2003,73907,70728,3179,4.3
"35049",35,49,2004,75047,71858,3189,4.2
"35049",35,49,2005,76704,73560,3144,4.1
"35049",35,49,2006,77340,74708,2632,3.4
"35049",35,49,2007,78018,75672,2346,3
"35049",35,49,2008,78172,75237,2935,3.8
"35049",35,49,2009,76501,71479,5022,6.6
"35049",35,49,2010,74289,69245,5044,6.8
"35049",35,49,2011,73631,69047,4584,6.2
"35049",35,49,2012,73658,69401,4257,5.8
"35049",35,49,2013,73219,69131,4088,5.6
"35049",35,49,2014,72660,68704,3956,5.4
"35049",35,49,2015,72865,68976,3889,5.3
"35049",35,49,2016,72855,68999,3856,5.3
"35049",35,49,2017,72851,69133,3718,5.1
"35051",35,51,1990,3463,3316,147,4.2
"35051",35,51,1991,3410,3210,200,5.9
"35051",35,51,1992,3498,3303,195,5.6
"35051",35,51,1993,3626,3454,172,4.7
"35051",35,51,1994,3536,3346,190,5.4
"35051",35,51,1995,3713,3539,174,4.7
"35051",35,51,1996,4001,3829,172,4.3
"35051",35,51,1997,4312,4154,158,3.7
"35051",35,51,1998,4434,4264,170,3.8
"35051",35,51,1999,4144,4013,131,3.2
"35051",35,51,2000,5255,5024,231,4.4
"35051",35,51,2001,5344,5093,251,4.7
"35051",35,51,2002,5370,5081,289,5.4
"35051",35,51,2003,5338,5043,295,5.5
"35051",35,51,2004,5365,5064,301,5.6
"35051",35,51,2005,5452,5160,292,5.4
"35051",35,51,2006,5417,5178,239,4.4
"35051",35,51,2007,5545,5349,196,3.5
"35051",35,51,2008,5893,5654,239,4.1
"35051",35,51,2009,5962,5618,344,5.8
"35051",35,51,2010,4026,3656,370,9.2
"35051",35,51,2011,3888,3505,383,9.9
"35051",35,51,2012,3973,3583,390,9.8
"35051",35,51,2013,3989,3600,389,9.8
"35051",35,51,2014,3951,3588,363,9.2
"35051",35,51,2015,4011,3647,364,9.1
"35051",35,51,2016,4027,3686,341,8.5
"35051",35,51,2017,4094,3770,324,7.9
"35053",35,53,1990,6670,6174,496,7.4
"35053",35,53,1991,6638,6137,501,7.5
"35053",35,53,1992,6868,6291,577,8.4
"35053",35,53,1993,6385,5806,579,9.1
"35053",35,53,1994,6418,5888,530,8.3
"35053",35,53,1995,6563,6020,543,8.3
"35053",35,53,1996,6488,5978,510,7.9
"35053",35,53,1997,6464,6018,446,6.9
"35053",35,53,1998,6477,6068,409,6.3
"35053",35,53,1999,6473,6135,338,5.2
"35053",35,53,2000,7908,7510,398,5
"35053",35,53,2001,8162,7735,427,5.2
"35053",35,53,2002,8541,8109,432,5.1
"35053",35,53,2003,8761,8321,440,5
"35053",35,53,2004,8934,8506,428,4.8
"35053",35,53,2005,9360,8944,416,4.4
"35053",35,53,2006,9286,8944,342,3.7
"35053",35,53,2007,9350,9050,300,3.2
"35053",35,53,2008,9512,9174,338,3.6
"35053",35,53,2009,9467,8969,498,5.3
"35053",35,53,2010,6876,6340,536,7.8
"35053",35,53,2011,6841,6318,523,7.6
"35053",35,53,2012,6819,6343,476,7
"35053",35,53,2013,6612,6124,488,7.4
"35053",35,53,2014,6478,6001,477,7.4
"35053",35,53,2015,6510,6019,491,7.5
"35053",35,53,2016,6622,6136,486,7.3
"35053",35,53,2017,6490,6066,424,6.5
"35055",35,55,1990,11172,9465,1707,15.3
"35055",35,55,1991,11910,9973,1937,16.3
"35055",35,55,1992,12157,9951,2206,18.1
"35055",35,55,1993,12109,10337,1772,14.6
"35055",35,55,1994,12612,10782,1830,14.5
"35055",35,55,1995,13048,11017,2031,15.6
"35055",35,55,1996,13356,11167,2189,16.4
"35055",35,55,1997,13395,11435,1960,14.6
"35055",35,55,1998,13484,11851,1633,12.1
"35055",35,55,1999,13063,11563,1500,11.5
"35055",35,55,2000,15479,14440,1039,6.7
"35055",35,55,2001,15794,14748,1046,6.6
"35055",35,55,2002,16937,15811,1126,6.6
"35055",35,55,2003,17251,15998,1253,7.3
"35055",35,55,2004,17190,15953,1237,7.2
"35055",35,55,2005,17422,16263,1159,6.7
"35055",35,55,2006,17618,16650,968,5.5
"35055",35,55,2007,17745,16877,868,4.9
"35055",35,55,2008,17647,16681,966,5.5
"35055",35,55,2009,17592,16034,1558,8.9
"35055",35,55,2010,15398,13757,1641,10.7
"35055",35,55,2011,15172,13580,1592,10.5
"35055",35,55,2012,15003,13434,1569,10.5
"35055",35,55,2013,15047,13493,1554,10.3
"35055",35,55,2014,15035,13545,1490,9.9
"35055",35,55,2015,14850,13492,1358,9.1
"35055",35,55,2016,14813,13564,1249,8.4
"35055",35,55,2017,14979,13790,1189,7.9
"35057",35,57,1990,4286,3957,329,7.7
"35057",35,57,1991,4503,4141,362,8
"35057",35,57,1992,4712,4235,477,10.1
"35057",35,57,1993,4579,4195,384,8.4
"35057",35,57,1994,5031,4698,333,6.6
"35057",35,57,1995,5248,4874,374,7.1
"35057",35,57,1996,5724,5276,448,7.8
"35057",35,57,1997,5967,5567,400,6.7
"35057",35,57,1998,6387,6048,339,5.3
"35057",35,57,1999,6531,6218,313,4.8
"35057",35,57,2000,7528,7154,374,5
"35057",35,57,2001,7406,7075,331,4.5
"35057",35,57,2002,7312,6950,362,5
"35057",35,57,2003,7490,7072,418,5.6
"35057",35,57,2004,7640,7210,430,5.6
"35057",35,57,2005,7606,7188,418,5.5
"35057",35,57,2006,7584,7255,329,4.3
"35057",35,57,2007,7086,6757,329,4.6
"35057",35,57,2008,6916,6532,384,5.6
"35057",35,57,2009,6905,6255,650,9.4
"35057",35,57,2010,6028,5331,697,11.6
"35057",35,57,2011,5875,5202,673,11.5
"35057",35,57,2012,5764,5152,612,10.6
"35057",35,57,2013,5597,5025,572,10.2
"35057",35,57,2014,5574,5028,546,9.8
"35057",35,57,2015,5441,4950,491,9
"35057",35,57,2016,5461,4963,498,9.1
"35057",35,57,2017,5484,5010,474,8.6
"35059",35,59,1990,1879,1792,87,4.6
"35059",35,59,1991,1843,1765,78,4.2
"35059",35,59,1992,1852,1768,84,4.5
"35059",35,59,1993,1882,1815,67,3.6
"35059",35,59,1994,1982,1895,87,4.4
"35059",35,59,1995,1917,1835,82,4.3
"35059",35,59,1996,1924,1837,87,4.5
"35059",35,59,1997,1969,1878,91,4.6
"35059",35,59,1998,2024,1943,81,4
"35059",35,59,1999,2033,1980,53,2.6
"35059",35,59,2000,2046,1970,76,3.7
"35059",35,59,2001,2038,1967,71,3.5
"35059",35,59,2002,2007,1934,73,3.6
"35059",35,59,2003,2009,1932,77,3.8
"35059",35,59,2004,1946,1875,71,3.6
"35059",35,59,2005,1925,1856,69,3.6
"35059",35,59,2006,1899,1842,57,3
"35059",35,59,2007,1874,1823,51,2.7
"35059",35,59,2008,1949,1892,57,2.9
"35059",35,59,2009,1926,1819,107,5.6
"35059",35,59,2010,1930,1809,121,6.3
"35059",35,59,2011,1941,1850,91,4.7
"35059",35,59,2012,1872,1790,82,4.4
"35059",35,59,2013,1865,1779,86,4.6
"35059",35,59,2014,1902,1815,87,4.6
"35059",35,59,2015,1884,1802,82,4.4
"35059",35,59,2016,1877,1802,75,4
"35059",35,59,2017,1870,1799,71,3.8
"35061",35,61,1990,19830,18574,1256,6.3
"35061",35,61,1991,20192,18840,1352,6.7
"35061",35,61,1992,20817,19614,1203,5.8
"35061",35,61,1993,22327,20955,1372,6.1
"35061",35,61,1994,23721,22584,1137,4.8
"35061",35,61,1995,25576,24387,1189,4.6
"35061",35,61,1996,26892,25644,1248,4.6
"35061",35,61,1997,28421,27112,1309,4.6
"35061",35,61,1998,29243,27754,1489,5.1
"35061",35,61,1999,29894,28596,1298,4.3
"35061",35,61,2000,29942,28552,1390,4.6
"35061",35,61,2001,30461,29000,1461,4.8
"35061",35,61,2002,30596,28890,1706,5.6
"35061",35,61,2003,30518,28696,1822,6
"35061",35,61,2004,30422,28731,1691,5.6
"35061",35,61,2005,30700,29068,1632,5.3
"35061",35,61,2006,30991,29661,1330,4.3
"35061",35,61,2007,30827,29620,1207,3.9
"35061",35,61,2008,31141,29556,1585,5.1
"35061",35,61,2009,30858,28223,2635,8.5
"35061",35,61,2010,31167,28187,2980,9.6
"35061",35,61,2011,30667,27909,2758,9
"35061",35,61,2012,30216,27595,2621,8.7
"35061",35,61,2013,29884,27388,2496,8.4
"35061",35,61,2014,29576,27249,2327,7.9
"35061",35,61,2015,29529,27335,2194,7.4
"35061",35,61,2016,29658,27519,2139,7.2
"35061",35,61,2017,29846,27857,1989,6.7
"36001",36,1,1990,158085,153397,4688,3
"36001",36,1,1991,158008,150537,7471,4.7
"36001",36,1,1992,156841,149015,7826,5
"36001",36,1,1993,156673,150059,6614,4.2
"36001",36,1,1994,157265,150806,6459,4.1
"36001",36,1,1995,158199,151616,6583,4.2
"36001",36,1,1996,156990,151137,5853,3.7
"36001",36,1,1997,159416,154115,5301,3.3
"36001",36,1,1998,159832,155062,4770,3
"36001",36,1,1999,158761,154244,4517,2.8
"36001",36,1,2000,153997,148813,5184,3.4
"36001",36,1,2001,154732,149564,5168,3.3
"36001",36,1,2002,157694,151536,6158,3.9
"36001",36,1,2003,157860,151200,6660,4.2
"36001",36,1,2004,158668,152045,6623,4.2
"36001",36,1,2005,159258,153040,6218,3.9
"36001",36,1,2006,159472,153385,6087,3.8
"36001",36,1,2007,158712,152567,6145,3.9
"36001",36,1,2008,160552,152756,7796,4.9
"36001",36,1,2009,158937,148183,10754,6.8
"36001",36,1,2010,161511,150264,11247,7
"36001",36,1,2011,158289,147330,10959,6.9
"36001",36,1,2012,160657,149260,11397,7.1
"36001",36,1,2013,160805,151059,9746,6.1
"36001",36,1,2014,157958,150241,7717,4.9
"36001",36,1,2015,159383,152461,6922,4.3
"36001",36,1,2016,159525,153060,6465,4.1
"36001",36,1,2017,159950,153134,6816,4.3
"36003",36,3,1990,22425,20941,1484,6.6
"36003",36,3,1991,23020,21159,1861,8.1
"36003",36,3,1992,23075,20864,2211,9.6
"36003",36,3,1993,22820,20857,1963,8.6
"36003",36,3,1994,22814,20908,1906,8.4
"36003",36,3,1995,23092,21314,1778,7.7
"36003",36,3,1996,23395,21627,1768,7.6
"36003",36,3,1997,23617,21688,1929,8.2
"36003",36,3,1998,23715,21944,1771,7.5
"36003",36,3,1999,23485,21709,1776,7.6
"36003",36,3,2000,22659,21544,1115,4.9
"36003",36,3,2001,22998,21908,1090,4.7
"36003",36,3,2002,23449,22192,1257,5.4
"36003",36,3,2003,23399,21881,1518,6.5
"36003",36,3,2004,23578,22071,1507,6.4
"36003",36,3,2005,23532,22163,1369,5.8
"36003",36,3,2006,23521,22306,1215,5.2
"36003",36,3,2007,23405,22129,1276,5.5
"36003",36,3,2008,24123,22578,1545,6.4
"36003",36,3,2009,23898,21816,2082,8.7
"36003",36,3,2010,24240,22022,2218,9.2
"36003",36,3,2011,23657,21545,2112,8.9
"36003",36,3,2012,23691,21697,1994,8.4
"36003",36,3,2013,23799,22014,1785,7.5
"36003",36,3,2014,23425,21969,1456,6.2
"36003",36,3,2015,20458,19129,1329,6.5
"36003",36,3,2016,20190,18916,1274,6.3
"36003",36,3,2017,19858,18527,1331,6.7
"36005",36,5,1990,459622,420747,38875,8.5
"36005",36,5,1991,451489,404393,47096,10.4
"36005",36,5,1992,456018,396095,59923,13.1
"36005",36,5,1993,452438,397202,55236,12.2
"36005",36,5,1994,446085,400767,45318,10.2
"36005",36,5,1995,446818,403992,42826,9.6
"36005",36,5,1996,459879,411234,48645,10.6
"36005",36,5,1997,478198,422168,56030,11.7
"36005",36,5,1998,481396,433618,47778,9.9
"36005",36,5,1999,484477,444968,39509,8.2
"36005",36,5,2000,486621,452036,34585,7.1
"36005",36,5,2001,488643,453138,35505,7.3
"36005",36,5,2002,496904,448504,48400,9.7
"36005",36,5,2003,497689,444901,52788,10.6
"36005",36,5,2004,502064,455837,46227,9.2
"36005",36,5,2005,507229,468809,38420,7.6
"36005",36,5,2006,505378,471748,33630,6.7
"36005",36,5,2007,512479,477487,34992,6.8
"36005",36,5,2008,523746,484145,39601,7.6
"36005",36,5,2009,533866,469624,64242,12
"36005",36,5,2010,582287,512477,69810,12
"36005",36,5,2011,584353,514635,69718,11.9
"36005",36,5,2012,594943,520987,73956,12.4
"36005",36,5,2013,603461,532428,71033,11.8
"36005",36,5,2014,609078,549442,59636,9.8
"36005",36,5,2015,613190,565512,47678,7.8
"36005",36,5,2016,618922,574972,43950,7.1
"36005",36,5,2017,621649,583116,38533,6.2
"36007",36,7,1990,105259,100804,4455,4.2
"36007",36,7,1991,105057,98910,6147,5.9
"36007",36,7,1992,104576,97542,7034,6.7
"36007",36,7,1993,103482,96354,7128,6.9
"36007",36,7,1994,101695,94907,6788,6.7
"36007",36,7,1995,98473,93242,5231,5.3
"36007",36,7,1996,96790,92555,4235,4.4
"36007",36,7,1997,99774,95539,4235,4.2
"36007",36,7,1998,99353,95345,4008,4
"36007",36,7,1999,99076,95018,4058,4.1
"36007",36,7,2000,97734,94155,3579,3.7
"36007",36,7,2001,98088,93925,4163,4.2
"36007",36,7,2002,98781,93088,5693,5.8
"36007",36,7,2003,96722,91138,5584,5.8
"36007",36,7,2004,96283,91075,5208,5.4
"36007",36,7,2005,96287,91585,4702,4.9
"36007",36,7,2006,96998,92545,4453,4.6
"36007",36,7,2007,96858,92549,4309,4.4
"36007",36,7,2008,98160,92690,5470,5.6
"36007",36,7,2009,97500,89553,7947,8.2
"36007",36,7,2010,97844,89316,8528,8.7
"36007",36,7,2011,94727,86579,8148,8.6
"36007",36,7,2012,94012,85835,8177,8.7
"36007",36,7,2013,91934,84779,7155,7.8
"36007",36,7,2014,88379,82515,5864,6.6
"36007",36,7,2015,87272,82072,5200,6
"36007",36,7,2016,86448,81757,4691,5.4
"36007",36,7,2017,85835,81016,4819,5.6
"36009",36,9,1990,39066,36555,2511,6.4
"36009",36,9,1991,39812,36220,3592,9
"36009",36,9,1992,39490,35560,3930,10
"36009",36,9,1993,38779,35360,3419,8.8
"36009",36,9,1994,39849,36557,3292,8.3
"36009",36,9,1995,39575,36577,2998,7.6
"36009",36,9,1996,41119,38234,2885,7
"36009",36,9,1997,42405,39371,3034,7.2
"36009",36,9,1998,41710,38700,3010,7.2
"36009",36,9,1999,41635,38686,2949,7.1
"36009",36,9,2000,40867,39002,1865,4.6
"36009",36,9,2001,41021,38959,2062,5
"36009",36,9,2002,41755,39427,2328,5.6
"36009",36,9,2003,42157,39725,2432,5.8
"36009",36,9,2004,42270,39740,2530,6
"36009",36,9,2005,42123,39858,2265,5.4
"36009",36,9,2006,41925,39788,2137,5.1
"36009",36,9,2007,41269,39164,2105,5.1
"36009",36,9,2008,41766,39222,2544,6.1
"36009",36,9,2009,41668,38079,3589,8.6
"36009",36,9,2010,39654,35881,3773,9.5
"36009",36,9,2011,38540,34943,3597,9.3
"36009",36,9,2012,38308,34733,3575,9.3
"36009",36,9,2013,38100,34851,3249,8.5
"36009",36,9,2014,36786,34212,2574,7
"36009",36,9,2015,35412,33189,2223,6.3
"36009",36,9,2016,35088,32995,2093,6
"36009",36,9,2017,34668,32502,2166,6.2
"36011",36,11,1990,39207,36805,2402,6.1
"36011",36,11,1991,39248,35991,3257,8.3
"36011",36,11,1992,38626,35547,3079,8
"36011",36,11,1993,38125,35469,2656,7
"36011",36,11,1994,37758,35396,2362,6.3
"36011",36,11,1995,37695,35341,2354,6.2
"36011",36,11,1996,38000,35842,2158,5.7
"36011",36,11,1997,38579,36321,2258,5.9
"36011",36,11,1998,38750,36730,2020,5.2
"36011",36,11,1999,38473,36510,1963,5.1
"36011",36,11,2000,40194,38613,1581,3.9
"36011",36,11,2001,39912,38209,1703,4.3
"36011",36,11,2002,41229,39259,1970,4.8
"36011",36,11,2003,41387,39221,2166,5.2
"36011",36,11,2004,41754,39618,2136,5.1
"36011",36,11,2005,41868,39835,2033,4.9
"36011",36,11,2006,41499,39566,1933,4.7
"36011",36,11,2007,41137,39312,1825,4.4
"36011",36,11,2008,41802,39482,2320,5.5
"36011",36,11,2009,41590,38157,3433,8.3
"36011",36,11,2010,39885,36480,3405,8.5
"36011",36,11,2011,39068,35899,3169,8.1
"36011",36,11,2012,39113,35884,3229,8.3
"36011",36,11,2013,38854,35989,2865,7.4
"36011",36,11,2014,37779,35518,2261,6
"36011",36,11,2015,37279,35291,1988,5.3
"36011",36,11,2016,36945,35077,1868,5.1
"36011",36,11,2017,36134,34291,1843,5.1
"36013",36,13,1990,68191,64255,3936,5.8
"36013",36,13,1991,69114,63810,5304,7.7
"36013",36,13,1992,68133,62513,5620,8.2
"36013",36,13,1993,68396,63684,4712,6.9
"36013",36,13,1994,68226,63734,4492,6.6
"36013",36,13,1995,67348,63386,3962,5.9
"36013",36,13,1996,68319,64828,3491,5.1
"36013",36,13,1997,69576,65654,3922,5.6
"36013",36,13,1998,68756,65133,3623,5.3
"36013",36,13,1999,67222,63808,3414,5.1
"36013",36,13,2000,67733,64986,2747,4.1
"36013",36,13,2001,66936,63824,3112,4.6
"36013",36,13,2002,67431,63701,3730,5.5
"36013",36,13,2003,66735,62909,3826,5.7
"36013",36,13,2004,66930,63277,3653,5.5
"36013",36,13,2005,67149,63929,3220,4.8
"36013",36,13,2006,67135,64126,3009,4.5
"36013",36,13,2007,66781,63790,2991,4.5
"36013",36,13,2008,67323,63591,3732,5.5
"36013",36,13,2009,65934,60467,5467,8.3
"36013",36,13,2010,63922,58262,5660,8.9
"36013",36,13,2011,61661,56616,5045,8.2
"36013",36,13,2012,61278,56055,5223,8.5
"36013",36,13,2013,60218,55387,4831,8
"36013",36,13,2014,58030,54081,3949,6.8
"36013",36,13,2015,57925,54438,3487,6
"36013",36,13,2016,56500,53222,3278,5.8
"36013",36,13,2017,55854,52460,3394,6.1
"36015",36,15,1990,44129,41992,2137,4.8
"36015",36,15,1991,43360,40479,2881,6.6
"36015",36,15,1992,43315,40364,2951,6.8
"36015",36,15,1993,42864,40436,2428,5.7
"36015",36,15,1994,43192,40917,2275,5.3
"36015",36,15,1995,43013,40947,2066,4.8
"36015",36,15,1996,44100,42221,1879,4.3
"36015",36,15,1997,45138,43157,1981,4.4
"36015",36,15,1998,45623,43714,1909,4.2
"36015",36,15,1999,45044,42895,2149,4.8
"36015",36,15,2000,42544,40695,1849,4.3
"36015",36,15,2001,42367,40274,2093,4.9
"36015",36,15,2002,42269,39575,2694,6.4
"36015",36,15,2003,41187,38550,2637,6.4
"36015",36,15,2004,40515,38084,2431,6
"36015",36,15,2005,40595,38438,2157,5.3
"36015",36,15,2006,40851,38879,1972,4.8
"36015",36,15,2007,40956,39080,1876,4.6
"36015",36,15,2008,41459,39147,2312,5.6
"36015",36,15,2009,41016,37364,3652,8.9
"36015",36,15,2010,41594,38105,3489,8.4
"36015",36,15,2011,40803,37606,3197,7.8
"36015",36,15,2012,40553,37142,3411,8.4
"36015",36,15,2013,39609,36479,3130,7.9
"36015",36,15,2014,38337,35940,2397,6.3
"36015",36,15,2015,37681,35473,2208,5.9
"36015",36,15,2016,36452,34367,2085,5.7
"36015",36,15,2017,35872,33865,2007,5.6
"36017",36,17,1990,25222,23858,1364,5.4
"36017",36,17,1991,24886,23181,1705,6.9
"36017",36,17,1992,25080,23139,1941,7.7
"36017",36,17,1993,25148,23104,2044,8.1
"36017",36,17,1994,25024,23018,2006,8
"36017",36,17,1995,24581,22780,1801,7.3
"36017",36,17,1996,23966,22403,1563,6.5
"36017",36,17,1997,24289,22770,1519,6.3
"36017",36,17,1998,24290,22915,1375,5.7
"36017",36,17,1999,24418,23002,1416,5.8
"36017",36,17,2000,24373,23390,983,4
"36017",36,17,2001,24514,23411,1103,4.5
"36017",36,17,2002,24619,23259,1360,5.5
"36017",36,17,2003,24219,22820,1399,5.8
"36017",36,17,2004,24090,22755,1335,5.5
"36017",36,17,2005,24291,23092,1199,4.9
"36017",36,17,2006,24712,23514,1198,4.8
"36017",36,17,2007,24405,23200,1205,4.9
"36017",36,17,2008,24672,23104,1568,6.4
"36017",36,17,2009,24407,22231,2176,8.9
"36017",36,17,2010,23691,21509,2182,9.2
"36017",36,17,2011,23830,21760,2070,8.7
"36017",36,17,2012,24127,22044,2083,8.6
"36017",36,17,2013,24097,22335,1762,7.3
"36017",36,17,2014,23286,21840,1446,6.2
"36017",36,17,2015,23216,21952,1264,5.4
"36017",36,17,2016,22987,21823,1164,5.1
"36017",36,17,2017,22593,21372,1221,5.4
"36019",36,19,1990,39283,36916,2367,6
"36019",36,19,1991,40308,37113,3195,7.9
"36019",36,19,1992,40493,36909,3584,8.9
"36019",36,19,1993,40731,37607,3124,7.7
"36019",36,19,1994,41312,38142,3170,7.7
"36019",36,19,1995,40265,37541,2724,6.8
"36019",36,19,1996,39888,37183,2705,6.8
"36019",36,19,1997,40375,37670,2705,6.7
"36019",36,19,1998,40034,37587,2447,6.1
"36019",36,19,1999,40232,37634,2598,6.5
"36019",36,19,2000,38375,36568,1807,4.7
"36019",36,19,2001,38768,37042,1726,4.5
"36019",36,19,2002,39657,37549,2108,5.3
"36019",36,19,2003,39878,37484,2394,6
"36019",36,19,2004,39890,37477,2413,6
"36019",36,19,2005,40018,37915,2103,5.3
"36019",36,19,2006,40064,37932,2132,5.3
"36019",36,19,2007,39784,37556,2228,5.6
"36019",36,19,2008,39988,37370,2618,6.5
"36019",36,19,2009,39787,36084,3703,9.3
"36019",36,19,2010,39701,35809,3892,9.8
"36019",36,19,2011,38413,34729,3684,9.6
"36019",36,19,2012,37998,34424,3574,9.4
"36019",36,19,2013,37176,34085,3091,8.3
"36019",36,19,2014,36140,33753,2387,6.6
"36019",36,19,2015,36125,34024,2101,5.8
"36019",36,19,2016,36043,34111,1932,5.4
"36019",36,19,2017,36268,34322,1946,5.4
"36021",36,21,1990,31321,30326,995,3.2
"36021",36,21,1991,31346,29625,1721,5.5
"36021",36,21,1992,31452,29647,1805,5.7
"36021",36,21,1993,32772,31086,1686,5.1
"36021",36,21,1994,32913,31381,1532,4.7
"36021",36,21,1995,32780,31407,1373,4.2
"36021",36,21,1996,32608,31285,1323,4.1
"36021",36,21,1997,33575,32366,1209,3.6
"36021",36,21,1998,33451,32355,1096,3.3
"36021",36,21,1999,34075,33031,1044,3.1
"36021",36,21,2000,31344,30259,1085,3.5
"36021",36,21,2001,31122,30034,1088,3.5
"36021",36,21,2002,31297,29967,1330,4.2
"36021",36,21,2003,31337,29975,1362,4.3
"36021",36,21,2004,31923,30529,1394,4.4
"36021",36,21,2005,32004,30771,1233,3.9
"36021",36,21,2006,32320,31135,1185,3.7
"36021",36,21,2007,31765,30530,1235,3.9
"36021",36,21,2008,31881,30342,1539,4.8
"36021",36,21,2009,31432,29121,2311,7.4
"36021",36,21,2010,32137,29789,2348,7.3
"36021",36,21,2011,31452,29216,2236,7.1
"36021",36,21,2012,31681,29451,2230,7
"36021",36,21,2013,31847,29936,1911,6
"36021",36,21,2014,31463,29981,1482,4.7
"36021",36,21,2015,31588,30331,1257,4
"36021",36,21,2016,31676,30510,1166,3.7
"36021",36,21,2017,31457,30249,1208,3.8
"36023",36,23,1990,24662,23093,1569,6.4
"36023",36,23,1991,24910,23051,1859,7.5
"36023",36,23,1992,25008,22973,2035,8.1
"36023",36,23,1993,24663,22700,1963,8
"36023",36,23,1994,24330,22455,1875,7.7
"36023",36,23,1995,23889,22233,1656,6.9
"36023",36,23,1996,23732,22268,1464,6.2
"36023",36,23,1997,24290,22665,1625,6.7
"36023",36,23,1998,23919,22116,1803,7.5
"36023",36,23,1999,22983,21414,1569,6.8
"36023",36,23,2000,24037,22983,1054,4.4
"36023",36,23,2001,24661,23498,1163,4.7
"36023",36,23,2002,24628,23173,1455,5.9
"36023",36,23,2003,24375,22951,1424,5.8
"36023",36,23,2004,24075,22585,1490,6.2
"36023",36,23,2005,23938,22643,1295,5.4
"36023",36,23,2006,23774,22524,1250,5.3
"36023",36,23,2007,23737,22508,1229,5.2
"36023",36,23,2008,24168,22623,1545,6.4
"36023",36,23,2009,24304,22088,2216,9.1
"36023",36,23,2010,24475,22304,2171,8.9
"36023",36,23,2011,24341,22284,2057,8.5
"36023",36,23,2012,24476,22365,2111,8.6
"36023",36,23,2013,24308,22426,1882,7.7
"36023",36,23,2014,23765,22220,1545,6.5
"36023",36,23,2015,23403,22028,1375,5.9
"36023",36,23,2016,23139,21822,1317,5.7
"36023",36,23,2017,23103,21746,1357,5.9
"36025",36,25,1990,21715,20593,1122,5.2
"36025",36,25,1991,21499,20061,1438,6.7
"36025",36,25,1992,21191,19542,1649,7.8
"36025",36,25,1993,20990,19563,1427,6.8
"36025",36,25,1994,21012,19665,1347,6.4
"36025",36,25,1995,21042,19889,1153,5.5
"36025",36,25,1996,20620,19539,1081,5.2
"36025",36,25,1997,21411,20287,1124,5.2
"36025",36,25,1998,21218,20255,963,4.5
"36025",36,25,1999,21078,19990,1088,5.2
"36025",36,25,2000,22070,21142,928,4.2
"36025",36,25,2001,22184,21267,917,4.1
"36025",36,25,2002,23068,21978,1090,4.7
"36025",36,25,2003,23012,21909,1103,4.8
"36025",36,25,2004,23161,22111,1050,4.5
"36025",36,25,2005,23525,22491,1034,4.4
"36025",36,25,2006,23509,22509,1000,4.3
"36025",36,25,2007,23129,22128,1001,4.3
"36025",36,25,2008,22917,21549,1368,6
"36025",36,25,2009,22265,20363,1902,8.5
"36025",36,25,2010,22431,20465,1966,8.8
"36025",36,25,2011,21717,19833,1884,8.7
"36025",36,25,2012,21589,19702,1887,8.7
"36025",36,25,2013,21050,19394,1656,7.9
"36025",36,25,2014,20118,18798,1320,6.6
"36025",36,25,2015,19609,18435,1174,6
"36025",36,25,2016,19352,18284,1068,5.5
"36025",36,25,2017,19104,18026,1078,5.6
"36027",36,27,1990,133795,129848,3947,3
"36027",36,27,1991,130602,123842,6760,5.2
"36027",36,27,1992,126135,117716,8419,6.7
"36027",36,27,1993,123084,112541,10543,8.6
"36027",36,27,1994,117715,109548,8167,6.9
"36027",36,27,1995,116064,110275,5789,5
"36027",36,27,1996,118421,113452,4969,4.2
"36027",36,27,1997,120627,115787,4840,4
"36027",36,27,1998,120487,116423,4064,3.4
"36027",36,27,1999,121547,117411,4136,3.4
"36027",36,27,2000,138446,133979,4467,3.2
"36027",36,27,2001,140038,135221,4817,3.4
"36027",36,27,2002,143262,137292,5970,4.2
"36027",36,27,2003,143707,137820,5887,4.1
"36027",36,27,2004,145368,139197,6171,4.2
"36027",36,27,2005,147009,141260,5749,3.9
"36027",36,27,2006,147568,141973,5595,3.8
"36027",36,27,2007,145515,139838,5677,3.9
"36027",36,27,2008,146689,139178,7511,5.1
"36027",36,27,2009,144842,133744,11098,7.7
"36027",36,27,2010,149196,137679,11517,7.7
"36027",36,27,2011,146309,135325,10984,7.5
"36027",36,27,2012,146383,134988,11395,7.8
"36027",36,27,2013,145589,135882,9707,6.7
"36027",36,27,2014,142866,135274,7592,5.3
"36027",36,27,2015,144065,137603,6462,4.5
"36027",36,27,2016,144019,138024,5995,4.2
"36027",36,27,2017,144725,138458,6267,4.3
"36029",36,29,1990,478878,453807,25071,5.2
"36029",36,29,1991,477777,444628,33149,6.9
"36029",36,29,1992,476542,441881,34661,7.3
"36029",36,29,1993,471279,440225,31054,6.6
"36029",36,29,1994,470061,442436,27625,5.9
"36029",36,29,1995,466357,442040,24317,5.2
"36029",36,29,1996,468758,446115,22643,4.8
"36029",36,29,1997,476382,452464,23918,5
"36029",36,29,1998,473137,449035,24102,5.1
"36029",36,29,1999,467824,443807,24017,5.1
"36029",36,29,2000,465621,445939,19682,4.2
"36029",36,29,2001,460247,438786,21461,4.7
"36029",36,29,2002,470145,444923,25222,5.4
"36029",36,29,2003,470115,443315,26800,5.7
"36029",36,29,2004,472080,445204,26876,5.7
"36029",36,29,2005,472255,447793,24462,5.2
"36029",36,29,2006,471116,448117,22999,4.9
"36029",36,29,2007,465331,443492,21839,4.7
"36029",36,29,2008,473549,446521,27028,5.7
"36029",36,29,2009,470654,432512,38142,8.1
"36029",36,29,2010,465675,426962,38713,8.3
"36029",36,29,2011,458769,422123,36646,8
"36029",36,29,2012,461760,423403,38357,8.3
"36029",36,29,2013,460260,426138,34122,7.4
"36029",36,29,2014,450411,422961,27450,6.1
"36029",36,29,2015,451194,427193,24001,5.3
"36029",36,29,2016,448132,426082,22050,4.9
"36029",36,29,2017,448645,425362,23283,5.2
"36031",36,31,1990,18111,16653,1458,8.1
"36031",36,31,1991,18300,16253,2047,11.2
"36031",36,31,1992,18701,16406,2295,12.3
"36031",36,31,1993,18015,16109,1906,10.6
"36031",36,31,1994,18101,16252,1849,10.2
"36031",36,31,1995,18044,16422,1622,9
"36031",36,31,1996,18029,16503,1526,8.5
"36031",36,31,1997,18294,16735,1559,8.5
"36031",36,31,1998,18491,17000,1491,8.1
"36031",36,31,1999,18480,16925,1555,8.4
"36031",36,31,2000,18442,17554,888,4.8
"36031",36,31,2001,18568,17724,844,4.5
"36031",36,31,2002,18782,17820,962,5.1
"36031",36,31,2003,18349,17389,960,5.2
"36031",36,31,2004,18638,17620,1018,5.5
"36031",36,31,2005,18741,17739,1002,5.3
"36031",36,31,2006,18738,17703,1035,5.5
"36031",36,31,2007,18557,17506,1051,5.7
"36031",36,31,2008,18617,17375,1242,6.7
"36031",36,31,2009,18343,16672,1671,9.1
"36031",36,31,2010,18736,17021,1715,9.2
"36031",36,31,2011,18201,16546,1655,9.1
"36031",36,31,2012,18176,16437,1739,9.6
"36031",36,31,2013,18113,16615,1498,8.3
"36031",36,31,2014,17626,16414,1212,6.9
"36031",36,31,2015,17409,16363,1046,6
"36031",36,31,2016,17354,16428,926,5.3
"36031",36,31,2017,17310,16348,962,5.6
"36033",36,33,1990,20644,18851,1793,8.7
"36033",36,33,1991,21261,18813,2448,11.5
"36033",36,33,1992,21370,19141,2229,10.4
"36033",36,33,1993,21440,19599,1841,8.6
"36033",36,33,1994,21504,19622,1882,8.8
"36033",36,33,1995,21414,19646,1768,8.3
"36033",36,33,1996,21772,19951,1821,8.4
"36033",36,33,1997,21738,19844,1894,8.7
"36033",36,33,1998,21421,19724,1697,7.9
"36033",36,33,1999,22293,20567,1726,7.7
"36033",36,33,2000,22103,20821,1282,5.8
"36033",36,33,2001,21836,20532,1304,6
"36033",36,33,2002,22271,20924,1347,6
"36033",36,33,2003,22398,20917,1481,6.6
"36033",36,33,2004,22391,20945,1446,6.5
"36033",36,33,2005,22551,21231,1320,5.9
"36033",36,33,2006,22657,21424,1233,5.4
"36033",36,33,2007,22634,21379,1255,5.5
"36033",36,33,2008,23056,21464,1592,6.9
"36033",36,33,2009,23032,21074,1958,8.5
"36033",36,33,2010,22245,20249,1996,9
"36033",36,33,2011,21725,19744,1981,9.1
"36033",36,33,2012,21796,19712,2084,9.6
"36033",36,33,2013,21544,19640,1904,8.8
"36033",36,33,2014,20601,19108,1493,7.2
"36033",36,33,2015,20083,18779,1304,6.5
"36033",36,33,2016,19923,18795,1128,5.7
"36033",36,33,2017,19982,18769,1213,6.1
"36035",36,35,1990,26747,24441,2306,8.6
"36035",36,35,1991,27085,24233,2852,10.5
"36035",36,35,1992,26987,24290,2697,10
"36035",36,35,1993,27063,24933,2130,7.9
"36035",36,35,1994,27509,25416,2093,7.6
"36035",36,35,1995,27443,25238,2205,8
"36035",36,35,1996,27224,24951,2273,8.3
"36035",36,35,1997,27511,25457,2054,7.5
"36035",36,35,1998,27039,25367,1672,6.2
"36035",36,35,1999,27047,25426,1621,6
"36035",36,35,2000,26196,24965,1231,4.7
"36035",36,35,2001,26264,25079,1185,4.5
"36035",36,35,2002,26914,25584,1330,4.9
"36035",36,35,2003,26513,25002,1511,5.7
"36035",36,35,2004,26748,25241,1507,5.6
"36035",36,35,2005,26970,25471,1499,5.6
"36035",36,35,2006,27426,25995,1431,5.2
"36035",36,35,2007,27345,25875,1470,5.4
"36035",36,35,2008,27664,25807,1857,6.7
"36035",36,35,2009,27246,24629,2617,9.6
"36035",36,35,2010,26105,23337,2768,10.6
"36035",36,35,2011,25552,22854,2698,10.6
"36035",36,35,2012,25392,22595,2797,11
"36035",36,35,2013,24736,22393,2343,9.5
"36035",36,35,2014,23537,21734,1803,7.7
"36035",36,35,2015,23580,22064,1516,6.4
"36035",36,35,2016,23379,22042,1337,5.7
"36035",36,35,2017,23317,21954,1363,5.8
"36037",36,37,1990,31331,29705,1626,5.2
"36037",36,37,1991,32274,29730,2544,7.9
"36037",36,37,1992,32133,29565,2568,8
"36037",36,37,1993,32067,29952,2115,6.6
"36037",36,37,1994,32074,30014,2060,6.4
"36037",36,37,1995,31890,30034,1856,5.8
"36037",36,37,1996,32381,30749,1632,5
"36037",36,37,1997,32772,30943,1829,5.6
"36037",36,37,1998,32757,31033,1724,5.3
"36037",36,37,1999,32305,30628,1677,5.2
"36037",36,37,2000,32428,31134,1294,4
"36037",36,37,2001,32205,30822,1383,4.3
"36037",36,37,2002,33100,31361,1739,5.3
"36037",36,37,2003,33154,31345,1809,5.5
"36037",36,37,2004,33066,31231,1835,5.5
"36037",36,37,2005,33104,31514,1590,4.8
"36037",36,37,2006,33119,31613,1506,4.5
"36037",36,37,2007,32868,31375,1493,4.5
"36037",36,37,2008,33542,31658,1884,5.6
"36037",36,37,2009,33101,30576,2525,7.6
"36037",36,37,2010,31730,29189,2541,8
"36037",36,37,2011,30922,28516,2406,7.8
"36037",36,37,2012,30885,28443,2442,7.9
"36037",36,37,2013,30534,28447,2087,6.8
"36037",36,37,2014,30155,28487,1668,5.5
"36037",36,37,2015,30270,28774,1496,4.9
"36037",36,37,2016,29932,28559,1373,4.6
"36037",36,37,2017,29723,28275,1448,4.9
"36039",36,39,1990,21063,20030,1033,4.9
"36039",36,39,1991,21424,19769,1655,7.7
"36039",36,39,1992,21622,19701,1921,8.9
"36039",36,39,1993,21455,19639,1816,8.5
"36039",36,39,1994,21410,19651,1759,8.2
"36039",36,39,1995,21081,19510,1571,7.5
"36039",36,39,1996,21009,19599,1410,6.7
"36039",36,39,1997,21694,20367,1327,6.1
"36039",36,39,1998,21965,20761,1204,5.5
"36039",36,39,1999,21904,20731,1173,5.4
"36039",36,39,2000,22496,21469,1027,4.6
"36039",36,39,2001,22490,21474,1016,4.5
"36039",36,39,2002,23732,22576,1156,4.9
"36039",36,39,2003,23727,22519,1208,5.1
"36039",36,39,2004,23306,22074,1232,5.3
"36039",36,39,2005,23754,22608,1146,4.8
"36039",36,39,2006,24099,22967,1132,4.7
"36039",36,39,2007,24124,22978,1146,4.8
"36039",36,39,2008,24370,22938,1432,5.9
"36039",36,39,2009,24079,22076,2003,8.3
"36039",36,39,2010,22101,20097,2004,9.1
"36039",36,39,2011,21576,19552,2024,9.4
"36039",36,39,2012,21547,19406,2141,9.9
"36039",36,39,2013,21353,19483,1870,8.8
"36039",36,39,2014,20806,19402,1404,6.7
"36039",36,39,2015,20836,19665,1171,5.6
"36039",36,39,2016,20700,19657,1043,5
"36039",36,39,2017,20757,19665,1092,5.3
"36041",36,41,1990,2755,2508,247,9
"36041",36,41,1991,2911,2606,305,10.5
"36041",36,41,1992,2860,2523,337,11.8
"36041",36,41,1993,2803,2489,314,11.2
"36041",36,41,1994,2670,2371,299,11.2
"36041",36,41,1995,2508,2222,286,11.4
"36041",36,41,1996,2517,2239,278,11
"36041",36,41,1997,2538,2253,285,11.2
"36041",36,41,1998,2507,2226,281,11.2
"36041",36,41,1999,2608,2337,271,10.4
"36041",36,41,2000,2848,2690,158,5.5
"36041",36,41,2001,2754,2622,132,4.8
"36041",36,41,2002,2915,2769,146,5
"36041",36,41,2003,2952,2794,158,5.4
"36041",36,41,2004,3064,2894,170,5.5
"36041",36,41,2005,3167,2995,172,5.4
"36041",36,41,2006,3119,2964,155,5
"36041",36,41,2007,3208,3057,151,4.7
"36041",36,41,2008,3079,2887,192,6.2
"36041",36,41,2009,3016,2790,226,7.5
"36041",36,41,2010,2502,2256,246,9.8
"36041",36,41,2011,2442,2201,241,9.9
"36041",36,41,2012,2449,2187,262,10.7
"36041",36,41,2013,2430,2198,232,9.5
"36041",36,41,2014,2440,2259,181,7.4
"36041",36,41,2015,2448,2283,165,6.7
"36041",36,41,2016,2379,2225,154,6.5
"36041",36,41,2017,2328,2152,176,7.6
"36043",36,43,1990,30293,28421,1872,6.2
"36043",36,43,1991,30375,27714,2661,8.8
"36043",36,43,1992,30306,27651,2655,8.8
"36043",36,43,1993,30326,27996,2330,7.7
"36043",36,43,1994,30642,28587,2055,6.7
"36043",36,43,1995,31301,29098,2203,7
"36043",36,43,1996,31574,29484,2090,6.6
"36043",36,43,1997,31744,29650,2094,6.6
"36043",36,43,1998,31622,29784,1838,5.8
"36043",36,43,1999,31408,29772,1636,5.2
"36043",36,43,2000,31544,30189,1355,4.3
"36043",36,43,2001,31095,29704,1391,4.5
"36043",36,43,2002,31435,29755,1680,5.3
"36043",36,43,2003,31369,29595,1774,5.7
"36043",36,43,2004,31414,29651,1763,5.6
"36043",36,43,2005,31671,30005,1666,5.3
"36043",36,43,2006,31400,29856,1544,4.9
"36043",36,43,2007,30974,29456,1518,4.9
"36043",36,43,2008,31311,29399,1912,6.1
"36043",36,43,2009,31173,28694,2479,8
"36043",36,43,2010,31552,28841,2711,8.6
"36043",36,43,2011,30723,28048,2675,8.7
"36043",36,43,2012,30538,27861,2677,8.8
"36043",36,43,2013,30004,27656,2348,7.8
"36043",36,43,2014,28978,27014,1964,6.8
"36043",36,43,2015,28580,26800,1780,6.2
"36043",36,43,2016,28358,26810,1548,5.5
"36043",36,43,2017,28294,26660,1634,5.8
"36045",36,45,1990,47036,42932,4104,8.7
"36045",36,45,1991,46673,41536,5137,11
"36045",36,45,1992,46657,41029,5628,12.1
"36045",36,45,1993,44966,39963,5003,11.1
"36045",36,45,1994,44364,39850,4514,10.2
"36045",36,45,1995,43883,39935,3948,9
"36045",36,45,1996,44127,40398,3729,8.5
"36045",36,45,1997,44993,41012,3981,8.8
"36045",36,45,1998,44527,40386,4141,9.3
"36045",36,45,1999,44665,40586,4079,9.1
"36045",36,45,2000,44776,42122,2654,5.9
"36045",36,45,2001,44876,42051,2825,6.3
"36045",36,45,2002,45880,42806,3074,6.7
"36045",36,45,2003,45949,42837,3112,6.8
"36045",36,45,2004,46282,43080,3202,6.9
"36045",36,45,2005,47105,44219,2886,6.1
"36045",36,45,2006,48402,45771,2631,5.4
"36045",36,45,2007,48137,45510,2627,5.5
"36045",36,45,2008,49275,45913,3362,6.8
"36045",36,45,2009,49515,45141,4374,8.8
"36045",36,45,2010,50310,45638,4672,9.3
"36045",36,45,2011,48934,44154,4780,9.8
"36045",36,45,2012,48426,43648,4778,9.9
"36045",36,45,2013,48330,43868,4462,9.2
"36045",36,45,2014,46808,43248,3560,7.6
"36045",36,45,2015,46788,43708,3080,6.6
"36045",36,45,2016,45970,43100,2870,6.2
"36045",36,45,2017,45455,42477,2978,6.6
"36047",36,47,1990,958938,883982,74956,7.8
"36047",36,47,1991,938381,848635,89746,9.6
"36047",36,47,1992,947537,832521,115016,12.1
"36047",36,47,1993,942128,833137,108991,11.6
"36047",36,47,1994,929886,838049,91837,9.9
"36047",36,47,1995,933276,847507,85769,9.2
"36047",36,47,1996,951952,856661,95291,10
"36047",36,47,1997,989677,883137,106540,10.8
"36047",36,47,1998,1000828,907559,93269,9.3
"36047",36,47,1999,1009644,929991,79653,7.9
"36047",36,47,2000,1042699,976598,66101,6.3
"36047",36,47,2001,1040426,973413,67013,6.4
"36047",36,47,2002,1047209,956631,90578,8.6
"36047",36,47,2003,1041574,946939,94635,9.1
"36047",36,47,2004,1057696,976927,80769,7.6
"36047",36,47,2005,1070528,1003685,66843,6.2
"36047",36,47,2006,1073743,1016247,57496,5.4
"36047",36,47,2007,1086423,1027298,59125,5.4
"36047",36,47,2008,1106224,1039579,66645,6
"36047",36,47,2009,1119823,1008638,111185,9.9
"36047",36,47,2010,1163502,1047981,115521,9.9
"36047",36,47,2011,1170616,1058657,111959,9.6
"36047",36,47,2012,1190125,1073762,116363,9.8
"36047",36,47,2013,1212011,1098648,113363,9.4
"36047",36,47,2014,1224532,1131176,93356,7.6
"36047",36,47,2015,1229405,1156891,72514,5.9
"36047",36,47,2016,1237966,1172174,65792,5.3
"36047",36,47,2017,1245943,1188114,57829,4.6
"36049",36,49,1990,12334,11457,877,7.1
"36049",36,49,1991,13112,11903,1209,9.2
"36049",36,49,1992,12747,11345,1402,11
"36049",36,49,1993,12527,11258,1269,10.1
"36049",36,49,1994,12493,11340,1153,9.2
"36049",36,49,1995,12576,11530,1046,8.3
"36049",36,49,1996,12513,11535,978,7.8
"36049",36,49,1997,12726,11730,996,7.8
"36049",36,49,1998,12220,11172,1048,8.6
"36049",36,49,1999,12346,11255,1091,8.8
"36049",36,49,2000,12639,11982,657,5.2
"36049",36,49,2001,12493,11732,761,6.1
"36049",36,49,2002,12627,11841,786,6.2
"36049",36,49,2003,12435,11639,796,6.4
"36049",36,49,2004,12552,11730,822,6.5
"36049",36,49,2005,12729,11971,758,6
"36049",36,49,2006,13042,12338,704,5.4
"36049",36,49,2007,12487,11809,678,5.4
"36049",36,49,2008,12637,11795,842,6.7
"36049",36,49,2009,12755,11636,1119,8.8
"36049",36,49,2010,12756,11592,1164,9.1
"36049",36,49,2011,12393,11197,1196,9.7
"36049",36,49,2012,12269,11043,1226,10
"36049",36,49,2013,12245,11087,1158,9.5
"36049",36,49,2014,11918,10983,935,7.8
"36049",36,49,2015,11834,11016,818,6.9
"36049",36,49,2016,11820,11027,793,6.7
"36049",36,49,2017,11727,10939,788,6.7
"36051",36,51,1990,32222,30821,1401,4.3
"36051",36,51,1991,32962,30838,2124,6.4
"36051",36,51,1992,33254,31028,2226,6.7
"36051",36,51,1993,33416,31517,1899,5.7
"36051",36,51,1994,33908,31923,1985,5.9
"36051",36,51,1995,34026,32182,1844,5.4
"36051",36,51,1996,34663,32883,1780,5.1
"36051",36,51,1997,35264,33443,1821,5.2
"36051",36,51,1998,35289,33510,1779,5
"36051",36,51,1999,35021,33298,1723,4.9
"36051",36,51,2000,32793,31454,1339,4.1
"36051",36,51,2001,32685,31262,1423,4.4
"36051",36,51,2002,32834,30974,1860,5.7
"36051",36,51,2003,32663,30709,1954,6
"36051",36,51,2004,32753,30848,1905,5.8
"36051",36,51,2005,32873,31242,1631,5
"36051",36,51,2006,32877,31306,1571,4.8
"36051",36,51,2007,32250,30671,1579,4.9
"36051",36,51,2008,32529,30594,1935,5.9
"36051",36,51,2009,32143,29442,2701,8.4
"36051",36,51,2010,32754,30104,2650,8.1
"36051",36,51,2011,32007,29560,2447,7.6
"36051",36,51,2012,32147,29625,2522,7.8
"36051",36,51,2013,31880,29640,2240,7
"36051",36,51,2014,31084,29285,1799,5.8
"36051",36,51,2015,31425,29776,1649,5.2
"36051",36,51,2016,31244,29702,1542,4.9
"36051",36,51,2017,31071,29492,1579,5.1
"36053",36,53,1990,35346,33547,1799,5.1
"36053",36,53,1991,35719,33086,2633,7.4
"36053",36,53,1992,35846,33079,2767,7.7
"36053",36,53,1993,35443,33035,2408,6.8
"36053",36,53,1994,35155,33056,2099,6
"36053",36,53,1995,35034,32997,2037,5.8
"36053",36,53,1996,35788,33924,1864,5.2
"36053",36,53,1997,36045,34207,1838,5.1
"36053",36,53,1998,35966,34343,1623,4.5
"36053",36,53,1999,36095,34434,1661,4.6
"36053",36,53,2000,34868,33518,1350,3.9
"36053",36,53,2001,34974,33397,1577,4.5
"36053",36,53,2002,35418,33564,1854,5.2
"36053",36,53,2003,35519,33550,1969,5.5
"36053",36,53,2004,35703,33714,1989,5.6
"36053",36,53,2005,36109,34253,1856,5.1
"36053",36,53,2006,36087,34444,1643,4.6
"36053",36,53,2007,35960,34286,1674,4.7
"36053",36,53,2008,36505,34410,2095,5.7
"36053",36,53,2009,36089,33175,2914,8.1
"36053",36,53,2010,35586,32631,2955,8.3
"36053",36,53,2011,34733,31896,2837,8.2
"36053",36,53,2012,34620,31675,2945,8.5
"36053",36,53,2013,34421,31803,2618,7.6
"36053",36,53,2014,33571,31419,2152,6.4
"36053",36,53,2015,33077,31201,1876,5.7
"36053",36,53,2016,32920,31188,1732,5.3
"36053",36,53,2017,32802,30972,1830,5.6
"36055",36,55,1990,376743,364035,12708,3.4
"36055",36,55,1991,380578,363858,16720,4.4
"36055",36,55,1992,381241,362665,18576,4.9
"36055",36,55,1993,384691,367085,17606,4.6
"36055",36,55,1994,384424,365701,18723,4.9
"36055",36,55,1995,381230,366186,15044,3.9
"36055",36,55,1996,383365,370060,13305,3.5
"36055",36,55,1997,389823,375890,13933,3.6
"36055",36,55,1998,390923,376841,14082,3.6
"36055",36,55,1999,386820,371950,14870,3.8
"36055",36,55,2000,375172,361843,13329,3.6
"36055",36,55,2001,373508,358170,15338,4.1
"36055",36,55,2002,375754,355873,19881,5.3
"36055",36,55,2003,374026,353621,20405,5.5
"36055",36,55,2004,373605,354250,19355,5.2
"36055",36,55,2005,376359,359288,17071,4.5
"36055",36,55,2006,375168,358950,16218,4.3
"36055",36,55,2007,373025,356559,16466,4.4
"36055",36,55,2008,378082,357407,20675,5.5
"36055",36,55,2009,375379,345928,29451,7.8
"36055",36,55,2010,378251,347846,30405,8
"36055",36,55,2011,373786,345099,28687,7.7
"36055",36,55,2012,376288,346636,29652,7.9
"36055",36,55,2013,374652,348519,26133,7
"36055",36,55,2014,366103,344893,21210,5.8
"36055",36,55,2015,367520,348923,18597,5.1
"36055",36,55,2016,365686,348518,17168,4.7
"36055",36,55,2017,364394,346201,18193,5
"36057",36,57,1990,24521,22800,1721,7
"36057",36,57,1991,24728,22324,2404,9.7
"36057",36,57,1992,24645,22202,2443,9.9
"36057",36,57,1993,24234,22401,1833,7.6
"36057",36,57,1994,24408,22555,1853,7.6
"36057",36,57,1995,24126,22165,1961,8.1
"36057",36,57,1996,24041,22101,1940,8.1
"36057",36,57,1997,24226,22462,1764,7.3
"36057",36,57,1998,23903,22471,1432,6
"36057",36,57,1999,23749,22251,1498,6.3
"36057",36,57,2000,23528,22396,1132,4.8
"36057",36,57,2001,23608,22431,1177,5
"36057",36,57,2002,24006,22647,1359,5.7
"36057",36,57,2003,24006,22476,1530,6.4
"36057",36,57,2004,24205,22770,1435,5.9
"36057",36,57,2005,24686,23372,1314,5.3
"36057",36,57,2006,24963,23542,1421,5.7
"36057",36,57,2007,24476,23045,1431,5.8
"36057",36,57,2008,24820,23065,1755,7.1
"36057",36,57,2009,24427,22118,2309,9.5
"36057",36,57,2010,23919,21507,2412,10.1
"36057",36,57,2011,23432,21034,2398,10.2
"36057",36,57,2012,23451,21011,2440,10.4
"36057",36,57,2013,23179,21049,2130,9.2
"36057",36,57,2014,22364,20694,1670,7.5
"36057",36,57,2015,22397,20929,1468,6.6
"36057",36,57,2016,22456,21173,1283,5.7
"36057",36,57,2017,22656,21343,1313,5.8
"36059",36,59,1990,699830,673682,26148,3.7
"36059",36,59,1991,687751,648623,39128,5.7
"36059",36,59,1992,682060,634021,48039,7
"36059",36,59,1993,676982,637145,39837,5.9
"36059",36,59,1994,675161,641006,34155,5.1
"36059",36,59,1995,675786,645219,30567,4.5
"36059",36,59,1996,680832,655442,25390,3.7
"36059",36,59,1997,692897,668713,24184,3.5
"36059",36,59,1998,696875,676297,20578,3
"36059",36,59,1999,700038,679355,20683,3
"36059",36,59,2000,673797,651257,22540,3.3
"36059",36,59,2001,670974,646155,24819,3.7
"36059",36,59,2002,681687,650420,31267,4.6
"36059",36,59,2003,681398,649939,31459,4.6
"36059",36,59,2004,684388,653640,30748,4.5
"36059",36,59,2005,689655,661861,27794,4
"36059",36,59,2006,696480,670604,25876,3.7
"36059",36,59,2007,694915,669351,25564,3.7
"36059",36,59,2008,700692,667509,33183,4.7
"36059",36,59,2009,692905,645100,47805,6.9
"36059",36,59,2010,691435,642118,49317,7.1
"36059",36,59,2011,683283,636681,46602,6.8
"36059",36,59,2012,693607,644803,48804,7
"36059",36,59,2013,697079,655888,41191,5.9
"36059",36,59,2014,688753,655871,32882,4.8
"36059",36,59,2015,701610,672024,29586,4.2
"36059",36,59,2016,704626,677104,27522,3.9
"36059",36,59,2017,707997,678632,29365,4.1
"36061",36,61,1990,779616,733003,46613,6
"36061",36,61,1991,763728,705291,58437,7.7
"36061",36,61,1992,767623,695237,72386,9.4
"36061",36,61,1993,770169,700532,69637,9
"36061",36,61,1994,774542,715619,58923,7.6
"36061",36,61,1995,780687,726517,54170,6.9
"36061",36,61,1996,804835,745201,59634,7.4
"36061",36,61,1997,835991,770289,65702,7.9
"36061",36,61,1998,850941,793728,57213,6.7
"36061",36,61,1999,865844,815414,50430,5.8
"36061",36,61,2000,855358,812237,43121,5
"36061",36,61,2001,866642,817837,48805,5.6
"36061",36,61,2002,871108,804781,66327,7.6
"36061",36,61,2003,867301,802107,65194,7.5
"36061",36,61,2004,883902,829168,54734,6.2
"36061",36,61,2005,902717,857093,45624,5.1
"36061",36,61,2006,909103,869930,39173,4.3
"36061",36,61,2007,917566,877728,39838,4.3
"36061",36,61,2008,931595,885850,45745,4.9
"36061",36,61,2009,931604,852963,78641,8.4
"36061",36,61,2010,881204,805555,75649,8.6
"36061",36,61,2011,882224,813275,68949,7.8
"36061",36,61,2012,894987,823126,71861,8
"36061",36,61,2013,904861,836910,67951,7.5
"36061",36,61,2014,913131,857230,55901,6.1
"36061",36,61,2015,920921,876135,44786,4.9
"36061",36,61,2016,932124,889769,42355,4.5
"36061",36,61,2017,939689,901733,37956,4
"36063",36,63,1990,109523,103287,6236,5.7
"36063",36,63,1991,109470,101141,8329,7.6
"36063",36,63,1992,109517,100364,9153,8.4
"36063",36,63,1993,108537,100370,8167,7.5
"36063",36,63,1994,108738,101261,7477,6.9
"36063",36,63,1995,108331,101822,6509,6
"36063",36,63,1996,110043,103351,6692,6.1
"36063",36,63,1997,112412,105109,7303,6.5
"36063",36,63,1998,111872,104522,7350,6.6
"36063",36,63,1999,110102,103393,6709,6.1
"36063",36,63,2000,109413,104250,5163,4.7
"36063",36,63,2001,108470,102519,5951,5.5
"36063",36,63,2002,111168,104185,6983,6.3
"36063",36,63,2003,111316,104007,7309,6.6
"36063",36,63,2004,111587,104703,6884,6.2
"36063",36,63,2005,111714,105517,6197,5.5
"36063",36,63,2006,112203,106228,5975,5.3
"36063",36,63,2007,111370,105428,5942,5.3
"36063",36,63,2008,114018,106367,7651,6.7
"36063",36,63,2009,113676,103142,10534,9.3
"36063",36,63,2010,107847,97467,10380,9.6
"36063",36,63,2011,105602,95951,9651,9.1
"36063",36,63,2012,105750,95894,9856,9.3
"36063",36,63,2013,105051,96158,8893,8.5
"36063",36,63,2014,101979,94822,7157,7
"36063",36,63,2015,101710,95451,6259,6.2
"36063",36,63,2016,100900,95019,5881,5.8
"36063",36,63,2017,101134,94850,6284,6.2
"36065",36,65,1990,114635,109534,5101,4.4
"36065",36,65,1991,114278,106736,7542,6.6
"36065",36,65,1992,114191,106250,7941,7
"36065",36,65,1993,113467,106470,6997,6.2
"36065",36,65,1994,113791,107791,6000,5.3
"36065",36,65,1995,113289,107491,5798,5.1
"36065",36,65,1996,111558,106097,5461,4.9
"36065",36,65,1997,112819,107373,5446,4.8
"36065",36,65,1998,113285,108505,4780,4.2
"36065",36,65,1999,113691,109134,4557,4
"36065",36,65,2000,110407,106089,4318,3.9
"36065",36,65,2001,109312,104334,4978,4.6
"36065",36,65,2002,110986,105157,5829,5.3
"36065",36,65,2003,110669,104703,5966,5.4
"36065",36,65,2004,110572,104850,5722,5.2
"36065",36,65,2005,111233,105942,5291,4.8
"36065",36,65,2006,110879,106093,4786,4.3
"36065",36,65,2007,109920,105220,4700,4.3
"36065",36,65,2008,111293,105296,5997,5.4
"36065",36,65,2009,110627,102470,8157,7.4
"36065",36,65,2010,112248,103684,8564,7.6
"36065",36,65,2011,108979,100271,8708,8
"36065",36,65,2012,108562,99615,8947,8.2
"36065",36,65,2013,107247,99277,7970,7.4
"36065",36,65,2014,103624,97301,6323,6.1
"36065",36,65,2015,102702,97231,5471,5.3
"36065",36,65,2016,102330,97380,4950,4.8
"36065",36,65,2017,102069,96875,5194,5.1
"36067",36,67,1990,243773,234447,9326,3.8
"36067",36,67,1991,243836,229392,14444,5.9
"36067",36,67,1992,243036,227293,15743,6.5
"36067",36,67,1993,241118,226966,14152,5.9
"36067",36,67,1994,237613,225513,12100,5.1
"36067",36,67,1995,234975,224231,10744,4.6
"36067",36,67,1996,235901,226272,9629,4.1
"36067",36,67,1997,238127,228985,9142,3.8
"36067",36,67,1998,236948,228745,8203,3.5
"36067",36,67,1999,236047,227817,8230,3.5
"36067",36,67,2000,229488,221363,8125,3.5
"36067",36,67,2001,228985,219789,9196,4
"36067",36,67,2002,231850,220581,11269,4.9
"36067",36,67,2003,231168,219486,11682,5.1
"36067",36,67,2004,231608,219905,11703,5.1
"36067",36,67,2005,233689,223200,10489,4.5
"36067",36,67,2006,234218,224259,9959,4.3
"36067",36,67,2007,232522,223044,9478,4.1
"36067",36,67,2008,235592,223381,12211,5.2
"36067",36,67,2009,233629,215790,17839,7.6
"36067",36,67,2010,236994,217970,19024,8
"36067",36,67,2011,232622,214674,17948,7.7
"36067",36,67,2012,232973,214624,18349,7.9
"36067",36,67,2013,231715,215866,15849,6.8
"36067",36,67,2014,225647,213104,12543,5.6
"36067",36,67,2015,223748,212733,11015,4.9
"36067",36,67,2016,222636,212601,10035,4.5
"36067",36,67,2017,221699,211199,10500,4.7
"36069",36,69,1990,50781,48611,2170,4.3
"36069",36,69,1991,51803,48945,2858,5.5
"36069",36,69,1992,52174,48969,3205,6.1
"36069",36,69,1993,52516,49740,2776,5.3
"36069",36,69,1994,52698,49873,2825,5.4
"36069",36,69,1995,52803,50172,2631,5
"36069",36,69,1996,53655,51277,2378,4.4
"36069",36,69,1997,54543,52286,2257,4.1
"36069",36,69,1998,54709,52553,2156,3.9
"36069",36,69,1999,54476,52193,2283,4.2
"36069",36,69,2000,54309,52373,1936,3.6
"36069",36,69,2001,54356,52204,2152,4
"36069",36,69,2002,55033,52216,2817,5.1
"36069",36,69,2003,55127,52287,2840,5.2
"36069",36,69,2004,55564,52801,2763,5
"36069",36,69,2005,56825,54274,2551,4.5
"36069",36,69,2006,56820,54357,2463,4.3
"36069",36,69,2007,56227,53872,2355,4.2
"36069",36,69,2008,56982,54042,2940,5.2
"36069",36,69,2009,56956,52826,4130,7.3
"36069",36,69,2010,56368,52176,4192,7.4
"36069",36,69,2011,55756,51805,3951,7.1
"36069",36,69,2012,56046,51971,4075,7.3
"36069",36,69,2013,55910,52396,3514,6.3
"36069",36,69,2014,55012,52139,2873,5.2
"36069",36,69,2015,55378,52768,2610,4.7
"36069",36,69,2016,55433,53044,2389,4.3
"36069",36,69,2017,55175,52668,2507,4.5
"36071",36,71,1990,152875,146200,6675,4.4
"36071",36,71,1991,153823,144496,9327,6.1
"36071",36,71,1992,154908,144891,10017,6.5
"36071",36,71,1993,156289,146925,9364,6
"36071",36,71,1994,153861,145551,8310,5.4
"36071",36,71,1995,153086,145551,7535,4.9
"36071",36,71,1996,155024,148429,6595,4.3
"36071",36,71,1997,158131,151592,6539,4.1
"36071",36,71,1998,159112,153679,5433,3.4
"36071",36,71,1999,160987,155110,5877,3.7
"36071",36,71,2000,161294,155817,5477,3.4
"36071",36,71,2001,163868,157879,5989,3.7
"36071",36,71,2002,169020,161741,7279,4.3
"36071",36,71,2003,172258,164197,8061,4.7
"36071",36,71,2004,175164,166958,8206,4.7
"36071",36,71,2005,177596,170098,7498,4.2
"36071",36,71,2006,179908,172387,7521,4.2
"36071",36,71,2007,179230,171540,7690,4.3
"36071",36,71,2008,181533,171776,9757,5.4
"36071",36,71,2009,180483,166368,14115,7.8
"36071",36,71,2010,181295,166830,14465,8
"36071",36,71,2011,178868,165070,13798,7.7
"36071",36,71,2012,179621,165414,14207,7.9
"36071",36,71,2013,178952,166724,12228,6.8
"36071",36,71,2014,176202,166535,9667,5.5
"36071",36,71,2015,178984,170653,8331,4.7
"36071",36,71,2016,180097,172319,7778,4.3
"36071",36,71,2017,181557,173213,8344,4.6
"36073",36,73,1990,19713,18411,1302,6.6
"36073",36,73,1991,19982,18519,1463,7.3
"36073",36,73,1992,20608,18850,1758,8.5
"36073",36,73,1993,21248,19667,1581,7.4
"36073",36,73,1994,20952,19473,1479,7.1
"36073",36,73,1995,21250,19606,1644,7.7
"36073",36,73,1996,21047,19876,1171,5.6
"36073",36,73,1997,21496,20161,1335,6.2
"36073",36,73,1998,21544,20394,1150,5.3
"36073",36,73,1999,21371,20250,1121,5.2
"36073",36,73,2000,20207,19260,947,4.7
"36073",36,73,2001,19926,18903,1023,5.1
"36073",36,73,2002,19938,18683,1255,6.3
"36073",36,73,2003,19920,18543,1377,6.9
"36073",36,73,2004,19858,18596,1262,6.4
"36073",36,73,2005,19959,18838,1121,5.6
"36073",36,73,2006,19927,18811,1116,5.6
"36073",36,73,2007,19476,18349,1127,5.8
"36073",36,73,2008,19574,18214,1360,6.9
"36073",36,73,2009,19376,17571,1805,9.3
"36073",36,73,2010,19149,17314,1835,9.6
"36073",36,73,2011,18812,17075,1737,9.2
"36073",36,73,2012,18873,17045,1828,9.7
"36073",36,73,2013,18710,17009,1701,9.1
"36073",36,73,2014,18124,16737,1387,7.7
"36073",36,73,2015,17977,16834,1143,6.4
"36073",36,73,2016,17868,16847,1021,5.7
"36073",36,73,2017,17796,16738,1058,5.9
"36075",36,75,1990,57420,53453,3967,6.9
"36075",36,75,1991,58325,52473,5852,10
"36075",36,75,1992,58273,52244,6029,10.3
"36075",36,75,1993,57970,52578,5392,9.3
"36075",36,75,1994,57443,52431,5012,8.7
"36075",36,75,1995,57328,52439,4889,8.5
"36075",36,75,1996,57427,53429,3998,7
"36075",36,75,1997,58337,54305,4032,6.9
"36075",36,75,1998,57445,54154,3291,5.7
"36075",36,75,1999,57794,54161,3633,6.3
"36075",36,75,2000,58432,55621,2811,4.8
"36075",36,75,2001,58350,55246,3104,5.3
"36075",36,75,2002,59302,55523,3779,6.4
"36075",36,75,2003,59880,55518,4362,7.3
"36075",36,75,2004,59918,55798,4120,6.9
"36075",36,75,2005,60241,56509,3732,6.2
"36075",36,75,2006,60265,56799,3466,5.8
"36075",36,75,2007,59415,56086,3329,5.6
"36075",36,75,2008,60525,56314,4211,7
"36075",36,75,2009,60028,54139,5889,9.8
"36075",36,75,2010,58886,52618,6268,10.6
"36075",36,75,2011,57994,51752,6242,10.8
"36075",36,75,2012,57942,51585,6357,11
"36075",36,75,2013,57217,51569,5648,9.9
"36075",36,75,2014,55299,50834,4465,8.1
"36075",36,75,2015,54331,50435,3896,7.2
"36075",36,75,2016,53653,50191,3462,6.5
"36075",36,75,2017,53334,49850,3484,6.5
"36077",36,77,1990,29604,28103,1501,5.1
"36077",36,77,1991,30921,29090,1831,5.9
"36077",36,77,1992,31239,29068,2171,6.9
"36077",36,77,1993,31078,29166,1912,6.2
"36077",36,77,1994,30548,28673,1875,6.1
"36077",36,77,1995,30865,29184,1681,5.4
"36077",36,77,1996,31472,29852,1620,5.1
"36077",36,77,1997,31857,30163,1694,5.3
"36077",36,77,1998,31760,30176,1584,5
"36077",36,77,1999,32092,30432,1660,5.2
"36077",36,77,2000,29583,28322,1261,4.3
"36077",36,77,2001,30155,28876,1279,4.2
"36077",36,77,2002,31281,29826,1455,4.7
"36077",36,77,2003,31024,29528,1496,4.8
"36077",36,77,2004,31411,29887,1524,4.9
"36077",36,77,2005,31942,30507,1435,4.5
"36077",36,77,2006,31984,30585,1399,4.4
"36077",36,77,2007,31622,30194,1428,4.5
"36077",36,77,2008,31703,29900,1803,5.7
"36077",36,77,2009,31640,29261,2379,7.5
"36077",36,77,2010,31880,29469,2411,7.6
"36077",36,77,2011,31375,28950,2425,7.7
"36077",36,77,2012,31460,28988,2472,7.9
"36077",36,77,2013,31133,29012,2121,6.8
"36077",36,77,2014,30135,28417,1718,5.7
"36077",36,77,2015,28868,27313,1555,5.4
"36077",36,77,2016,28391,26997,1394,4.9
"36077",36,77,2017,28231,26796,1435,5.1
"36079",36,79,1990,48024,46442,1582,3.3
"36079",36,79,1991,48573,45998,2575,5.3
"36079",36,79,1992,48520,45596,2924,6
"36079",36,79,1993,48577,45982,2595,5.3
"36079",36,79,1994,48553,46286,2267,4.7
"36079",36,79,1995,49046,47127,1919,3.9
"36079",36,79,1996,50023,48244,1779,3.6
"36079",36,79,1997,52058,50477,1581,3
"36079",36,79,1998,53961,52529,1432,2.7
"36079",36,79,1999,55339,53758,1581,2.9
"36079",36,79,2000,52023,50498,1525,2.9
"36079",36,79,2001,52507,50839,1668,3.2
"36079",36,79,2002,53815,51696,2119,3.9
"36079",36,79,2003,54374,52196,2178,4
"36079",36,79,2004,55319,53132,2187,4
"36079",36,79,2005,56067,53984,2083,3.7
"36079",36,79,2006,56183,54225,1958,3.5
"36079",36,79,2007,55673,53787,1886,3.4
"36079",36,79,2008,56065,53581,2484,4.4
"36079",36,79,2009,55010,51328,3682,6.7
"36079",36,79,2010,52594,48807,3787,7.2
"36079",36,79,2011,51607,47980,3627,7
"36079",36,79,2012,51603,47899,3704,7.2
"36079",36,79,2013,51371,48251,3120,6.1
"36079",36,79,2014,50488,48012,2476,4.9
"36079",36,79,2015,50903,48735,2168,4.3
"36079",36,79,2016,51024,48994,2030,4
"36079",36,79,2017,51333,49150,2183,4.3
"36081",36,81,1990,951544,894340,57204,6
"36081",36,81,1991,937529,862172,75357,8
"36081",36,81,1992,949368,848915,100453,10.6
"36081",36,81,1993,945067,853345,91722,9.7
"36081",36,81,1994,944035,865918,78117,8.3
"36081",36,81,1995,946007,873978,72029,7.6
"36081",36,81,1996,972370,893569,78801,8.1
"36081",36,81,1997,1007533,921189,86344,8.6
"36081",36,81,1998,1021305,950752,70553,6.9
"36081",36,81,1999,1039869,977017,62852,6
"36081",36,81,2000,1064415,1008221,56194,5.3
"36081",36,81,2001,1063736,1007593,56143,5.3
"36081",36,81,2002,1065959,990084,75875,7.1
"36081",36,81,2003,1054959,976778,78181,7.4
"36081",36,81,2004,1072546,1004676,67870,6.3
"36081",36,81,2005,1090028,1032819,57209,5.2
"36081",36,81,2006,1091546,1042607,48939,4.5
"36081",36,81,2007,1102350,1052959,49391,4.5
"36081",36,81,2008,1120482,1064170,56312,5
"36081",36,81,2009,1129395,1034421,94974,8.4
"36081",36,81,2010,1106461,1011049,95412,8.6
"36081",36,81,2011,1108920,1019249,89671,8.1
"36081",36,81,2012,1124169,1031021,93148,8.3
"36081",36,81,2013,1143134,1054708,88426,7.7
"36081",36,81,2014,1159346,1085553,73793,6.4
"36081",36,81,2015,1171067,1112332,58735,5
"36081",36,81,2016,1180920,1127490,53430,4.5
"36081",36,81,2017,1190292,1143025,47267,4
"36083",36,83,1990,81515,78212,3303,4.1
"36083",36,83,1991,82224,77166,5058,6.2
"36083",36,83,1992,82102,76869,5233,6.4
"36083",36,83,1993,82131,77853,4278,5.2
"36083",36,83,1994,82454,78088,4366,5.3
"36083",36,83,1995,80670,76308,4362,5.4
"36083",36,83,1996,80500,76560,3940,4.9
"36083",36,83,1997,81493,77798,3695,4.5
"36083",36,83,1998,81032,77768,3264,4
"36083",36,83,1999,80379,77241,3138,3.9
"36083",36,83,2000,80419,77484,2935,3.6
"36083",36,83,2001,80796,77726,3070,3.8
"36083",36,83,2002,82208,78493,3715,4.5
"36083",36,83,2003,82105,78326,3779,4.6
"36083",36,83,2004,83071,79250,3821,4.6
"36083",36,83,2005,83813,80311,3502,4.2
"36083",36,83,2006,83873,80475,3398,4.1
"36083",36,83,2007,83128,79590,3538,4.3
"36083",36,83,2008,84331,79974,4357,5.2
"36083",36,83,2009,83896,77680,6216,7.4
"36083",36,83,2010,84603,78045,6558,7.8
"36083",36,83,2011,82767,76480,6287,7.6
"36083",36,83,2012,83602,77126,6476,7.7
"36083",36,83,2013,83498,77929,5569,6.7
"36083",36,83,2014,81513,77137,4376,5.4
"36083",36,83,2015,82047,78237,3810,4.6
"36083",36,83,2016,82111,78594,3517,4.3
"36083",36,83,2017,82277,78608,3669,4.5
"36085",36,85,1990,180326,169242,11084,6.1
"36085",36,85,1991,179804,165522,14282,7.9
"36085",36,85,1992,183318,165170,18148,9.9
"36085",36,85,1993,184816,167449,17367,9.4
"36085",36,85,1994,184530,170126,14404,7.8
"36085",36,85,1995,184479,170734,13745,7.5
"36085",36,85,1996,190600,175707,14893,7.8
"36085",36,85,1997,198049,181419,16630,8.4
"36085",36,85,1998,202597,188688,13909,6.9
"36085",36,85,1999,208191,196207,11984,5.8
"36085",36,85,2000,217223,206215,11008,5.1
"36085",36,85,2001,218353,207249,11104,5.1
"36085",36,85,2002,220908,205571,15337,6.9
"36085",36,85,2003,221855,205235,16620,7.5
"36085",36,85,2004,226083,211569,14514,6.4
"36085",36,85,2005,231455,219267,12188,5.3
"36085",36,85,2006,236624,226076,10548,4.5
"36085",36,85,2007,239789,228808,10981,4.6
"36085",36,85,2008,244150,231712,12438,5.1
"36085",36,85,2009,246087,225883,20204,8.2
"36085",36,85,2010,216950,196490,20460,9.4
"36085",36,85,2011,216722,196872,19850,9.2
"36085",36,85,2012,218237,197583,20654,9.5
"36085",36,85,2013,221068,201233,19835,9
"36085",36,85,2014,221656,205156,16500,7.4
"36085",36,85,2015,222148,209186,12962,5.8
"36085",36,85,2016,225069,213322,11747,5.2
"36085",36,85,2017,226924,216508,10416,4.6
"36087",36,87,1990,144499,139680,4819,3.3
"36087",36,87,1991,142651,134621,8030,5.6
"36087",36,87,1992,142117,132981,9136,6.4
"36087",36,87,1993,144276,135353,8923,6.2
"36087",36,87,1994,142754,135129,7625,5.3
"36087",36,87,1995,140629,133737,6892,4.9
"36087",36,87,1996,141237,135156,6081,4.3
"36087",36,87,1997,144190,138406,5784,4
"36087",36,87,1998,147574,142601,4973,3.4
"36087",36,87,1999,148554,143483,5071,3.4
"36087",36,87,2000,144031,139261,4770,3.3
"36087",36,87,2001,144364,139272,5092,3.5
"36087",36,87,2002,147190,140806,6384,4.3
"36087",36,87,2003,148401,141503,6898,4.6
"36087",36,87,2004,149804,143168,6636,4.4
"36087",36,87,2005,151221,145210,6011,4
"36087",36,87,2006,152379,146739,5640,3.7
"36087",36,87,2007,153871,147944,5927,3.9
"36087",36,87,2008,156197,148768,7429,4.8
"36087",36,87,2009,153851,143259,10592,6.9
"36087",36,87,2010,149978,138804,11174,7.5
"36087",36,87,2011,148873,138245,10628,7.1
"36087",36,87,2012,150454,139454,11000,7.3
"36087",36,87,2013,150777,141334,9443,6.3
"36087",36,87,2014,150029,142290,7739,5.2
"36087",36,87,2015,153062,146141,6921,4.5
"36087",36,87,2016,153536,147108,6428,4.2
"36087",36,87,2017,154508,147720,6788,4.4
"36089",36,89,1990,49480,45547,3933,7.9
"36089",36,89,1991,51678,46614,5064,9.8
"36089",36,89,1992,51773,46679,5094,9.8
"36089",36,89,1993,50961,46401,4560,8.9
"36089",36,89,1994,51319,46501,4818,9.4
"36089",36,89,1995,50794,46521,4273,8.4
"36089",36,89,1996,51053,46933,4120,8.1
"36089",36,89,1997,51695,47560,4135,8
"36089",36,89,1998,52038,47917,4121,7.9
"36089",36,89,1999,52070,47776,4294,8.2
"36089",36,89,2000,48706,45912,2794,5.7
"36089",36,89,2001,48721,45759,2962,6.1
"36089",36,89,2002,49830,46562,3268,6.6
"36089",36,89,2003,49310,45857,3453,7
"36089",36,89,2004,49052,45626,3426,7
"36089",36,89,2005,49164,46189,2975,6.1
"36089",36,89,2006,49620,46793,2827,5.7
"36089",36,89,2007,49337,46476,2861,5.8
"36089",36,89,2008,50282,46719,3563,7.1
"36089",36,89,2009,49756,44882,4874,9.8
"36089",36,89,2010,49964,44802,5162,10.3
"36089",36,89,2011,48900,43824,5076,10.4
"36089",36,89,2012,48589,43627,4962,10.2
"36089",36,89,2013,48498,44069,4429,9.1
"36089",36,89,2014,47277,43618,3659,7.7
"36089",36,89,2015,44139,40922,3217,7.3
"36089",36,89,2016,43643,40769,2874,6.6
"36089",36,89,2017,43612,40661,2951,6.8
"36091",36,91,1990,96777,93263,3514,3.6
"36091",36,91,1991,98030,92680,5350,5.5
"36091",36,91,1992,99307,93485,5822,5.9
"36091",36,91,1993,100413,95414,4999,5
"36091",36,91,1994,102495,97576,4919,4.8
"36091",36,91,1995,101289,96527,4762,4.7
"36091",36,91,1996,101707,97324,4383,4.3
"36091",36,91,1997,104271,100219,4052,3.9
"36091",36,91,1998,105714,102063,3651,3.5
"36091",36,91,1999,106561,103063,3498,3.3
"36091",36,91,2000,110124,106435,3689,3.3
"36091",36,91,2001,112163,108414,3749,3.3
"36091",36,91,2002,115221,110821,4400,3.8
"36091",36,91,2003,116292,111699,4593,3.9
"36091",36,91,2004,118025,113447,4578,3.9
"36091",36,91,2005,119981,115603,4378,3.6
"36091",36,91,2006,120351,116140,4211,3.5
"36091",36,91,2007,119421,115047,4374,3.7
"36091",36,91,2008,121922,116361,5561,4.6
"36091",36,91,2009,122056,114315,7741,6.3
"36091",36,91,2010,118048,109910,8138,6.9
"36091",36,91,2011,115669,107973,7696,6.7
"36091",36,91,2012,117525,109520,8005,6.8
"36091",36,91,2013,118109,111244,6865,5.8
"36091",36,91,2014,116159,110745,5414,4.7
"36091",36,91,2015,117549,112677,4872,4.1
"36091",36,91,2016,118251,113742,4509,3.8
"36091",36,91,2017,118482,113720,4762,4
"36093",36,93,1990,75314,72403,2911,3.9
"36093",36,93,1991,75839,71363,4476,5.9
"36093",36,93,1992,75631,70879,4752,6.3
"36093",36,93,1993,75243,71371,3872,5.1
"36093",36,93,1994,75347,71654,3693,4.9
"36093",36,93,1995,73895,70017,3878,5.2
"36093",36,93,1996,73223,69780,3443,4.7
"36093",36,93,1997,74314,71009,3305,4.4
"36093",36,93,1998,74012,71034,2978,4
"36093",36,93,1999,72855,70300,2555,3.5
"36093",36,93,2000,72222,69694,2528,3.5
"36093",36,93,2001,72300,69850,2450,3.4
"36093",36,93,2002,73836,70800,3036,4.1
"36093",36,93,2003,73783,70480,3303,4.5
"36093",36,93,2004,74521,71184,3337,4.5
"36093",36,93,2005,75405,72261,3144,4.2
"36093",36,93,2006,76133,73050,3083,4
"36093",36,93,2007,75551,72418,3133,4.1
"36093",36,93,2008,77005,73087,3918,5.1
"36093",36,93,2009,76792,71210,5582,7.3
"36093",36,93,2010,79016,72974,6042,7.6
"36093",36,93,2011,77068,71293,5775,7.5
"36093",36,93,2012,78052,72058,5994,7.7
"36093",36,93,2013,78057,72831,5226,6.7
"36093",36,93,2014,76434,72338,4096,5.4
"36093",36,93,2015,76183,72596,3587,4.7
"36093",36,93,2016,76287,72983,3304,4.3
"36093",36,93,2017,76475,73008,3467,4.5
"36095",36,95,1990,15152,14371,781,5.2
"36095",36,95,1991,15470,14358,1112,7.2
"36095",36,95,1992,15709,14392,1317,8.4
"36095",36,95,1993,15608,14546,1062,6.8
"36095",36,95,1994,15542,14582,960,6.2
"36095",36,95,1995,15264,14324,940,6.2
"36095",36,95,1996,15359,14433,926,6
"36095",36,95,1997,15551,14638,913,5.9
"36095",36,95,1998,15318,14561,757,4.9
"36095",36,95,1999,15326,14524,802,5.2
"36095",36,95,2000,15120,14469,651,4.3
"36095",36,95,2001,15243,14596,647,4.2
"36095",36,95,2002,15565,14690,875,5.6
"36095",36,95,2003,15464,14644,820,5.3
"36095",36,95,2004,15633,14777,856,5.5
"36095",36,95,2005,15856,15056,800,5
"36095",36,95,2006,15849,15045,804,5.1
"36095",36,95,2007,15725,14816,909,5.8
"36095",36,95,2008,15914,14822,1092,6.9
"36095",36,95,2009,15581,14198,1383,8.9
"36095",36,95,2010,15924,14504,1420,8.9
"36095",36,95,2011,15557,14163,1394,9
"36095",36,95,2012,15455,14034,1421,9.2
"36095",36,95,2013,15298,14057,1241,8.1
"36095",36,95,2014,14804,13813,991,6.7
"36095",36,95,2015,14757,13901,856,5.8
"36095",36,95,2016,14820,14017,803,5.4
"36095",36,95,2017,14823,14005,818,5.5
"36097",36,97,1990,9169,8661,508,5.5
"36097",36,97,1991,9203,8495,708,7.7
"36097",36,97,1992,9119,8336,783,8.6
"36097",36,97,1993,8893,8226,667,7.5
"36097",36,97,1994,8634,8039,595,6.9
"36097",36,97,1995,8776,8246,530,6
"36097",36,97,1996,9056,8550,506,5.6
"36097",36,97,1997,8996,8464,532,5.9
"36097",36,97,1998,8890,8363,527,5.9
"36097",36,97,1999,9130,8606,524,5.7
"36097",36,97,2000,9352,8930,422,4.5
"36097",36,97,2001,9418,8912,506,5.4
"36097",36,97,2002,9644,8976,668,6.9
"36097",36,97,2003,9782,9154,628,6.4
"36097",36,97,2004,9797,9217,580,5.9
"36097",36,97,2005,9881,9342,539,5.5
"36097",36,97,2006,9969,9470,499,5
"36097",36,97,2007,9965,9468,497,5
"36097",36,97,2008,10157,9568,589,5.8
"36097",36,97,2009,10054,9215,839,8.3
"36097",36,97,2010,9042,8220,822,9.1
"36097",36,97,2011,9008,8212,796,8.8
"36097",36,97,2012,9032,8184,848,9.4
"36097",36,97,2013,8880,8099,781,8.8
"36097",36,97,2014,8643,8037,606,7
"36097",36,97,2015,8399,7845,554,6.6
"36097",36,97,2016,8331,7830,501,6
"36097",36,97,2017,8291,7804,487,5.9
"36099",36,99,1990,16390,15620,770,4.7
"36099",36,99,1991,16525,15510,1015,6.1
"36099",36,99,1992,16831,15730,1101,6.5
"36099",36,99,1993,16104,15078,1026,6.4
"36099",36,99,1994,15557,14611,946,6.1
"36099",36,99,1995,14935,14040,895,6
"36099",36,99,1996,15296,14482,814,5.3
"36099",36,99,1997,15371,14531,840,5.5
"36099",36,99,1998,15718,14951,767,4.9
"36099",36,99,1999,15952,15084,868,5.4
"36099",36,99,2000,16342,15659,683,4.2
"36099",36,99,2001,16501,15795,706,4.3
"36099",36,99,2002,17066,16148,918,5.4
"36099",36,99,2003,17178,16253,925,5.4
"36099",36,99,2004,17221,16323,898,5.2
"36099",36,99,2005,17337,16532,805,4.6
"36099",36,99,2006,17336,16563,773,4.5
"36099",36,99,2007,16993,16237,756,4.4
"36099",36,99,2008,17185,16237,948,5.5
"36099",36,99,2009,17207,15903,1304,7.6
"36099",36,99,2010,16423,15078,1345,8.2
"36099",36,99,2011,16104,14829,1275,7.9
"36099",36,99,2012,16242,14946,1296,8
"36099",36,99,2013,15922,14817,1105,6.9
"36099",36,99,2014,15584,14708,876,5.6
"36099",36,99,2015,15812,15000,812,5.1
"36099",36,99,2016,15591,14849,742,4.8
"36099",36,99,2017,16266,15518,748,4.6
"36101",36,101,1990,46510,44085,2425,5.2
"36101",36,101,1991,48032,44519,3513,7.3
"36101",36,101,1992,48738,44823,3915,8
"36101",36,101,1993,48495,45273,3222,6.6
"36101",36,101,1994,48559,45397,3162,6.5
"36101",36,101,1995,47947,44723,3224,6.7
"36101",36,101,1996,48370,45499,2871,5.9
"36101",36,101,1997,49299,46053,3246,6.6
"36101",36,101,1998,48430,45521,2909,6
"36101",36,101,1999,48257,45527,2730,5.7
"36101",36,101,2000,47811,45841,1970,4.1
"36101",36,101,2001,48307,45938,2369,4.9
"36101",36,101,2002,47105,43780,3325,7.1
"36101",36,101,2003,44926,41653,3273,7.3
"36101",36,101,2004,44118,41300,2818,6.4
"36101",36,101,2005,44595,42072,2523,5.7
"36101",36,101,2006,44698,42367,2331,5.2
"36101",36,101,2007,44734,42386,2348,5.2
"36101",36,101,2008,45922,43132,2790,6.1
"36101",36,101,2009,46013,41573,4440,9.6
"36101",36,101,2010,47303,42780,4523,9.6
"36101",36,101,2011,46123,41919,4204,9.1
"36101",36,101,2012,45823,41544,4279,9.3
"36101",36,101,2013,45687,41830,3857,8.4
"36101",36,101,2014,44285,41237,3048,6.9
"36101",36,101,2015,43956,41194,2762,6.3
"36101",36,101,2016,43446,40919,2527,5.8
"36101",36,101,2017,43104,40603,2501,5.8
"36103",36,103,1990,710029,678592,31437,4.4
"36103",36,103,1991,701133,652613,48520,6.9
"36103",36,103,1992,696219,639404,56815,8.2
"36103",36,103,1993,695135,644627,50508,7.3
"36103",36,103,1994,692849,649778,43071,6.2
"36103",36,103,1995,692879,655549,37330,5.4
"36103",36,103,1996,700920,668660,32260,4.6
"36103",36,103,1997,716299,686063,30236,4.2
"36103",36,103,1998,723546,697830,25716,3.6
"36103",36,103,1999,731693,705583,26110,3.6
"36103",36,103,2000,731428,706167,25261,3.5
"36103",36,103,2001,737015,709002,28013,3.8
"36103",36,103,2002,754013,718973,35040,4.6
"36103",36,103,2003,760943,724648,36295,4.8
"36103",36,103,2004,768946,733115,35831,4.7
"36103",36,103,2005,777672,745077,32595,4.2
"36103",36,103,2006,787066,756494,30572,3.9
"36103",36,103,2007,787940,757541,30399,3.9
"36103",36,103,2008,799996,759899,40097,5
"36103",36,103,2009,791881,734271,57610,7.3
"36103",36,103,2010,777863,717598,60265,7.7
"36103",36,103,2011,770533,711930,58603,7.6
"36103",36,103,2012,779400,718733,60667,7.8
"36103",36,103,2013,781627,730042,51585,6.6
"36103",36,103,2014,769481,728090,41391,5.4
"36103",36,103,2015,780621,743913,36708,4.7
"36103",36,103,2016,779202,745241,33961,4.4
"36103",36,103,2017,782689,747145,35544,4.5
"36105",36,105,1990,33349,31637,1712,5.1
"36105",36,105,1991,33311,30627,2684,8.1
"36105",36,105,1992,33681,30627,3054,9.1
"36105",36,105,1993,33526,30788,2738,8.2
"36105",36,105,1994,32712,30260,2452,7.5
"36105",36,105,1995,32250,30211,2039,6.3
"36105",36,105,1996,32527,30447,2080,6.4
"36105",36,105,1997,31804,29759,2045,6.4
"36105",36,105,1998,31639,29695,1944,6.1
"36105",36,105,1999,31607,29766,1841,5.8
"36105",36,105,2000,32971,31523,1448,4.4
"36105",36,105,2001,33262,31753,1509,4.5
"36105",36,105,2002,34326,32623,1703,5
"36105",36,105,2003,34390,32597,1793,5.2
"36105",36,105,2004,34923,33073,1850,5.3
"36105",36,105,2005,35159,33456,1703,4.8
"36105",36,105,2006,35383,33611,1772,5
"36105",36,105,2007,35227,33391,1836,5.2
"36105",36,105,2008,35661,33339,2322,6.5
"36105",36,105,2009,35381,32309,3072,8.7
"36105",36,105,2010,36475,33226,3249,8.9
"36105",36,105,2011,35480,32335,3145,8.9
"36105",36,105,2012,35311,32093,3218,9.1
"36105",36,105,2013,34588,31778,2810,8.1
"36105",36,105,2014,33423,31229,2194,6.6
"36105",36,105,2015,33904,32077,1827,5.4
"36105",36,105,2016,34260,32623,1637,4.8
"36105",36,105,2017,34590,32885,1705,4.9
"36107",36,107,1990,26362,25217,1145,4.3
"36107",36,107,1991,26471,24914,1557,5.9
"36107",36,107,1992,26485,24728,1757,6.6
"36107",36,107,1993,26360,24667,1693,6.4
"36107",36,107,1994,26432,24632,1800,6.8
"36107",36,107,1995,25782,24325,1457,5.7
"36107",36,107,1996,25779,24587,1192,4.6
"36107",36,107,1997,26596,25545,1051,4
"36107",36,107,1998,26711,25714,997,3.7
"36107",36,107,1999,26689,25690,999,3.7
"36107",36,107,2000,26398,25482,916,3.5
"36107",36,107,2001,26467,25380,1087,4.1
"36107",36,107,2002,26729,25272,1457,5.5
"36107",36,107,2003,26318,24842,1476,5.6
"36107",36,107,2004,26140,24779,1361,5.2
"36107",36,107,2005,26310,25069,1241,4.7
"36107",36,107,2006,26454,25325,1129,4.3
"36107",36,107,2007,26179,24952,1227,4.7
"36107",36,107,2008,26367,24973,1394,5.3
"36107",36,107,2009,26244,24124,2120,8.1
"36107",36,107,2010,26568,24448,2120,8
"36107",36,107,2011,25818,23832,1986,7.7
"36107",36,107,2012,25466,23457,2009,7.9
"36107",36,107,2013,24972,23194,1778,7.1
"36107",36,107,2014,23884,22428,1456,6.1
"36107",36,107,2015,23517,22216,1301,5.5
"36107",36,107,2016,23168,21980,1188,5.1
"36107",36,107,2017,22978,21788,1190,5.2
"36109",36,109,1990,48973,47143,1830,3.7
"36109",36,109,1991,48479,46402,2077,4.3
"36109",36,109,1992,48329,46072,2257,4.7
"36109",36,109,1993,48739,46763,1976,4.1
"36109",36,109,1994,48891,47036,1855,3.8
"36109",36,109,1995,49078,47356,1722,3.5
"36109",36,109,1996,49555,48057,1498,3
"36109",36,109,1997,50337,48763,1574,3.1
"36109",36,109,1998,50527,49054,1473,2.9
"36109",36,109,1999,52129,50685,1444,2.8
"36109",36,109,2000,50538,48872,1666,3.3
"36109",36,109,2001,51243,49518,1725,3.4
"36109",36,109,2002,52573,50444,2129,4
"36109",36,109,2003,53288,51200,2088,3.9
"36109",36,109,2004,54010,51837,2173,4
"36109",36,109,2005,54600,52653,1947,3.6
"36109",36,109,2006,55378,53506,1872,3.4
"36109",36,109,2007,55351,53485,1866,3.4
"36109",36,109,2008,56222,53896,2326,4.1
"36109",36,109,2009,56661,53344,3317,5.9
"36109",36,109,2010,54767,51397,3370,6.2
"36109",36,109,2011,54190,50910,3280,6.1
"36109",36,109,2012,55074,51699,3375,6.1
"36109",36,109,2013,55924,53012,2912,5.2
"36109",36,109,2014,55000,52589,2411,4.4
"36109",36,109,2015,50714,48486,2228,4.4
"36109",36,109,2016,50697,48590,2107,4.2
"36109",36,109,2017,50395,48184,2211,4.4
"36111",36,111,1990,84549,81448,3101,3.7
"36111",36,111,1991,84970,79924,5046,5.9
"36111",36,111,1992,84122,78521,5601,6.7
"36111",36,111,1993,83191,77066,6125,7.4
"36111",36,111,1994,80707,75394,5313,6.6
"36111",36,111,1995,78450,74175,4275,5.4
"36111",36,111,1996,78004,74490,3514,4.5
"36111",36,111,1997,81011,77672,3339,4.1
"36111",36,111,1998,82534,79657,2877,3.5
"36111",36,111,1999,83583,80624,2959,3.5
"36111",36,111,2000,88059,84900,3159,3.6
"36111",36,111,2001,88191,84850,3341,3.8
"36111",36,111,2002,90790,86817,3973,4.4
"36111",36,111,2003,91397,87246,4151,4.5
"36111",36,111,2004,91379,86945,4434,4.9
"36111",36,111,2005,91816,87828,3988,4.3
"36111",36,111,2006,92551,88744,3807,4.1
"36111",36,111,2007,90485,86555,3930,4.3
"36111",36,111,2008,90715,85770,4945,5.5
"36111",36,111,2009,89944,83014,6930,7.7
"36111",36,111,2010,93606,86310,7296,7.8
"36111",36,111,2011,91289,84123,7166,7.8
"36111",36,111,2012,91045,83508,7537,8.3
"36111",36,111,2013,90350,83899,6451,7.1
"36111",36,111,2014,88385,83349,5036,5.7
"36111",36,111,2015,88848,84584,4264,4.8
"36111",36,111,2016,88746,84824,3922,4.4
"36111",36,111,2017,88895,84798,4097,4.6
"36113",36,113,1990,30895,29098,1797,5.8
"36113",36,113,1991,31655,28903,2752,8.7
"36113",36,113,1992,31941,28905,3036,9.5
"36113",36,113,1993,31909,29264,2645,8.3
"36113",36,113,1994,32642,30126,2516,7.7
"36113",36,113,1995,32845,30516,2329,7.1
"36113",36,113,1996,32539,30308,2231,6.9
"36113",36,113,1997,32613,30403,2210,6.8
"36113",36,113,1998,32361,30340,2021,6.2
"36113",36,113,1999,32103,30224,1879,5.9
"36113",36,113,2000,33152,31763,1389,4.2
"36113",36,113,2001,33280,31809,1471,4.4
"36113",36,113,2002,33753,32083,1670,4.9
"36113",36,113,2003,34478,32729,1749,5.1
"36113",36,113,2004,34999,33286,1713,4.9
"36113",36,113,2005,35471,33852,1619,4.6
"36113",36,113,2006,36502,34876,1626,4.5
"36113",36,113,2007,36324,34706,1618,4.5
"36113",36,113,2008,36689,34624,2065,5.6
"36113",36,113,2009,36435,33557,2878,7.9
"36113",36,113,2010,34154,31082,3072,9
"36113",36,113,2011,33619,30619,3000,8.9
"36113",36,113,2012,33761,30660,3101,9.2
"36113",36,113,2013,33147,30437,2710,8.2
"36113",36,113,2014,32440,30305,2135,6.6
"36113",36,113,2015,32441,30647,1794,5.5
"36113",36,113,2016,32198,30508,1690,5.2
"36113",36,113,2017,32188,30476,1712,5.3
"36115",36,115,1990,28577,27040,1537,5.4
"36115",36,115,1991,29037,26887,2150,7.4
"36115",36,115,1992,29147,26802,2345,8
"36115",36,115,1993,28916,26971,1945,6.7
"36115",36,115,1994,29629,27761,1868,6.3
"36115",36,115,1995,29826,28059,1767,5.9
"36115",36,115,1996,29370,27727,1643,5.6
"36115",36,115,1997,29661,27930,1731,5.8
"36115",36,115,1998,29088,27687,1401,4.8
"36115",36,115,1999,28795,27486,1309,4.5
"36115",36,115,2000,29981,28859,1122,3.7
"36115",36,115,2001,30098,28888,1210,4
"36115",36,115,2002,30422,29030,1392,4.6
"36115",36,115,2003,30963,29561,1402,4.5
"36115",36,115,2004,31796,30299,1497,4.7
"36115",36,115,2005,32144,30708,1436,4.5
"36115",36,115,2006,32887,31550,1337,4.1
"36115",36,115,2007,32403,31060,1343,4.1
"36115",36,115,2008,32850,31099,1751,5.3
"36115",36,115,2009,32510,30092,2418,7.4
"36115",36,115,2010,30233,27741,2492,8.2
"36115",36,115,2011,29721,27318,2403,8.1
"36115",36,115,2012,29899,27426,2473,8.3
"36115",36,115,2013,29415,27222,2193,7.5
"36115",36,115,2014,28691,26946,1745,6.1
"36115",36,115,2015,28818,27373,1445,5
"36115",36,115,2016,28534,27205,1329,4.7
"36115",36,115,2017,28504,27166,1338,4.7
"36117",36,117,1990,46175,43957,2218,4.8
"36117",36,117,1991,47277,44220,3057,6.5
"36117",36,117,1992,47638,44163,3475,7.3
"36117",36,117,1993,48023,45088,2935,6.1
"36117",36,117,1994,48224,45298,2926,6.1
"36117",36,117,1995,48621,45901,2720,5.6
"36117",36,117,1996,49519,47031,2488,5
"36117",36,117,1997,50208,47808,2400,4.8
"36117",36,117,1998,50830,48422,2408,4.7
"36117",36,117,1999,50688,48177,2511,5
"36117",36,117,2000,48722,46858,1864,3.8
"36117",36,117,2001,48694,46452,2242,4.6
"36117",36,117,2002,49096,46035,3061,6.2
"36117",36,117,2003,48701,45823,2878,5.9
"36117",36,117,2004,48515,45843,2672,5.5
"36117",36,117,2005,48987,46588,2399,4.9
"36117",36,117,2006,48603,46348,2255,4.6
"36117",36,117,2007,47564,45317,2247,4.7
"36117",36,117,2008,48189,45369,2820,5.9
"36117",36,117,2009,47691,43725,3966,8.3
"36117",36,117,2010,47429,43227,4202,8.9
"36117",36,117,2011,46445,42533,3912,8.4
"36117",36,117,2012,46529,42536,3993,8.6
"36117",36,117,2013,45964,42482,3482,7.6
"36117",36,117,2014,44604,41851,2753,6.2
"36117",36,117,2015,44542,42174,2368,5.3
"36117",36,117,2016,44282,42077,2205,5
"36117",36,117,2017,44024,41803,2221,5
"36119",36,119,1990,472146,455423,16723,3.5
"36119",36,119,1991,461417,436529,24888,5.4
"36119",36,119,1992,453727,425595,28132,6.2
"36119",36,119,1993,444257,419654,24603,5.5
"36119",36,119,1994,439448,417820,21628,4.9
"36119",36,119,1995,438004,418645,19359,4.4
"36119",36,119,1996,445777,427675,18102,4.1
"36119",36,119,1997,453117,436277,16840,3.7
"36119",36,119,1998,454002,438915,15087,3.3
"36119",36,119,1999,455085,439711,15374,3.4
"36119",36,119,2000,461112,445401,15711,3.4
"36119",36,119,2001,463716,446213,17503,3.8
"36119",36,119,2002,471246,450012,21234,4.5
"36119",36,119,2003,472045,450950,21095,4.5
"36119",36,119,2004,477966,456741,21225,4.4
"36119",36,119,2005,482484,463188,19296,4
"36119",36,119,2006,487426,469034,18392,3.8
"36119",36,119,2007,489581,471440,18141,3.7
"36119",36,119,2008,495831,472088,23743,4.8
"36119",36,119,2009,487641,453096,34545,7.1
"36119",36,119,2010,478676,443476,35200,7.4
"36119",36,119,2011,473504,440021,33483,7.1
"36119",36,119,2012,477481,442827,34654,7.3
"36119",36,119,2013,477670,447795,29875,6.3
"36119",36,119,2014,472758,448482,24276,5.1
"36119",36,119,2015,481220,459373,21847,4.5
"36119",36,119,2016,480991,460382,20609,4.3
"36119",36,119,2017,484107,462054,22053,4.6
"36121",36,121,1990,19788,18635,1153,5.8
"36121",36,121,1991,20120,18457,1663,8.3
"36121",36,121,1992,20278,18499,1779,8.8
"36121",36,121,1993,20929,19247,1682,8
"36121",36,121,1994,21642,19939,1703,7.9
"36121",36,121,1995,21289,19848,1441,6.8
"36121",36,121,1996,20481,19138,1343,6.6
"36121",36,121,1997,20882,19464,1418,6.8
"36121",36,121,1998,20888,19285,1603,7.7
"36121",36,121,1999,20880,19392,1488,7.1
"36121",36,121,2000,20236,19274,962,4.8
"36121",36,121,2001,20305,19310,995,4.9
"36121",36,121,2002,21206,20000,1206,5.7
"36121",36,121,2003,21091,19821,1270,6
"36121",36,121,2004,20999,19691,1308,6.2
"36121",36,121,2005,21431,20307,1124,5.2
"36121",36,121,2006,21824,20767,1057,4.8
"36121",36,121,2007,21424,20375,1049,4.9
"36121",36,121,2008,21392,20062,1330,6.2
"36121",36,121,2009,21030,19147,1883,9
"36121",36,121,2010,19457,17616,1841,9.5
"36121",36,121,2011,18881,17232,1649,8.7
"36121",36,121,2012,18902,17229,1673,8.9
"36121",36,121,2013,18818,17327,1491,7.9
"36121",36,121,2014,18435,17234,1201,6.5
"36121",36,121,2015,18483,17443,1040,5.6
"36121",36,121,2016,18226,17255,971,5.3
"36121",36,121,2017,18086,17057,1029,5.7
"36123",36,123,1990,11016,10448,568,5.2
"36123",36,123,1991,11544,10767,777,6.7
"36123",36,123,1992,11632,10795,837,7.2
"36123",36,123,1993,11842,11178,664,5.6
"36123",36,123,1994,12398,11752,646,5.2
"36123",36,123,1995,12947,12339,608,4.7
"36123",36,123,1996,13117,12581,536,4.1
"36123",36,123,1997,13569,13007,562,4.1
"36123",36,123,1998,13485,12966,519,3.8
"36123",36,123,1999,13683,13128,555,4.1
"36123",36,123,2000,12055,11605,450,3.7
"36123",36,123,2001,12025,11567,458,3.8
"36123",36,123,2002,12584,11975,609,4.8
"36123",36,123,2003,12886,12270,616,4.8
"36123",36,123,2004,13057,12464,593,4.5
"36123",36,123,2005,12995,12436,559,4.3
"36123",36,123,2006,13056,12509,547,4.2
"36123",36,123,2007,13055,12508,547,4.2
"36123",36,123,2008,13242,12594,648,4.9
"36123",36,123,2009,13233,12341,892,6.7
"36123",36,123,2010,12230,11327,903,7.4
"36123",36,123,2011,12086,11181,905,7.5
"36123",36,123,2012,12090,11147,943,7.8
"36123",36,123,2013,11977,11158,819,6.8
"36123",36,123,2014,11744,11080,664,5.7
"36123",36,123,2015,11810,11222,588,5
"36123",36,123,2016,11794,11274,520,4.4
"36123",36,123,2017,11702,11179,523,4.5
"37001",37,1,1990,61496,59038,2458,4
"37001",37,1,1991,62240,58621,3619,5.8
"37001",37,1,1992,62656,59341,3315,5.3
"37001",37,1,1993,62949,60158,2791,4.4
"37001",37,1,1994,63510,61298,2212,3.5
"37001",37,1,1995,64539,62176,2363,3.7
"37001",37,1,1996,66697,64345,2352,3.5
"37001",37,1,1997,67972,65673,2299,3.4
"37001",37,1,1998,67745,65812,1933,2.9
"37001",37,1,1999,68353,66689,1664,2.4
"37001",37,1,2000,69593,67432,2161,3.1
"37001",37,1,2001,69145,65330,3815,5.5
"37001",37,1,2002,69095,64121,4974,7.2
"37001",37,1,2003,70121,65118,5003,7.1
"37001",37,1,2004,69221,64924,4297,6.2
"37001",37,1,2005,68710,64582,4128,6
"37001",37,1,2006,69615,65815,3800,5.5
"37001",37,1,2007,69983,66446,3537,5.1
"37001",37,1,2008,71184,66652,4532,6.4
"37001",37,1,2009,71389,63057,8332,11.7
"37001",37,1,2010,76806,68451,8355,10.9
"37001",37,1,2011,77265,69803,7462,9.7
"37001",37,1,2012,78000,71344,6656,8.5
"37001",37,1,2013,77241,71636,5605,7.3
"37001",37,1,2014,76827,72461,4366,5.7
"37001",37,1,2015,77289,73147,4142,5.4
"37001",37,1,2016,78862,75124,3738,4.7
"37001",37,1,2017,79767,76334,3433,4.3
"37003",37,3,1990,16045,15457,588,3.7
"37003",37,3,1991,16385,15312,1073,6.5
"37003",37,3,1992,16386,15688,698,4.3
"37003",37,3,1993,16541,16020,521,3.1
"37003",37,3,1994,16935,16429,506,3
"37003",37,3,1995,17114,16520,594,3.5
"37003",37,3,1996,17379,16779,600,3.5
"37003",37,3,1997,17552,17018,534,3
"37003",37,3,1998,17397,17006,391,2.2
"37003",37,3,1999,17796,17410,386,2.2
"37003",37,3,2000,19441,18915,526,2.7
"37003",37,3,2001,19264,18150,1114,5.8
"37003",37,3,2002,18664,17350,1314,7
"37003",37,3,2003,18578,17268,1310,7.1
"37003",37,3,2004,18540,17434,1106,6
"37003",37,3,2005,18234,17246,988,5.4
"37003",37,3,2006,18500,17610,890,4.8
"37003",37,3,2007,18206,17254,952,5.2
"37003",37,3,2008,18214,16947,1267,7
"37003",37,3,2009,18177,15656,2521,13.9
"37003",37,3,2010,18260,15877,2383,13.1
"37003",37,3,2011,17893,15875,2018,11.3
"37003",37,3,2012,17674,15981,1693,9.6
"37003",37,3,2013,17479,16120,1359,7.8
"37003",37,3,2014,17470,16487,983,5.6
"37003",37,3,2015,17539,16675,864,4.9
"37003",37,3,2016,17815,17058,757,4.2
"37003",37,3,2017,18159,17492,667,3.7
"37005",37,5,1990,4852,4694,158,3.3
"37005",37,5,1991,4971,4726,245,4.9
"37005",37,5,1992,5075,4737,338,6.7
"37005",37,5,1993,4903,4654,249,5.1
"37005",37,5,1994,4913,4692,221,4.5
"37005",37,5,1995,5321,5002,319,6
"37005",37,5,1996,5622,5170,452,8
"37005",37,5,1997,5707,5404,303,5.3
"37005",37,5,1998,5654,5439,215,3.8
"37005",37,5,1999,5952,5762,190,3.2
"37005",37,5,2000,5652,5318,334,5.9
"37005",37,5,2001,5279,4831,448,8.5
"37005",37,5,2002,4856,4415,441,9.1
"37005",37,5,2003,4908,4457,451,9.2
"37005",37,5,2004,4871,4567,304,6.2
"37005",37,5,2005,4873,4603,270,5.5
"37005",37,5,2006,4950,4704,246,5
"37005",37,5,2007,4898,4645,253,5.2
"37005",37,5,2008,4549,4211,338,7.4
"37005",37,5,2009,4667,4114,553,11.8
"37005",37,5,2010,4748,4179,569,12
"37005",37,5,2011,4630,4064,566,12.2
"37005",37,5,2012,4604,4123,481,10.4
"37005",37,5,2013,4418,4030,388,8.8
"37005",37,5,2014,4393,4092,301,6.9
"37005",37,5,2015,4466,4192,274,6.1
"37005",37,5,2016,4421,4178,243,5.5
"37005",37,5,2017,4324,4101,223,5.2
"37007",37,7,1990,11755,11253,502,4.3
"37007",37,7,1991,12146,11110,1036,8.5
"37007",37,7,1992,12412,10686,1726,13.9
"37007",37,7,1993,11752,10691,1061,9
"37007",37,7,1994,11572,10369,1203,10.4
"37007",37,7,1995,11545,10481,1064,9.2
"37007",37,7,1996,11530,10709,821,7.1
"37007",37,7,1997,11575,10874,701,6.1
"37007",37,7,1998,11329,10428,901,8
"37007",37,7,1999,10738,9985,753,7
"37007",37,7,2000,11045,10472,573,5.2
"37007",37,7,2001,11304,10354,950,8.4
"37007",37,7,2002,11052,10037,1015,9.2
"37007",37,7,2003,10984,9944,1040,9.5
"37007",37,7,2004,10872,9943,929,8.5
"37007",37,7,2005,10562,9777,785,7.4
"37007",37,7,2006,10670,9866,804,7.5
"37007",37,7,2007,10302,9547,755,7.3
"37007",37,7,2008,10252,9349,903,8.8
"37007",37,7,2009,10096,8603,1493,14.8
"37007",37,7,2010,11180,9602,1578,14.1
"37007",37,7,2011,11099,9735,1364,12.3
"37007",37,7,2012,11057,9850,1207,10.9
"37007",37,7,2013,10919,9886,1033,9.5
"37007",37,7,2014,10922,10147,775,7.1
"37007",37,7,2015,10829,10122,707,6.5
"37007",37,7,2016,10649,10032,617,5.8
"37007",37,7,2017,10545,9985,560,5.3
"37009",37,9,1990,11378,10731,647,5.7
"37009",37,9,1991,11618,10700,918,7.9
"37009",37,9,1992,11620,10559,1061,9.1
"37009",37,9,1993,11731,10884,847,7.2
"37009",37,9,1994,11553,10873,680,5.9
"37009",37,9,1995,11841,10911,930,7.9
"37009",37,9,1996,11839,10574,1265,10.7
"37009",37,9,1997,11679,10522,1157,9.9
"37009",37,9,1998,11414,10584,830,7.3
"37009",37,9,1999,11797,11027,770,6.5
"37009",37,9,2000,12533,11902,631,5
"37009",37,9,2001,12682,11679,1003,7.9
"37009",37,9,2002,12614,11554,1060,8.4
"37009",37,9,2003,12877,12019,858,6.7
"37009",37,9,2004,12819,12131,688,5.4
"37009",37,9,2005,12759,12028,731,5.7
"37009",37,9,2006,12816,12097,719,5.6
"37009",37,9,2007,13078,12423,655,5
"37009",37,9,2008,12551,11710,841,6.7
"37009",37,9,2009,12547,11042,1505,12
"37009",37,9,2010,13722,12100,1622,11.8
"37009",37,9,2011,13245,11795,1450,10.9
"37009",37,9,2012,13186,11810,1376,10.4
"37009",37,9,2013,12855,11676,1179,9.2
"37009",37,9,2014,12416,11564,852,6.9
"37009",37,9,2015,12310,11569,741,6
"37009",37,9,2016,12495,11896,599,4.8
"37009",37,9,2017,12709,12178,531,4.2
"37011",37,11,1990,7311,6867,444,6.1
"37011",37,11,1991,7324,6692,632,8.6
"37011",37,11,1992,7355,6642,713,9.7
"37011",37,11,1993,7289,6684,605,8.3
"37011",37,11,1994,7266,6774,492,6.8
"37011",37,11,1995,7524,7066,458,6.1
"37011",37,11,1996,7741,7354,387,5
"37011",37,11,1997,7931,7594,337,4.2
"37011",37,11,1998,7958,7675,283,3.6
"37011",37,11,1999,8148,7876,272,3.3
"37011",37,11,2000,7964,7649,315,4
"37011",37,11,2001,8066,7629,437,5.4
"37011",37,11,2002,7614,7114,500,6.6
"37011",37,11,2003,8053,7588,465,5.8
"37011",37,11,2004,8068,7661,407,5
"37011",37,11,2005,7961,7535,426,5.4
"37011",37,11,2006,8018,7628,390,4.9
"37011",37,11,2007,8257,7870,387,4.7
"37011",37,11,2008,8826,8325,501,5.7
"37011",37,11,2009,8986,8155,831,9.2
"37011",37,11,2010,7945,7089,856,10.8
"37011",37,11,2011,7766,6904,862,11.1
"37011",37,11,2012,7743,6920,823,10.6
"37011",37,11,2013,7684,7000,684,8.9
"37011",37,11,2014,7653,7152,501,6.5
"37011",37,11,2015,7531,7084,447,5.9
"37011",37,11,2016,7568,7187,381,5
"37011",37,11,2017,7697,7362,335,4.4
"37013",37,13,1990,20566,19571,995,4.8
"37013",37,13,1991,20453,18980,1473,7.2
"37013",37,13,1992,20716,18906,1810,8.7
"37013",37,13,1993,19887,18520,1367,6.9
"37013",37,13,1994,19728,18426,1302,6.6
"37013",37,13,1995,20021,18371,1650,8.2
"37013",37,13,1996,20494,18864,1630,8
"37013",37,13,1997,21130,19598,1532,7.3
"37013",37,13,1998,20622,18992,1630,7.9
"37013",37,13,1999,20672,19108,1564,7.6
"37013",37,13,2000,20738,19501,1237,6
"37013",37,13,2001,20097,18383,1714,8.5
"37013",37,13,2002,19627,17850,1777,9.1
"37013",37,13,2003,20130,18416,1714,8.5
"37013",37,13,2004,19991,18621,1370,6.9
"37013",37,13,2005,20198,18904,1294,6.4
"37013",37,13,2006,20572,19398,1174,5.7
"37013",37,13,2007,21313,20122,1191,5.6
"37013",37,13,2008,20743,19269,1474,7.1
"37013",37,13,2009,20791,18428,2363,11.4
"37013",37,13,2010,21171,18692,2479,11.7
"37013",37,13,2011,21473,19085,2388,11.1
"37013",37,13,2012,21047,18820,2227,10.6
"37013",37,13,2013,20457,18514,1943,9.5
"37013",37,13,2014,20096,18618,1478,7.4
"37013",37,13,2015,20117,18791,1326,6.6
"37013",37,13,2016,20285,19131,1154,5.7
"37013",37,13,2017,20100,19068,1032,5.1
"37015",37,15,1990,9038,8569,469,5.2
"37015",37,15,1991,9124,8596,528,5.8
"37015",37,15,1992,9282,8632,650,7
"37015",37,15,1993,8964,8384,580,6.5
"37015",37,15,1994,9037,8443,594,6.6
"37015",37,15,1995,9432,8791,641,6.8
"37015",37,15,1996,9431,8804,627,6.6
"37015",37,15,1997,9289,8767,522,5.6
"37015",37,15,1998,9004,8478,526,5.8
"37015",37,15,1999,8878,8379,499,5.6
"37015",37,15,2000,8400,7816,584,7
"37015",37,15,2001,8319,7666,653,7.8
"37015",37,15,2002,8142,7484,658,8.1
"37015",37,15,2003,8488,7869,619,7.3
"37015",37,15,2004,8355,7714,641,7.7
"37015",37,15,2005,8769,8145,624,7.1
"37015",37,15,2006,8731,8165,566,6.5
"37015",37,15,2007,8818,8325,493,5.6
"37015",37,15,2008,8694,8036,658,7.6
"37015",37,15,2009,9016,8030,986,10.9
"37015",37,15,2010,9191,8108,1083,11.8
"37015",37,15,2011,9071,7976,1095,12.1
"37015",37,15,2012,8668,7679,989,11.4
"37015",37,15,2013,8460,7608,852,10.1
"37015",37,15,2014,8524,7850,674,7.9
"37015",37,15,2015,8603,7981,622,7.2
"37015",37,15,2016,8427,7870,557,6.6
"37015",37,15,2017,8177,7680,497,6.1
"37017",37,17,1990,13465,12557,908,6.7
"37017",37,17,1991,13703,12201,1502,11
"37017",37,17,1992,14376,12698,1678,11.7
"37017",37,17,1993,15351,14009,1342,8.7
"37017",37,17,1994,16478,15205,1273,7.7
"37017",37,17,1995,17795,16598,1197,6.7
"37017",37,17,1996,19545,18364,1181,6
"37017",37,17,1997,20267,19213,1054,5.2
"37017",37,17,1998,20279,19083,1196,5.9
"37017",37,17,1999,20481,19450,1031,5
"37017",37,17,2000,14713,13826,887,6
"37017",37,17,2001,14955,13668,1287,8.6
"37017",37,17,2002,14745,13320,1425,9.7
"37017",37,17,2003,15053,13797,1256,8.3
"37017",37,17,2004,15642,14538,1104,7.1
"37017",37,17,2005,15440,14303,1137,7.4
"37017",37,17,2006,15232,14262,970,6.4
"37017",37,17,2007,15668,14702,966,6.2
"37017",37,17,2008,15444,14257,1187,7.7
"37017",37,17,2009,15350,13480,1870,12.2
"37017",37,17,2010,15194,13169,2025,13.3
"37017",37,17,2011,14863,12871,1992,13.4
"37017",37,17,2012,14450,12615,1835,12.7
"37017",37,17,2013,14348,12692,1656,11.5
"37017",37,17,2014,14300,12957,1343,9.4
"37017",37,17,2015,14740,13567,1173,8
"37017",37,17,2016,14553,13548,1005,6.9
"37017",37,17,2017,14462,13599,863,6
"37019",37,19,1990,24703,23201,1502,6.1
"37019",37,19,1991,25885,23699,2186,8.4
"37019",37,19,1992,27201,24219,2982,11
"37019",37,19,1993,28043,25012,3031,10.8
"37019",37,19,1994,28717,25714,3003,10.5
"37019",37,19,1995,29419,26885,2534,8.6
"37019",37,19,1996,31044,28829,2215,7.1
"37019",37,19,1997,32330,30590,1740,5.4
"37019",37,19,1998,33306,31610,1696,5.1
"37019",37,19,1999,35001,33547,1454,4.2
"37019",37,19,2000,35564,33976,1588,4.5
"37019",37,19,2001,36921,34872,2049,5.5
"37019",37,19,2002,37530,34932,2598,6.9
"37019",37,19,2003,39245,36750,2495,6.4
"37019",37,19,2004,40333,38168,2165,5.4
"37019",37,19,2005,42827,40686,2141,5
"37019",37,19,2006,46535,44463,2072,4.5
"37019",37,19,2007,47823,45649,2174,4.5
"37019",37,19,2008,49932,46777,3155,6.3
"37019",37,19,2009,50979,45515,5464,10.7
"37019",37,19,2010,46529,40701,5828,12.5
"37019",37,19,2011,47015,41273,5742,12.2
"37019",37,19,2012,47348,42027,5321,11.2
"37019",37,19,2013,47687,43022,4665,9.8
"37019",37,19,2014,47714,43941,3773,7.9
"37019",37,19,2015,48537,44994,3543,7.3
"37019",37,19,2016,49656,46452,3204,6.5
"37019",37,19,2017,51242,48341,2901,5.7
"37021",37,21,1990,91530,88781,2749,3
"37021",37,21,1991,94656,90148,4508,4.8
"37021",37,21,1992,96743,91545,5198,5.4
"37021",37,21,1993,98310,94188,4122,4.2
"37021",37,21,1994,99271,95485,3786,3.8
"37021",37,21,1995,99368,95743,3625,3.6
"37021",37,21,1996,103099,99765,3334,3.2
"37021",37,21,1997,105900,102905,2995,2.8
"37021",37,21,1998,105497,102712,2785,2.6
"37021",37,21,1999,105178,102809,2369,2.3
"37021",37,21,2000,108031,104697,3334,3.1
"37021",37,21,2001,109607,104953,4654,4.2
"37021",37,21,2002,110381,104785,5596,5.1
"37021",37,21,2003,113491,108150,5341,4.7
"37021",37,21,2004,113413,108574,4839,4.3
"37021",37,21,2005,115125,110113,5012,4.4
"37021",37,21,2006,118775,114342,4433,3.7
"37021",37,21,2007,120202,115970,4232,3.5
"37021",37,21,2008,122278,116582,5696,4.7
"37021",37,21,2009,121935,111790,10145,8.3
"37021",37,21,2010,123680,113096,10584,8.6
"37021",37,21,2011,124660,114760,9900,7.9
"37021",37,21,2012,126437,117278,9159,7.2
"37021",37,21,2013,127657,120025,7632,6
"37021",37,21,2014,127750,121751,5999,4.7
"37021",37,21,2015,130400,124712,5688,4.4
"37021",37,21,2016,134224,129041,5183,3.9
"37021",37,21,2017,136994,132216,4778,3.5
"37023",37,23,1990,41929,40285,1644,3.9
"37023",37,23,1991,42218,39668,2550,6
"37023",37,23,1992,43225,40770,2455,5.7
"37023",37,23,1993,43146,41181,1965,4.6
"37023",37,23,1994,43500,41942,1558,3.6
"37023",37,23,1995,44203,42169,2034,4.6
"37023",37,23,1996,44699,42738,1961,4.4
"37023",37,23,1997,44783,43075,1708,3.8
"37023",37,23,1998,43939,42451,1488,3.4
"37023",37,23,1999,44007,42904,1103,2.5
"37023",37,23,2000,46421,44805,1616,3.5
"37023",37,23,2001,45586,42630,2956,6.5
"37023",37,23,2002,43575,40163,3412,7.8
"37023",37,23,2003,43047,39721,3326,7.7
"37023",37,23,2004,42231,39428,2803,6.6
"37023",37,23,2005,41432,38812,2620,6.3
"37023",37,23,2006,41543,39165,2378,5.7
"37023",37,23,2007,40070,37685,2385,6
"37023",37,23,2008,40287,37032,3255,8.1
"37023",37,23,2009,39670,34060,5610,14.1
"37023",37,23,2010,41687,36305,5382,12.9
"37023",37,23,2011,41196,36483,4713,11.4
"37023",37,23,2012,40692,36687,4005,9.8
"37023",37,23,2013,40101,36781,3320,8.3
"37023",37,23,2014,39375,36921,2454,6.2
"37023",37,23,2015,39325,37114,2211,5.6
"37023",37,23,2016,39814,37878,1936,4.9
"37023",37,23,2017,40584,38848,1736,4.3
"37025",37,25,1990,55386,53386,2000,3.6
"37025",37,25,1991,55624,52870,2754,5
"37025",37,25,1992,57157,53794,3363,5.9
"37025",37,25,1993,57758,55257,2501,4.3
"37025",37,25,1994,59050,57110,1940,3.3
"37025",37,25,1995,60836,58745,2091,3.4
"37025",37,25,1996,63752,61660,2092,3.3
"37025",37,25,1997,65380,63464,1916,2.9
"37025",37,25,1998,66459,64888,1571,2.4
"37025",37,25,1999,69469,68083,1386,2
"37025",37,25,2000,72210,70058,2152,3
"37025",37,25,2001,74980,71379,3601,4.8
"37025",37,25,2002,75089,70926,4163,5.5
"37025",37,25,2003,77743,72104,5639,7.3
"37025",37,25,2004,76771,72055,4716,6.1
"37025",37,25,2005,77153,73595,3558,4.6
"37025",37,25,2006,80713,77389,3324,4.1
"37025",37,25,2007,82663,79012,3651,4.4
"37025",37,25,2008,84919,80093,4826,5.7
"37025",37,25,2009,84852,75546,9306,11
"37025",37,25,2010,89049,78773,10276,11.5
"37025",37,25,2011,89830,80488,9342,10.4
"37025",37,25,2012,91361,83139,8222,9
"37025",37,25,2013,92218,85209,7009,7.6
"37025",37,25,2014,94340,88842,5498,5.8
"37025",37,25,2015,97608,92552,5056,5.2
"37025",37,25,2016,101077,96459,4618,4.6
"37025",37,25,2017,104403,100064,4339,4.2
"37027",37,27,1990,40308,38701,1607,4
"37027",37,27,1991,40931,38123,2808,6.9
"37027",37,27,1992,41055,38993,2062,5
"37027",37,27,1993,41004,39375,1629,4
"37027",37,27,1994,40981,39835,1146,2.8
"37027",37,27,1995,41526,39956,1570,3.8
"37027",37,27,1996,42232,40591,1641,3.9
"37027",37,27,1997,42968,40924,2044,4.8
"37027",37,27,1998,41283,40275,1008,2.4
"37027",37,27,1999,41378,40616,762,1.8
"37027",37,27,2000,42560,41340,1220,2.9
"37027",37,27,2001,42285,39560,2725,6.4
"37027",37,27,2002,40861,37608,3253,8
"37027",37,27,2003,40599,37178,3421,8.4
"37027",37,27,2004,39833,36892,2941,7.4
"37027",37,27,2005,39683,36453,3230,8.1
"37027",37,27,2006,39817,36849,2968,7.5
"37027",37,27,2007,38427,35713,2714,7.1
"37027",37,27,2008,38151,35210,2941,7.7
"37027",37,27,2009,37967,32257,5710,15
"37027",37,27,2010,38213,32542,5671,14.8
"37027",37,27,2011,37342,32395,4947,13.2
"37027",37,27,2012,36895,32613,4282,11.6
"37027",37,27,2013,36369,32887,3482,9.6
"37027",37,27,2014,35502,32921,2581,7.3
"37027",37,27,2015,35465,33244,2221,6.3
"37027",37,27,2016,35861,34000,1861,5.2
"37027",37,27,2017,36528,34877,1651,4.5
"37029",37,29,1990,2822,2731,91,3.2
"37029",37,29,1991,2755,2635,120,4.4
"37029",37,29,1992,2840,2693,147,5.2
"37029",37,29,1993,2847,2720,127,4.5
"37029",37,29,1994,2912,2796,116,4
"37029",37,29,1995,3042,2909,133,4.4
"37029",37,29,1996,3158,3038,120,3.8
"37029",37,29,1997,3206,3103,103,3.2
"37029",37,29,1998,3224,3125,99,3.1
"37029",37,29,1999,3310,3226,84,2.5
"37029",37,29,2000,3325,3228,97,2.9
"37029",37,29,2001,3410,3277,133,3.9
"37029",37,29,2002,3531,3373,158,4.5
"37029",37,29,2003,3882,3724,158,4.1
"37029",37,29,2004,4203,4042,161,3.8
"37029",37,29,2005,4374,4196,178,4.1
"37029",37,29,2006,4519,4327,192,4.2
"37029",37,29,2007,4620,4436,184,4
"37029",37,29,2008,4541,4297,244,5.4
"37029",37,29,2009,4465,4091,374,8.4
"37029",37,29,2010,4594,4209,385,8.4
"37029",37,29,2011,4591,4198,393,8.6
"37029",37,29,2012,4521,4166,355,7.9
"37029",37,29,2013,4522,4200,322,7.1
"37029",37,29,2014,4554,4276,278,6.1
"37029",37,29,2015,4612,4348,264,5.7
"37029",37,29,2016,4654,4414,240,5.2
"37029",37,29,2017,4680,4471,209,4.5
"37031",37,31,1990,25638,24564,1074,4.2
"37031",37,31,1991,26387,24900,1487,5.6
"37031",37,31,1992,27324,25639,1685,6.2
"37031",37,31,1993,27364,25569,1795,6.6
"37031",37,31,1994,27400,25813,1587,5.8
"37031",37,31,1995,28318,26709,1609,5.7
"37031",37,31,1996,29293,27876,1417,4.8
"37031",37,31,1997,30401,28998,1403,4.6
"37031",37,31,1998,30201,28838,1363,4.5
"37031",37,31,1999,30203,29006,1197,4
"37031",37,31,2000,29694,28482,1212,4.1
"37031",37,31,2001,29774,28190,1584,5.3
"37031",37,31,2002,30009,28238,1771,5.9
"37031",37,31,2003,31306,29655,1651,5.3
"37031",37,31,2004,31731,30259,1472,4.6
"37031",37,31,2005,32250,30757,1493,4.6
"37031",37,31,2006,32918,31562,1356,4.1
"37031",37,31,2007,33229,31899,1330,4
"37031",37,31,2008,32743,31001,1742,5.3
"37031",37,31,2009,32624,29799,2825,8.7
"37031",37,31,2010,31379,28373,3006,9.6
"37031",37,31,2011,30966,27960,3006,9.7
"37031",37,31,2012,31502,28685,2817,8.9
"37031",37,31,2013,31178,28746,2432,7.8
"37031",37,31,2014,31088,29152,1936,6.2
"37031",37,31,2015,31335,29480,1855,5.9
"37031",37,31,2016,31540,29913,1627,5.2
"37031",37,31,2017,32040,30599,1441,4.5
"37033",37,33,1990,10202,9805,397,3.9
"37033",37,33,1991,11075,10438,637,5.8
"37033",37,33,1992,11164,10556,608,5.4
"37033",37,33,1993,10946,10436,510,4.7
"37033",37,33,1994,11330,10913,417,3.7
"37033",37,33,1995,11783,11357,426,3.6
"37033",37,33,1996,12271,11844,427,3.5
"37033",37,33,1997,12890,12424,466,3.6
"37033",37,33,1998,13025,12674,351,2.7
"37033",37,33,1999,13457,13166,291,2.2
"37033",37,33,2000,10917,10515,402,3.7
"37033",37,33,2001,10891,10170,721,6.6
"37033",37,33,2002,10907,10027,880,8.1
"37033",37,33,2003,10871,9928,943,8.7
"37033",37,33,2004,10687,9848,839,7.9
"37033",37,33,2005,10583,9762,821,7.8
"37033",37,33,2006,10715,9953,762,7.1
"37033",37,33,2007,10706,9993,713,6.7
"37033",37,33,2008,10747,9888,859,8
"37033",37,33,2009,10861,9503,1358,12.5
"37033",37,33,2010,10069,8737,1332,13.2
"37033",37,33,2011,10109,8918,1191,11.8
"37033",37,33,2012,9961,8901,1060,10.6
"37033",37,33,2013,9858,8971,887,9
"37033",37,33,2014,9656,8959,697,7.2
"37033",37,33,2015,9624,9017,607,6.3
"37033",37,33,2016,9681,9154,527,5.4
"37033",37,33,2017,9731,9258,473,4.9
"37035",37,35,1990,71446,68455,2991,4.2
"37035",37,35,1991,72615,67729,4886,6.7
"37035",37,35,1992,73934,69473,4461,6
"37035",37,35,1993,73246,70204,3042,4.2
"37035",37,35,1994,74162,71527,2635,3.6
"37035",37,35,1995,75241,72063,3178,4.2
"37035",37,35,1996,76876,73832,3044,4
"37035",37,35,1997,76950,74436,2514,3.3
"37035",37,35,1998,76108,74088,2020,2.7
"37035",37,35,1999,76787,75278,1509,2
"37035",37,35,2000,80519,78333,2186,2.7
"37035",37,35,2001,80956,75890,5066,6.3
"37035",37,35,2002,78762,72180,6582,8.4
"37035",37,35,2003,77740,71634,6106,7.9
"37035",37,35,2004,77185,72177,5008,6.5
"37035",37,35,2005,76867,72108,4759,6.2
"37035",37,35,2006,77385,73255,4130,5.3
"37035",37,35,2007,76408,72207,4201,5.5
"37035",37,35,2008,76720,71301,5419,7.1
"37035",37,35,2009,77039,66291,10748,14
"37035",37,35,2010,77898,67726,10172,13.1
"37035",37,35,2011,76812,67852,8960,11.7
"37035",37,35,2012,76572,68806,7766,10.1
"37035",37,35,2013,76000,69551,6449,8.5
"37035",37,35,2014,74671,69921,4750,6.4
"37035",37,35,2015,75149,71007,4142,5.5
"37035",37,35,2016,76805,73171,3634,4.7
"37035",37,35,2017,78425,75123,3302,4.2
"37037",37,37,1990,22069,21445,624,2.8
"37037",37,37,1991,22817,21625,1192,5.2
"37037",37,37,1992,22994,22111,883,3.8
"37037",37,37,1993,23019,22424,595,2.6
"37037",37,37,1994,23495,22902,593,2.5
"37037",37,37,1995,24117,23466,651,2.7
"37037",37,37,1996,25546,24877,669,2.6
"37037",37,37,1997,26483,25818,665,2.5
"37037",37,37,1998,26854,26320,534,2
"37037",37,37,1999,27412,26938,474,1.7
"37037",37,37,2000,26909,26179,730,2.7
"37037",37,37,2001,28368,27236,1132,4
"37037",37,37,2002,28975,27430,1545,5.3
"37037",37,37,2003,29502,27997,1505,5.1
"37037",37,37,2004,29987,28809,1178,3.9
"37037",37,37,2005,30758,29521,1237,4
"37037",37,37,2006,32468,31221,1247,3.8
"37037",37,37,2007,32498,31263,1235,3.8
"37037",37,37,2008,33767,32114,1653,4.9
"37037",37,37,2009,34333,31615,2718,7.9
"37037",37,37,2010,30661,28039,2622,8.6
"37037",37,37,2011,31120,28595,2525,8.1
"37037",37,37,2012,31617,29137,2480,7.8
"37037",37,37,2013,31556,29575,1981,6.3
"37037",37,37,2014,32250,30672,1578,4.9
"37037",37,37,2015,33383,31799,1584,4.7
"37037",37,37,2016,34487,33027,1460,4.2
"37037",37,37,2017,35166,33801,1365,3.9
"37039",37,39,1990,9503,8636,867,9.1
"37039",37,39,1991,9257,8286,971,10.5
"37039",37,39,1992,9204,8162,1042,11.3
"37039",37,39,1993,9305,8363,942,10.1
"37039",37,39,1994,9463,8687,776,8.2
"37039",37,39,1995,9845,9228,617,6.3
"37039",37,39,1996,10114,9436,678,6.7
"37039",37,39,1997,10195,9535,660,6.5
"37039",37,39,1998,11530,10849,681,5.9
"37039",37,39,1999,11984,11154,830,6.9
"37039",37,39,2000,11499,10769,730,6.3
"37039",37,39,2001,10275,9386,889,8.7
"37039",37,39,2002,9978,8953,1025,10.3
"37039",37,39,2003,9842,9042,800,8.1
"37039",37,39,2004,9903,9314,589,5.9
"37039",37,39,2005,10422,9797,625,6
"37039",37,39,2006,10546,9981,565,5.4
"37039",37,39,2007,10231,9596,635,6.2
"37039",37,39,2008,9976,9067,909,9.1
"37039",37,39,2009,9972,8445,1527,15.3
"37039",37,39,2010,11654,10150,1504,12.9
"37039",37,39,2011,11594,10221,1373,11.8
"37039",37,39,2012,11423,10171,1252,11
"37039",37,39,2013,11264,10226,1038,9.2
"37039",37,39,2014,11107,10318,789,7.1
"37039",37,39,2015,11121,10403,718,6.5
"37039",37,39,2016,11134,10502,632,5.7
"37039",37,39,2017,11157,10591,566,5.1
"37041",37,41,1990,6206,5883,323,5.2
"37041",37,41,1991,6255,5907,348,5.6
"37041",37,41,1992,6597,6176,421,6.4
"37041",37,41,1993,6722,6374,348,5.2
"37041",37,41,1994,6623,6286,337,5.1
"37041",37,41,1995,6760,6338,422,6.2
"37041",37,41,1996,6704,6331,373,5.6
"37041",37,41,1997,6672,6432,240,3.6
"37041",37,41,1998,6617,6421,196,3
"37041",37,41,1999,6746,6540,206,3.1
"37041",37,41,2000,6506,6252,254,3.9
"37041",37,41,2001,6437,6089,348,5.4
"37041",37,41,2002,6340,5959,381,6
"37041",37,41,2003,6849,6493,356,5.2
"37041",37,41,2004,6910,6592,318,4.6
"37041",37,41,2005,6975,6633,342,4.9
"37041",37,41,2006,7015,6667,348,5
"37041",37,41,2007,7123,6687,436,6.1
"37041",37,41,2008,6692,6116,576,8.6
"37041",37,41,2009,6533,5763,770,11.8
"37041",37,41,2010,6151,5413,738,12
"37041",37,41,2011,5957,5233,724,12.2
"37041",37,41,2012,5905,5262,643,10.9
"37041",37,41,2013,5721,5158,563,9.8
"37041",37,41,2014,5680,5231,449,7.9
"37041",37,41,2015,5640,5237,403,7.1
"37041",37,41,2016,5596,5238,358,6.4
"37041",37,41,2017,5617,5310,307,5.5
"37043",37,43,1990,3241,3057,184,5.7
"37043",37,43,1991,3213,2959,254,7.9
"37043",37,43,1992,3181,2923,258,8.1
"37043",37,43,1993,3307,3015,292,8.8
"37043",37,43,1994,3350,3135,215,6.4
"37043",37,43,1995,3565,3389,176,4.9
"37043",37,43,1996,3703,3475,228,6.2
"37043",37,43,1997,3856,3548,308,8
"37043",37,43,1998,4207,4079,128,3
"37043",37,43,1999,4331,4200,131,3
"37043",37,43,2000,4046,3884,162,4
"37043",37,43,2001,3969,3776,193,4.9
"37043",37,43,2002,4059,3825,234,5.8
"37043",37,43,2003,4198,3996,202,4.8
"37043",37,43,2004,4380,4199,181,4.1
"37043",37,43,2005,4502,4313,189,4.2
"37043",37,43,2006,4686,4505,181,3.9
"37043",37,43,2007,4903,4706,197,4
"37043",37,43,2008,4659,4361,298,6.4
"37043",37,43,2009,4604,4067,537,11.7
"37043",37,43,2010,4243,3712,531,12.5
"37043",37,43,2011,4145,3667,478,11.5
"37043",37,43,2012,4168,3736,432,10.4
"37043",37,43,2013,4054,3699,355,8.8
"37043",37,43,2014,4107,3835,272,6.6
"37043",37,43,2015,4045,3796,249,6.2
"37043",37,43,2016,4047,3826,221,5.5
"37043",37,43,2017,3958,3759,199,5
"37045",37,45,1990,45806,43772,2034,4.4
"37045",37,45,1991,46487,43128,3359,7.2
"37045",37,45,1992,46259,42843,3416,7.4
"37045",37,45,1993,45717,43258,2459,5.4
"37045",37,45,1994,45578,43542,2036,4.5
"37045",37,45,1995,46884,44444,2440,5.2
"37045",37,45,1996,48240,44738,3502,7.3
"37045",37,45,1997,47697,45014,2683,5.6
"37045",37,45,1998,46437,43911,2526,5.4
"37045",37,45,1999,45281,42952,2329,5.1
"37045",37,45,2000,49126,46734,2392,4.9
"37045",37,45,2001,49968,45407,4561,9.1
"37045",37,45,2002,48708,43774,4934,10.1
"37045",37,45,2003,48134,44016,4118,8.6
"37045",37,45,2004,47184,43692,3492,7.4
"37045",37,45,2005,47426,44129,3297,7
"37045",37,45,2006,47884,44856,3028,6.3
"37045",37,45,2007,49360,46420,2940,6
"37045",37,45,2008,48838,44846,3992,8.2
"37045",37,45,2009,48587,41274,7313,15.1
"37045",37,45,2010,45633,38893,6740,14.8
"37045",37,45,2011,45873,40201,5672,12.4
"37045",37,45,2012,45749,40700,5049,11
"37045",37,45,2013,46531,42113,4418,9.5
"37045",37,45,2014,45990,42631,3359,7.3
"37045",37,45,2015,46086,43141,2945,6.4
"37045",37,45,2016,46764,44208,2556,5.5
"37045",37,45,2017,47537,45295,2242,4.7
"37047",37,47,1990,22216,20904,1312,5.9
"37047",37,47,1991,23940,22045,1895,7.9
"37047",37,47,1992,25043,22534,2509,10
"37047",37,47,1993,25154,23021,2133,8.5
"37047",37,47,1994,26499,24501,1998,7.5
"37047",37,47,1995,25822,24079,1743,6.8
"37047",37,47,1996,24670,22718,1952,7.9
"37047",37,47,1997,24690,23133,1557,6.3
"37047",37,47,1998,23678,21823,1855,7.8
"37047",37,47,1999,23237,21160,2077,8.9
"37047",37,47,2000,23571,21782,1789,7.6
"37047",37,47,2001,23288,21367,1921,8.2
"37047",37,47,2002,22787,20754,2033,8.9
"37047",37,47,2003,23487,21648,1839,7.8
"37047",37,47,2004,23611,22128,1483,6.3
"37047",37,47,2005,23690,22178,1512,6.4
"37047",37,47,2006,23665,22347,1318,5.6
"37047",37,47,2007,24348,23037,1311,5.4
"37047",37,47,2008,24150,22294,1856,7.7
"37047",37,47,2009,24433,21287,3146,12.9
"37047",37,47,2010,24184,20943,3241,13.4
"37047",37,47,2011,23939,20734,3205,13.4
"37047",37,47,2012,23183,20341,2842,12.3
"37047",37,47,2013,24084,21604,2480,10.3
"37047",37,47,2014,23030,21066,1964,8.5
"37047",37,47,2015,22610,20907,1703,7.5
"37047",37,47,2016,22572,21125,1447,6.4
"37047",37,47,2017,22324,21079,1245,5.6
"37049",37,49,1990,33729,32182,1547,4.6
"37049",37,49,1991,34329,32403,1926,5.6
"37049",37,49,1992,35442,33188,2254,6.4
"37049",37,49,1993,34225,32217,2008,5.9
"37049",37,49,1994,34461,32428,2033,5.9
"37049",37,49,1995,35185,33344,1841,5.2
"37049",37,49,1996,36403,34692,1711,4.7
"37049",37,49,1997,37755,36131,1624,4.3
"37049",37,49,1998,37871,36219,1652,4.4
"37049",37,49,1999,38121,36526,1595,4.2
"37049",37,49,2000,38689,37104,1585,4.1
"37049",37,49,2001,38719,36547,2172,5.6
"37049",37,49,2002,38597,36259,2338,6.1
"37049",37,49,2003,40097,37822,2275,5.7
"37049",37,49,2004,40181,38276,1905,4.7
"37049",37,49,2005,40795,38880,1915,4.7
"37049",37,49,2006,41958,40121,1837,4.4
"37049",37,49,2007,43233,41388,1845,4.3
"37049",37,49,2008,42095,39608,2487,5.9
"37049",37,49,2009,42338,37947,4391,10.4
"37049",37,49,2010,42279,37743,4536,10.7
"37049",37,49,2011,41925,37500,4425,10.6
"37049",37,49,2012,41875,37905,3970,9.5
"37049",37,49,2013,41467,37866,3601,8.7
"37049",37,49,2014,41105,38260,2845,6.9
"37049",37,49,2015,41340,38837,2503,6.1
"37049",37,49,2016,41713,39531,2182,5.2
"37049",37,49,2017,41845,39861,1984,4.7
"37051",37,51,1990,103547,98500,5047,4.9
"37051",37,51,1991,107305,100978,6327,5.9
"37051",37,51,1992,109565,103209,6356,5.8
"37051",37,51,1993,111569,105536,6033,5.4
"37051",37,51,1994,111501,105718,5783,5.2
"37051",37,51,1995,113077,107043,6034,5.3
"37051",37,51,1996,117037,111642,5395,4.6
"37051",37,51,1997,119199,114116,5083,4.3
"37051",37,51,1998,120515,115594,4921,4.1
"37051",37,51,1999,123115,118412,4703,3.8
"37051",37,51,2000,119608,114356,5252,4.4
"37051",37,51,2001,119623,112431,7192,6
"37051",37,51,2002,120118,111941,8177,6.8
"37051",37,51,2003,122697,115103,7594,6.2
"37051",37,51,2004,122892,116410,6482,5.3
"37051",37,51,2005,127153,120282,6871,5.4
"37051",37,51,2006,129015,122062,6953,5.4
"37051",37,51,2007,129424,122573,6851,5.3
"37051",37,51,2008,133207,125074,8133,6.1
"37051",37,51,2009,137050,124807,12243,8.9
"37051",37,51,2010,131096,117827,13269,10.1
"37051",37,51,2011,132538,118604,13934,10.5
"37051",37,51,2012,132432,118538,13894,10.5
"37051",37,51,2013,130858,118196,12662,9.7
"37051",37,51,2014,127592,117291,10301,8.1
"37051",37,51,2015,126260,117036,9224,7.3
"37051",37,51,2016,127205,119070,8135,6.4
"37051",37,51,2017,127617,120278,7339,5.8
"37053",37,53,1990,7003,6773,230,3.3
"37053",37,53,1991,7238,6922,316,4.4
"37053",37,53,1992,7219,6963,256,3.5
"37053",37,53,1993,7454,7161,293,3.9
"37053",37,53,1994,7648,7397,251,3.3
"37053",37,53,1995,7966,7690,276,3.5
"37053",37,53,1996,8390,8139,251,3
"37053",37,53,1997,8940,8682,258,2.9
"37053",37,53,1998,9140,8896,244,2.7
"37053",37,53,1999,9340,9124,216,2.3
"37053",37,53,2000,9247,8996,251,2.7
"37053",37,53,2001,9692,9403,289,3
"37053",37,53,2002,9973,9677,296,3
"37053",37,53,2003,10737,10396,341,3.2
"37053",37,53,2004,11381,11052,329,2.9
"37053",37,53,2005,12065,11698,367,3
"37053",37,53,2006,12644,12221,423,3.3
"37053",37,53,2007,12530,12134,396,3.2
"37053",37,53,2008,12793,12237,556,4.3
"37053",37,53,2009,12704,11833,871,6.9
"37053",37,53,2010,12189,11104,1085,8.9
"37053",37,53,2011,12350,11232,1118,9.1
"37053",37,53,2012,12460,11395,1065,8.5
"37053",37,53,2013,12601,11611,990,7.9
"37053",37,53,2014,12717,11913,804,6.3
"37053",37,53,2015,12848,12103,745,5.8
"37053",37,53,2016,13139,12472,667,5.1
"37053",37,53,2017,13285,12692,593,4.5
"37055",37,55,1990,14153,13514,639,4.5
"37055",37,55,1991,14610,13671,939,6.4
"37055",37,55,1992,14973,13807,1166,7.8
"37055",37,55,1993,15057,13951,1106,7.3
"37055",37,55,1994,15384,14479,905,5.9
"37055",37,55,1995,15999,15067,932,5.8
"37055",37,55,1996,16746,15784,962,5.7
"37055",37,55,1997,17839,16829,1010,5.7
"37055",37,55,1998,18104,17102,1002,5.5
"37055",37,55,1999,18585,17699,886,4.8
"37055",37,55,2000,18833,18032,801,4.3
"37055",37,55,2001,19160,18094,1066,5.6
"37055",37,55,2002,20752,19607,1145,5.5
"37055",37,55,2003,21818,20721,1097,5
"37055",37,55,2004,22351,21311,1040,4.7
"37055",37,55,2005,22519,21464,1055,4.7
"37055",37,55,2006,22416,21416,1000,4.5
"37055",37,55,2007,22662,21560,1102,4.9
"37055",37,55,2008,21995,20599,1396,6.3
"37055",37,55,2009,21738,19545,2193,10.1
"37055",37,55,2010,19686,17300,2386,12.1
"37055",37,55,2011,20053,17443,2610,13
"37055",37,55,2012,20718,18156,2562,12.4
"37055",37,55,2013,20509,18245,2264,11
"37055",37,55,2014,20118,18421,1697,8.4
"37055",37,55,2015,20299,18785,1514,7.5
"37055",37,55,2016,19983,18633,1350,6.8
"37055",37,55,2017,20162,18962,1200,6
"37057",37,57,1990,73052,70187,2865,3.9
"37057",37,57,1991,73846,69565,4281,5.8
"37057",37,57,1992,75045,70283,4762,6.3
"37057",37,57,1993,74900,71805,3095,4.1
"37057",37,57,1994,75548,73080,2468,3.3
"37057",37,57,1995,76632,74188,2444,3.2
"37057",37,57,1996,79385,76900,2485,3.1
"37057",37,57,1997,81037,78659,2378,2.9
"37057",37,57,1998,81054,78797,2257,2.8
"37057",37,57,1999,81754,79857,1897,2.3
"37057",37,57,2000,79844,77286,2558,3.2
"37057",37,57,2001,80338,75428,4910,6.1
"37057",37,57,2002,79070,73840,5230,6.6
"37057",37,57,2003,79379,73714,5665,7.1
"37057",37,57,2004,78148,73105,5043,6.5
"37057",37,57,2005,78306,73618,4688,6
"37057",37,57,2006,79638,74990,4648,5.8
"37057",37,57,2007,79345,74935,4410,5.6
"37057",37,57,2008,77717,72235,5482,7.1
"37057",37,57,2009,77564,67652,9912,12.8
"37057",37,57,2010,80622,70703,9919,12.3
"37057",37,57,2011,79406,70659,8747,11
"37057",37,57,2012,79611,71892,7719,9.7
"37057",37,57,2013,79304,72799,6505,8.2
"37057",37,57,2014,78406,73453,4953,6.3
"37057",37,57,2015,78735,74355,4380,5.6
"37057",37,57,2016,79431,75604,3827,4.8
"37057",37,57,2017,80147,76663,3484,4.3
"37059",37,59,1990,15742,15043,699,4.4
"37059",37,59,1991,15667,14880,787,5
"37059",37,59,1992,15613,14965,648,4.2
"37059",37,59,1993,15916,15276,640,4
"37059",37,59,1994,16102,15666,436,2.7
"37059",37,59,1995,16426,15833,593,3.6
"37059",37,59,1996,17127,16516,611,3.6
"37059",37,59,1997,17558,17122,436,2.5
"37059",37,59,1998,17849,17381,468,2.6
"37059",37,59,1999,18247,17780,467,2.6
"37059",37,59,2000,18487,17722,765,4.1
"37059",37,59,2001,18968,17984,984,5.2
"37059",37,59,2002,19041,17946,1095,5.8
"37059",37,59,2003,19368,18195,1173,6.1
"37059",37,59,2004,19365,18409,956,4.9
"37059",37,59,2005,19826,18987,839,4.2
"37059",37,59,2006,20548,19695,853,4.2
"37059",37,59,2007,20580,19581,999,4.9
"37059",37,59,2008,20953,19694,1259,6
"37059",37,59,2009,20806,18445,2361,11.3
"37059",37,59,2010,20258,17878,2380,11.7
"37059",37,59,2011,19991,17876,2115,10.6
"37059",37,59,2012,19996,18183,1813,9.1
"37059",37,59,2013,19961,18464,1497,7.5
"37059",37,59,2014,19685,18530,1155,5.9
"37059",37,59,2015,19848,18849,999,5
"37059",37,59,2016,20149,19243,906,4.5
"37059",37,59,2017,20330,19508,822,4
"37061",37,61,1990,19858,18767,1091,5.5
"37061",37,61,1991,20626,18852,1774,8.6
"37061",37,61,1992,21108,19157,1951,9.2
"37061",37,61,1993,20955,19313,1642,7.8
"37061",37,61,1994,20852,19628,1224,5.9
"37061",37,61,1995,22461,21227,1234,5.5
"37061",37,61,1996,22696,21493,1203,5.3
"37061",37,61,1997,22780,21739,1041,4.6
"37061",37,61,1998,22197,20683,1514,6.8
"37061",37,61,1999,22981,21551,1430,6.2
"37061",37,61,2000,23486,22486,1000,4.3
"37061",37,61,2001,22744,21355,1389,6.1
"37061",37,61,2002,22905,21206,1699,7.4
"37061",37,61,2003,24366,22729,1637,6.7
"37061",37,61,2004,24341,22964,1377,5.7
"37061",37,61,2005,23659,22232,1427,6
"37061",37,61,2006,23444,22235,1209,5.2
"37061",37,61,2007,24280,23201,1079,4.4
"37061",37,61,2008,24027,22643,1384,5.8
"37061",37,61,2009,24427,22123,2304,9.4
"37061",37,61,2010,25810,23416,2394,9.3
"37061",37,61,2011,26233,23751,2482,9.5
"37061",37,61,2012,26421,24011,2410,9.1
"37061",37,61,2013,26448,24336,2112,8
"37061",37,61,2014,26591,24891,1700,6.4
"37061",37,61,2015,26488,24969,1519,5.7
"37061",37,61,2016,26478,25065,1413,5.3
"37061",37,61,2017,25578,24317,1261,4.9
"37063",37,63,1990,102027,99302,2725,2.7
"37063",37,63,1991,103497,99926,3571,3.5
"37063",37,63,1992,106053,101784,4269,4
"37063",37,63,1993,106602,102886,3716,3.5
"37063",37,63,1994,107764,104450,3314,3.1
"37063",37,63,1995,108662,105445,3217,3
"37063",37,63,1996,113361,110172,3189,2.8
"37063",37,63,1997,116793,113954,2839,2.4
"37063",37,63,1998,117809,115271,2538,2.2
"37063",37,63,1999,119112,116660,2452,2.1
"37063",37,63,2000,122577,119017,3560,2.9
"37063",37,63,2001,126994,121510,5484,4.3
"37063",37,63,2002,127381,119893,7488,5.9
"37063",37,63,2003,127158,120142,7016,5.5
"37063",37,63,2004,127848,122147,5701,4.5
"37063",37,63,2005,129938,124302,5636,4.3
"37063",37,63,2006,134474,129229,5245,3.9
"37063",37,63,2007,136544,131366,5178,3.8
"37063",37,63,2008,141313,134659,6654,4.7
"37063",37,63,2009,143682,132533,11149,7.8
"37063",37,63,2010,143411,131592,11819,8.2
"37063",37,63,2011,145292,133534,11758,8.1
"37063",37,63,2012,148700,137697,11003,7.4
"37063",37,63,2013,150359,140933,9426,6.3
"37063",37,63,2014,152993,145148,7845,5.1
"37063",37,63,2015,156610,148757,7853,5
"37063",37,63,2016,161943,154649,7294,4.5
"37063",37,63,2017,165496,158750,6746,4.1
"37065",37,65,1990,28252,26843,1409,5
"37065",37,65,1991,28763,26588,2175,7.6
"37065",37,65,1992,28482,26089,2393,8.4
"37065",37,65,1993,27729,25747,1982,7.1
"37065",37,65,1994,27123,25178,1945,7.2
"37065",37,65,1995,27524,25296,2228,8.1
"37065",37,65,1996,28911,25487,3424,11.8
"37065",37,65,1997,27272,24218,3054,11.2
"37065",37,65,1998,25923,23507,2416,9.3
"37065",37,65,1999,25226,23129,2097,8.3
"37065",37,65,2000,25133,23687,1446,5.8
"37065",37,65,2001,25431,23351,2080,8.2
"37065",37,65,2002,25140,22399,2741,10.9
"37065",37,65,2003,25090,22631,2459,9.8
"37065",37,65,2004,24479,22387,2092,8.5
"37065",37,65,2005,24224,22184,2040,8.4
"37065",37,65,2006,24278,22329,1949,8
"37065",37,65,2007,24242,22429,1813,7.5
"37065",37,65,2008,24498,22024,2474,10.1
"37065",37,65,2009,24427,20559,3868,15.8
"37065",37,65,2010,25501,21486,4015,15.7
"37065",37,65,2011,24925,21057,3868,15.5
"37065",37,65,2012,24358,20871,3487,14.3
"37065",37,65,2013,23959,20849,3110,13
"37065",37,65,2014,23245,20846,2399,10.3
"37065",37,65,2015,22820,20635,2185,9.6
"37065",37,65,2016,22398,20455,1943,8.7
"37065",37,65,2017,22132,20409,1723,7.8
"37067",37,67,1990,145661,139864,5797,4
"37067",37,67,1991,144690,138247,6443,4.5
"37067",37,67,1992,146680,139225,7455,5.1
"37067",37,67,1993,147730,141584,6146,4.2
"37067",37,67,1994,150450,144769,5681,3.8
"37067",37,67,1995,151542,146603,4939,3.3
"37067",37,67,1996,156359,151302,5057,3.2
"37067",37,67,1997,157978,153543,4435,2.8
"37067",37,67,1998,156808,152626,4182,2.7
"37067",37,67,1999,157066,153412,3654,2.3
"37067",37,67,2000,162259,157131,5128,3.2
"37067",37,67,2001,164557,156969,7588,4.6
"37067",37,67,2002,165168,155740,9428,5.7
"37067",37,67,2003,166347,157185,9162,5.5
"37067",37,67,2004,165876,157658,8218,5
"37067",37,67,2005,168092,160199,7893,4.7
"37067",37,67,2006,173023,165618,7405,4.3
"37067",37,67,2007,173449,165850,7599,4.4
"37067",37,67,2008,176953,167023,9930,5.6
"37067",37,67,2009,179178,162229,16949,9.5
"37067",37,67,2010,173002,155453,17549,10.1
"37067",37,67,2011,173621,156559,17062,9.8
"37067",37,67,2012,176410,160794,15616,8.9
"37067",37,67,2013,177448,164068,13380,7.5
"37067",37,67,2014,177327,166674,10653,6
"37067",37,67,2015,179729,169830,9899,5.5
"37067",37,67,2016,182455,173578,8877,4.9
"37067",37,67,2017,184234,176075,8159,4.4
"37069",37,69,1990,18843,17960,883,4.7
"37069",37,69,1991,19537,18197,1340,6.9
"37069",37,69,1992,19949,18611,1338,6.7
"37069",37,69,1993,20108,19120,988,4.9
"37069",37,69,1994,20398,19718,680,3.3
"37069",37,69,1995,21220,20329,891,4.2
"37069",37,69,1996,22569,21649,920,4.1
"37069",37,69,1997,23331,22508,823,3.5
"37069",37,69,1998,23587,22966,621,2.6
"37069",37,69,1999,24195,23576,619,2.6
"37069",37,69,2000,24492,23709,783,3.2
"37069",37,69,2001,25015,23791,1224,4.9
"37069",37,69,2002,25022,23389,1633,6.5
"37069",37,69,2003,25568,23989,1579,6.2
"37069",37,69,2004,25708,24380,1328,5.2
"37069",37,69,2005,25987,24751,1236,4.8
"37069",37,69,2006,26831,25705,1126,4.2
"37069",37,69,2007,26930,25737,1193,4.4
"37069",37,69,2008,27744,26024,1720,6.2
"37069",37,69,2009,27633,24796,2837,10.3
"37069",37,69,2010,27954,24907,3047,10.9
"37069",37,69,2011,27941,24963,2978,10.7
"37069",37,69,2012,28165,25436,2729,9.7
"37069",37,69,2013,28238,25905,2333,8.3
"37069",37,69,2014,28304,26458,1846,6.5
"37069",37,69,2015,28715,27014,1701,5.9
"37069",37,69,2016,29315,27784,1531,5.2
"37069",37,69,2017,30122,28716,1406,4.7
"37071",37,71,1990,95441,91582,3859,4
"37071",37,71,1991,96093,89772,6321,6.6
"37071",37,71,1992,96571,89887,6684,6.9
"37071",37,71,1993,96460,91424,5036,5.2
"37071",37,71,1994,97341,93165,4176,4.3
"37071",37,71,1995,98403,94350,4053,4.1
"37071",37,71,1996,101936,96588,5348,5.2
"37071",37,71,1997,101712,97545,4167,4.1
"37071",37,71,1998,99947,96548,3399,3.4
"37071",37,71,1999,102039,98329,3710,3.6
"37071",37,71,2000,100292,94873,5419,5.4
"37071",37,71,2001,102061,94421,7640,7.5
"37071",37,71,2002,99633,91974,7659,7.7
"37071",37,71,2003,98527,91427,7100,7.2
"37071",37,71,2004,96058,89978,6080,6.3
"37071",37,71,2005,96079,90231,5848,6.1
"37071",37,71,2006,98059,92664,5395,5.5
"37071",37,71,2007,97592,92055,5537,5.7
"37071",37,71,2008,99629,92132,7497,7.5
"37071",37,71,2009,99832,86084,13748,13.8
"37071",37,71,2010,101249,87571,13678,13.5
"37071",37,71,2011,100475,88559,11916,11.9
"37071",37,71,2012,100997,90442,10555,10.5
"37071",37,71,2013,100807,91777,9030,9
"37071",37,71,2014,100840,93969,6871,6.8
"37071",37,71,2015,102781,96604,6177,6
"37071",37,71,2016,105536,99912,5624,5.3
"37071",37,71,2017,108698,103677,5021,4.6
"37073",37,73,1990,4080,3973,107,2.6
"37073",37,73,1991,4140,3995,145,3.5
"37073",37,73,1992,4291,4096,195,4.5
"37073",37,73,1993,4273,4125,148,3.5
"37073",37,73,1994,4585,4404,181,3.9
"37073",37,73,1995,4568,4417,151,3.3
"37073",37,73,1996,4667,4520,147,3.1
"37073",37,73,1997,4652,4520,132,2.8
"37073",37,73,1998,4664,4522,142,3
"37073",37,73,1999,4818,4685,133,2.8
"37073",37,73,2000,4667,4510,157,3.4
"37073",37,73,2001,4673,4470,203,4.3
"37073",37,73,2002,4671,4466,205,4.4
"37073",37,73,2003,4839,4640,199,4.1
"37073",37,73,2004,4881,4685,196,4
"37073",37,73,2005,4918,4717,201,4.1
"37073",37,73,2006,4958,4762,196,4
"37073",37,73,2007,4987,4774,213,4.3
"37073",37,73,2008,4853,4597,256,5.3
"37073",37,73,2009,4822,4465,357,7.4
"37073",37,73,2010,5460,5025,435,8
"37073",37,73,2011,5426,4981,445,8.2
"37073",37,73,2012,5357,4946,411,7.7
"37073",37,73,2013,5255,4889,366,7
"37073",37,73,2014,5198,4889,309,5.9
"37073",37,73,2015,5144,4862,282,5.5
"37073",37,73,2016,5185,4919,266,5.1
"37073",37,73,2017,5239,5002,237,4.5
"37075",37,75,1990,3441,2923,518,15.1
"37075",37,75,1991,3652,2946,706,19.3
"37075",37,75,1992,4099,3383,716,17.5
"37075",37,75,1993,4273,3677,596,13.9
"37075",37,75,1994,4326,3742,584,13.5
"37075",37,75,1995,4437,3813,624,14.1
"37075",37,75,1996,4523,3981,542,12
"37075",37,75,1997,4389,3905,484,11
"37075",37,75,1998,4134,3749,385,9.3
"37075",37,75,1999,3878,3553,325,8.4
"37075",37,75,2000,3822,3573,249,6.5
"37075",37,75,2001,3932,3583,349,8.9
"37075",37,75,2002,3826,3452,374,9.8
"37075",37,75,2003,3878,3557,321,8.3
"37075",37,75,2004,3831,3531,300,7.8
"37075",37,75,2005,4039,3759,280,6.9
"37075",37,75,2006,4099,3838,261,6.4
"37075",37,75,2007,4678,4344,334,7.1
"37075",37,75,2008,4371,3907,464,10.6
"37075",37,75,2009,3696,3063,633,17.1
"37075",37,75,2010,3702,3052,650,17.6
"37075",37,75,2011,3617,2964,653,18.1
"37075",37,75,2012,3576,2944,632,17.7
"37075",37,75,2013,3516,2980,536,15.2
"37075",37,75,2014,3318,2875,443,13.4
"37075",37,75,2015,3187,2805,382,12
"37075",37,75,2016,3099,2825,274,8.8
"37075",37,75,2017,3172,2956,216,6.8
"37077",37,77,1990,19647,18746,901,4.6
"37077",37,77,1991,19540,18418,1122,5.7
"37077",37,77,1992,20871,19666,1205,5.8
"37077",37,77,1993,21107,20111,996,4.7
"37077",37,77,1994,21481,20524,957,4.5
"37077",37,77,1995,21675,20751,924,4.3
"37077",37,77,1996,22726,21866,860,3.8
"37077",37,77,1997,23474,22824,650,2.8
"37077",37,77,1998,23570,22900,670,2.8
"37077",37,77,1999,23566,22843,723,3.1
"37077",37,77,2000,22578,21599,979,4.3
"37077",37,77,2001,23328,21870,1458,6.3
"37077",37,77,2002,24007,22259,1748,7.3
"37077",37,77,2003,24346,22472,1874,7.7
"37077",37,77,2004,23939,22321,1618,6.8
"37077",37,77,2005,23754,22320,1434,6
"37077",37,77,2006,24261,23000,1261,5.2
"37077",37,77,2007,25096,23815,1281,5.1
"37077",37,77,2008,25437,23743,1694,6.7
"37077",37,77,2009,25625,22935,2690,10.5
"37077",37,77,2010,27384,24716,2668,9.7
"37077",37,77,2011,27862,25380,2482,8.9
"37077",37,77,2012,28301,26036,2265,8
"37077",37,77,2013,28335,26396,1939,6.8
"37077",37,77,2014,28137,26609,1528,5.4
"37077",37,77,2015,28531,27121,1410,4.9
"37077",37,77,2016,29251,27987,1264,4.3
"37077",37,77,2017,30039,28877,1162,3.9
"37079",37,79,1990,7495,7186,309,4.1
"37079",37,79,1991,7697,7286,411,5.3
"37079",37,79,1992,7781,7386,395,5.1
"37079",37,79,1993,7782,7422,360,4.6
"37079",37,79,1994,8033,7600,433,5.4
"37079",37,79,1995,8370,8005,365,4.4
"37079",37,79,1996,8718,8383,335,3.8
"37079",37,79,1997,9092,8812,280,3.1
"37079",37,79,1998,9226,8885,341,3.7
"37079",37,79,1999,9418,8976,442,4.7
"37079",37,79,2000,8629,8234,395,4.6
"37079",37,79,2001,8662,8084,578,6.7
"37079",37,79,2002,8516,7893,623,7.3
"37079",37,79,2003,8896,8305,591,6.6
"37079",37,79,2004,8933,8382,551,6.2
"37079",37,79,2005,8934,8384,550,6.2
"37079",37,79,2006,9110,8615,495,5.4
"37079",37,79,2007,9174,8676,498,5.4
"37079",37,79,2008,9262,8656,606,6.5
"37079",37,79,2009,9257,8290,967,10.4
"37079",37,79,2010,9428,8474,954,10.1
"37079",37,79,2011,9558,8640,918,9.6
"37079",37,79,2012,9652,8822,830,8.6
"37079",37,79,2013,9411,8669,742,7.9
"37079",37,79,2014,9415,8827,588,6.2
"37079",37,79,2015,9480,8955,525,5.5
"37079",37,79,2016,9514,9011,503,5.3
"37079",37,79,2017,9577,9145,432,4.5
"37081",37,81,1990,200622,193512,7110,3.5
"37081",37,81,1991,202997,192533,10464,5.2
"37081",37,81,1992,205669,194760,10909,5.3
"37081",37,81,1993,207287,198227,9060,4.4
"37081",37,81,1994,210104,202745,7359,3.5
"37081",37,81,1995,213738,206666,7072,3.3
"37081",37,81,1996,220800,213431,7369,3.3
"37081",37,81,1997,224191,217265,6926,3.1
"37081",37,81,1998,223454,217571,5883,2.6
"37081",37,81,1999,225431,219949,5482,2.4
"37081",37,81,2000,233796,226263,7533,3.2
"37081",37,81,2001,236816,225058,11758,5
"37081",37,81,2002,236931,221976,14955,6.3
"37081",37,81,2003,238775,224234,14541,6.1
"37081",37,81,2004,237572,224941,12631,5.3
"37081",37,81,2005,240605,228396,12209,5.1
"37081",37,81,2006,246620,235196,11424,4.6
"37081",37,81,2007,247292,235637,11655,4.7
"37081",37,81,2008,250557,235604,14953,6
"37081",37,81,2009,249715,223165,26550,10.6
"37081",37,81,2010,252010,224039,27971,11.1
"37081",37,81,2011,253095,226641,26454,10.5
"37081",37,81,2012,254739,230428,24311,9.5
"37081",37,81,2013,255228,234235,20993,8.2
"37081",37,81,2014,253379,236765,16614,6.6
"37081",37,81,2015,256282,241229,15053,5.9
"37081",37,81,2016,258205,244695,13510,5.2
"37081",37,81,2017,260244,247698,12546,4.8
"37083",37,83,1990,23886,22494,1392,5.8
"37083",37,83,1991,24323,22264,2059,8.5
"37083",37,83,1992,25147,22957,2190,8.7
"37083",37,83,1993,24960,22992,1968,7.9
"37083",37,83,1994,24357,22593,1764,7.2
"37083",37,83,1995,24100,21943,2157,9
"37083",37,83,1996,24186,21815,2371,9.8
"37083",37,83,1997,23978,21811,2167,9
"37083",37,83,1998,23046,21058,1988,8.6
"37083",37,83,1999,23114,21443,1671,7.2
"37083",37,83,2000,22983,21614,1369,6
"37083",37,83,2001,22838,20637,2201,9.6
"37083",37,83,2002,22413,20112,2301,10.3
"37083",37,83,2003,23343,21361,1982,8.5
"37083",37,83,2004,23430,21636,1794,7.7
"37083",37,83,2005,23665,21968,1697,7.2
"37083",37,83,2006,23925,22374,1551,6.5
"37083",37,83,2007,24355,22793,1562,6.4
"37083",37,83,2008,23799,21677,2122,8.9
"37083",37,83,2009,24239,20950,3289,13.6
"37083",37,83,2010,22791,19435,3356,14.7
"37083",37,83,2011,22346,19085,3261,14.6
"37083",37,83,2012,21942,18972,2970,13.5
"37083",37,83,2013,21762,19195,2567,11.8
"37083",37,83,2014,21271,19210,2061,9.7
"37083",37,83,2015,20772,18941,1831,8.8
"37083",37,83,2016,20662,19025,1637,7.9
"37083",37,83,2017,20659,19135,1524,7.4
"37085",37,85,1990,31620,30179,1441,4.6
"37085",37,85,1991,31584,29698,1886,6
"37085",37,85,1992,31866,29900,1966,6.2
"37085",37,85,1993,32093,30550,1543,4.8
"37085",37,85,1994,32631,31481,1150,3.5
"37085",37,85,1995,34548,33273,1275,3.7
"37085",37,85,1996,36172,34800,1372,3.8
"37085",37,85,1997,37838,36521,1317,3.5
"37085",37,85,1998,37947,36541,1406,3.7
"37085",37,85,1999,36945,35689,1256,3.4
"37085",37,85,2000,42417,40831,1586,3.7
"37085",37,85,2001,43074,40438,2636,6.1
"37085",37,85,2002,42989,39790,3199,7.4
"37085",37,85,2003,43835,40993,2842,6.5
"37085",37,85,2004,44271,41909,2362,5.3
"37085",37,85,2005,45310,42913,2397,5.3
"37085",37,85,2006,46730,44436,2294,4.9
"37085",37,85,2007,47956,45634,2322,4.8
"37085",37,85,2008,47889,44746,3143,6.6
"37085",37,85,2009,48255,42771,5484,11.4
"37085",37,85,2010,48774,43251,5523,11.3
"37085",37,85,2011,49138,43552,5586,11.4
"37085",37,85,2012,49719,44443,5276,10.6
"37085",37,85,2013,49676,45085,4591,9.2
"37085",37,85,2014,49388,45739,3649,7.4
"37085",37,85,2015,50251,46878,3373,6.7
"37085",37,85,2016,51407,48431,2976,5.8
"37085",37,85,2017,52575,49870,2705,5.1
"37087",37,87,1990,22993,21884,1109,4.8
"37087",37,87,1991,23942,22512,1430,6
"37087",37,87,1992,24287,22704,1583,6.5
"37087",37,87,1993,23671,22197,1474,6.2
"37087",37,87,1994,23624,22109,1515,6.4
"37087",37,87,1995,23871,22540,1331,5.6
"37087",37,87,1996,25089,23856,1233,4.9
"37087",37,87,1997,26172,24998,1174,4.5
"37087",37,87,1998,25041,23516,1525,6.1
"37087",37,87,1999,24807,23818,989,4
"37087",37,87,2000,25958,24961,997,3.8
"37087",37,87,2001,26572,25087,1485,5.6
"37087",37,87,2002,26718,24998,1720,6.4
"37087",37,87,2003,27176,25748,1428,5.3
"37087",37,87,2004,26994,25768,1226,4.5
"37087",37,87,2005,27125,25911,1214,4.5
"37087",37,87,2006,27603,26491,1112,4
"37087",37,87,2007,27421,26316,1105,4
"37087",37,87,2008,27812,26266,1546,5.6
"37087",37,87,2009,27812,25153,2659,9.6
"37087",37,87,2010,27600,24762,2838,10.3
"37087",37,87,2011,27510,24736,2774,10.1
"37087",37,87,2012,27515,25008,2507,9.1
"37087",37,87,2013,27582,25428,2154,7.8
"37087",37,87,2014,27255,25666,1589,5.8
"37087",37,87,2015,27651,26197,1454,5.3
"37087",37,87,2016,28456,27162,1294,4.5
"37087",37,87,2017,29020,27833,1187,4.1
"37089",37,89,1990,32415,31578,837,2.6
"37089",37,89,1991,32777,31355,1422,4.3
"37089",37,89,1992,33129,31496,1633,4.9
"37089",37,89,1993,33382,31994,1388,4.2
"37089",37,89,1994,35091,33930,1161,3.3
"37089",37,89,1995,35926,34780,1146,3.2
"37089",37,89,1996,36624,35542,1082,3
"37089",37,89,1997,37113,36277,836,2.3
"37089",37,89,1998,37549,36590,959,2.6
"37089",37,89,1999,39096,38180,916,2.3
"37089",37,89,2000,42348,41092,1256,3
"37089",37,89,2001,43385,41538,1847,4.3
"37089",37,89,2002,43999,41708,2291,5.2
"37089",37,89,2003,45370,43168,2202,4.9
"37089",37,89,2004,45446,43553,1893,4.2
"37089",37,89,2005,46267,44326,1941,4.2
"37089",37,89,2006,47901,46192,1709,3.6
"37089",37,89,2007,48419,46724,1695,3.5
"37089",37,89,2008,49544,47221,2323,4.7
"37089",37,89,2009,49766,45380,4386,8.8
"37089",37,89,2010,48301,43901,4400,9.1
"37089",37,89,2011,48402,44291,4111,8.5
"37089",37,89,2012,48589,44949,3640,7.5
"37089",37,89,2013,49054,46007,3047,6.2
"37089",37,89,2014,49434,46937,2497,5.1
"37089",37,89,2015,50660,48252,2408,4.8
"37089",37,89,2016,52242,50015,2227,4.3
"37089",37,89,2017,53278,51222,2056,3.9
"37091",37,91,1990,10102,9517,585,5.8
"37091",37,91,1991,10182,9296,886,8.7
"37091",37,91,1992,10522,9517,1005,9.6
"37091",37,91,1993,10501,9502,999,9.5
"37091",37,91,1994,10132,9428,704,6.9
"37091",37,91,1995,10003,9437,566,5.7
"37091",37,91,1996,10176,9602,574,5.6
"37091",37,91,1997,10681,10133,548,5.1
"37091",37,91,1998,10355,9900,455,4.4
"37091",37,91,1999,10763,10339,424,3.9
"37091",37,91,2000,9540,9052,488,5.1
"37091",37,91,2001,9779,9083,696,7.1
"37091",37,91,2002,9434,8759,675,7.2
"37091",37,91,2003,9728,9139,589,6.1
"37091",37,91,2004,9653,9089,564,5.8
"37091",37,91,2005,9808,9232,576,5.9
"37091",37,91,2006,9718,9180,538,5.5
"37091",37,91,2007,9925,9406,519,5.2
"37091",37,91,2008,9811,9164,647,6.6
"37091",37,91,2009,10054,9084,970,9.6
"37091",37,91,2010,9830,8787,1043,10.6
"37091",37,91,2011,9632,8539,1093,11.3
"37091",37,91,2012,9574,8543,1031,10.8
"37091",37,91,2013,9503,8610,893,9.4
"37091",37,91,2014,9386,8690,696,7.4
"37091",37,91,2015,9221,8570,651,7.1
"37091",37,91,2016,9306,8694,612,6.6
"37091",37,91,2017,9275,8735,540,5.8
"37093",37,93,1990,9720,9229,491,5.1
"37093",37,93,1991,9764,9119,645,6.6
"37093",37,93,1992,10057,9223,834,8.3
"37093",37,93,1993,10354,9521,833,8
"37093",37,93,1994,10787,10064,723,6.7
"37093",37,93,1995,10854,10136,718,6.6
"37093",37,93,1996,11223,10631,592,5.3
"37093",37,93,1997,11432,10868,564,4.9
"37093",37,93,1998,11706,11123,583,5
"37093",37,93,1999,12322,11473,849,6.9
"37093",37,93,2000,14523,13703,820,5.6
"37093",37,93,2001,14854,13875,979,6.6
"37093",37,93,2002,15403,14220,1183,7.7
"37093",37,93,2003,16231,15027,1204,7.4
"37093",37,93,2004,16891,15909,982,5.8
"37093",37,93,2005,18402,17340,1062,5.8
"37093",37,93,2006,19520,18479,1041,5.3
"37093",37,93,2007,19126,18157,969,5.1
"37093",37,93,2008,19699,18584,1115,5.7
"37093",37,93,2009,20799,19133,1666,8
"37093",37,93,2010,18577,16695,1882,10.1
"37093",37,93,2011,19451,17335,2116,10.9
"37093",37,93,2012,19831,17715,2116,10.7
"37093",37,93,2013,19761,17808,1953,9.9
"37093",37,93,2014,19400,17778,1622,8.4
"37093",37,93,2015,19831,18257,1574,7.9
"37093",37,93,2016,19895,18584,1311,6.6
"37093",37,93,2017,19912,18760,1152,5.8
"37095",37,95,1990,2564,2364,200,7.8
"37095",37,95,1991,2761,2545,216,7.8
"37095",37,95,1992,2891,2600,291,10.1
"37095",37,95,1993,2849,2562,287,10.1
"37095",37,95,1994,2812,2530,282,10
"37095",37,95,1995,2892,2604,288,10
"37095",37,95,1996,3020,2745,275,9.1
"37095",37,95,1997,3130,2905,225,7.2
"37095",37,95,1998,3114,2893,221,7.1
"37095",37,95,1999,3199,2997,202,6.3
"37095",37,95,2000,2875,2713,162,5.6
"37095",37,95,2001,2763,2564,199,7.2
"37095",37,95,2002,2725,2522,203,7.4
"37095",37,95,2003,2848,2638,210,7.4
"37095",37,95,2004,2952,2764,188,6.4
"37095",37,95,2005,2906,2734,172,5.9
"37095",37,95,2006,2680,2538,142,5.3
"37095",37,95,2007,2689,2536,153,5.7
"37095",37,95,2008,2674,2490,184,6.9
"37095",37,95,2009,2627,2398,229,8.7
"37095",37,95,2010,2235,1987,248,11.1
"37095",37,95,2011,2114,1831,283,13.4
"37095",37,95,2012,2131,1845,286,13.4
"37095",37,95,2013,2161,1911,250,11.6
"37095",37,95,2014,2200,1997,203,9.2
"37095",37,95,2015,2145,1949,196,9.1
"37095",37,95,2016,2108,1908,200,9.5
"37095",37,95,2017,2122,1941,181,8.5
"37097",37,97,1990,52398,50368,2030,3.9
"37097",37,97,1991,53788,50370,3418,6.4
"37097",37,97,1992,54707,51808,2899,5.3
"37097",37,97,1993,54872,52834,2038,3.7
"37097",37,97,1994,55972,54311,1661,3
"37097",37,97,1995,57924,56009,1915,3.3
"37097",37,97,1996,59903,57817,2086,3.5
"37097",37,97,1997,61737,59997,1740,2.8
"37097",37,97,1998,62600,60959,1641,2.6
"37097",37,97,1999,65230,63714,1516,2.3
"37097",37,97,2000,66143,63864,2279,3.4
"37097",37,97,2001,66458,62653,3805,5.7
"37097",37,97,2002,66827,62402,4425,6.6
"37097",37,97,2003,69316,64858,4458,6.4
"37097",37,97,2004,71146,67341,3805,5.3
"37097",37,97,2005,72392,68749,3643,5
"37097",37,97,2006,76658,73303,3355,4.4
"37097",37,97,2007,79857,76196,3661,4.6
"37097",37,97,2008,78849,73841,5008,6.4
"37097",37,97,2009,78912,68873,10039,12.7
"37097",37,97,2010,78671,68532,10139,12.9
"37097",37,97,2011,78531,69589,8942,11.4
"37097",37,97,2012,79259,71394,7865,9.9
"37097",37,97,2013,79420,72776,6644,8.4
"37097",37,97,2014,79966,74924,5042,6.3
"37097",37,97,2015,82183,77666,4517,5.5
"37097",37,97,2016,84472,80414,4058,4.8
"37097",37,97,2017,87100,83394,3706,4.3
"37099",37,99,1990,13596,12839,757,5.6
"37099",37,99,1991,13685,12757,928,6.8
"37099",37,99,1992,14274,13258,1016,7.1
"37099",37,99,1993,14483,13510,973,6.7
"37099",37,99,1994,14694,13863,831,5.7
"37099",37,99,1995,14932,14096,836,5.6
"37099",37,99,1996,15615,14746,869,5.6
"37099",37,99,1997,16368,15466,902,5.5
"37099",37,99,1998,16446,15718,728,4.4
"37099",37,99,1999,16610,15973,637,3.8
"37099",37,99,2000,17256,16587,669,3.9
"37099",37,99,2001,19108,18294,814,4.3
"37099",37,99,2002,18936,18002,934,4.9
"37099",37,99,2003,19797,18838,959,4.8
"37099",37,99,2004,19795,18958,837,4.2
"37099",37,99,2005,20511,19676,835,4.1
"37099",37,99,2006,21525,20748,777,3.6
"37099",37,99,2007,21884,21080,804,3.7
"37099",37,99,2008,20956,19908,1048,5
"37099",37,99,2009,20703,18860,1843,8.9
"37099",37,99,2010,18434,16422,2012,10.9
"37099",37,99,2011,18070,16059,2011,11.1
"37099",37,99,2012,18073,16161,1912,10.6
"37099",37,99,2013,18421,16804,1617,8.8
"37099",37,99,2014,18369,17140,1229,6.7
"37099",37,99,2015,18465,17340,1125,6.1
"37099",37,99,2016,18811,17789,1022,5.4
"37099",37,99,2017,18983,18064,919,4.8
"37101",37,101,1990,44653,42787,1866,4.2
"37101",37,101,1991,46154,43468,2686,5.8
"37101",37,101,1992,47286,44847,2439,5.2
"37101",37,101,1993,47761,45959,1802,3.8
"37101",37,101,1994,48897,47456,1441,2.9
"37101",37,101,1995,50833,49384,1449,2.9
"37101",37,101,1996,54377,53036,1341,2.5
"37101",37,101,1997,57411,56066,1345,2.3
"37101",37,101,1998,59881,58456,1425,2.4
"37101",37,101,1999,62204,61005,1199,1.9
"37101",37,101,2000,64266,62432,1834,2.9
"37101",37,101,2001,65957,63186,2771,4.2
"37101",37,101,2002,66208,62490,3718,5.6
"37101",37,101,2003,67607,64022,3585,5.3
"37101",37,101,2004,68796,65728,3068,4.5
"37101",37,101,2005,70876,67718,3158,4.5
"37101",37,101,2006,74090,71163,2927,4
"37101",37,101,2007,75088,72010,3078,4.1
"37101",37,101,2008,77790,73394,4396,5.7
"37101",37,101,2009,78503,70719,7784,9.9
"37101",37,101,2010,81701,73591,8110,9.9
"37101",37,101,2011,82457,74629,7828,9.5
"37101",37,101,2012,83522,76485,7037,8.4
"37101",37,101,2013,84436,78453,5983,7.1
"37101",37,101,2014,85885,80997,4888,5.7
"37101",37,101,2015,88159,83549,4610,5.2
"37101",37,101,2016,91492,87211,4281,4.7
"37101",37,101,2017,93991,90069,3922,4.2
"37103",37,103,1990,4422,4214,208,4.7
"37103",37,103,1991,4455,4207,248,5.6
"37103",37,103,1992,4535,4261,274,6
"37103",37,103,1993,4478,4259,219,4.9
"37103",37,103,1994,4499,4279,220,4.9
"37103",37,103,1995,4543,4293,250,5.5
"37103",37,103,1996,4516,4324,192,4.3
"37103",37,103,1997,4614,4437,177,3.8
"37103",37,103,1998,4546,4345,201,4.4
"37103",37,103,1999,4588,4334,254,5.5
"37103",37,103,2000,4684,4474,210,4.5
"37103",37,103,2001,4621,4363,258,5.6
"37103",37,103,2002,4659,4341,318,6.8
"37103",37,103,2003,4731,4468,263,5.6
"37103",37,103,2004,4888,4658,230,4.7
"37103",37,103,2005,4935,4695,240,4.9
"37103",37,103,2006,4807,4588,219,4.6
"37103",37,103,2007,4820,4606,214,4.4
"37103",37,103,2008,4696,4396,300,6.4
"37103",37,103,2009,4621,4124,497,10.8
"37103",37,103,2010,4598,4083,515,11.2
"37103",37,103,2011,4583,4096,487,10.6
"37103",37,103,2012,4589,4134,455,9.9
"37103",37,103,2013,4539,4157,382,8.4
"37103",37,103,2014,4489,4191,298,6.6
"37103",37,103,2015,4548,4286,262,5.8
"37103",37,103,2016,4511,4273,238,5.3
"37103",37,103,2017,4497,4295,202,4.5
"37105",37,105,1990,21232,20162,1070,5
"37105",37,105,1991,22094,20589,1505,6.8
"37105",37,105,1992,23555,21978,1577,6.7
"37105",37,105,1993,24143,22942,1201,5
"37105",37,105,1994,25016,23903,1113,4.4
"37105",37,105,1995,25988,24777,1211,4.7
"37105",37,105,1996,26431,25189,1242,4.7
"37105",37,105,1997,26902,25930,972,3.6
"37105",37,105,1998,29524,28497,1027,3.5
"37105",37,105,1999,27152,26260,892,3.3
"37105",37,105,2000,24697,23723,974,3.9
"37105",37,105,2001,24918,23416,1502,6
"37105",37,105,2002,25021,23115,1906,7.6
"37105",37,105,2003,25341,23529,1812,7.2
"37105",37,105,2004,25599,24118,1481,5.8
"37105",37,105,2005,25968,24526,1442,5.6
"37105",37,105,2006,26237,24822,1415,5.4
"37105",37,105,2007,26470,24975,1495,5.6
"37105",37,105,2008,25800,23863,1937,7.5
"37105",37,105,2009,26038,22346,3692,14.2
"37105",37,105,2010,27095,23633,3462,12.8
"37105",37,105,2011,27228,23873,3355,12.3
"37105",37,105,2012,27094,24014,3080,11.4
"37105",37,105,2013,26079,23433,2646,10.1
"37105",37,105,2014,25024,22977,2047,8.2
"37105",37,105,2015,26090,24208,1882,7.2
"37105",37,105,2016,26202,24663,1539,5.9
"37105",37,105,2017,26639,25267,1372,5.2
"37107",37,107,1990,28261,26914,1347,4.8
"37107",37,107,1991,28799,27007,1792,6.2
"37107",37,107,1992,29439,27387,2052,7
"37107",37,107,1993,29056,27082,1974,6.8
"37107",37,107,1994,29102,27065,2037,7
"37107",37,107,1995,29549,27694,1855,6.3
"37107",37,107,1996,30467,28392,2075,6.8
"37107",37,107,1997,30547,29025,1522,5
"37107",37,107,1998,30469,28674,1795,5.9
"37107",37,107,1999,30679,28714,1965,6.4
"37107",37,107,2000,27835,26393,1442,5.2
"37107",37,107,2001,27556,25372,2184,7.9
"37107",37,107,2002,26786,24506,2280,8.5
"37107",37,107,2003,27178,25174,2004,7.4
"37107",37,107,2004,27292,25687,1605,5.9
"37107",37,107,2005,27695,26091,1604,5.8
"37107",37,107,2006,27443,25911,1532,5.6
"37107",37,107,2007,27936,26463,1473,5.3
"37107",37,107,2008,27008,25074,1934,7.2
"37107",37,107,2009,26971,23778,3193,11.8
"37107",37,107,2010,26874,23686,3188,11.9
"37107",37,107,2011,27601,24596,3005,10.9
"37107",37,107,2012,28489,25696,2793,9.8
"37107",37,107,2013,28502,26023,2479,8.7
"37107",37,107,2014,27862,25866,1996,7.2
"37107",37,107,2015,27741,25980,1761,6.3
"37107",37,107,2016,27621,26002,1619,5.9
"37107",37,107,2017,28126,26844,1282,4.6
"37109",37,109,1990,28147,26985,1162,4.1
"37109",37,109,1991,28355,26579,1776,6.3
"37109",37,109,1992,28688,27075,1613,5.6
"37109",37,109,1993,29422,28171,1251,4.3
"37109",37,109,1994,30406,29274,1132,3.7
"37109",37,109,1995,30937,29479,1458,4.7
"37109",37,109,1996,32034,30410,1624,5.1
"37109",37,109,1997,32163,31019,1144,3.6
"37109",37,109,1998,32122,31064,1058,3.3
"37109",37,109,1999,32812,31871,941,2.9
"37109",37,109,2000,34894,33601,1293,3.7
"37109",37,109,2001,35623,33270,2353,6.6
"37109",37,109,2002,35393,32876,2517,7.1
"37109",37,109,2003,36013,33513,2500,6.9
"37109",37,109,2004,35624,33493,2131,6
"37109",37,109,2005,36213,34184,2029,5.6
"37109",37,109,2006,37828,35936,1892,5
"37109",37,109,2007,39774,37819,1955,4.9
"37109",37,109,2008,39344,36514,2830,7.2
"37109",37,109,2009,39200,33770,5430,13.9
"37109",37,109,2010,39984,34893,5091,12.7
"37109",37,109,2011,39803,35353,4450,11.2
"37109",37,109,2012,39941,36103,3838,9.6
"37109",37,109,2013,39874,36584,3290,8.3
"37109",37,109,2014,39646,37202,2444,6.2
"37109",37,109,2015,40614,38408,2206,5.4
"37109",37,109,2016,41051,39116,1935,4.7
"37109",37,109,2017,42232,40529,1703,4
"37111",37,111,1990,18991,17852,1139,6
"37111",37,111,1991,19267,17706,1561,8.1
"37111",37,111,1992,19441,17926,1515,7.8
"37111",37,111,1993,19376,18222,1154,6
"37111",37,111,1994,19824,18824,1000,5
"37111",37,111,1995,20589,19400,1189,5.8
"37111",37,111,1996,20821,19465,1356,6.5
"37111",37,111,1997,20915,19846,1069,5.1
"37111",37,111,1998,20912,20097,815,3.9
"37111",37,111,1999,20726,19880,846,4.1
"37111",37,111,2000,21488,20575,913,4.2
"37111",37,111,2001,21327,19800,1527,7.2
"37111",37,111,2002,21430,19673,1757,8.2
"37111",37,111,2003,21684,20125,1559,7.2
"37111",37,111,2004,21562,20166,1396,6.5
"37111",37,111,2005,21131,19634,1497,7.1
"37111",37,111,2006,21072,19787,1285,6.1
"37111",37,111,2007,21439,20245,1194,5.6
"37111",37,111,2008,20799,19105,1694,8.1
"37111",37,111,2009,20475,17355,3120,15.2
"37111",37,111,2010,20610,17864,2746,13.3
"37111",37,111,2011,20594,18048,2546,12.4
"37111",37,111,2012,20596,18366,2230,10.8
"37111",37,111,2013,20426,18593,1833,9
"37111",37,111,2014,20811,19470,1341,6.4
"37111",37,111,2015,21260,20091,1169,5.5
"37111",37,111,2016,20993,19985,1008,4.8
"37111",37,111,2017,20948,20078,870,4.2
"37113",37,113,1990,11118,10725,393,3.5
"37113",37,113,1991,11596,10968,628,5.4
"37113",37,113,1992,11919,11126,793,6.7
"37113",37,113,1993,12167,11351,816,6.7
"37113",37,113,1994,12257,11657,600,4.9
"37113",37,113,1995,12683,12182,501,4
"37113",37,113,1996,13362,12792,570,4.3
"37113",37,113,1997,14106,13543,563,4
"37113",37,113,1998,14138,13438,700,5
"37113",37,113,1999,14305,13781,524,3.7
"37113",37,113,2000,14162,13619,543,3.8
"37113",37,113,2001,14531,13868,663,4.6
"37113",37,113,2002,14995,14192,803,5.4
"37113",37,113,2003,15405,14650,755,4.9
"37113",37,113,2004,15393,14679,714,4.6
"37113",37,113,2005,15623,14888,735,4.7
"37113",37,113,2006,16119,15412,707,4.4
"37113",37,113,2007,16643,15963,680,4.1
"37113",37,113,2008,16285,15325,960,5.9
"37113",37,113,2009,15922,14169,1753,11
"37113",37,113,2010,15461,13679,1782,11.5
"37113",37,113,2011,15483,13729,1754,11.3
"37113",37,113,2012,15483,13840,1643,10.6
"37113",37,113,2013,15200,13812,1388,9.1
"37113",37,113,2014,15040,14045,995,6.6
"37113",37,113,2015,15119,14187,932,6.2
"37113",37,113,2016,15201,14383,818,5.4
"37113",37,113,2017,15216,14498,718,4.7
"37115",37,115,1990,8215,7863,352,4.3
"37115",37,115,1991,8525,7943,582,6.8
"37115",37,115,1992,8546,8027,519,6.1
"37115",37,115,1993,8561,8138,423,4.9
"37115",37,115,1994,8622,8249,373,4.3
"37115",37,115,1995,8659,8302,357,4.1
"37115",37,115,1996,9142,8703,439,4.8
"37115",37,115,1997,9377,9029,348,3.7
"37115",37,115,1998,9350,9059,291,3.1
"37115",37,115,1999,9304,9046,258,2.8
"37115",37,115,2000,9405,9059,346,3.7
"37115",37,115,2001,9612,9087,525,5.5
"37115",37,115,2002,9596,9022,574,6
"37115",37,115,2003,9697,9196,501,5.2
"37115",37,115,2004,9676,9173,503,5.2
"37115",37,115,2005,9766,9264,502,5.1
"37115",37,115,2006,9935,9523,412,4.1
"37115",37,115,2007,9830,9442,388,3.9
"37115",37,115,2008,10017,9454,563,5.6
"37115",37,115,2009,9908,8976,932,9.4
"37115",37,115,2010,9389,8415,974,10.4
"37115",37,115,2011,9435,8467,968,10.3
"37115",37,115,2012,9489,8563,926,9.8
"37115",37,115,2013,9486,8710,776,8.2
"37115",37,115,2014,9399,8812,587,6.2
"37115",37,115,2015,9470,8930,540,5.7
"37115",37,115,2016,9691,9219,472,4.9
"37115",37,115,2017,9873,9444,429,4.3
"37117",37,117,1990,12179,11534,645,5.3
"37117",37,117,1991,13048,12300,748,5.7
"37117",37,117,1992,13566,12597,969,7.1
"37117",37,117,1993,12992,12097,895,6.9
"37117",37,117,1994,12950,12136,814,6.3
"37117",37,117,1995,12992,12170,822,6.3
"37117",37,117,1996,12915,11528,1387,10.7
"37117",37,117,1997,12478,11269,1209,9.7
"37117",37,117,1998,11657,10724,933,8
"37117",37,117,1999,11644,10667,977,8.4
"37117",37,117,2000,11836,11027,809,6.8
"37117",37,117,2001,11750,10937,813,6.9
"37117",37,117,2002,11885,11113,772,6.5
"37117",37,117,2003,12223,11356,867,7.1
"37117",37,117,2004,12006,11213,793,6.6
"37117",37,117,2005,12011,11310,701,5.8
"37117",37,117,2006,11923,11271,652,5.5
"37117",37,117,2007,12022,11386,636,5.3
"37117",37,117,2008,11891,11127,764,6.4
"37117",37,117,2009,11864,10600,1264,10.7
"37117",37,117,2010,10479,9144,1335,12.7
"37117",37,117,2011,10638,9316,1322,12.4
"37117",37,117,2012,10431,9179,1252,12
"37117",37,117,2013,10106,9049,1057,10.5
"37117",37,117,2014,9885,9112,773,7.8
"37117",37,117,2015,9717,8971,746,7.7
"37117",37,117,2016,9804,9142,662,6.8
"37117",37,117,2017,9636,9081,555,5.8
"37119",37,119,1990,298113,290080,8033,2.7
"37119",37,119,1991,301831,288185,13646,4.5
"37119",37,119,1992,307186,291556,15630,5.1
"37119",37,119,1993,315947,302017,13930,4.4
"37119",37,119,1994,325817,314512,11305,3.5
"37119",37,119,1995,335487,325339,10148,3
"37119",37,119,1996,351138,340838,10300,2.9
"37119",37,119,1997,362553,352685,9868,2.7
"37119",37,119,1998,365516,357166,8350,2.3
"37119",37,119,1999,378981,371241,7740,2
"37119",37,119,2000,397029,385524,11505,2.9
"37119",37,119,2001,409161,391446,17715,4.3
"37119",37,119,2002,411447,387468,23979,5.8
"37119",37,119,2003,418025,393995,24030,5.7
"37119",37,119,2004,416749,395649,21100,5.1
"37119",37,119,2005,426529,405368,21161,5
"37119",37,119,2006,445356,425476,19880,4.5
"37119",37,119,2007,456736,436055,20681,4.5
"37119",37,119,2008,466991,439235,27756,5.9
"37119",37,119,2009,465775,416463,49312,10.6
"37119",37,119,2010,502428,448844,53584,10.7
"37119",37,119,2011,513764,462812,50952,9.9
"37119",37,119,2012,527788,481623,46165,8.7
"37119",37,119,2013,537143,496753,40390,7.5
"37119",37,119,2014,548086,515227,32859,6
"37119",37,119,2015,565288,534989,30299,5.4
"37119",37,119,2016,582855,555245,27610,4.7
"37119",37,119,2017,601998,576068,25930,4.3
"37121",37,121,1990,6936,6478,458,6.6
"37121",37,121,1991,7380,6673,707,9.6
"37121",37,121,1992,7191,6485,706,9.8
"37121",37,121,1993,6843,6303,540,7.9
"37121",37,121,1994,6678,6089,589,8.8
"37121",37,121,1995,7057,6529,528,7.5
"37121",37,121,1996,7489,7087,402,5.4
"37121",37,121,1997,7567,7127,440,5.8
"37121",37,121,1998,7323,6782,541,7.4
"37121",37,121,1999,7365,6887,478,6.5
"37121",37,121,2000,7794,7448,346,4.4
"37121",37,121,2001,7806,7107,699,9
"37121",37,121,2002,7708,6940,768,10
"37121",37,121,2003,7709,7109,600,7.8
"37121",37,121,2004,7542,7027,515,6.8
"37121",37,121,2005,7767,7197,570,7.3
"37121",37,121,2006,7565,7096,469,6.2
"37121",37,121,2007,7344,6822,522,7.1
"37121",37,121,2008,7087,6519,568,8
"37121",37,121,2009,7180,6289,891,12.4
"37121",37,121,2010,6807,5964,843,12.4
"37121",37,121,2011,6738,5938,800,11.9
"37121",37,121,2012,6649,5836,813,12.2
"37121",37,121,2013,6668,5935,733,11
"37121",37,121,2014,6537,6031,506,7.7
"37121",37,121,2015,6311,5879,432,6.8
"37121",37,121,2016,6181,5803,378,6.1
"37121",37,121,2017,6114,5789,325,5.3
"37123",37,123,1990,12071,11334,737,6.1
"37123",37,123,1991,12061,10948,1113,9.2
"37123",37,123,1992,12392,11180,1212,9.8
"37123",37,123,1993,11840,10896,944,8
"37123",37,123,1994,11863,11089,774,6.5
"37123",37,123,1995,11893,11096,797,6.7
"37123",37,123,1996,12224,11410,814,6.7
"37123",37,123,1997,12335,11629,706,5.7
"37123",37,123,1998,12048,11526,522,4.3
"37123",37,123,1999,12303,11790,513,4.2
"37123",37,123,2000,12797,12302,495,3.9
"37123",37,123,2001,12771,11910,861,6.7
"37123",37,123,2002,12674,11649,1025,8.1
"37123",37,123,2003,12538,11435,1103,8.8
"37123",37,123,2004,12520,11632,888,7.1
"37123",37,123,2005,12345,11504,841,6.8
"37123",37,123,2006,12187,11368,819,6.7
"37123",37,123,2007,11922,11171,751,6.3
"37123",37,123,2008,11302,10382,920,8.1
"37123",37,123,2009,11059,9570,1489,13.5
"37123",37,123,2010,11443,10032,1411,12.3
"37123",37,123,2011,11505,10149,1356,11.8
"37123",37,123,2012,11554,10331,1223,10.6
"37123",37,123,2013,11679,10711,968,8.3
"37123",37,123,2014,11473,10740,733,6.4
"37123",37,123,2015,11625,10963,662,5.7
"37123",37,123,2016,11689,11084,605,5.2
"37123",37,123,2017,11732,11188,544,4.6
"37125",37,125,1990,27839,26736,1103,4
"37125",37,125,1991,28179,26563,1616,5.7
"37125",37,125,1992,28631,26617,2014,7
"37125",37,125,1993,28650,26903,1747,6.1
"37125",37,125,1994,28592,27413,1179,4.1
"37125",37,125,1995,28547,27458,1089,3.8
"37125",37,125,1996,29958,28521,1437,4.8
"37125",37,125,1997,30093,28995,1098,3.6
"37125",37,125,1998,30484,29271,1213,4
"37125",37,125,1999,30948,29879,1069,3.5
"37125",37,125,2000,34728,33488,1240,3.6
"37125",37,125,2001,35126,33429,1697,4.8
"37125",37,125,2002,34908,32663,2245,6.4
"37125",37,125,2003,35532,33254,2278,6.4
"37125",37,125,2004,35750,33775,1975,5.5
"37125",37,125,2005,35748,33927,1821,5.1
"37125",37,125,2006,36356,34626,1730,4.8
"37125",37,125,2007,37189,35495,1694,4.6
"37125",37,125,2008,36370,34153,2217,6.1
"37125",37,125,2009,36267,32591,3676,10.1
"37125",37,125,2010,36325,32650,3675,10.1
"37125",37,125,2011,37081,33542,3539,9.5
"37125",37,125,2012,37474,34181,3293,8.8
"37125",37,125,2013,37899,34956,2943,7.8
"37125",37,125,2014,38185,35846,2339,6.1
"37125",37,125,2015,38289,36069,2220,5.8
"37125",37,125,2016,39469,37490,1979,5
"37125",37,125,2017,39922,38118,1804,4.5
"37127",37,127,1990,41427,39692,1735,4.2
"37127",37,127,1991,43062,40289,2773,6.4
"37127",37,127,1992,43609,40389,3220,7.4
"37127",37,127,1993,43617,40928,2689,6.2
"37127",37,127,1994,43011,40824,2187,5.1
"37127",37,127,1995,44476,42154,2322,5.2
"37127",37,127,1996,46177,43316,2861,6.2
"37127",37,127,1997,44942,42280,2662,5.9
"37127",37,127,1998,44495,42072,2423,5.4
"37127",37,127,1999,44669,42344,2325,5.2
"37127",37,127,2000,43641,41668,1973,4.5
"37127",37,127,2001,44128,41361,2767,6.3
"37127",37,127,2002,43696,40241,3455,7.9
"37127",37,127,2003,44358,41195,3163,7.1
"37127",37,127,2004,44210,41420,2790,6.3
"37127",37,127,2005,44187,41528,2659,6
"37127",37,127,2006,44817,42356,2461,5.5
"37127",37,127,2007,46370,43912,2458,5.3
"37127",37,127,2008,46886,43428,3458,7.4
"37127",37,127,2009,47359,41655,5704,12
"37127",37,127,2010,47453,41495,5958,12.6
"37127",37,127,2011,46919,41064,5855,12.5
"37127",37,127,2012,46110,40796,5314,11.5
"37127",37,127,2013,45333,40644,4689,10.3
"37127",37,127,2014,44251,40720,3531,8
"37127",37,127,2015,43865,40670,3195,7.3
"37127",37,127,2016,43881,40996,2885,6.6
"37127",37,127,2017,43584,40912,2672,6.1
"37129",37,129,1990,65544,62594,2950,4.5
"37129",37,129,1991,68617,64493,4124,6
"37129",37,129,1992,70335,65144,5191,7.4
"37129",37,129,1993,71720,66583,5137,7.2
"37129",37,129,1994,73072,68040,5032,6.9
"37129",37,129,1995,75083,70853,4230,5.6
"37129",37,129,1996,78832,75302,3530,4.5
"37129",37,129,1997,81239,78140,3099,3.8
"37129",37,129,1998,82121,79120,3001,3.7
"37129",37,129,1999,83834,81273,2561,3.1
"37129",37,129,2000,87947,84778,3169,3.6
"37129",37,129,2001,89716,85313,4403,4.9
"37129",37,129,2002,89692,84052,5640,6.3
"37129",37,129,2003,92071,86890,5181,5.6
"37129",37,129,2004,93889,89750,4139,4.4
"37129",37,129,2005,97891,93864,4027,4.1
"37129",37,129,2006,101711,97961,3750,3.7
"37129",37,129,2007,104304,100377,3927,3.8
"37129",37,129,2008,105444,100018,5426,5.1
"37129",37,129,2009,104719,95014,9705,9.3
"37129",37,129,2010,107583,97140,10443,9.7
"37129",37,129,2011,107501,97230,10271,9.6
"37129",37,129,2012,108852,99450,9402,8.6
"37129",37,129,2013,109520,101245,8275,7.6
"37129",37,129,2014,110572,103997,6575,5.9
"37129",37,129,2015,113388,107314,6074,5.4
"37129",37,129,2016,115933,110461,5472,4.7
"37129",37,129,2017,118501,113526,4975,4.2
"37131",37,131,1990,8656,8255,401,4.6
"37131",37,131,1991,8749,8131,618,7.1
"37131",37,131,1992,9029,8318,711,7.9
"37131",37,131,1993,8752,8191,561,6.4
"37131",37,131,1994,8699,8010,689,7.9
"37131",37,131,1995,8511,7881,630,7.4
"37131",37,131,1996,8584,7925,659,7.7
"37131",37,131,1997,8650,8002,648,7.5
"37131",37,131,1998,8461,7825,636,7.5
"37131",37,131,1999,8561,8001,560,6.5
"37131",37,131,2000,8721,8254,467,5.4
"37131",37,131,2001,8639,7914,725,8.4
"37131",37,131,2002,8497,7703,794,9.3
"37131",37,131,2003,8850,8151,699,7.9
"37131",37,131,2004,8833,8215,618,7
"37131",37,131,2005,8941,8344,597,6.7
"37131",37,131,2006,8995,8481,514,5.7
"37131",37,131,2007,9084,8542,542,6
"37131",37,131,2008,8667,8000,667,7.7
"37131",37,131,2009,8633,7656,977,11.3
"37131",37,131,2010,8703,7690,1013,11.6
"37131",37,131,2011,8630,7574,1056,12.2
"37131",37,131,2012,8297,7345,952,11.5
"37131",37,131,2013,8159,7344,815,10
"37131",37,131,2014,7945,7305,640,8.1
"37131",37,131,2015,7866,7273,593,7.5
"37131",37,131,2016,7806,7240,566,7.3
"37131",37,131,2017,7769,7276,493,6.3
"37133",37,133,1990,41594,39550,2044,4.9
"37133",37,133,1991,41982,39772,2210,5.3
"37133",37,133,1992,41762,39721,2041,4.9
"37133",37,133,1993,42520,40493,2027,4.8
"37133",37,133,1994,43044,41168,1876,4.4
"37133",37,133,1995,43645,41924,1721,3.9
"37133",37,133,1996,45682,43839,1843,4
"37133",37,133,1997,48011,46398,1613,3.4
"37133",37,133,1998,48363,46656,1707,3.5
"37133",37,133,1999,50276,48512,1764,3.5
"37133",37,133,2000,53363,51074,2289,4.3
"37133",37,133,2001,54280,51325,2955,5.4
"37133",37,133,2002,53487,50020,3467,6.5
"37133",37,133,2003,53864,50408,3456,6.4
"37133",37,133,2004,55319,52336,2983,5.4
"37133",37,133,2005,55996,53011,2985,5.3
"37133",37,133,2006,58206,55620,2586,4.4
"37133",37,133,2007,59887,57207,2680,4.5
"37133",37,133,2008,63010,59461,3549,5.6
"37133",37,133,2009,65809,60234,5575,8.5
"37133",37,133,2010,63342,58102,5240,8.3
"37133",37,133,2011,62686,57493,5193,8.3
"37133",37,133,2012,63599,58505,5094,8
"37133",37,133,2013,64041,59535,4506,7
"37133",37,133,2014,64033,60131,3902,6.1
"37133",37,133,2015,63749,59993,3756,5.9
"37133",37,133,2016,63649,60145,3504,5.5
"37133",37,133,2017,64162,60903,3259,5.1
"37135",37,135,1990,53321,52026,1295,2.4
"37135",37,135,1991,54733,53206,1527,2.8
"37135",37,135,1992,56166,54584,1582,2.8
"37135",37,135,1993,57624,56320,1304,2.3
"37135",37,135,1994,59287,58118,1169,2
"37135",37,135,1995,60131,58985,1146,1.9
"37135",37,135,1996,61822,60733,1089,1.8
"37135",37,135,1997,63873,62905,968,1.5
"37135",37,135,1998,64455,63610,845,1.3
"37135",37,135,1999,65505,64759,746,1.1
"37135",37,135,2000,65035,63423,1612,2.5
"37135",37,135,2001,66565,64284,2281,3.4
"37135",37,135,2002,64853,62057,2796,4.3
"37135",37,135,2003,64347,61616,2731,4.2
"37135",37,135,2004,64123,61682,2441,3.8
"37135",37,135,2005,65060,62622,2438,3.7
"37135",37,135,2006,67112,64893,2219,3.3
"37135",37,135,2007,67916,65724,2192,3.2
"37135",37,135,2008,69732,66952,2780,4
"37135",37,135,2009,69999,65481,4518,6.5
"37135",37,135,2010,69962,65345,4617,6.6
"37135",37,135,2011,70173,65582,4591,6.5
"37135",37,135,2012,72076,67675,4401,6.1
"37135",37,135,2013,72648,68785,3863,5.3
"37135",37,135,2014,72691,69311,3380,4.6
"37135",37,135,2015,73372,69975,3397,4.6
"37135",37,135,2016,74856,71683,3173,4.2
"37135",37,135,2017,76435,73514,2921,3.8
"37137",37,137,1990,5049,4845,204,4
"37137",37,137,1991,5118,4874,244,4.8
"37137",37,137,1992,5273,4972,301,5.7
"37137",37,137,1993,5154,4941,213,4.1
"37137",37,137,1994,5295,4994,301,5.7
"37137",37,137,1995,5440,5111,329,6
"37137",37,137,1996,5571,5288,283,5.1
"37137",37,137,1997,5653,5410,243,4.3
"37137",37,137,1998,5660,5432,228,4
"37137",37,137,1999,5659,5444,215,3.8
"37137",37,137,2000,5438,5221,217,4
"37137",37,137,2001,5359,5066,293,5.5
"37137",37,137,2002,5409,5101,308,5.7
"37137",37,137,2003,5573,5268,305,5.5
"37137",37,137,2004,5597,5341,256,4.6
"37137",37,137,2005,5691,5434,257,4.5
"37137",37,137,2006,5645,5387,258,4.6
"37137",37,137,2007,5600,5361,239,4.3
"37137",37,137,2008,5413,5092,321,5.9
"37137",37,137,2009,5297,4767,530,10
"37137",37,137,2010,5502,4941,561,10.2
"37137",37,137,2011,5481,4948,533,9.7
"37137",37,137,2012,5371,4887,484,9
"37137",37,137,2013,5330,4883,447,8.4
"37137",37,137,2014,5302,4950,352,6.6
"37137",37,137,2015,5335,5017,318,6
"37137",37,137,2016,5403,5118,285,5.3
"37137",37,137,2017,5416,5156,260,4.8
"37139",37,139,1990,13602,13009,593,4.4
"37139",37,139,1991,13198,12473,725,5.5
"37139",37,139,1992,13572,12795,777,5.7
"37139",37,139,1993,13854,13093,761,5.5
"37139",37,139,1994,13945,13214,731,5.2
"37139",37,139,1995,14524,13816,708,4.9
"37139",37,139,1996,15069,14306,763,5.1
"37139",37,139,1997,15350,14636,714,4.7
"37139",37,139,1998,15373,14703,670,4.4
"37139",37,139,1999,15632,15073,559,3.6
"37139",37,139,2000,15475,14898,577,3.7
"37139",37,139,2001,15473,14701,772,5
"37139",37,139,2002,15682,14816,866,5.5
"37139",37,139,2003,16435,15600,835,5.1
"37139",37,139,2004,16990,16215,775,4.6
"37139",37,139,2005,17239,16418,821,4.8
"37139",37,139,2006,17834,16943,891,5
"37139",37,139,2007,18288,17374,914,5
"37139",37,139,2008,17953,16729,1224,6.8
"37139",37,139,2009,17797,16029,1768,9.9
"37139",37,139,2010,18498,16657,1841,10
"37139",37,139,2011,18269,16383,1886,10.3
"37139",37,139,2012,18123,16303,1820,10
"37139",37,139,2013,17676,15973,1703,9.6
"37139",37,139,2014,17281,15886,1395,8.1
"37139",37,139,2015,17450,16185,1265,7.2
"37139",37,139,2016,17378,16286,1092,6.3
"37139",37,139,2017,17493,16517,976,5.6
"37141",37,141,1990,13730,13106,624,4.5
"37141",37,141,1991,14300,13165,1135,7.9
"37141",37,141,1992,15289,13916,1373,9
"37141",37,141,1993,13693,12512,1181,8.6
"37141",37,141,1994,14378,13412,966,6.7
"37141",37,141,1995,14978,14102,876,5.8
"37141",37,141,1996,16105,15270,835,5.2
"37141",37,141,1997,16614,15836,778,4.7
"37141",37,141,1998,16882,15988,894,5.3
"37141",37,141,1999,17418,16591,827,4.7
"37141",37,141,2000,19510,18719,791,4.1
"37141",37,141,2001,19945,18833,1112,5.6
"37141",37,141,2002,20239,18689,1550,7.7
"37141",37,141,2003,20700,19337,1363,6.6
"37141",37,141,2004,21043,20014,1029,4.9
"37141",37,141,2005,21914,20864,1050,4.8
"37141",37,141,2006,23402,22427,975,4.2
"37141",37,141,2007,23590,22594,996,4.2
"37141",37,141,2008,24381,22913,1468,6
"37141",37,141,2009,24623,21929,2694,10.9
"37141",37,141,2010,24446,21650,2796,11.4
"37141",37,141,2011,24622,21831,2791,11.3
"37141",37,141,2012,24880,22285,2595,10.4
"37141",37,141,2013,25025,22765,2260,9
"37141",37,141,2014,25315,23518,1797,7.1
"37141",37,141,2015,26017,24431,1586,6.1
"37141",37,141,2016,26822,25404,1418,5.3
"37141",37,141,2017,27362,26069,1293,4.7
"37143",37,143,1990,4493,4330,163,3.6
"37143",37,143,1991,4357,4118,239,5.5
"37143",37,143,1992,4399,4138,261,5.9
"37143",37,143,1993,4405,4189,216,4.9
"37143",37,143,1994,4412,4213,199,4.5
"37143",37,143,1995,4617,4384,233,5
"37143",37,143,1996,4824,4604,220,4.6
"37143",37,143,1997,4823,4605,218,4.5
"37143",37,143,1998,4807,4614,193,4
"37143",37,143,1999,4908,4766,142,2.9
"37143",37,143,2000,4791,4606,185,3.9
"37143",37,143,2001,4850,4587,263,5.4
"37143",37,143,2002,4838,4568,270,5.6
"37143",37,143,2003,5013,4760,253,5
"37143",37,143,2004,5093,4854,239,4.7
"37143",37,143,2005,5142,4896,246,4.8
"37143",37,143,2006,5264,4988,276,5.2
"37143",37,143,2007,5337,5060,277,5.2
"37143",37,143,2008,5299,4942,357,6.7
"37143",37,143,2009,5186,4638,548,10.6
"37143",37,143,2010,5334,4766,568,10.6
"37143",37,143,2011,5303,4721,582,11
"37143",37,143,2012,5266,4717,549,10.4
"37143",37,143,2013,5223,4722,501,9.6
"37143",37,143,2014,5102,4704,398,7.8
"37143",37,143,2015,5156,4788,368,7.1
"37143",37,143,2016,5096,4768,328,6.4
"37143",37,143,2017,5117,4821,296,5.8
"37145",37,145,1990,16697,15653,1044,6.3
"37145",37,145,1991,16485,14966,1519,9.2
"37145",37,145,1992,16435,14816,1619,9.9
"37145",37,145,1993,16298,15039,1259,7.7
"37145",37,145,1994,16031,15041,990,6.2
"37145",37,145,1995,17204,16291,913,5.3
"37145",37,145,1996,18434,17412,1022,5.5
"37145",37,145,1997,18428,17555,873,4.7
"37145",37,145,1998,18023,17225,798,4.4
"37145",37,145,1999,17723,16972,751,4.2
"37145",37,145,2000,18212,17430,782,4.3
"37145",37,145,2001,18818,17543,1275,6.8
"37145",37,145,2002,18692,17279,1413,7.6
"37145",37,145,2003,18637,17216,1421,7.6
"37145",37,145,2004,18472,17257,1215,6.6
"37145",37,145,2005,18733,17537,1196,6.4
"37145",37,145,2006,19162,17973,1189,6.2
"37145",37,145,2007,18861,17593,1268,6.7
"37145",37,145,2008,19015,17646,1369,7.2
"37145",37,145,2009,19191,17022,2169,11.3
"37145",37,145,2010,18704,16386,2318,12.4
"37145",37,145,2011,18560,16347,2213,11.9
"37145",37,145,2012,18394,16365,2029,11
"37145",37,145,2013,18290,16445,1845,10.1
"37145",37,145,2014,17945,16551,1394,7.8
"37145",37,145,2015,17884,16670,1214,6.8
"37145",37,145,2016,18016,17029,987,5.5
"37145",37,145,2017,18321,17466,855,4.7
"37147",37,147,1990,57235,54937,2298,4
"37147",37,147,1991,58249,54779,3470,6
"37147",37,147,1992,58229,54554,3675,6.3
"37147",37,147,1993,59056,56017,3039,5.1
"37147",37,147,1994,60941,58130,2811,4.6
"37147",37,147,1995,63823,60794,3029,4.7
"37147",37,147,1996,65545,62260,3285,5
"37147",37,147,1997,66971,63633,3338,5
"37147",37,147,1998,67176,64224,2952,4.4
"37147",37,147,1999,70161,67061,3100,4.4
"37147",37,147,2000,70106,67216,2890,4.1
"37147",37,147,2001,69840,65804,4036,5.8
"37147",37,147,2002,68699,64183,4516,6.6
"37147",37,147,2003,71610,67005,4605,6.4
"37147",37,147,2004,71873,67802,4071,5.7
"37147",37,147,2005,73488,69235,4253,5.8
"37147",37,147,2006,76178,72195,3983,5.2
"37147",37,147,2007,79009,75003,4006,5.1
"37147",37,147,2008,80996,75795,5201,6.4
"37147",37,147,2009,82319,74040,8279,10.1
"37147",37,147,2010,85917,77174,8743,10.2
"37147",37,147,2011,85776,77087,8689,10.1
"37147",37,147,2012,87721,79725,7996,9.1
"37147",37,147,2013,87887,80794,7093,8.1
"37147",37,147,2014,87492,81848,5644,6.5
"37147",37,147,2015,87688,82376,5312,6.1
"37147",37,147,2016,88118,83209,4909,5.6
"37147",37,147,2017,89270,84865,4405,4.9
"37149",37,149,1990,6926,6779,147,2.1
"37149",37,149,1991,7364,7145,219,3
"37149",37,149,1992,7369,7093,276,3.7
"37149",37,149,1993,7304,7077,227,3.1
"37149",37,149,1994,7431,7217,214,2.9
"37149",37,149,1995,7608,7406,202,2.7
"37149",37,149,1996,7743,7558,185,2.4
"37149",37,149,1997,7851,7676,175,2.2
"37149",37,149,1998,7840,7679,161,2.1
"37149",37,149,1999,8288,8030,258,3.1
"37149",37,149,2000,8524,8219,305,3.6
"37149",37,149,2001,8790,8418,372,4.2
"37149",37,149,2002,8637,8186,451,5.2
"37149",37,149,2003,8916,8495,421,4.7
"37149",37,149,2004,8988,8597,391,4.4
"37149",37,149,2005,9104,8724,380,4.2
"37149",37,149,2006,9390,9062,328,3.5
"37149",37,149,2007,9701,9370,331,3.4
"37149",37,149,2008,9538,9081,457,4.8
"37149",37,149,2009,9447,8589,858,9.1
"37149",37,149,2010,8561,7692,869,10.2
"37149",37,149,2011,8444,7657,787,9.3
"37149",37,149,2012,8349,7640,709,8.5
"37149",37,149,2013,8666,8091,575,6.6
"37149",37,149,2014,8408,7957,451,5.4
"37149",37,149,2015,8661,8220,441,5.1
"37149",37,149,2016,8815,8406,409,4.6
"37149",37,149,2017,8944,8567,377,4.2
"37151",37,151,1990,63110,61171,1939,3.1
"37151",37,151,1991,64011,61001,3010,4.7
"37151",37,151,1992,64683,61887,2796,4.3
"37151",37,151,1993,64736,62783,1953,3
"37151",37,151,1994,65878,63993,1885,2.9
"37151",37,151,1995,67169,65260,1909,2.8
"37151",37,151,1996,70463,68069,2394,3.4
"37151",37,151,1997,71719,69811,1908,2.7
"37151",37,151,1998,72091,70100,1991,2.8
"37151",37,151,1999,73324,71364,1960,2.7
"37151",37,151,2000,72549,70105,2444,3.4
"37151",37,151,2001,73599,69587,4012,5.5
"37151",37,151,2002,73512,68830,4682,6.4
"37151",37,151,2003,74226,69651,4575,6.2
"37151",37,151,2004,73593,69895,3698,5
"37151",37,151,2005,74686,71131,3555,4.8
"37151",37,151,2006,76469,72952,3517,4.6
"37151",37,151,2007,74238,70754,3484,4.7
"37151",37,151,2008,75059,70321,4738,6.3
"37151",37,151,2009,74265,65927,8338,11.2
"37151",37,151,2010,69399,61084,8315,12
"37151",37,151,2011,68708,61191,7517,10.9
"37151",37,151,2012,68475,61672,6803,9.9
"37151",37,151,2013,67952,62081,5871,8.6
"37151",37,151,2014,66648,62280,4368,6.6
"37151",37,151,2015,66641,62839,3802,5.7
"37151",37,151,2016,66817,63531,3286,4.9
"37151",37,151,2017,67249,64275,2974,4.4
"37153",37,153,1990,22409,21108,1301,5.8
"37153",37,153,1991,22230,20168,2062,9.3
"37153",37,153,1992,21927,19978,1949,8.9
"37153",37,153,1993,21361,19503,1858,8.7
"37153",37,153,1994,21537,19427,2110,9.8
"37153",37,153,1995,21200,19185,2015,9.5
"37153",37,153,1996,21323,18919,2404,11.3
"37153",37,153,1997,20388,18554,1834,9
"37153",37,153,1998,19685,18020,1665,8.5
"37153",37,153,1999,19663,18402,1261,6.4
"37153",37,153,2000,20953,19850,1103,5.3
"37153",37,153,2001,21318,19570,1748,8.2
"37153",37,153,2002,20485,18321,2164,10.6
"37153",37,153,2003,20437,18446,1991,9.7
"37153",37,153,2004,20169,18558,1611,8
"37153",37,153,2005,20124,18579,1545,7.7
"37153",37,153,2006,20216,18691,1525,7.5
"37153",37,153,2007,20691,19152,1539,7.4
"37153",37,153,2008,20109,18262,1847,9.2
"37153",37,153,2009,19973,17181,2792,14
"37153",37,153,2010,18927,16113,2814,14.9
"37153",37,153,2011,18285,15615,2670,14.6
"37153",37,153,2012,17929,15530,2399,13.4
"37153",37,153,2013,17436,15386,2050,11.8
"37153",37,153,2014,16940,15422,1518,9
"37153",37,153,2015,16926,15586,1340,7.9
"37153",37,153,2016,16772,15612,1160,6.9
"37153",37,153,2017,16726,15700,1026,6.1
"37155",37,155,1990,49199,45469,3730,7.6
"37155",37,155,1991,51263,46631,4632,9
"37155",37,155,1992,53893,48305,5588,10.4
"37155",37,155,1993,54737,50256,4481,8.2
"37155",37,155,1994,54611,50462,4149,7.6
"37155",37,155,1995,55110,50376,4734,8.6
"37155",37,155,1996,55991,50779,5212,9.3
"37155",37,155,1997,56977,52471,4506,7.9
"37155",37,155,1998,56303,52022,4281,7.6
"37155",37,155,1999,55452,50972,4480,8.1
"37155",37,155,2000,53760,50193,3567,6.6
"37155",37,155,2001,52319,47268,5051,9.7
"37155",37,155,2002,52036,46982,5054,9.7
"37155",37,155,2003,52391,47960,4431,8.5
"37155",37,155,2004,51796,48112,3684,7.1
"37155",37,155,2005,52340,48783,3557,6.8
"37155",37,155,2006,53884,50559,3325,6.2
"37155",37,155,2007,56833,53332,3501,6.2
"37155",37,155,2008,55922,51507,4415,7.9
"37155",37,155,2009,55871,49221,6650,11.9
"37155",37,155,2010,53853,46478,7375,13.7
"37155",37,155,2011,53473,45863,7610,14.2
"37155",37,155,2012,52819,45822,6997,13.2
"37155",37,155,2013,52119,45939,6180,11.9
"37155",37,155,2014,51134,46292,4842,9.5
"37155",37,155,2015,51047,46723,4324,8.5
"37155",37,155,2016,50497,46492,4005,7.9
"37155",37,155,2017,50296,46953,3343,6.6
"37157",37,157,1990,46705,44256,2449,5.2
"37157",37,157,1991,46900,43315,3585,7.6
"37157",37,157,1992,47412,43818,3594,7.6
"37157",37,157,1993,47047,44327,2720,5.8
"37157",37,157,1994,47901,45099,2802,5.8
"37157",37,157,1995,47625,45447,2178,4.6
"37157",37,157,1996,48722,46454,2268,4.7
"37157",37,157,1997,48471,45846,2625,5.4
"37157",37,157,1998,46634,44149,2485,5.3
"37157",37,157,1999,46348,44107,2241,4.8
"37157",37,157,2000,46279,44084,2195,4.7
"37157",37,157,2001,46637,43457,3180,6.8
"37157",37,157,2002,46461,42758,3703,8
"37157",37,157,2003,46934,42804,4130,8.8
"37157",37,157,2004,45742,42404,3338,7.3
"37157",37,157,2005,45686,42675,3011,6.6
"37157",37,157,2006,46067,43339,2728,5.9
"37157",37,157,2007,44568,41822,2746,6.2
"37157",37,157,2008,44504,41197,3307,7.4
"37157",37,157,2009,43899,38348,5551,12.6
"37157",37,157,2010,44210,38369,5841,13.2
"37157",37,157,2011,43567,38210,5357,12.3
"37157",37,157,2012,43033,38186,4847,11.3
"37157",37,157,2013,42156,38076,4080,9.7
"37157",37,157,2014,41126,38045,3081,7.5
"37157",37,157,2015,41121,38400,2721,6.6
"37157",37,157,2016,40810,38505,2305,5.6
"37157",37,157,2017,41106,38956,2150,5.2
"37159",37,159,1990,58514,56233,2281,3.9
"37159",37,159,1991,58407,55208,3199,5.5
"37159",37,159,1992,58909,55687,3222,5.5
"37159",37,159,1993,59490,57076,2414,4.1
"37159",37,159,1994,60885,58916,1969,3.2
"37159",37,159,1995,62466,60204,2262,3.6
"37159",37,159,1996,64940,62629,2311,3.6
"37159",37,159,1997,65816,63801,2015,3.1
"37159",37,159,1998,65532,63729,1803,2.8
"37159",37,159,1999,67260,65231,2029,3
"37159",37,159,2000,65703,62799,2904,4.4
"37159",37,159,2001,65453,61195,4258,6.5
"37159",37,159,2002,65564,61406,4158,6.3
"37159",37,159,2003,67700,62600,5100,7.5
"37159",37,159,2004,67890,62980,4910,7.2
"37159",37,159,2005,67803,64151,3652,5.4
"37159",37,159,2006,69324,65876,3448,5
"37159",37,159,2007,70465,66228,4237,6
"37159",37,159,2008,69967,65244,4723,6.8
"37159",37,159,2009,70583,61606,8977,12.7
"37159",37,159,2010,64328,55278,9050,14.1
"37159",37,159,2011,63505,55598,7907,12.5
"37159",37,159,2012,63310,56426,6884,10.9
"37159",37,159,2013,62823,56994,5829,9.3
"37159",37,159,2014,62452,58040,4412,7.1
"37159",37,159,2015,63095,59252,3843,6.1
"37159",37,159,2016,64164,60595,3569,5.6
"37159",37,159,2017,65907,62804,3103,4.7
"37161",37,161,1990,30321,28731,1590,5.2
"37161",37,161,1991,30834,28556,2278,7.4
"37161",37,161,1992,30714,28782,1932,6.3
"37161",37,161,1993,30739,28994,1745,5.7
"37161",37,161,1994,30770,29394,1376,4.5
"37161",37,161,1995,30986,29206,1780,5.7
"37161",37,161,1996,31470,29471,1999,6.4
"37161",37,161,1997,31411,29545,1866,5.9
"37161",37,161,1998,30347,28848,1499,4.9
"37161",37,161,1999,29837,27703,2134,7.2
"37161",37,161,2000,31082,29292,1790,5.8
"37161",37,161,2001,30691,28408,2283,7.4
"37161",37,161,2002,30583,27725,2858,9.3
"37161",37,161,2003,31487,28813,2674,8.5
"37161",37,161,2004,30027,27330,2697,9
"37161",37,161,2005,29473,26929,2544,8.6
"37161",37,161,2006,29746,27442,2304,7.7
"37161",37,161,2007,30295,28352,1943,6.4
"37161",37,161,2008,29663,27289,2374,8
"37161",37,161,2009,28325,23714,4611,16.3
"37161",37,161,2010,26979,22464,4515,16.7
"37161",37,161,2011,26482,22625,3857,14.6
"37161",37,161,2012,26780,23245,3535,13.2
"37161",37,161,2013,25935,23039,2896,11.2
"37161",37,161,2014,25460,23279,2181,8.6
"37161",37,161,2015,25050,23104,1946,7.8
"37161",37,161,2016,24784,23127,1657,6.7
"37161",37,161,2017,24610,23096,1514,6.2
"37163",37,163,1990,23626,22543,1083,4.6
"37163",37,163,1991,23128,21410,1718,7.4
"37163",37,163,1992,23784,22171,1613,6.8
"37163",37,163,1993,23539,21884,1655,7
"37163",37,163,1994,23242,21965,1277,5.5
"37163",37,163,1995,23859,22493,1366,5.7
"37163",37,163,1996,24046,22542,1504,6.3
"37163",37,163,1997,24540,23244,1296,5.3
"37163",37,163,1998,23987,22760,1227,5.1
"37163",37,163,1999,24246,23116,1130,4.7
"37163",37,163,2000,28932,27927,1005,3.5
"37163",37,163,2001,29288,27500,1788,6.1
"37163",37,163,2002,29312,27325,1987,6.8
"37163",37,163,2003,31165,29387,1778,5.7
"37163",37,163,2004,31371,29859,1512,4.8
"37163",37,163,2005,31203,29682,1521,4.9
"37163",37,163,2006,31237,29815,1422,4.6
"37163",37,163,2007,33022,31712,1310,4
"37163",37,163,2008,32368,30643,1725,5.3
"37163",37,163,2009,31303,28555,2748,8.8
"37163",37,163,2010,29558,26703,2855,9.7
"37163",37,163,2011,29686,26786,2900,9.8
"37163",37,163,2012,29697,26932,2765,9.3
"37163",37,163,2013,29661,27265,2396,8.1
"37163",37,163,2014,29643,27723,1920,6.5
"37163",37,163,2015,29543,27794,1749,5.9
"37163",37,163,2016,29485,27876,1609,5.5
"37163",37,163,2017,29398,27984,1414,4.8
"37165",37,165,1990,16599,15159,1440,8.7
"37165",37,165,1991,16903,15106,1797,10.6
"37165",37,165,1992,17227,15336,1891,11
"37165",37,165,1993,17481,15896,1585,9.1
"37165",37,165,1994,17571,16214,1357,7.7
"37165",37,165,1995,17660,16418,1242,7
"37165",37,165,1996,18154,16887,1267,7
"37165",37,165,1997,18146,16833,1313,7.2
"37165",37,165,1998,17812,16346,1466,8.2
"37165",37,165,1999,17970,16835,1135,6.3
"37165",37,165,2000,15772,14778,994,6.3
"37165",37,165,2001,16077,14592,1485,9.2
"37165",37,165,2002,15858,14304,1554,9.8
"37165",37,165,2003,16231,14391,1840,11.3
"37165",37,165,2004,15354,13715,1639,10.7
"37165",37,165,2005,15076,13613,1463,9.7
"37165",37,165,2006,14801,13491,1310,8.9
"37165",37,165,2007,14507,13058,1449,10
"37165",37,165,2008,13888,12374,1514,10.9
"37165",37,165,2009,13789,11469,2320,16.8
"37165",37,165,2010,13098,10789,2309,17.6
"37165",37,165,2011,12855,10537,2318,18
"37165",37,165,2012,12462,10324,2138,17.2
"37165",37,165,2013,12250,10404,1846,15.1
"37165",37,165,2014,11997,10562,1435,12
"37165",37,165,2015,11860,10603,1257,10.6
"37165",37,165,2016,11623,10562,1061,9.1
"37165",37,165,2017,11523,10619,904,7.8
"37167",37,167,1990,28394,27069,1325,4.7
"37167",37,167,1991,28663,26738,1925,6.7
"37167",37,167,1992,28407,26644,1763,6.2
"37167",37,167,1993,27934,26496,1438,5.1
"37167",37,167,1994,27220,25537,1683,6.2
"37167",37,167,1995,27063,25488,1575,5.8
"37167",37,167,1996,27488,25775,1713,6.2
"37167",37,167,1997,27748,26404,1344,4.8
"37167",37,167,1998,27675,26732,943,3.4
"37167",37,167,1999,27971,26974,997,3.6
"37167",37,167,2000,29930,28785,1145,3.8
"37167",37,167,2001,29543,27459,2084,7.1
"37167",37,167,2002,29181,27087,2094,7.2
"37167",37,167,2003,29720,27585,2135,7.2
"37167",37,167,2004,29189,27386,1803,6.2
"37167",37,167,2005,29475,27888,1587,5.4
"37167",37,167,2006,30040,28513,1527,5.1
"37167",37,167,2007,30681,29191,1490,4.9
"37167",37,167,2008,30088,28138,1950,6.5
"37167",37,167,2009,30271,26622,3649,12.1
"37167",37,167,2010,29064,25232,3832,13.2
"37167",37,167,2011,28833,25440,3393,11.8
"37167",37,167,2012,28752,25893,2859,9.9
"37167",37,167,2013,28855,26498,2357,8.2
"37167",37,167,2014,28532,26805,1727,6.1
"37167",37,167,2015,28796,27263,1533,5.3
"37167",37,167,2016,29257,27900,1357,4.6
"37167",37,167,2017,29824,28585,1239,4.2
"37169",37,169,1990,20462,19601,861,4.2
"37169",37,169,1991,20380,19421,959,4.7
"37169",37,169,1992,20750,19884,866,4.2
"37169",37,169,1993,20821,20137,684,3.3
"37169",37,169,1994,21382,20739,643,3
"37169",37,169,1995,22014,21399,615,2.8
"37169",37,169,1996,22924,22342,582,2.5
"37169",37,169,1997,23367,22861,506,2.2
"37169",37,169,1998,23475,22938,537,2.3
"37169",37,169,1999,23840,23295,545,2.3
"37169",37,169,2000,24007,23180,827,3.4
"37169",37,169,2001,24193,22925,1268,5.2
"37169",37,169,2002,23949,22502,1447,6
"37169",37,169,2003,24040,22596,1444,6
"37169",37,169,2004,23794,22545,1249,5.2
"37169",37,169,2005,23944,22748,1196,5
"37169",37,169,2006,24265,23221,1044,4.3
"37169",37,169,2007,23807,22765,1042,4.4
"37169",37,169,2008,24087,22690,1397,5.8
"37169",37,169,2009,23500,21012,2488,10.6
"37169",37,169,2010,22847,20244,2603,11.4
"37169",37,169,2011,22507,20163,2344,10.4
"37169",37,169,2012,22391,20309,2082,9.3
"37169",37,169,2013,22180,20437,1743,7.9
"37169",37,169,2014,21788,20465,1323,6.1
"37169",37,169,2015,21804,20620,1184,5.4
"37169",37,169,2016,21850,20806,1044,4.8
"37169",37,169,2017,22034,21087,947,4.3
"37171",37,171,1990,33750,32218,1532,4.5
"37171",37,171,1991,34496,32330,2166,6.3
"37171",37,171,1992,35341,33283,2058,5.8
"37171",37,171,1993,35335,33880,1455,4.1
"37171",37,171,1994,35840,34399,1441,4
"37171",37,171,1995,36440,34679,1761,4.8
"37171",37,171,1996,36702,34949,1753,4.8
"37171",37,171,1997,36846,35531,1315,3.6
"37171",37,171,1998,36125,34793,1332,3.7
"37171",37,171,1999,35568,34266,1302,3.7
"37171",37,171,2000,37095,35610,1485,4
"37171",37,171,2001,36837,34571,2266,6.2
"37171",37,171,2002,36054,33235,2819,7.8
"37171",37,171,2003,36201,33467,2734,7.6
"37171",37,171,2004,35469,33343,2126,6
"37171",37,171,2005,34916,32871,2045,5.9
"37171",37,171,2006,34969,33179,1790,5.1
"37171",37,171,2007,35132,33263,1869,5.3
"37171",37,171,2008,34132,31493,2639,7.7
"37171",37,171,2009,33728,29533,4195,12.4
"37171",37,171,2010,34423,30290,4133,12
"37171",37,171,2011,33832,30178,3654,10.8
"37171",37,171,2012,33651,30410,3241,9.6
"37171",37,171,2013,33280,30507,2773,8.3
"37171",37,171,2014,33014,30977,2037,6.2
"37171",37,171,2015,33328,31522,1806,5.4
"37171",37,171,2016,33488,31888,1600,4.8
"37171",37,171,2017,33680,32246,1434,4.3
"37173",37,173,1990,5807,5082,725,12.5
"37173",37,173,1991,6163,5244,919,14.9
"37173",37,173,1992,6350,5223,1127,17.7
"37173",37,173,1993,6135,5189,946,15.4
"37173",37,173,1994,6025,5101,924,15.3
"37173",37,173,1995,5963,4969,994,16.7
"37173",37,173,1996,6157,5063,1094,17.8
"37173",37,173,1997,6356,5281,1075,16.9
"37173",37,173,1998,5868,5114,754,12.8
"37173",37,173,1999,6180,5503,677,11
"37173",37,173,2000,6213,5667,546,8.8
"37173",37,173,2001,6721,6189,532,7.9
"37173",37,173,2002,6601,6038,563,8.5
"37173",37,173,2003,6742,6211,531,7.9
"37173",37,173,2004,6643,6164,479,7.2
"37173",37,173,2005,6868,6395,473,6.9
"37173",37,173,2006,7255,6849,406,5.6
"37173",37,173,2007,7292,6833,459,6.3
"37173",37,173,2008,6933,6393,540,7.8
"37173",37,173,2009,6795,5983,812,11.9
"37173",37,173,2010,6269,5345,924,14.7
"37173",37,173,2011,6484,5470,1014,15.6
"37173",37,173,2012,6522,5562,960,14.7
"37173",37,173,2013,6598,5782,816,12.4
"37173",37,173,2014,6489,5903,586,9
"37173",37,173,2015,6775,6255,520,7.7
"37173",37,173,2016,7111,6677,434,6.1
"37173",37,173,2017,6941,6587,354,5.1
"37175",37,175,1990,11721,11306,415,3.5
"37175",37,175,1991,11912,11316,596,5
"37175",37,175,1992,11992,11340,652,5.4
"37175",37,175,1993,11510,10949,561,4.9
"37175",37,175,1994,11441,10921,520,4.5
"37175",37,175,1995,11118,10661,457,4.1
"37175",37,175,1996,11296,10949,347,3.1
"37175",37,175,1997,11665,11418,247,2.1
"37175",37,175,1998,11738,11461,277,2.4
"37175",37,175,1999,11633,11420,213,1.8
"37175",37,175,2000,13440,13010,430,3.2
"37175",37,175,2001,13371,12701,670,5
"37175",37,175,2002,13171,12215,956,7.3
"37175",37,175,2003,12676,11569,1107,8.7
"37175",37,175,2004,12201,11354,847,6.9
"37175",37,175,2005,12361,11706,655,5.3
"37175",37,175,2006,12627,12096,531,4.2
"37175",37,175,2007,13357,12864,493,3.7
"37175",37,175,2008,13345,12665,680,5.1
"37175",37,175,2009,13232,12003,1229,9.3
"37175",37,175,2010,13805,12456,1349,9.8
"37175",37,175,2011,13393,12130,1263,9.4
"37175",37,175,2012,13456,12286,1170,8.7
"37175",37,175,2013,13397,12405,992,7.4
"37175",37,175,2014,13345,12564,781,5.9
"37175",37,175,2015,13546,12809,737,5.4
"37175",37,175,2016,13944,13265,679,4.9
"37175",37,175,2017,14217,13597,620,4.4
"37177",37,177,1990,1875,1684,191,10.2
"37177",37,177,1991,1870,1659,211,11.3
"37177",37,177,1992,1957,1667,290,14.8
"37177",37,177,1993,1900,1665,235,12.4
"37177",37,177,1994,1824,1669,155,8.5
"37177",37,177,1995,1833,1647,186,10.1
"37177",37,177,1996,1828,1659,169,9.2
"37177",37,177,1997,1836,1676,160,8.7
"37177",37,177,1998,1917,1761,156,8.1
"37177",37,177,1999,1901,1743,158,8.3
"37177",37,177,2000,1887,1750,137,7.3
"37177",37,177,2001,1892,1741,151,8
"37177",37,177,2002,2013,1843,170,8.4
"37177",37,177,2003,2143,1955,188,8.8
"37177",37,177,2004,2177,2029,148,6.8
"37177",37,177,2005,2185,2025,160,7.3
"37177",37,177,2006,2121,1999,122,5.8
"37177",37,177,2007,2213,2088,125,5.6
"37177",37,177,2008,2204,2049,155,7
"37177",37,177,2009,2206,1967,239,10.8
"37177",37,177,2010,1659,1414,245,14.8
"37177",37,177,2011,1633,1389,244,14.9
"37177",37,177,2012,1583,1367,216,13.6
"37177",37,177,2013,1562,1360,202,12.9
"37177",37,177,2014,1554,1399,155,10
"37177",37,177,2015,1547,1400,147,9.5
"37177",37,177,2016,1528,1399,129,8.4
"37177",37,177,2017,1534,1417,117,7.6
"37179",37,179,1990,46314,45013,1301,2.8
"37179",37,179,1991,47154,44790,2364,5
"37179",37,179,1992,48319,45733,2586,5.4
"37179",37,179,1993,49810,47746,2064,4.1
"37179",37,179,1994,51891,50189,1702,3.3
"37179",37,179,1995,53830,52416,1414,2.6
"37179",37,179,1996,56747,55348,1399,2.5
"37179",37,179,1997,58790,57353,1437,2.4
"37179",37,179,1998,60235,58868,1367,2.3
"37179",37,179,1999,63467,62206,1261,2
"37179",37,179,2000,67442,65589,1853,2.7
"37179",37,179,2001,70966,68110,2856,4
"37179",37,179,2002,73564,69684,3880,5.3
"37179",37,179,2003,76383,72447,3936,5.2
"37179",37,179,2004,78467,74732,3735,4.8
"37179",37,179,2005,82302,78628,3674,4.5
"37179",37,179,2006,88957,85447,3510,3.9
"37179",37,179,2007,91672,88052,3620,3.9
"37179",37,179,2008,95592,90372,5220,5.5
"37179",37,179,2009,95385,85847,9538,10
"37179",37,179,2010,101154,91016,10138,10
"37179",37,179,2011,102404,93069,9335,9.1
"37179",37,179,2012,104230,96045,8185,7.9
"37179",37,179,2013,105688,98763,6925,6.6
"37179",37,179,2014,108820,103104,5716,5.3
"37179",37,179,2015,112322,106879,5443,4.8
"37179",37,179,2016,115647,110555,5092,4.4
"37179",37,179,2017,119334,114557,4777,4
"37181",37,181,1990,20351,18701,1650,8.1
"37181",37,181,1991,20499,18521,1978,9.6
"37181",37,181,1992,20625,18665,1960,9.5
"37181",37,181,1993,19942,18203,1739,8.7
"37181",37,181,1994,19718,17971,1747,8.9
"37181",37,181,1995,19530,17912,1618,8.3
"37181",37,181,1996,20047,18450,1597,8
"37181",37,181,1997,20044,18684,1360,6.8
"37181",37,181,1998,19629,18272,1357,6.9
"37181",37,181,1999,20146,18733,1413,7
"37181",37,181,2000,20297,18933,1364,6.7
"37181",37,181,2001,20242,18417,1825,9
"37181",37,181,2002,19986,17985,2001,10
"37181",37,181,2003,19949,17822,2127,10.7
"37181",37,181,2004,19299,17444,1855,9.6
"37181",37,181,2005,18976,17350,1626,8.6
"37181",37,181,2006,18773,17369,1404,7.5
"37181",37,181,2007,19622,18320,1302,6.6
"37181",37,181,2008,19522,17804,1718,8.8
"37181",37,181,2009,19363,16718,2645,13.7
"37181",37,181,2010,19018,16332,2686,14.1
"37181",37,181,2011,18646,15867,2779,14.9
"37181",37,181,2012,18486,15985,2501,13.5
"37181",37,181,2013,18128,16045,2083,11.5
"37181",37,181,2014,18063,16375,1688,9.3
"37181",37,181,2015,18047,16501,1546,8.6
"37181",37,181,2016,17984,16698,1286,7.2
"37181",37,181,2017,17897,16775,1122,6.3
"37183",37,183,1990,254508,248082,6426,2.5
"37183",37,183,1991,261842,253611,8231,3.1
"37183",37,183,1992,272810,263297,9513,3.5
"37183",37,183,1993,281383,272667,8716,3.1
"37183",37,183,1994,292362,284747,7615,2.6
"37183",37,183,1995,302960,295892,7068,2.3
"37183",37,183,1996,324019,317389,6630,2
"37183",37,183,1997,339968,334127,5841,1.7
"37183",37,183,1998,350589,345203,5386,1.5
"37183",37,183,1999,361379,356380,4999,1.4
"37183",37,183,2000,367403,358674,8729,2.4
"37183",37,183,2001,378061,363186,14875,3.9
"37183",37,183,2002,377841,356450,21391,5.7
"37183",37,183,2003,385646,365385,20261,5.3
"37183",37,183,2004,390143,373280,16863,4.3
"37183",37,183,2005,403861,387342,16519,4.1
"37183",37,183,2006,427016,411511,15505,3.6
"37183",37,183,2007,441589,426174,15415,3.5
"37183",37,183,2008,456089,435242,20847,4.6
"37183",37,183,2009,459057,421150,37907,8.3
"37183",37,183,2010,480565,440710,39855,8.3
"37183",37,183,2011,487849,449517,38332,7.9
"37183",37,183,2012,502454,466623,35831,7.1
"37183",37,183,2013,511268,480573,30695,6
"37183",37,183,2014,523577,497805,25772,4.9
"37183",37,183,2015,539483,514064,25419,4.7
"37183",37,183,2016,556100,532222,23878,4.3
"37183",37,183,2017,572771,550321,22450,3.9
"37185",37,185,1990,7462,6939,523,7
"37185",37,185,1991,7759,6845,914,11.8
"37185",37,185,1992,7645,6884,761,10
"37185",37,185,1993,7308,6716,592,8.1
"37185",37,185,1994,7146,6597,549,7.7
"37185",37,185,1995,7230,6617,613,8.5
"37185",37,185,1996,7523,6768,755,10
"37185",37,185,1997,7266,6830,436,6
"37185",37,185,1998,7346,6838,508,6.9
"37185",37,185,1999,7430,6969,461,6.2
"37185",37,185,2000,8154,7668,486,6
"37185",37,185,2001,8160,7468,692,8.5
"37185",37,185,2002,7933,7217,716,9
"37185",37,185,2003,8193,7518,675,8.2
"37185",37,185,2004,8273,7671,602,7.3
"37185",37,185,2005,8015,7449,566,7.1
"37185",37,185,2006,7886,7386,500,6.3
"37185",37,185,2007,7796,7311,485,6.2
"37185",37,185,2008,7765,7116,649,8.4
"37185",37,185,2009,7900,6861,1039,13.2
"37185",37,185,2010,7550,6514,1036,13.7
"37185",37,185,2011,7641,6574,1067,14
"37185",37,185,2012,7578,6635,943,12.4
"37185",37,185,2013,7301,6501,800,11
"37185",37,185,2014,7222,6579,643,8.9
"37185",37,185,2015,7212,6614,598,8.3
"37185",37,185,2016,7135,6614,521,7.3
"37185",37,185,2017,6872,6395,477,6.9
"37187",37,187,1990,6170,5912,258,4.2
"37187",37,187,1991,6514,6110,404,6.2
"37187",37,187,1992,6213,5707,506,8.1
"37187",37,187,1993,6099,5568,531,8.7
"37187",37,187,1994,6114,5654,460,7.5
"37187",37,187,1995,6255,5607,648,10.4
"37187",37,187,1996,6109,5662,447,7.3
"37187",37,187,1997,5996,5630,366,6.1
"37187",37,187,1998,6127,5674,453,7.4
"37187",37,187,1999,6346,5966,380,6
"37187",37,187,2000,5982,5665,317,5.3
"37187",37,187,2001,5943,5525,418,7
"37187",37,187,2002,5986,5508,478,8
"37187",37,187,2003,6189,5696,493,8
"37187",37,187,2004,6108,5687,421,6.9
"37187",37,187,2005,6111,5705,406,6.6
"37187",37,187,2006,6117,5710,407,6.7
"37187",37,187,2007,6412,5999,413,6.4
"37187",37,187,2008,6145,5677,468,7.6
"37187",37,187,2009,6231,5497,734,11.8
"37187",37,187,2010,5692,4880,812,14.3
"37187",37,187,2011,4989,4147,842,16.9
"37187",37,187,2012,4871,4124,747,15.3
"37187",37,187,2013,5300,4640,660,12.5
"37187",37,187,2014,5042,4556,486,9.6
"37187",37,187,2015,4967,4536,431,8.7
"37187",37,187,2016,4861,4500,361,7.4
"37187",37,187,2017,4805,4480,325,6.8
"37189",37,189,1990,19783,18904,879,4.4
"37189",37,189,1991,20119,19242,877,4.4
"37189",37,189,1992,20825,20086,739,3.5
"37189",37,189,1993,21154,20545,609,2.9
"37189",37,189,1994,22005,21500,505,2.3
"37189",37,189,1995,22635,21900,735,3.2
"37189",37,189,1996,22932,22283,649,2.8
"37189",37,189,1997,23361,22850,511,2.2
"37189",37,189,1998,23490,23054,436,1.9
"37189",37,189,1999,23982,23643,339,1.4
"37189",37,189,2000,23317,22650,667,2.9
"37189",37,189,2001,23710,22860,850,3.6
"37189",37,189,2002,22191,21193,998,4.5
"37189",37,189,2003,22740,21749,991,4.4
"37189",37,189,2004,22673,21752,921,4.1
"37189",37,189,2005,23171,22252,919,4
"37189",37,189,2006,23843,22959,884,3.7
"37189",37,189,2007,24743,23905,838,3.4
"37189",37,189,2008,22998,21916,1082,4.7
"37189",37,189,2009,23041,21211,1830,7.9
"37189",37,189,2010,26883,24773,2110,7.8
"37189",37,189,2011,27002,24875,2127,7.9
"37189",37,189,2012,27059,25062,1997,7.4
"37189",37,189,2013,26955,25233,1722,6.4
"37189",37,189,2014,27039,25636,1403,5.2
"37189",37,189,2015,27391,26064,1327,4.8
"37189",37,189,2016,27921,26665,1256,4.5
"37189",37,189,2017,28574,27401,1173,4.1
"37191",37,191,1990,47998,45806,2192,4.6
"37191",37,191,1991,49383,45892,3491,7.1
"37191",37,191,1992,47748,44382,3366,7
"37191",37,191,1993,46921,44379,2542,5.4
"37191",37,191,1994,48402,45881,2521,5.2
"37191",37,191,1995,48775,46312,2463,5
"37191",37,191,1996,49094,46730,2364,4.8
"37191",37,191,1997,50353,48246,2107,4.2
"37191",37,191,1998,49944,47765,2179,4.4
"37191",37,191,1999,50504,48436,2068,4.1
"37191",37,191,2000,51076,49066,2010,3.9
"37191",37,191,2001,51606,48722,2884,5.6
"37191",37,191,2002,50607,47381,3226,6.4
"37191",37,191,2003,51591,48452,3139,6.1
"37191",37,191,2004,51026,48345,2681,5.3
"37191",37,191,2005,51135,48460,2675,5.2
"37191",37,191,2006,52107,49666,2441,4.7
"37191",37,191,2007,52722,50347,2375,4.5
"37191",37,191,2008,53513,50452,3061,5.7
"37191",37,191,2009,53940,49219,4721,8.8
"37191",37,191,2010,54808,49787,5021,9.2
"37191",37,191,2011,54885,49924,4961,9
"37191",37,191,2012,55377,50689,4688,8.5
"37191",37,191,2013,54777,50520,4257,7.8
"37191",37,191,2014,53869,50416,3453,6.4
"37191",37,191,2015,53729,50472,3257,6.1
"37191",37,191,2016,53498,50381,3117,5.8
"37191",37,191,2017,53488,50752,2736,5.1
"37193",37,193,1990,31786,30565,1221,3.8
"37193",37,193,1991,32291,30497,1794,5.6
"37193",37,193,1992,32829,31187,1642,5
"37193",37,193,1993,32134,31015,1119,3.5
"37193",37,193,1994,32421,31187,1234,3.8
"37193",37,193,1995,33076,31516,1560,4.7
"37193",37,193,1996,33489,31667,1822,5.4
"37193",37,193,1997,33166,31994,1172,3.5
"37193",37,193,1998,32634,31771,863,2.6
"37193",37,193,1999,33831,32956,875,2.6
"37193",37,193,2000,34110,32909,1201,3.5
"37193",37,193,2001,33682,31675,2007,6
"37193",37,193,2002,33240,30459,2781,8.4
"37193",37,193,2003,33636,31181,2455,7.3
"37193",37,193,2004,33175,31177,1998,6
"37193",37,193,2005,32852,30991,1861,5.7
"37193",37,193,2006,31410,29715,1695,5.4
"37193",37,193,2007,31357,29660,1697,5.4
"37193",37,193,2008,30141,27894,2247,7.5
"37193",37,193,2009,30172,26342,3830,12.7
"37193",37,193,2010,31081,26905,4176,13.4
"37193",37,193,2011,31095,27435,3660,11.8
"37193",37,193,2012,30585,27411,3174,10.4
"37193",37,193,2013,29954,27278,2676,8.9
"37193",37,193,2014,29546,27591,1955,6.6
"37193",37,193,2015,29629,27945,1684,5.7
"37193",37,193,2016,30172,28727,1445,4.8
"37193",37,193,2017,31187,29845,1342,4.3
"37195",37,195,1990,35241,32438,2803,8
"37195",37,195,1991,35279,31562,3717,10.5
"37195",37,195,1992,36435,32561,3874,10.6
"37195",37,195,1993,36735,32914,3821,10.4
"37195",37,195,1994,35938,32686,3252,9
"37195",37,195,1995,36194,33030,3164,8.7
"37195",37,195,1996,35824,32672,3152,8.8
"37195",37,195,1997,36852,33895,2957,8
"37195",37,195,1998,36626,34090,2536,6.9
"37195",37,195,1999,37901,35043,2858,7.5
"37195",37,195,2000,37315,35258,2057,5.5
"37195",37,195,2001,37910,35144,2766,7.3
"37195",37,195,2002,37990,35085,2905,7.6
"37195",37,195,2003,38987,35836,3151,8.1
"37195",37,195,2004,38649,35521,3128,8.1
"37195",37,195,2005,38996,35893,3103,8
"37195",37,195,2006,39775,36952,2823,7.1
"37195",37,195,2007,40724,38173,2551,6.3
"37195",37,195,2008,39932,36868,3064,7.7
"37195",37,195,2009,39661,34648,5013,12.6
"37195",37,195,2010,38233,32918,5315,13.9
"37195",37,195,2011,38258,32935,5323,13.9
"37195",37,195,2012,38327,33345,4982,13
"37195",37,195,2013,38146,33663,4483,11.8
"37195",37,195,2014,37633,34056,3577,9.5
"37195",37,195,2015,36751,33260,3491,9.5
"37195",37,195,2016,36448,33479,2969,8.1
"37195",37,195,2017,36056,33419,2637,7.3
"37197",37,197,1990,16442,15702,740,4.5
"37197",37,197,1991,16382,15609,773,4.7
"37197",37,197,1992,16586,15838,748,4.5
"37197",37,197,1993,16714,16132,582,3.5
"37197",37,197,1994,16976,16476,500,2.9
"37197",37,197,1995,17712,17021,691,3.9
"37197",37,197,1996,18337,17794,543,3
"37197",37,197,1997,18674,18141,533,2.9
"37197",37,197,1998,18593,18121,472,2.5
"37197",37,197,1999,18820,18327,493,2.6
"37197",37,197,2000,19131,18458,673,3.5
"37197",37,197,2001,19352,18360,992,5.1
"37197",37,197,2002,19385,18247,1138,5.9
"37197",37,197,2003,19425,18244,1181,6.1
"37197",37,197,2004,19096,18103,993,5.2
"37197",37,197,2005,19164,18279,885,4.6
"37197",37,197,2006,19560,18725,835,4.3
"37197",37,197,2007,19086,18271,815,4.3
"37197",37,197,2008,19327,18247,1080,5.6
"37197",37,197,2009,18744,16798,1946,10.4
"37197",37,197,2010,18198,16203,1995,11
"37197",37,197,2011,17963,16113,1850,10.3
"37197",37,197,2012,17964,16315,1649,9.2
"37197",37,197,2013,17877,16497,1380,7.7
"37197",37,197,2014,17528,16533,995,5.7
"37197",37,197,2015,17487,16613,874,5
"37197",37,197,2016,17593,16822,771,4.4
"37197",37,197,2017,17756,17043,713,4
"37199",37,199,1990,6717,6196,521,7.8
"37199",37,199,1991,6568,6002,566,8.6
"37199",37,199,1992,6631,6002,629,9.5
"37199",37,199,1993,6323,5832,491,7.8
"37199",37,199,1994,6639,6146,493,7.4
"37199",37,199,1995,6251,5886,365,5.8
"37199",37,199,1996,6325,5949,376,5.9
"37199",37,199,1997,6528,6192,336,5.1
"37199",37,199,1998,6616,6226,390,5.9
"37199",37,199,1999,6795,6461,334,4.9
"37199",37,199,2000,8538,8229,309,3.6
"37199",37,199,2001,8240,7440,800,9.7
"37199",37,199,2002,7983,7242,741,9.3
"37199",37,199,2003,8088,7523,565,7
"37199",37,199,2004,7881,7371,510,6.5
"37199",37,199,2005,7870,7306,564,7.2
"37199",37,199,2006,7946,7503,443,5.6
"37199",37,199,2007,8077,7609,468,5.8
"37199",37,199,2008,7760,7173,587,7.6
"37199",37,199,2009,7878,6939,939,11.9
"37199",37,199,2010,7810,6884,926,11.9
"37199",37,199,2011,7874,6981,893,11.3
"37199",37,199,2012,7975,7123,852,10.7
"37199",37,199,2013,7807,7064,743,9.5
"37199",37,199,2014,7491,6984,507,6.8
"37199",37,199,2015,7415,6978,437,5.9
"37199",37,199,2016,7471,7085,386,5.2
"37199",37,199,2017,7452,7109,343,4.6
"38001",38,1,1990,1784,1760,24,1.3
"38001",38,1,1991,1606,1567,39,2.4
"38001",38,1,1992,1530,1495,35,2.3
"38001",38,1,1993,1499,1465,34,2.3
"38001",38,1,1994,1649,1617,32,1.9
"38001",38,1,1995,1492,1468,24,1.6
"38001",38,1,1996,1519,1495,24,1.6
"38001",38,1,1997,1451,1420,31,2.1
"38001",38,1,1998,1444,1410,34,2.4
"38001",38,1,1999,1392,1354,38,2.7
"38001",38,1,2000,1316,1280,36,2.7
"38001",38,1,2001,1189,1157,32,2.7
"38001",38,1,2002,1229,1186,43,3.5
"38001",38,1,2003,1254,1216,38,3
"38001",38,1,2004,1283,1250,33,2.6
"38001",38,1,2005,1312,1269,43,3.3
"38001",38,1,2006,1307,1268,39,3
"38001",38,1,2007,1294,1262,32,2.5
"38001",38,1,2008,1260,1230,30,2.4
"38001",38,1,2009,1271,1230,41,3.2
"38001",38,1,2010,1202,1167,35,2.9
"38001",38,1,2011,1165,1132,33,2.8
"38001",38,1,2012,1112,1080,32,2.9
"38001",38,1,2013,1111,1083,28,2.5
"38001",38,1,2014,1113,1083,30,2.7
"38001",38,1,2015,1109,1077,32,2.9
"38001",38,1,2016,1138,1109,29,2.5
"38001",38,1,2017,1122,1095,27,2.4
"38003",38,3,1990,6079,5888,191,3.1
"38003",38,3,1991,5686,5473,213,3.7
"38003",38,3,1992,5444,5238,206,3.8
"38003",38,3,1993,5573,5379,194,3.5
"38003",38,3,1994,6079,5907,172,2.8
"38003",38,3,1995,5918,5771,147,2.5
"38003",38,3,1996,6028,5866,162,2.7
"38003",38,3,1997,6049,5904,145,2.4
"38003",38,3,1998,5839,5685,154,2.6
"38003",38,3,1999,5718,5545,173,3
"38003",38,3,2000,6025,5833,192,3.2
"38003",38,3,2001,5895,5722,173,2.9
"38003",38,3,2002,5995,5789,206,3.4
"38003",38,3,2003,6058,5845,213,3.5
"38003",38,3,2004,6092,5892,200,3.3
"38003",38,3,2005,6046,5838,208,3.4
"38003",38,3,2006,5954,5738,216,3.6
"38003",38,3,2007,6029,5840,189,3.1
"38003",38,3,2008,6274,6090,184,2.9
"38003",38,3,2009,6247,5978,269,4.3
"38003",38,3,2010,6187,5911,276,4.5
"38003",38,3,2011,6046,5808,238,3.9
"38003",38,3,2012,5753,5556,197,3.4
"38003",38,3,2013,5713,5530,183,3.2
"38003",38,3,2014,5600,5427,173,3.1
"38003",38,3,2015,5647,5466,181,3.2
"38003",38,3,2016,5646,5467,179,3.2
"38003",38,3,2017,5519,5368,151,2.7
"38005",38,5,1990,2900,2672,228,7.9
"38005",38,5,1991,2674,2458,216,8.1
"38005",38,5,1992,2753,2372,381,13.8
"38005",38,5,1993,2627,2268,359,13.7
"38005",38,5,1994,3039,2788,251,8.3
"38005",38,5,1995,2805,2518,287,10.2
"38005",38,5,1996,2859,2574,285,10
"38005",38,5,1997,2760,2573,187,6.8
"38005",38,5,1998,2870,2652,218,7.6
"38005",38,5,1999,2804,2586,218,7.8
"38005",38,5,2000,2616,2460,156,6
"38005",38,5,2001,2593,2440,153,5.9
"38005",38,5,2002,2668,2510,158,5.9
"38005",38,5,2003,2726,2575,151,5.5
"38005",38,5,2004,2801,2663,138,4.9
"38005",38,5,2005,2794,2637,157,5.6
"38005",38,5,2006,2747,2583,164,6
"38005",38,5,2007,2644,2470,174,6.6
"38005",38,5,2008,2640,2470,170,6.4
"38005",38,5,2009,2632,2474,158,6
"38005",38,5,2010,2915,2757,158,5.4
"38005",38,5,2011,2930,2753,177,6
"38005",38,5,2012,2775,2581,194,7
"38005",38,5,2013,2549,2355,194,7.6
"38005",38,5,2014,2515,2352,163,6.5
"38005",38,5,2015,2481,2367,114,4.6
"38005",38,5,2016,2445,2347,98,4
"38005",38,5,2017,2400,2315,85,3.5
"38007",38,7,1990,554,530,24,4.3
"38007",38,7,1991,651,622,29,4.5
"38007",38,7,1992,570,538,32,5.6
"38007",38,7,1993,549,529,20,3.6
"38007",38,7,1994,466,447,19,4.1
"38007",38,7,1995,588,572,16,2.7
"38007",38,7,1996,580,563,17,2.9
"38007",38,7,1997,526,513,13,2.5
"38007",38,7,1998,521,499,22,4.2
"38007",38,7,1999,522,497,25,4.8
"38007",38,7,2000,486,474,12,2.5
"38007",38,7,2001,496,485,11,2.2
"38007",38,7,2002,504,490,14,2.8
"38007",38,7,2003,500,485,15,3
"38007",38,7,2004,494,482,12,2.4
"38007",38,7,2005,504,490,14,2.8
"38007",38,7,2006,523,510,13,2.5
"38007",38,7,2007,507,494,13,2.6
"38007",38,7,2008,524,513,11,2.1
"38007",38,7,2009,529,516,13,2.5
"38007",38,7,2010,426,412,14,3.3
"38007",38,7,2011,440,423,17,3.9
"38007",38,7,2012,474,458,16,3.4
"38007",38,7,2013,475,461,14,2.9
"38007",38,7,2014,491,477,14,2.9
"38007",38,7,2015,468,454,14,3
"38007",38,7,2016,440,427,13,3
"38007",38,7,2017,437,424,13,3
"38009",38,9,1990,3736,3584,152,4.1
"38009",38,9,1991,3493,3347,146,4.2
"38009",38,9,1992,3363,3213,150,4.5
"38009",38,9,1993,3341,3204,137,4.1
"38009",38,9,1994,3568,3454,114,3.2
"38009",38,9,1995,3405,3315,90,2.6
"38009",38,9,1996,3464,3364,100,2.9
"38009",38,9,1997,3512,3415,97,2.8
"38009",38,9,1998,3423,3293,130,3.8
"38009",38,9,1999,3364,3210,154,4.6
"38009",38,9,2000,3482,3350,132,3.8
"38009",38,9,2001,3477,3363,114,3.3
"38009",38,9,2002,3588,3426,162,4.5
"38009",38,9,2003,3546,3376,170,4.8
"38009",38,9,2004,3523,3381,142,4
"38009",38,9,2005,3511,3369,142,4
"38009",38,9,2006,3450,3322,128,3.7
"38009",38,9,2007,3423,3300,123,3.6
"38009",38,9,2008,3602,3485,117,3.2
"38009",38,9,2009,3640,3500,140,3.8
"38009",38,9,2010,3397,3262,135,4
"38009",38,9,2011,3436,3307,129,3.8
"38009",38,9,2012,3409,3293,116,3.4
"38009",38,9,2013,3260,3134,126,3.9
"38009",38,9,2014,3259,3148,111,3.4
"38009",38,9,2015,3243,3101,142,4.4
"38009",38,9,2016,3243,3093,150,4.6
"38009",38,9,2017,3147,3044,103,3.3
"38011",38,11,1990,1966,1935,31,1.6
"38011",38,11,1991,1919,1865,54,2.8
"38011",38,11,1992,1814,1729,85,4.7
"38011",38,11,1993,1825,1755,70,3.8
"38011",38,11,1994,1839,1788,51,2.8
"38011",38,11,1995,1836,1799,37,2
"38011",38,11,1996,1830,1795,35,1.9
"38011",38,11,1997,1868,1845,23,1.2
"38011",38,11,1998,1846,1808,38,2.1
"38011",38,11,1999,1822,1780,42,2.3
"38011",38,11,2000,1801,1764,37,2.1
"38011",38,11,2001,1764,1726,38,2.2
"38011",38,11,2002,1707,1665,42,2.5
"38011",38,11,2003,1755,1715,40,2.3
"38011",38,11,2004,1733,1691,42,2.4
"38011",38,11,2005,1732,1691,41,2.4
"38011",38,11,2006,1771,1732,39,2.2
"38011",38,11,2007,1763,1727,36,2
"38011",38,11,2008,1736,1700,36,2.1
"38011",38,11,2009,1737,1685,52,3
"38011",38,11,2010,1772,1726,46,2.6
"38011",38,11,2011,1876,1835,41,2.2
"38011",38,11,2012,1918,1883,35,1.8
"38011",38,11,2013,1999,1959,40,2
"38011",38,11,2014,1895,1861,34,1.8
"38011",38,11,2015,1863,1828,35,1.9
"38011",38,11,2016,1844,1804,40,2.2
"38011",38,11,2017,1793,1762,31,1.7
"38013",38,13,1990,1251,1221,30,2.4
"38013",38,13,1991,1221,1172,49,4
"38013",38,13,1992,1098,1051,47,4.3
"38013",38,13,1993,1100,1056,44,4
"38013",38,13,1994,1136,1107,29,2.6
"38013",38,13,1995,1082,1052,30,2.8
"38013",38,13,1996,1083,1052,31,2.9
"38013",38,13,1997,1075,1053,22,2
"38013",38,13,1998,1041,1007,34,3.3
"38013",38,13,1999,1015,979,36,3.5
"38013",38,13,2000,1053,1022,31,2.9
"38013",38,13,2001,957,927,30,3.1
"38013",38,13,2002,1012,975,37,3.7
"38013",38,13,2003,1019,985,34,3.3
"38013",38,13,2004,1052,1016,36,3.4
"38013",38,13,2005,1023,996,27,2.6
"38013",38,13,2006,1018,992,26,2.6
"38013",38,13,2007,1016,990,26,2.6
"38013",38,13,2008,1059,1034,25,2.4
"38013",38,13,2009,1101,1066,35,3.2
"38013",38,13,2010,1130,1099,31,2.7
"38013",38,13,2011,1235,1206,29,2.3
"38013",38,13,2012,1375,1348,27,2
"38013",38,13,2013,1388,1358,30,2.2
"38013",38,13,2014,1299,1266,33,2.5
"38013",38,13,2015,1182,1143,39,3.3
"38013",38,13,2016,1150,1098,52,4.5
"38013",38,13,2017,1104,1070,34,3.1
"38015",38,15,1990,33086,31841,1245,3.8
"38015",38,15,1991,34503,33099,1404,4.1
"38015",38,15,1992,35402,33941,1461,4.1
"38015",38,15,1993,36593,35190,1403,3.8
"38015",38,15,1994,36706,35365,1341,3.7
"38015",38,15,1995,38355,37207,1148,3
"38015",38,15,1996,39320,38301,1019,2.6
"38015",38,15,1997,40605,39623,982,2.4
"38015",38,15,1998,40645,39619,1026,2.5
"38015",38,15,1999,40236,39197,1039,2.6
"38015",38,15,2000,40119,39178,941,2.3
"38015",38,15,2001,40547,39577,970,2.4
"38015",38,15,2002,40736,39457,1279,3.1
"38015",38,15,2003,41743,40462,1281,3.1
"38015",38,15,2004,43343,42124,1219,2.8
"38015",38,15,2005,44286,43032,1254,2.8
"38015",38,15,2006,45843,44622,1221,2.7
"38015",38,15,2007,47237,45984,1253,2.7
"38015",38,15,2008,47416,46099,1317,2.8
"38015",38,15,2009,47555,45868,1687,3.5
"38015",38,15,2010,46337,44662,1675,3.6
"38015",38,15,2011,46730,45210,1520,3.3
"38015",38,15,2012,46608,45293,1315,2.8
"38015",38,15,2013,47344,46166,1178,2.5
"38015",38,15,2014,47474,46316,1158,2.4
"38015",38,15,2015,48981,47814,1167,2.4
"38015",38,15,2016,50845,49541,1304,2.6
"38015",38,15,2017,50739,49515,1224,2.4
"38017",38,17,1990,59934,58103,1831,3.1
"38017",38,17,1991,60511,58593,1918,3.2
"38017",38,17,1992,61570,59623,1947,3.2
"38017",38,17,1993,63481,61785,1696,2.7
"38017",38,17,1994,65287,63833,1454,2.2
"38017",38,17,1995,67129,65820,1309,1.9
"38017",38,17,1996,69916,68771,1145,1.6
"38017",38,17,1997,73179,72116,1063,1.5
"38017",38,17,1998,74283,73208,1075,1.4
"38017",38,17,1999,73099,71853,1246,1.7
"38017",38,17,2000,75351,73751,1600,2.1
"38017",38,17,2001,76054,74445,1609,2.1
"38017",38,17,2002,75982,73836,2146,2.8
"38017",38,17,2003,77467,75182,2285,2.9
"38017",38,17,2004,80707,78543,2164,2.7
"38017",38,17,2005,82230,80023,2207,2.7
"38017",38,17,2006,84220,82058,2162,2.6
"38017",38,17,2007,87690,85446,2244,2.6
"38017",38,17,2008,88926,86519,2407,2.7
"38017",38,17,2009,87854,84241,3613,4.1
"38017",38,17,2010,88824,85680,3144,3.5
"38017",38,17,2011,89620,86697,2923,3.3
"38017",38,17,2012,89610,86980,2630,2.9
"38017",38,17,2013,91442,88921,2521,2.8
"38017",38,17,2014,92834,90590,2244,2.4
"38017",38,17,2015,95417,93277,2140,2.2
"38017",38,17,2016,100647,98411,2236,2.2
"38017",38,17,2017,102364,100234,2130,2.1
"38019",38,19,1990,2714,2604,110,4.1
"38019",38,19,1991,2551,2435,116,4.5
"38019",38,19,1992,2522,2416,106,4.2
"38019",38,19,1993,2603,2472,131,5
"38019",38,19,1994,2746,2626,120,4.4
"38019",38,19,1995,2574,2476,98,3.8
"38019",38,19,1996,2611,2510,101,3.9
"38019",38,19,1997,2578,2498,80,3.1
"38019",38,19,1998,2528,2455,73,2.9
"38019",38,19,1999,2510,2434,76,3
"38019",38,19,2000,2357,2278,79,3.4
"38019",38,19,2001,2293,2220,73,3.2
"38019",38,19,2002,2239,2152,87,3.9
"38019",38,19,2003,2239,2155,84,3.8
"38019",38,19,2004,2196,2117,79,3.6
"38019",38,19,2005,2146,2067,79,3.7
"38019",38,19,2006,2140,2068,72,3.4
"38019",38,19,2007,2092,2029,63,3
"38019",38,19,2008,2037,1974,63,3.1
"38019",38,19,2009,1979,1911,68,3.4
"38019",38,19,2010,2260,2191,69,3.1
"38019",38,19,2011,2249,2181,68,3
"38019",38,19,2012,2148,2080,68,3.2
"38019",38,19,2013,2077,2008,69,3.3
"38019",38,19,2014,2053,1994,59,2.9
"38019",38,19,2015,2062,2005,57,2.8
"38019",38,19,2016,2125,2069,56,2.6
"38019",38,19,2017,2101,2046,55,2.6
"38021",38,21,1990,3072,2996,76,2.5
"38021",38,21,1991,2913,2820,93,3.2
"38021",38,21,1992,2767,2684,83,3
"38021",38,21,1993,2809,2737,72,2.6
"38021",38,21,1994,3009,2935,74,2.5
"38021",38,21,1995,2918,2855,63,2.2
"38021",38,21,1996,2866,2818,48,1.7
"38021",38,21,1997,2809,2768,41,1.5
"38021",38,21,1998,2884,2829,55,1.9
"38021",38,21,1999,2921,2874,47,1.6
"38021",38,21,2000,3063,2998,65,2.1
"38021",38,21,2001,2977,2904,73,2.5
"38021",38,21,2002,2878,2793,85,3
"38021",38,21,2003,2844,2754,90,3.2
"38021",38,21,2004,2831,2753,78,2.8
"38021",38,21,2005,2962,2881,81,2.7
"38021",38,21,2006,3019,2936,83,2.7
"38021",38,21,2007,2947,2868,79,2.7
"38021",38,21,2008,2918,2830,88,3
"38021",38,21,2009,2771,2627,144,5.2
"38021",38,21,2010,2856,2764,92,3.2
"38021",38,21,2011,2823,2741,82,2.9
"38021",38,21,2012,2709,2635,74,2.7
"38021",38,21,2013,2661,2599,62,2.3
"38021",38,21,2014,2589,2537,52,2
"38021",38,21,2015,2553,2506,47,1.8
"38021",38,21,2016,2558,2509,49,1.9
"38021",38,21,2017,2552,2507,45,1.8
"38023",38,23,1990,1181,1161,20,1.7
"38023",38,23,1991,1177,1154,23,2
"38023",38,23,1992,1138,1118,20,1.8
"38023",38,23,1993,1170,1147,23,2
"38023",38,23,1994,1184,1164,20,1.7
"38023",38,23,1995,1221,1202,19,1.6
"38023",38,23,1996,1214,1187,27,2.2
"38023",38,23,1997,1187,1167,20,1.7
"38023",38,23,1998,1166,1140,26,2.2
"38023",38,23,1999,1123,1093,30,2.7
"38023",38,23,2000,1066,1035,31,2.9
"38023",38,23,2001,1007,979,28,2.8
"38023",38,23,2002,1033,996,37,3.6
"38023",38,23,2003,1079,1042,37,3.4
"38023",38,23,2004,1017,982,35,3.4
"38023",38,23,2005,980,948,32,3.3
"38023",38,23,2006,957,921,36,3.8
"38023",38,23,2007,900,870,30,3.3
"38023",38,23,2008,887,859,28,3.2
"38023",38,23,2009,878,846,32,3.6
"38023",38,23,2010,1383,1354,29,2.1
"38023",38,23,2011,1579,1551,28,1.8
"38023",38,23,2012,1787,1760,27,1.5
"38023",38,23,2013,1774,1749,25,1.4
"38023",38,23,2014,1874,1846,28,1.5
"38023",38,23,2015,1816,1783,33,1.8
"38023",38,23,2016,1691,1647,44,2.6
"38023",38,23,2017,1623,1596,27,1.7
"38025",38,25,1990,2554,2498,56,2.2
"38025",38,25,1991,1896,1834,62,3.3
"38025",38,25,1992,1847,1772,75,4.1
"38025",38,25,1993,1891,1821,70,3.7
"38025",38,25,1994,2691,2622,69,2.6
"38025",38,25,1995,2028,1980,48,2.4
"38025",38,25,1996,1999,1930,69,3.5
"38025",38,25,1997,1980,1917,63,3.2
"38025",38,25,1998,2005,1931,74,3.7
"38025",38,25,1999,1955,1869,86,4.4
"38025",38,25,2000,1763,1707,56,3.2
"38025",38,25,2001,1719,1662,57,3.3
"38025",38,25,2002,1749,1678,71,4.1
"38025",38,25,2003,1797,1729,68,3.8
"38025",38,25,2004,1715,1654,61,3.6
"38025",38,25,2005,1730,1672,58,3.4
"38025",38,25,2006,1733,1675,58,3.3
"38025",38,25,2007,1691,1626,65,3.8
"38025",38,25,2008,1752,1696,56,3.2
"38025",38,25,2009,1780,1705,75,4.2
"38025",38,25,2010,2301,2227,74,3.2
"38025",38,25,2011,2929,2868,61,2.1
"38025",38,25,2012,3680,3622,58,1.6
"38025",38,25,2013,4107,4049,58,1.4
"38025",38,25,2014,4298,4244,54,1.3
"38025",38,25,2015,4020,3941,79,2
"38025",38,25,2016,3262,3160,102,3.1
"38025",38,25,2017,3211,3143,68,2.1
"38027",38,27,1990,1442,1350,92,6.4
"38027",38,27,1991,1391,1277,114,8.2
"38027",38,27,1992,1241,1104,137,11
"38027",38,27,1993,1252,1146,106,8.5
"38027",38,27,1994,1346,1248,98,7.3
"38027",38,27,1995,1286,1211,75,5.8
"38027",38,27,1996,1321,1254,67,5.1
"38027",38,27,1997,1284,1229,55,4.3
"38027",38,27,1998,1394,1324,70,5
"38027",38,27,1999,1313,1241,72,5.5
"38027",38,27,2000,1364,1307,57,4.2
"38027",38,27,2001,1369,1312,57,4.2
"38027",38,27,2002,1369,1297,72,5.3
"38027",38,27,2003,1378,1306,72,5.2
"38027",38,27,2004,1351,1285,66,4.9
"38027",38,27,2005,1342,1267,75,5.6
"38027",38,27,2006,1319,1252,67,5.1
"38027",38,27,2007,1293,1222,71,5.5
"38027",38,27,2008,1248,1178,70,5.6
"38027",38,27,2009,1184,1121,63,5.3
"38027",38,27,2010,1297,1235,62,4.8
"38027",38,27,2011,1273,1210,63,4.9
"38027",38,27,2012,1250,1186,64,5.1
"38027",38,27,2013,1271,1195,76,6
"38027",38,27,2014,1292,1220,72,5.6
"38027",38,27,2015,1271,1210,61,4.8
"38027",38,27,2016,1284,1229,55,4.3
"38027",38,27,2017,1301,1241,60,4.6
"38029",38,29,1990,2128,2060,68,3.2
"38029",38,29,1991,1969,1888,81,4.1
"38029",38,29,1992,2077,1970,107,5.2
"38029",38,29,1993,2098,2010,88,4.2
"38029",38,29,1994,2336,2251,85,3.6
"38029",38,29,1995,2156,2087,69,3.2
"38029",38,29,1996,2127,2055,72,3.4
"38029",38,29,1997,2101,2037,64,3
"38029",38,29,1998,2038,1964,74,3.6
"38029",38,29,1999,2048,1967,81,4
"38029",38,29,2000,2080,1993,87,4.2
"38029",38,29,2001,1975,1886,89,4.5
"38029",38,29,2002,2017,1903,114,5.7
"38029",38,29,2003,2013,1897,116,5.8
"38029",38,29,2004,1889,1785,104,5.5
"38029",38,29,2005,1854,1757,97,5.2
"38029",38,29,2006,1823,1734,89,4.9
"38029",38,29,2007,1703,1615,88,5.2
"38029",38,29,2008,1685,1603,82,4.9
"38029",38,29,2009,1677,1565,112,6.7
"38029",38,29,2010,1826,1700,126,6.9
"38029",38,29,2011,1771,1664,107,6
"38029",38,29,2012,1648,1559,89,5.4
"38029",38,29,2013,1591,1506,85,5.3
"38029",38,29,2014,1561,1474,87,5.6
"38029",38,29,2015,1553,1476,77,5
"38029",38,29,2016,1591,1522,69,4.3
"38029",38,29,2017,1580,1517,63,4
"38031",38,31,1990,1933,1866,67,3.5
"38031",38,31,1991,1919,1839,80,4.2
"38031",38,31,1992,1906,1817,89,4.7
"38031",38,31,1993,1951,1874,77,3.9
"38031",38,31,1994,2042,1983,59,2.9
"38031",38,31,1995,2168,2109,59,2.7
"38031",38,31,1996,2176,2124,52,2.4
"38031",38,31,1997,2211,2167,44,2
"38031",38,31,1998,2232,2185,47,2.1
"38031",38,31,1999,2325,2269,56,2.4
"38031",38,31,2000,1958,1902,56,2.9
"38031",38,31,2001,1843,1789,54,2.9
"38031",38,31,2002,1833,1768,65,3.5
"38031",38,31,2003,1781,1717,64,3.6
"38031",38,31,2004,1800,1743,57,3.2
"38031",38,31,2005,1775,1721,54,3
"38031",38,31,2006,1722,1664,58,3.4
"38031",38,31,2007,1701,1643,58,3.4
"38031",38,31,2008,1769,1716,53,3
"38031",38,31,2009,1728,1666,62,3.6
"38031",38,31,2010,1802,1740,62,3.4
"38031",38,31,2011,1766,1710,56,3.2
"38031",38,31,2012,1684,1631,53,3.1
"38031",38,31,2013,1634,1578,56,3.4
"38031",38,31,2014,1633,1583,50,3.1
"38031",38,31,2015,1630,1583,47,2.9
"38031",38,31,2016,1693,1643,50,3
"38031",38,31,2017,1675,1634,41,2.4
"38033",38,33,1990,926,905,21,2.3
"38033",38,33,1991,1022,978,44,4.3
"38033",38,33,1992,883,842,41,4.6
"38033",38,33,1993,922,882,40,4.3
"38033",38,33,1994,841,811,30,3.6
"38033",38,33,1995,949,921,28,3
"38033",38,33,1996,909,880,29,3.2
"38033",38,33,1997,874,851,23,2.6
"38033",38,33,1998,906,878,28,3.1
"38033",38,33,1999,922,886,36,3.9
"38033",38,33,2000,911,883,28,3.1
"38033",38,33,2001,893,871,22,2.5
"38033",38,33,2002,901,876,25,2.8
"38033",38,33,2003,953,930,23,2.4
"38033",38,33,2004,935,906,29,3.1
"38033",38,33,2005,911,882,29,3.2
"38033",38,33,2006,850,823,27,3.2
"38033",38,33,2007,877,853,24,2.7
"38033",38,33,2008,868,844,24,2.8
"38033",38,33,2009,892,861,31,3.5
"38033",38,33,2010,982,956,26,2.6
"38033",38,33,2011,980,956,24,2.4
"38033",38,33,2012,981,957,24,2.4
"38033",38,33,2013,973,951,22,2.3
"38033",38,33,2014,976,956,20,2
"38033",38,33,2015,978,956,22,2.2
"38033",38,33,2016,975,949,26,2.7
"38033",38,33,2017,955,936,19,2
"38035",38,35,1990,33108,31633,1475,4.5
"38035",38,35,1991,33842,32565,1277,3.8
"38035",38,35,1992,34195,32992,1203,3.5
"38035",38,35,1993,35703,34547,1156,3.2
"38035",38,35,1994,36088,34969,1119,3.1
"38035",38,35,1995,37564,36606,958,2.6
"38035",38,35,1996,38207,37340,867,2.3
"38035",38,35,1997,37791,36662,1129,3
"38035",38,35,1998,37147,36359,788,2.1
"38035",38,35,1999,35788,34893,895,2.5
"38035",38,35,2000,35939,34924,1015,2.8
"38035",38,35,2001,36039,35021,1018,2.8
"38035",38,35,2002,35780,34481,1299,3.6
"38035",38,35,2003,36218,34978,1240,3.4
"38035",38,35,2004,37390,36236,1154,3.1
"38035",38,35,2005,38089,36881,1208,3.2
"38035",38,35,2006,38454,37297,1157,3
"38035",38,35,2007,39381,38252,1129,2.9
"38035",38,35,2008,38946,37778,1168,3
"38035",38,35,2009,37905,36405,1500,4
"38035",38,35,2010,37866,36549,1317,3.5
"38035",38,35,2011,37731,36342,1389,3.7
"38035",38,35,2012,37306,36043,1263,3.4
"38035",38,35,2013,37216,36083,1133,3
"38035",38,35,2014,36997,35973,1024,2.8
"38035",38,35,2015,37527,36612,915,2.4
"38035",38,35,2016,38983,38070,913,2.3
"38035",38,35,2017,39203,38347,856,2.2
"38037",38,37,1990,2189,2158,31,1.4
"38037",38,37,1991,1567,1523,44,2.8
"38037",38,37,1992,1513,1459,54,3.6
"38037",38,37,1993,1511,1459,52,3.4
"38037",38,37,1994,2239,2189,50,2.2
"38037",38,37,1995,1662,1615,47,2.8
"38037",38,37,1996,1633,1593,40,2.4
"38037",38,37,1997,1524,1490,34,2.2
"38037",38,37,1998,1484,1442,42,2.8
"38037",38,37,1999,1554,1497,57,3.7
"38037",38,37,2000,1364,1322,42,3.1
"38037",38,37,2001,1356,1314,42,3.1
"38037",38,37,2002,1320,1270,50,3.8
"38037",38,37,2003,1313,1259,54,4.1
"38037",38,37,2004,1277,1230,47,3.7
"38037",38,37,2005,1255,1205,50,4
"38037",38,37,2006,1244,1199,45,3.6
"38037",38,37,2007,1200,1157,43,3.6
"38037",38,37,2008,1200,1151,49,4.1
"38037",38,37,2009,1202,1151,51,4.2
"38037",38,37,2010,1423,1370,53,3.7
"38037",38,37,2011,1392,1343,49,3.5
"38037",38,37,2012,1300,1259,41,3.2
"38037",38,37,2013,1275,1238,37,2.9
"38037",38,37,2014,1298,1262,36,2.8
"38037",38,37,2015,1320,1278,42,3.2
"38037",38,37,2016,1303,1264,39,3
"38037",38,37,2017,1289,1252,37,2.9
"38039",38,39,1990,1561,1528,33,2.1
"38039",38,39,1991,1505,1466,39,2.6
"38039",38,39,1992,1439,1386,53,3.7
"38039",38,39,1993,1536,1493,43,2.8
"38039",38,39,1994,1818,1781,37,2
"38039",38,39,1995,1843,1810,33,1.8
"38039",38,39,1996,1672,1635,37,2.2
"38039",38,39,1997,1664,1637,27,1.6
"38039",38,39,1998,1652,1617,35,2.1
"38039",38,39,1999,1584,1550,34,2.1
"38039",38,39,2000,1371,1337,34,2.5
"38039",38,39,2001,1360,1328,32,2.4
"38039",38,39,2002,1321,1276,45,3.4
"38039",38,39,2003,1362,1321,41,3
"38039",38,39,2004,1370,1336,34,2.5
"38039",38,39,2005,1385,1345,40,2.9
"38039",38,39,2006,1321,1280,41,3.1
"38039",38,39,2007,1313,1278,35,2.7
"38039",38,39,2008,1275,1244,31,2.4
"38039",38,39,2009,1284,1241,43,3.3
"38039",38,39,2010,1320,1281,39,3
"38039",38,39,2011,1267,1229,38,3
"38039",38,39,2012,1225,1192,33,2.7
"38039",38,39,2013,1202,1174,28,2.3
"38039",38,39,2014,1186,1158,28,2.4
"38039",38,39,2015,1155,1128,27,2.3
"38039",38,39,2016,1165,1132,33,2.8
"38039",38,39,2017,1137,1104,33,2.9
"38041",38,41,1990,1564,1518,46,2.9
"38041",38,41,1991,1497,1444,53,3.5
"38041",38,41,1992,1383,1321,62,4.5
"38041",38,41,1993,1366,1318,48,3.5
"38041",38,41,1994,1555,1511,44,2.8
"38041",38,41,1995,1451,1408,43,3
"38041",38,41,1996,1408,1377,31,2.2
"38041",38,41,1997,1385,1349,36,2.6
"38041",38,41,1998,1340,1297,43,3.2
"38041",38,41,1999,1345,1296,49,3.6
"38041",38,41,2000,1257,1219,38,3
"38041",38,41,2001,1218,1184,34,2.8
"38041",38,41,2002,1244,1196,48,3.9
"38041",38,41,2003,1252,1202,50,4
"38041",38,41,2004,1215,1173,42,3.5
"38041",38,41,2005,1190,1146,44,3.7
"38041",38,41,2006,1198,1156,42,3.5
"38041",38,41,2007,1155,1109,46,4
"38041",38,41,2008,1122,1083,39,3.5
"38041",38,41,2009,1177,1133,44,3.7
"38041",38,41,2010,1479,1434,45,3
"38041",38,41,2011,1489,1446,43,2.9
"38041",38,41,2012,1454,1415,39,2.7
"38041",38,41,2013,1479,1440,39,2.6
"38041",38,41,2014,1539,1507,32,2.1
"38041",38,41,2015,1555,1516,39,2.5
"38041",38,41,2016,1546,1500,46,3
"38041",38,41,2017,1528,1499,29,1.9
"38043",38,43,1990,1608,1522,86,5.3
"38043",38,43,1991,1495,1408,87,5.8
"38043",38,43,1992,1454,1362,92,6.3
"38043",38,43,1993,1445,1371,74,5.1
"38043",38,43,1994,1558,1477,81,5.2
"38043",38,43,1995,1536,1464,72,4.7
"38043",38,43,1996,1500,1439,61,4.1
"38043",38,43,1997,1445,1389,56,3.9
"38043",38,43,1998,1447,1388,59,4.1
"38043",38,43,1999,1463,1395,68,4.6
"38043",38,43,2000,1304,1244,60,4.6
"38043",38,43,2001,1260,1195,65,5.2
"38043",38,43,2002,1249,1176,73,5.8
"38043",38,43,2003,1243,1168,75,6
"38043",38,43,2004,1232,1158,74,6
"38043",38,43,2005,1222,1162,60,4.9
"38043",38,43,2006,1268,1208,60,4.7
"38043",38,43,2007,1225,1166,59,4.8
"38043",38,43,2008,1242,1191,51,4.1
"38043",38,43,2009,1209,1152,57,4.7
"38043",38,43,2010,1408,1333,75,5.3
"38043",38,43,2011,1357,1286,71,5.2
"38043",38,43,2012,1264,1199,65,5.1
"38043",38,43,2013,1256,1197,59,4.7
"38043",38,43,2014,1280,1230,50,3.9
"38043",38,43,2015,1343,1294,49,3.6
"38043",38,43,2016,1381,1329,52,3.8
"38043",38,43,2017,1355,1307,48,3.5
"38045",38,45,1990,2431,2376,55,2.3
"38045",38,45,1991,2254,2199,55,2.4
"38045",38,45,1992,2285,2228,57,2.5
"38045",38,45,1993,2326,2264,62,2.7
"38045",38,45,1994,2483,2414,69,2.8
"38045",38,45,1995,2363,2302,61,2.6
"38045",38,45,1996,2379,2320,59,2.5
"38045",38,45,1997,2349,2292,57,2.4
"38045",38,45,1998,2315,2261,54,2.3
"38045",38,45,1999,2279,2219,60,2.6
"38045",38,45,2000,2287,2223,64,2.8
"38045",38,45,2001,2260,2190,70,3.1
"38045",38,45,2002,2262,2183,79,3.5
"38045",38,45,2003,2327,2243,84,3.6
"38045",38,45,2004,2335,2255,80,3.4
"38045",38,45,2005,2261,2186,75,3.3
"38045",38,45,2006,2269,2197,72,3.2
"38045",38,45,2007,2187,2118,69,3.2
"38045",38,45,2008,2238,2165,73,3.3
"38045",38,45,2009,2269,2173,96,4.2
"38045",38,45,2010,2481,2393,88,3.5
"38045",38,45,2011,2398,2326,72,3
"38045",38,45,2012,2277,2220,57,2.5
"38045",38,45,2013,2238,2187,51,2.3
"38045",38,45,2014,2260,2206,54,2.4
"38045",38,45,2015,2272,2216,56,2.5
"38045",38,45,2016,2325,2270,55,2.4
"38045",38,45,2017,2298,2255,43,1.9
"38047",38,47,1990,1233,1207,26,2.1
"38047",38,47,1991,1261,1221,40,3.2
"38047",38,47,1992,1181,1152,29,2.5
"38047",38,47,1993,1206,1183,23,1.9
"38047",38,47,1994,1203,1175,28,2.3
"38047",38,47,1995,1253,1231,22,1.8
"38047",38,47,1996,1233,1208,25,2
"38047",38,47,1997,1178,1153,25,2.1
"38047",38,47,1998,1125,1105,20,1.8
"38047",38,47,1999,1137,1116,21,1.8
"38047",38,47,2000,1044,1015,29,2.8
"38047",38,47,2001,1024,994,30,2.9
"38047",38,47,2002,966,931,35,3.6
"38047",38,47,2003,976,941,35,3.6
"38047",38,47,2004,961,921,40,4.2
"38047",38,47,2005,933,899,34,3.6
"38047",38,47,2006,956,925,31,3.2
"38047",38,47,2007,928,895,33,3.6
"38047",38,47,2008,924,891,33,3.6
"38047",38,47,2009,943,909,34,3.6
"38047",38,47,2010,1001,965,36,3.6
"38047",38,47,2011,978,948,30,3.1
"38047",38,47,2012,908,880,28,3.1
"38047",38,47,2013,918,890,28,3.1
"38047",38,47,2014,928,901,27,2.9
"38047",38,47,2015,948,921,27,2.8
"38047",38,47,2016,964,931,33,3.4
"38047",38,47,2017,958,934,24,2.5
"38049",38,49,1990,2777,2618,159,5.7
"38049",38,49,1991,2699,2544,155,5.7
"38049",38,49,1992,2701,2533,168,6.2
"38049",38,49,1993,2762,2596,166,6
"38049",38,49,1994,2887,2748,139,4.8
"38049",38,49,1995,2858,2747,111,3.9
"38049",38,49,1996,2891,2768,123,4.3
"38049",38,49,1997,2954,2832,122,4.1
"38049",38,49,1998,2895,2760,135,4.7
"38049",38,49,1999,2787,2645,142,5.1
"38049",38,49,2000,2813,2676,137,4.9
"38049",38,49,2001,2793,2657,136,4.9
"38049",38,49,2002,2780,2604,176,6.3
"38049",38,49,2003,2814,2625,189,6.7
"38049",38,49,2004,2794,2632,162,5.8
"38049",38,49,2005,2783,2627,156,5.6
"38049",38,49,2006,2798,2659,139,5
"38049",38,49,2007,2726,2590,136,5
"38049",38,49,2008,2734,2594,140,5.1
"38049",38,49,2009,2678,2540,138,5.2
"38049",38,49,2010,3283,3125,158,4.8
"38049",38,49,2011,3326,3172,154,4.6
"38049",38,49,2012,3284,3143,141,4.3
"38049",38,49,2013,3292,3155,137,4.2
"38049",38,49,2014,3304,3167,137,4.1
"38049",38,49,2015,3281,3143,138,4.2
"38049",38,49,2016,3390,3225,165,4.9
"38049",38,49,2017,3339,3199,140,4.2
"38051",38,51,1990,1785,1761,24,1.3
"38051",38,51,1991,1818,1790,28,1.5
"38051",38,51,1992,1718,1682,36,2.1
"38051",38,51,1993,1714,1674,40,2.3
"38051",38,51,1994,1731,1688,43,2.5
"38051",38,51,1995,1807,1771,36,2
"38051",38,51,1996,1804,1769,35,1.9
"38051",38,51,1997,1734,1705,29,1.7
"38051",38,51,1998,1757,1715,42,2.4
"38051",38,51,1999,1726,1687,39,2.3
"38051",38,51,2000,1561,1516,45,2.9
"38051",38,51,2001,1500,1457,43,2.9
"38051",38,51,2002,1487,1439,48,3.2
"38051",38,51,2003,1508,1459,49,3.2
"38051",38,51,2004,1490,1447,43,2.9
"38051",38,51,2005,1462,1420,42,2.9
"38051",38,51,2006,1463,1422,41,2.8
"38051",38,51,2007,1420,1380,40,2.8
"38051",38,51,2008,1392,1352,40,2.9
"38051",38,51,2009,1341,1289,52,3.9
"38051",38,51,2010,1342,1283,59,4.4
"38051",38,51,2011,1309,1260,49,3.7
"38051",38,51,2012,1248,1208,40,3.2
"38051",38,51,2013,1251,1213,38,3
"38051",38,51,2014,1247,1210,37,3
"38051",38,51,2015,1245,1206,39,3.1
"38051",38,51,2016,1246,1208,38,3
"38051",38,51,2017,1249,1217,32,2.6
"38053",38,53,1990,2939,2874,65,2.2
"38053",38,53,1991,2879,2769,110,3.8
"38053",38,53,1992,2883,2747,136,4.7
"38053",38,53,1993,2805,2722,83,3
"38053",38,53,1994,3406,3326,80,2.3
"38053",38,53,1995,3267,3178,89,2.7
"38053",38,53,1996,3293,3190,103,3.1
"38053",38,53,1997,3264,3171,93,2.8
"38053",38,53,1998,3189,3081,108,3.4
"38053",38,53,1999,3206,3074,132,4.1
"38053",38,53,2000,2679,2595,84,3.1
"38053",38,53,2001,2677,2603,74,2.8
"38053",38,53,2002,2652,2548,104,3.9
"38053",38,53,2003,2714,2609,105,3.9
"38053",38,53,2004,2744,2650,94,3.4
"38053",38,53,2005,2692,2593,99,3.7
"38053",38,53,2006,2813,2722,91,3.2
"38053",38,53,2007,2928,2838,90,3.1
"38053",38,53,2008,3111,3036,75,2.4
"38053",38,53,2009,2911,2816,95,3.3
"38053",38,53,2010,3586,3508,78,2.2
"38053",38,53,2011,4620,4537,83,1.8
"38053",38,53,2012,6098,6005,93,1.5
"38053",38,53,2013,7561,7448,113,1.5
"38053",38,53,2014,9195,9057,138,1.5
"38053",38,53,2015,9209,8980,229,2.5
"38053",38,53,2016,7980,7682,298,3.7
"38053",38,53,2017,8198,7997,201,2.5
"38055",38,55,1990,4611,4400,211,4.6
"38055",38,55,1991,4649,4367,282,6.1
"38055",38,55,1992,4536,4207,329,7.3
"38055",38,55,1993,4539,4268,271,6
"38055",38,55,1994,4621,4379,242,5.2
"38055",38,55,1995,4635,4430,205,4.4
"38055",38,55,1996,4690,4444,246,5.2
"38055",38,55,1997,4652,4394,258,5.5
"38055",38,55,1998,4567,4299,268,5.9
"38055",38,55,1999,4559,4254,305,6.7
"38055",38,55,2000,4560,4345,215,4.7
"38055",38,55,2001,4430,4215,215,4.9
"38055",38,55,2002,4598,4340,258,5.6
"38055",38,55,2003,4509,4241,268,5.9
"38055",38,55,2004,4606,4350,256,5.6
"38055",38,55,2005,4615,4389,226,4.9
"38055",38,55,2006,4661,4450,211,4.5
"38055",38,55,2007,4726,4508,218,4.6
"38055",38,55,2008,4834,4616,218,4.5
"38055",38,55,2009,4953,4720,233,4.7
"38055",38,55,2010,5101,4844,257,5
"38055",38,55,2011,4982,4746,236,4.7
"38055",38,55,2012,4755,4546,209,4.4
"38055",38,55,2013,4825,4622,203,4.2
"38055",38,55,2014,4891,4697,194,4
"38055",38,55,2015,4925,4741,184,3.7
"38055",38,55,2016,5090,4914,176,3.5
"38055",38,55,2017,5103,4945,158,3.1
"38057",38,57,1990,4858,4564,294,6.1
"38057",38,57,1991,5029,4650,379,7.5
"38057",38,57,1992,4871,4422,449,9.2
"38057",38,57,1993,4906,4484,422,8.6
"38057",38,57,1994,4963,4534,429,8.6
"38057",38,57,1995,5220,4858,362,6.9
"38057",38,57,1996,5544,5265,279,5
"38057",38,57,1997,5084,4760,324,6.4
"38057",38,57,1998,4880,4543,337,6.9
"38057",38,57,1999,4659,4342,317,6.8
"38057",38,57,2000,4497,4301,196,4.4
"38057",38,57,2001,4474,4290,184,4.1
"38057",38,57,2002,4602,4386,216,4.7
"38057",38,57,2003,4693,4469,224,4.8
"38057",38,57,2004,4747,4534,213,4.5
"38057",38,57,2005,4577,4370,207,4.5
"38057",38,57,2006,4771,4591,180,3.8
"38057",38,57,2007,4753,4556,197,4.1
"38057",38,57,2008,4841,4620,221,4.6
"38057",38,57,2009,5126,4908,218,4.3
"38057",38,57,2010,4325,4098,227,5.2
"38057",38,57,2011,4142,3918,224,5.4
"38057",38,57,2012,4037,3822,215,5.3
"38057",38,57,2013,4170,3978,192,4.6
"38057",38,57,2014,4151,3988,163,3.9
"38057",38,57,2015,4310,4129,181,4.2
"38057",38,57,2016,4673,4469,204,4.4
"38057",38,57,2017,4520,4341,179,4
"38059",38,59,1990,12111,11535,576,4.8
"38059",38,59,1991,12378,11718,660,5.3
"38059",38,59,1992,12537,11817,720,5.7
"38059",38,59,1993,12944,12279,665,5.1
"38059",38,59,1994,12919,12341,578,4.5
"38059",38,59,1995,13452,12913,539,4
"38059",38,59,1996,13572,13107,465,3.4
"38059",38,59,1997,13912,13447,465,3.3
"38059",38,59,1998,13931,13460,471,3.4
"38059",38,59,1999,13723,13205,518,3.8
"38059",38,59,2000,13857,13441,416,3
"38059",38,59,2001,13808,13371,437,3.2
"38059",38,59,2002,13739,13210,529,3.9
"38059",38,59,2003,13916,13372,544,3.9
"38059",38,59,2004,14356,13839,517,3.6
"38059",38,59,2005,14527,14009,518,3.6
"38059",38,59,2006,14840,14352,488,3.3
"38059",38,59,2007,15021,14516,505,3.4
"38059",38,59,2008,15004,14480,524,3.5
"38059",38,59,2009,14964,14316,648,4.3
"38059",38,59,2010,15993,15263,730,4.6
"38059",38,59,2011,15833,15197,636,4
"38059",38,59,2012,15505,14950,555,3.6
"38059",38,59,2013,15781,15258,523,3.3
"38059",38,59,2014,15967,15446,521,3.3
"38059",38,59,2015,16273,15772,501,3.1
"38059",38,59,2016,16866,16320,546,3.2
"38059",38,59,2017,16805,16294,511,3
"38061",38,61,1990,3049,2887,162,5.3
"38061",38,61,1991,3049,2832,217,7.1
"38061",38,61,1992,2991,2723,268,9
"38061",38,61,1993,3289,3030,259,7.9
"38061",38,61,1994,3315,3023,292,8.8
"38061",38,61,1995,3172,2881,291,9.2
"38061",38,61,1996,3106,2904,202,6.5
"38061",38,61,1997,3029,2893,136,4.5
"38061",38,61,1998,3024,2852,172,5.7
"38061",38,61,1999,3090,2876,214,6.9
"38061",38,61,2000,3019,2878,141,4.7
"38061",38,61,2001,2948,2823,125,4.2
"38061",38,61,2002,2918,2757,161,5.5
"38061",38,61,2003,2979,2818,161,5.4
"38061",38,61,2004,3100,2936,164,5.3
"38061",38,61,2005,2991,2814,177,5.9
"38061",38,61,2006,2907,2733,174,6
"38061",38,61,2007,2972,2801,171,5.8
"38061",38,61,2008,2989,2864,125,4.2
"38061",38,61,2009,3706,3560,146,3.9
"38061",38,61,2010,5510,5366,144,2.6
"38061",38,61,2011,6500,6360,140,2.2
"38061",38,61,2012,7412,7291,121,1.6
"38061",38,61,2013,8007,7884,123,1.5
"38061",38,61,2014,9063,8948,115,1.3
"38061",38,61,2015,8147,7987,160,2
"38061",38,61,2016,7162,6950,212,3
"38061",38,61,2017,7088,6945,143,2
"38063",38,63,1990,1736,1672,64,3.7
"38063",38,63,1991,1762,1694,68,3.9
"38063",38,63,1992,1689,1620,69,4.1
"38063",38,63,1993,1720,1655,65,3.8
"38063",38,63,1994,1702,1632,70,4.1
"38063",38,63,1995,1756,1693,63,3.6
"38063",38,63,1996,1762,1695,67,3.8
"38063",38,63,1997,1702,1631,71,4.2
"38063",38,63,1998,1696,1634,62,3.7
"38063",38,63,1999,1590,1519,71,4.5
"38063",38,63,2000,1822,1752,70,3.8
"38063",38,63,2001,1815,1748,67,3.7
"38063",38,63,2002,1691,1616,75,4.4
"38063",38,63,2003,1751,1678,73,4.2
"38063",38,63,2004,1766,1699,67,3.8
"38063",38,63,2005,1696,1625,71,4.2
"38063",38,63,2006,1686,1615,71,4.2
"38063",38,63,2007,1642,1575,67,4.1
"38063",38,63,2008,1732,1674,58,3.3
"38063",38,63,2009,1717,1646,71,4.1
"38063",38,63,2010,1691,1623,68,4
"38063",38,63,2011,1664,1592,72,4.3
"38063",38,63,2012,1547,1483,64,4.1
"38063",38,63,2013,1555,1488,67,4.3
"38063",38,63,2014,1534,1476,58,3.8
"38063",38,63,2015,1519,1462,57,3.8
"38063",38,63,2016,1541,1489,52,3.4
"38063",38,63,2017,1503,1457,46,3.1
"38065",38,65,1990,1208,1162,46,3.8
"38065",38,65,1991,1196,1134,62,5.2
"38065",38,65,1992,1120,1057,63,5.6
"38065",38,65,1993,1132,1088,44,3.9
"38065",38,65,1994,1152,1114,38,3.3
"38065",38,65,1995,1180,1146,34,2.9
"38065",38,65,1996,1142,1095,47,4.1
"38065",38,65,1997,1168,1114,54,4.6
"38065",38,65,1998,1095,1047,48,4.4
"38065",38,65,1999,1052,997,55,5.2
"38065",38,65,2000,1127,1080,47,4.2
"38065",38,65,2001,1102,1060,42,3.8
"38065",38,65,2002,1075,1026,49,4.6
"38065",38,65,2003,1191,1143,48,4
"38065",38,65,2004,1249,1202,47,3.8
"38065",38,65,2005,1097,1045,52,4.7
"38065",38,65,2006,1099,1055,44,4
"38065",38,65,2007,1131,1083,48,4.2
"38065",38,65,2008,1148,1096,52,4.5
"38065",38,65,2009,1281,1230,51,4
"38065",38,65,2010,927,874,53,5.7
"38065",38,65,2011,925,868,57,6.2
"38065",38,65,2012,891,831,60,6.7
"38065",38,65,2013,891,837,54,6.1
"38065",38,65,2014,882,826,56,6.3
"38065",38,65,2015,883,831,52,5.9
"38065",38,65,2016,902,853,49,5.4
"38065",38,65,2017,887,850,37,4.2
"38067",38,67,1990,4662,4265,397,8.5
"38067",38,67,1991,4664,4289,375,8
"38067",38,67,1992,4790,4396,394,8.2
"38067",38,67,1993,4804,4390,414,8.6
"38067",38,67,1994,5011,4645,366,7.3
"38067",38,67,1995,5175,4875,300,5.8
"38067",38,67,1996,5152,4857,295,5.7
"38067",38,67,1997,5109,4832,277,5.4
"38067",38,67,1998,5120,4827,293,5.7
"38067",38,67,1999,4978,4677,301,6
"38067",38,67,2000,4689,4444,245,5.2
"38067",38,67,2001,4706,4503,203,4.3
"38067",38,67,2002,4192,3934,258,6.2
"38067",38,67,2003,4272,3976,296,6.9
"38067",38,67,2004,4184,3846,338,8.1
"38067",38,67,2005,4156,3886,270,6.5
"38067",38,67,2006,4101,3849,252,6.1
"38067",38,67,2007,4022,3797,225,5.6
"38067",38,67,2008,3939,3734,205,5.2
"38067",38,67,2009,3910,3681,229,5.9
"38067",38,67,2010,4024,3768,256,6.4
"38067",38,67,2011,3929,3658,271,6.9
"38067",38,67,2012,3709,3471,238,6.4
"38067",38,67,2013,3627,3407,220,6.1
"38067",38,67,2014,3604,3403,201,5.6
"38067",38,67,2015,3611,3418,193,5.3
"38067",38,67,2016,3675,3492,183,5
"38067",38,67,2017,3575,3428,147,4.1
"38069",38,69,1990,2141,2081,60,2.8
"38069",38,69,1991,2273,2198,75,3.3
"38069",38,69,1992,2243,2165,78,3.5
"38069",38,69,1993,2273,2205,68,3
"38069",38,69,1994,2231,2178,53,2.4
"38069",38,69,1995,2410,2359,51,2.1
"38069",38,69,1996,2488,2427,61,2.5
"38069",38,69,1997,2474,2414,60,2.4
"38069",38,69,1998,2470,2399,71,2.9
"38069",38,69,1999,2583,2501,82,3.2
"38069",38,69,2000,2194,2119,75,3.4
"38069",38,69,2001,1915,1833,82,4.3
"38069",38,69,2002,1937,1842,95,4.9
"38069",38,69,2003,1966,1860,106,5.4
"38069",38,69,2004,1983,1889,94,4.7
"38069",38,69,2005,1951,1861,90,4.6
"38069",38,69,2006,1922,1837,85,4.4
"38069",38,69,2007,1913,1827,86,4.5
"38069",38,69,2008,1934,1850,84,4.3
"38069",38,69,2009,1897,1797,100,5.3
"38069",38,69,2010,1997,1891,106,5.3
"38069",38,69,2011,1936,1843,93,4.8
"38069",38,69,2012,1875,1794,81,4.3
"38069",38,69,2013,1830,1753,77,4.2
"38069",38,69,2014,1806,1730,76,4.2
"38069",38,69,2015,1839,1762,77,4.2
"38069",38,69,2016,1906,1831,75,3.9
"38069",38,69,2017,1922,1861,61,3.2
"38071",38,71,1990,6223,5997,226,3.6
"38071",38,71,1991,6172,5951,221,3.6
"38071",38,71,1992,6308,6033,275,4.4
"38071",38,71,1993,6480,6220,260,4
"38071",38,71,1994,6506,6280,226,3.5
"38071",38,71,1995,6603,6394,209,3.2
"38071",38,71,1996,6752,6548,204,3
"38071",38,71,1997,6759,6583,176,2.6
"38071",38,71,1998,6545,6349,196,3
"38071",38,71,1999,6409,6200,209,3.3
"38071",38,71,2000,6187,5979,208,3.4
"38071",38,71,2001,6249,6048,201,3.2
"38071",38,71,2002,6102,5861,241,3.9
"38071",38,71,2003,6007,5752,255,4.2
"38071",38,71,2004,6009,5766,243,4
"38071",38,71,2005,6011,5781,230,3.8
"38071",38,71,2006,5967,5726,241,4
"38071",38,71,2007,5890,5657,233,4
"38071",38,71,2008,5841,5621,220,3.8
"38071",38,71,2009,5691,5452,239,4.2
"38071",38,71,2010,6042,5812,230,3.8
"38071",38,71,2011,6073,5841,232,3.8
"38071",38,71,2012,5827,5586,241,4.1
"38071",38,71,2013,5753,5536,217,3.8
"38071",38,71,2014,5676,5475,201,3.5
"38071",38,71,2015,5692,5499,193,3.4
"38071",38,71,2016,6172,5998,174,2.8
"38071",38,71,2017,5872,5715,157,2.7
"38073",38,73,1990,2704,2657,47,1.7
"38073",38,73,1991,2624,2562,62,2.4
"38073",38,73,1992,2588,2504,84,3.2
"38073",38,73,1993,2639,2544,95,3.6
"38073",38,73,1994,2841,2763,78,2.7
"38073",38,73,1995,2813,2760,53,1.9
"38073",38,73,1996,2906,2844,62,2.1
"38073",38,73,1997,2862,2811,51,1.8
"38073",38,73,1998,2763,2703,60,2.2
"38073",38,73,1999,2753,2686,67,2.4
"38073",38,73,2000,3099,3026,73,2.4
"38073",38,73,2001,3036,2964,72,2.4
"38073",38,73,2002,2981,2896,85,2.9
"38073",38,73,2003,2966,2874,92,3.1
"38073",38,73,2004,3110,3019,91,2.9
"38073",38,73,2005,3093,2996,97,3.1
"38073",38,73,2006,3184,3059,125,3.9
"38073",38,73,2007,3061,2965,96,3.1
"38073",38,73,2008,3094,2983,111,3.6
"38073",38,73,2009,2943,2711,232,7.9
"38073",38,73,2010,2856,2725,131,4.6
"38073",38,73,2011,2879,2777,102,3.5
"38073",38,73,2012,2799,2715,84,3
"38073",38,73,2013,2768,2688,80,2.9
"38073",38,73,2014,2732,2655,77,2.8
"38073",38,73,2015,2777,2709,68,2.4
"38073",38,73,2016,2850,2787,63,2.2
"38073",38,73,2017,2852,2797,55,1.9
"38075",38,75,1990,1386,1353,33,2.4
"38075",38,75,1991,1338,1298,40,3
"38075",38,75,1992,1329,1285,44,3.3
"38075",38,75,1993,1356,1323,33,2.4
"38075",38,75,1994,1412,1377,35,2.5
"38075",38,75,1995,1389,1362,27,1.9
"38075",38,75,1996,1396,1369,27,1.9
"38075",38,75,1997,1424,1401,23,1.6
"38075",38,75,1998,1404,1372,32,2.3
"38075",38,75,1999,1368,1331,37,2.7
"38075",38,75,2000,1305,1272,33,2.5
"38075",38,75,2001,1292,1261,31,2.4
"38075",38,75,2002,1298,1258,40,3.1
"38075",38,75,2003,1291,1251,40,3.1
"38075",38,75,2004,1293,1258,35,2.7
"38075",38,75,2005,1300,1260,40,3.1
"38075",38,75,2006,1338,1297,41,3.1
"38075",38,75,2007,1291,1252,39,3
"38075",38,75,2008,1263,1230,33,2.6
"38075",38,75,2009,1242,1193,49,3.9
"38075",38,75,2010,1459,1418,41,2.8
"38075",38,75,2011,1446,1406,40,2.8
"38075",38,75,2012,1445,1412,33,2.3
"38075",38,75,2013,1403,1369,34,2.4
"38075",38,75,2014,1408,1371,37,2.6
"38075",38,75,2015,1339,1294,45,3.4
"38075",38,75,2016,1313,1263,50,3.8
"38075",38,75,2017,1305,1272,33,2.5
"38077",38,77,1990,8590,8206,384,4.5
"38077",38,77,1991,8339,7949,390,4.7
"38077",38,77,1992,8368,8028,340,4.1
"38077",38,77,1993,8390,8056,334,4
"38077",38,77,1994,9349,9032,317,3.4
"38077",38,77,1995,9183,8898,285,3.1
"38077",38,77,1996,9721,9467,254,2.6
"38077",38,77,1997,9826,9605,221,2.2
"38077",38,77,1998,9638,9388,250,2.6
"38077",38,77,1999,9517,9253,264,2.8
"38077",38,77,2000,9379,9121,258,2.8
"38077",38,77,2001,8997,8726,271,3
"38077",38,77,2002,9238,8906,332,3.6
"38077",38,77,2003,9307,8965,342,3.7
"38077",38,77,2004,9257,8948,309,3.3
"38077",38,77,2005,9047,8742,305,3.4
"38077",38,77,2006,9005,8692,313,3.5
"38077",38,77,2007,8996,8696,300,3.3
"38077",38,77,2008,8967,8619,348,3.9
"38077",38,77,2009,8678,8232,446,5.1
"38077",38,77,2010,9060,8712,348,3.8
"38077",38,77,2011,8883,8544,339,3.8
"38077",38,77,2012,8565,8253,312,3.6
"38077",38,77,2013,8580,8291,289,3.4
"38077",38,77,2014,8521,8263,258,3
"38077",38,77,2015,8603,8368,235,2.7
"38077",38,77,2016,8941,8698,243,2.7
"38077",38,77,2017,8882,8673,209,2.4
"38079",38,79,1990,4863,4172,691,14.2
"38079",38,79,1991,4451,3784,667,15
"38079",38,79,1992,4737,3990,747,15.8
"38079",38,79,1993,5131,4345,786,15.3
"38079",38,79,1994,5793,5103,690,11.9
"38079",38,79,1995,5805,5114,691,11.9
"38079",38,79,1996,5664,4957,707,12.5
"38079",38,79,1997,5660,5056,604,10.7
"38079",38,79,1998,5665,5010,655,11.6
"38079",38,79,1999,5770,4997,773,13.4
"38079",38,79,2000,5233,4734,499,9.5
"38079",38,79,2001,5616,5142,474,8.4
"38079",38,79,2002,5492,4826,666,12.1
"38079",38,79,2003,5337,4756,581,10.9
"38079",38,79,2004,5279,4781,498,9.4
"38079",38,79,2005,5211,4725,486,9.3
"38079",38,79,2006,5116,4648,468,9.1
"38079",38,79,2007,5157,4690,467,9.1
"38079",38,79,2008,5013,4535,478,9.5
"38079",38,79,2009,4951,4381,570,11.5
"38079",38,79,2010,5291,4715,576,10.9
"38079",38,79,2011,5154,4590,564,10.9
"38079",38,79,2012,5022,4493,529,10.5
"38079",38,79,2013,4896,4291,605,12.4
"38079",38,79,2014,4792,4247,545,11.4
"38079",38,79,2015,4890,4386,504,10.3
"38079",38,79,2016,5004,4466,538,10.8
"38079",38,79,2017,4883,4387,496,10.2
"38081",38,81,1990,2076,2040,36,1.7
"38081",38,81,1991,2195,2129,66,3
"38081",38,81,1992,2108,2033,75,3.6
"38081",38,81,1993,2146,2087,59,2.7
"38081",38,81,1994,2130,2071,59,2.8
"38081",38,81,1995,2412,2356,56,2.3
"38081",38,81,1996,2391,2345,46,1.9
"38081",38,81,1997,2394,2355,39,1.6
"38081",38,81,1998,2467,2417,50,2
"38081",38,81,1999,2568,2519,49,1.9
"38081",38,81,2000,2349,2293,56,2.4
"38081",38,81,2001,2263,2191,72,3.2
"38081",38,81,2002,2112,2038,74,3.5
"38081",38,81,2003,2169,2106,63,2.9
"38081",38,81,2004,2349,2280,69,2.9
"38081",38,81,2005,2432,2367,65,2.7
"38081",38,81,2006,2540,2442,98,3.9
"38081",38,81,2007,2226,2145,81,3.6
"38081",38,81,2008,2231,2128,103,4.6
"38081",38,81,2009,2000,1789,211,10.6
"38081",38,81,2010,2045,1957,88,4.3
"38081",38,81,2011,2111,2046,65,3.1
"38081",38,81,2012,2147,2090,57,2.7
"38081",38,81,2013,2140,2086,54,2.5
"38081",38,81,2014,2166,2118,48,2.2
"38081",38,81,2015,2257,2216,41,1.8
"38081",38,81,2016,2343,2298,45,1.9
"38081",38,81,2017,2399,2350,49,2
"38083",38,83,1990,780,759,21,2.7
"38083",38,83,1991,750,723,27,3.6
"38083",38,83,1992,707,673,34,4.8
"38083",38,83,1993,703,679,24,3.4
"38083",38,83,1994,785,758,27,3.4
"38083",38,83,1995,751,733,18,2.4
"38083",38,83,1996,721,699,22,3.1
"38083",38,83,1997,699,683,16,2.3
"38083",38,83,1998,690,660,30,4.3
"38083",38,83,1999,714,667,47,6.6
"38083",38,83,2000,791,750,41,5.2
"38083",38,83,2001,797,754,43,5.4
"38083",38,83,2002,714,669,45,6.3
"38083",38,83,2003,762,721,41,5.4
"38083",38,83,2004,762,715,47,6.2
"38083",38,83,2005,746,703,43,5.8
"38083",38,83,2006,702,664,38,5.4
"38083",38,83,2007,635,603,32,5
"38083",38,83,2008,645,618,27,4.2
"38083",38,83,2009,659,625,34,5.2
"38083",38,83,2010,811,779,32,3.9
"38083",38,83,2011,799,767,32,4
"38083",38,83,2012,737,710,27,3.7
"38083",38,83,2013,718,689,29,4
"38083",38,83,2014,726,690,36,5
"38083",38,83,2015,726,689,37,5.1
"38083",38,83,2016,739,698,41,5.5
"38083",38,83,2017,728,695,33,4.5
"38085",38,85,1990,1812,1546,266,14.7
"38085",38,85,1991,1286,1010,276,21.5
"38085",38,85,1992,1381,1043,338,24.5
"38085",38,85,1993,1391,1140,251,18
"38085",38,85,1994,2045,1911,134,6.6
"38085",38,85,1995,1646,1540,106,6.4
"38085",38,85,1996,1655,1552,103,6.2
"38085",38,85,1997,1629,1525,104,6.4
"38085",38,85,1998,1693,1585,108,6.4
"38085",38,85,1999,1681,1562,119,7.1
"38085",38,85,2000,1263,1192,71,5.6
"38085",38,85,2001,1309,1244,65,5
"38085",38,85,2002,1345,1273,72,5.4
"38085",38,85,2003,1341,1270,71,5.3
"38085",38,85,2004,1348,1258,90,6.7
"38085",38,85,2005,1337,1246,91,6.8
"38085",38,85,2006,1333,1240,93,7
"38085",38,85,2007,1292,1210,82,6.3
"38085",38,85,2008,1306,1237,69,5.3
"38085",38,85,2009,1286,1222,64,5
"38085",38,85,2010,1308,1241,67,5.1
"38085",38,85,2011,1330,1258,72,5.4
"38085",38,85,2012,1307,1239,68,5.2
"38085",38,85,2013,1315,1254,61,4.6
"38085",38,85,2014,1302,1241,61,4.7
"38085",38,85,2015,1294,1237,57,4.4
"38085",38,85,2016,1345,1286,59,4.4
"38085",38,85,2017,1333,1285,48,3.6
"38087",38,87,1990,586,572,14,2.4
"38087",38,87,1991,453,436,17,3.8
"38087",38,87,1992,427,407,20,4.7
"38087",38,87,1993,397,380,17,4.3
"38087",38,87,1994,536,522,14,2.6
"38087",38,87,1995,428,416,12,2.8
"38087",38,87,1996,420,412,8,1.9
"38087",38,87,1997,396,390,6,1.5
"38087",38,87,1998,400,390,10,2.5
"38087",38,87,1999,414,391,23,5.6
"38087",38,87,2000,426,415,11,2.6
"38087",38,87,2001,392,383,9,2.3
"38087",38,87,2002,457,447,10,2.2
"38087",38,87,2003,489,475,14,2.9
"38087",38,87,2004,447,433,14,3.1
"38087",38,87,2005,526,514,12,2.3
"38087",38,87,2006,528,516,12,2.3
"38087",38,87,2007,629,619,10,1.6
"38087",38,87,2008,760,750,10,1.3
"38087",38,87,2009,561,549,12,2.1
"38087",38,87,2010,470,459,11,2.3
"38087",38,87,2011,493,483,10,2
"38087",38,87,2012,529,518,11,2.1
"38087",38,87,2013,523,512,11,2.1
"38087",38,87,2014,513,502,11,2.1
"38087",38,87,2015,465,453,12,2.6
"38087",38,87,2016,438,427,11,2.5
"38087",38,87,2017,427,419,8,1.9
"38089",38,89,1990,12133,11687,446,3.7
"38089",38,89,1991,11876,11297,579,4.9
"38089",38,89,1992,11839,11163,676,5.7
"38089",38,89,1993,12020,11508,512,4.3
"38089",38,89,1994,12775,12245,530,4.1
"38089",38,89,1995,12384,11984,400,3.2
"38089",38,89,1996,12755,12396,359,2.8
"38089",38,89,1997,13087,12757,330,2.5
"38089",38,89,1998,13056,12635,421,3.2
"38089",38,89,1999,12576,12057,519,4.1
"38089",38,89,2000,12316,11966,350,2.8
"38089",38,89,2001,12323,11990,333,2.7
"38089",38,89,2002,12622,12185,437,3.5
"38089",38,89,2003,12830,12396,434,3.4
"38089",38,89,2004,13048,12636,412,3.2
"38089",38,89,2005,13426,13033,393,2.9
"38089",38,89,2006,13717,13359,358,2.6
"38089",38,89,2007,13947,13601,346,2.5
"38089",38,89,2008,14314,13977,337,2.4
"38089",38,89,2009,14409,13950,459,3.2
"38089",38,89,2010,14546,14142,404,2.8
"38089",38,89,2011,16072,15719,353,2.2
"38089",38,89,2012,18262,17929,333,1.8
"38089",38,89,2013,19479,19149,330,1.7
"38089",38,89,2014,21338,20994,344,1.6
"38089",38,89,2015,20298,19749,549,2.7
"38089",38,89,2016,18161,17456,705,3.9
"38089",38,89,2017,18283,17794,489,2.7
"38091",38,91,1990,1260,1240,20,1.6
"38091",38,91,1991,1022,1003,19,1.9
"38091",38,91,1992,1025,1000,25,2.4
"38091",38,91,1993,1022,1005,17,1.7
"38091",38,91,1994,1300,1282,18,1.4
"38091",38,91,1995,1129,1108,21,1.9
"38091",38,91,1996,1117,1098,19,1.7
"38091",38,91,1997,1128,1109,19,1.7
"38091",38,91,1998,1110,1093,17,1.5
"38091",38,91,1999,1098,1085,13,1.2
"38091",38,91,2000,1176,1152,24,2
"38091",38,91,2001,1126,1104,22,2
"38091",38,91,2002,1151,1124,27,2.3
"38091",38,91,2003,1145,1118,27,2.4
"38091",38,91,2004,1214,1186,28,2.3
"38091",38,91,2005,1151,1120,31,2.7
"38091",38,91,2006,1132,1104,28,2.5
"38091",38,91,2007,1119,1093,26,2.3
"38091",38,91,2008,1168,1143,25,2.1
"38091",38,91,2009,1116,1084,32,2.9
"38091",38,91,2010,1100,1070,30,2.7
"38091",38,91,2011,1114,1085,29,2.6
"38091",38,91,2012,1049,1021,28,2.7
"38091",38,91,2013,1042,1017,25,2.4
"38091",38,91,2014,1029,1006,23,2.2
"38091",38,91,2015,1063,1039,24,2.3
"38091",38,91,2016,1079,1056,23,2.1
"38091",38,91,2017,1082,1064,18,1.7
"38093",38,93,1990,11235,10849,386,3.4
"38093",38,93,1991,11104,10684,420,3.8
"38093",38,93,1992,10929,10470,459,4.2
"38093",38,93,1993,11133,10692,441,4
"38093",38,93,1994,11359,10975,384,3.4
"38093",38,93,1995,11355,11008,347,3.1
"38093",38,93,1996,11757,11444,313,2.7
"38093",38,93,1997,12047,11795,252,2.1
"38093",38,93,1998,12004,11719,285,2.4
"38093",38,93,1999,11781,11472,309,2.6
"38093",38,93,2000,11843,11543,300,2.5
"38093",38,93,2001,11741,11441,300,2.6
"38093",38,93,2002,11608,11212,396,3.4
"38093",38,93,2003,11460,11034,426,3.7
"38093",38,93,2004,11685,11308,377,3.2
"38093",38,93,2005,11672,11303,369,3.2
"38093",38,93,2006,11922,11561,361,3
"38093",38,93,2007,11876,11537,339,2.9
"38093",38,93,2008,11750,11406,344,2.9
"38093",38,93,2009,11883,11462,421,3.5
"38093",38,93,2010,11264,10797,467,4.1
"38093",38,93,2011,10840,10428,412,3.8
"38093",38,93,2012,10425,10067,358,3.4
"38093",38,93,2013,10503,10174,329,3.1
"38093",38,93,2014,10441,10154,287,2.7
"38093",38,93,2015,10713,10437,276,2.6
"38093",38,93,2016,11127,10854,273,2.5
"38093",38,93,2017,11074,10817,257,2.3
"38095",38,95,1990,1631,1585,46,2.8
"38095",38,95,1991,1553,1505,48,3.1
"38095",38,95,1992,1537,1491,46,3
"38095",38,95,1993,1647,1608,39,2.4
"38095",38,95,1994,1753,1715,38,2.2
"38095",38,95,1995,1553,1513,40,2.6
"38095",38,95,1996,1596,1551,45,2.8
"38095",38,95,1997,1533,1498,35,2.3
"38095",38,95,1998,1456,1419,37,2.5
"38095",38,95,1999,1359,1325,34,2.5
"38095",38,95,2000,1440,1399,41,2.8
"38095",38,95,2001,1360,1320,40,2.9
"38095",38,95,2002,1343,1292,51,3.8
"38095",38,95,2003,1336,1283,53,4
"38095",38,95,2004,1346,1288,58,4.3
"38095",38,95,2005,1269,1206,63,5
"38095",38,95,2006,1199,1137,62,5.2
"38095",38,95,2007,1144,1099,45,3.9
"38095",38,95,2008,1110,1074,36,3.2
"38095",38,95,2009,1076,1043,33,3.1
"38095",38,95,2010,1396,1358,38,2.7
"38095",38,95,2011,1350,1309,41,3
"38095",38,95,2012,1260,1218,42,3.3
"38095",38,95,2013,1215,1168,47,3.9
"38095",38,95,2014,1236,1193,43,3.5
"38095",38,95,2015,1242,1209,33,2.7
"38095",38,95,2016,1337,1308,29,2.2
"38095",38,95,2017,1237,1206,31,2.5
"38097",38,97,1990,4027,3870,157,3.9
"38097",38,97,1991,3818,3658,160,4.2
"38097",38,97,1992,3765,3608,157,4.2
"38097",38,97,1993,3823,3669,154,4
"38097",38,97,1994,4068,3921,147,3.6
"38097",38,97,1995,4028,3892,136,3.4
"38097",38,97,1996,4032,3895,137,3.4
"38097",38,97,1997,4015,3888,127,3.2
"38097",38,97,1998,3824,3708,116,3
"38097",38,97,1999,3821,3699,122,3.2
"38097",38,97,2000,4268,4145,123,2.9
"38097",38,97,2001,4248,4120,128,3
"38097",38,97,2002,4116,3950,166,4
"38097",38,97,2003,4131,3979,152,3.7
"38097",38,97,2004,4209,4051,158,3.8
"38097",38,97,2005,4235,4076,159,3.8
"38097",38,97,2006,4243,4090,153,3.6
"38097",38,97,2007,4237,4096,141,3.3
"38097",38,97,2008,4167,4029,138,3.3
"38097",38,97,2009,4024,3864,160,4
"38097",38,97,2010,4562,4393,169,3.7
"38097",38,97,2011,4606,4438,168,3.6
"38097",38,97,2012,4532,4389,143,3.2
"38097",38,97,2013,4502,4372,130,2.9
"38097",38,97,2014,4460,4344,116,2.6
"38097",38,97,2015,4452,4326,126,2.8
"38097",38,97,2016,4619,4491,128,2.8
"38097",38,97,2017,4654,4542,112,2.4
"38099",38,99,1990,6374,6088,286,4.5
"38099",38,99,1991,6578,6285,293,4.5
"38099",38,99,1992,6397,6060,337,5.3
"38099",38,99,1993,6466,6069,397,6.1
"38099",38,99,1994,6245,5857,388,6.2
"38099",38,99,1995,6530,6205,325,5
"38099",38,99,1996,6603,6318,285,4.3
"38099",38,99,1997,6410,6155,255,4
"38099",38,99,1998,6336,6083,253,4
"38099",38,99,1999,6360,6101,259,4.1
"38099",38,99,2000,6457,6224,233,3.6
"38099",38,99,2001,6349,6138,211,3.3
"38099",38,99,2002,6066,5800,266,4.4
"38099",38,99,2003,6031,5774,257,4.3
"38099",38,99,2004,5935,5658,277,4.7
"38099",38,99,2005,5895,5613,282,4.8
"38099",38,99,2006,5834,5564,270,4.6
"38099",38,99,2007,5733,5492,241,4.2
"38099",38,99,2008,5685,5438,247,4.3
"38099",38,99,2009,5593,5320,273,4.9
"38099",38,99,2010,6222,5905,317,5.1
"38099",38,99,2011,5968,5668,300,5
"38099",38,99,2012,5666,5389,277,4.9
"38099",38,99,2013,5627,5348,279,5
"38099",38,99,2014,5576,5319,257,4.6
"38099",38,99,2015,5580,5347,233,4.2
"38099",38,99,2016,5685,5472,213,3.7
"38099",38,99,2017,5647,5461,186,3.3
"38101",38,101,1990,26353,25195,1158,4.4
"38101",38,101,1991,25862,24724,1138,4.4
"38101",38,101,1992,26487,25198,1289,4.9
"38101",38,101,1993,27202,25916,1286,4.7
"38101",38,101,1994,28615,27577,1038,3.6
"38101",38,101,1995,28977,28070,907,3.1
"38101",38,101,1996,29722,28895,827,2.8
"38101",38,101,1997,30110,29366,744,2.5
"38101",38,101,1998,29686,28816,870,2.9
"38101",38,101,1999,28980,28028,952,3.3
"38101",38,101,2000,27968,27072,896,3.2
"38101",38,101,2001,27923,27025,898,3.2
"38101",38,101,2002,27584,26515,1069,3.9
"38101",38,101,2003,27732,26631,1101,4
"38101",38,101,2004,28198,27206,992,3.5
"38101",38,101,2005,28271,27290,981,3.5
"38101",38,101,2006,28690,27794,896,3.1
"38101",38,101,2007,29340,28461,879,3
"38101",38,101,2008,29718,28841,877,3
"38101",38,101,2009,29832,28731,1101,3.7
"38101",38,101,2010,31526,30436,1090,3.5
"38101",38,101,2011,32491,31454,1037,3.2
"38101",38,101,2012,33955,33055,900,2.7
"38101",38,101,2013,34493,33558,935,2.7
"38101",38,101,2014,34553,33647,906,2.6
"38101",38,101,2015,34299,33205,1094,3.2
"38101",38,101,2016,33679,32301,1378,4.1
"38101",38,101,2017,32971,31909,1062,3.2
"38103",38,103,1990,2530,2382,148,5.8
"38103",38,103,1991,2555,2384,171,6.7
"38103",38,103,1992,2472,2273,199,8.1
"38103",38,103,1993,2529,2359,170,6.7
"38103",38,103,1994,2500,2355,145,5.8
"38103",38,103,1995,2544,2439,105,4.1
"38103",38,103,1996,2540,2438,102,4
"38103",38,103,1997,2544,2452,92,3.6
"38103",38,103,1998,2532,2446,86,3.4
"38103",38,103,1999,2586,2482,104,4
"38103",38,103,2000,2351,2257,94,4
"38103",38,103,2001,2253,2166,87,3.9
"38103",38,103,2002,2285,2178,107,4.7
"38103",38,103,2003,2285,2174,111,4.9
"38103",38,103,2004,2309,2200,109,4.7
"38103",38,103,2005,2200,2095,105,4.8
"38103",38,103,2006,2195,2093,102,4.6
"38103",38,103,2007,2132,2034,98,4.6
"38103",38,103,2008,2113,2020,93,4.4
"38103",38,103,2009,2040,1933,107,5.2
"38103",38,103,2010,2328,2235,93,4
"38103",38,103,2011,2311,2210,101,4.4
"38103",38,103,2012,2228,2139,89,4
"38103",38,103,2013,2215,2119,96,4.3
"38103",38,103,2014,2195,2099,96,4.4
"38103",38,103,2015,2173,2086,87,4
"38103",38,103,2016,2201,2116,85,3.9
"38103",38,103,2017,2183,2113,70,3.2
"38105",38,105,1990,9843,9505,338,3.4
"38105",38,105,1991,10323,9867,456,4.4
"38105",38,105,1992,10072,9489,583,5.8
"38105",38,105,1993,10197,9721,476,4.7
"38105",38,105,1994,9951,9497,454,4.6
"38105",38,105,1995,10259,9909,350,3.4
"38105",38,105,1996,10496,10215,281,2.7
"38105",38,105,1997,10403,10134,269,2.6
"38105",38,105,1998,10039,9646,393,3.9
"38105",38,105,1999,9506,8945,561,5.9
"38105",38,105,2000,10526,10221,305,2.9
"38105",38,105,2001,10809,10551,258,2.4
"38105",38,105,2002,10873,10520,353,3.2
"38105",38,105,2003,10910,10563,347,3.2
"38105",38,105,2004,11108,10812,296,2.7
"38105",38,105,2005,11706,11439,267,2.3
"38105",38,105,2006,12652,12392,260,2.1
"38105",38,105,2007,13081,12833,248,1.9
"38105",38,105,2008,14674,14425,249,1.7
"38105",38,105,2009,14758,14388,370,2.5
"38105",38,105,2010,14407,14091,316,2.2
"38105",38,105,2011,20091,19807,284,1.4
"38105",38,105,2012,27098,26795,303,1.1
"38105",38,105,2013,29283,28922,361,1.2
"38105",38,105,2014,31868,31488,380,1.2
"38105",38,105,2015,28717,28035,682,2.4
"38105",38,105,2016,22726,21742,984,4.3
"38105",38,105,2017,23013,22436,577,2.5
"39001",39,1,1990,9998,8906,1092,10.9
"39001",39,1,1991,10139,8886,1253,12.4
"39001",39,1,1992,10607,9031,1576,14.9
"39001",39,1,1993,11252,9537,1715,15.2
"39001",39,1,1994,11194,9722,1472,13.1
"39001",39,1,1995,11410,9957,1453,12.7
"39001",39,1,1996,11273,9749,1524,13.5
"39001",39,1,1997,11193,9860,1333,11.9
"39001",39,1,1998,11344,9993,1351,11.9
"39001",39,1,1999,11741,10529,1212,10.3
"39001",39,1,2000,12564,11628,936,7.4
"39001",39,1,2001,12488,11560,928,7.4
"39001",39,1,2002,12624,11392,1232,9.8
"39001",39,1,2003,12613,11349,1264,10
"39001",39,1,2004,12878,11621,1257,9.8
"39001",39,1,2005,13131,12015,1116,8.5
"39001",39,1,2006,13263,12255,1008,7.6
"39001",39,1,2007,13547,12506,1041,7.7
"39001",39,1,2008,13185,11958,1227,9.3
"39001",39,1,2009,13026,11116,1910,14.7
"39001",39,1,2010,11881,9986,1895,15.9
"39001",39,1,2011,11524,9871,1653,14.3
"39001",39,1,2012,10770,9416,1354,12.6
"39001",39,1,2013,10693,9333,1360,12.7
"39001",39,1,2014,10512,9545,967,9.2
"39001",39,1,2015,10681,9842,839,7.9
"39001",39,1,2016,10957,10135,822,7.5
"39001",39,1,2017,10996,10208,788,7.2
"39003",39,3,1990,52803,48766,4037,7.6
"39003",39,3,1991,52550,48378,4172,7.9
"39003",39,3,1992,52130,47787,4343,8.3
"39003",39,3,1993,51700,47513,4187,8.1
"39003",39,3,1994,51558,48086,3472,6.7
"39003",39,3,1995,51156,48065,3091,6
"39003",39,3,1996,51478,47866,3612,7
"39003",39,3,1997,50724,47686,3038,6
"39003",39,3,1998,50395,47670,2725,5.4
"39003",39,3,1999,51343,48690,2653,5.2
"39003",39,3,2000,51566,49187,2379,4.6
"39003",39,3,2001,51549,48955,2594,5
"39003",39,3,2002,52181,48800,3381,6.5
"39003",39,3,2003,52611,48956,3655,6.9
"39003",39,3,2004,52550,48983,3567,6.8
"39003",39,3,2005,52706,49415,3291,6.2
"39003",39,3,2006,52786,49569,3217,6.1
"39003",39,3,2007,52259,48969,3290,6.3
"39003",39,3,2008,51638,47826,3812,7.4
"39003",39,3,2009,51347,45541,5806,11.3
"39003",39,3,2010,52009,46442,5567,10.7
"39003",39,3,2011,50958,46106,4852,9.5
"39003",39,3,2012,49937,46089,3848,7.7
"39003",39,3,2013,49469,45593,3876,7.8
"39003",39,3,2014,48339,45536,2803,5.8
"39003",39,3,2015,47839,45520,2319,4.8
"39003",39,3,2016,48327,45909,2418,5
"39003",39,3,2017,48897,46453,2444,5
"39005",39,5,1990,24383,23002,1381,5.7
"39005",39,5,1991,24833,23148,1685,6.8
"39005",39,5,1992,25593,23821,1772,6.9
"39005",39,5,1993,25488,23620,1868,7.3
"39005",39,5,1994,25652,24263,1389,5.4
"39005",39,5,1995,26017,24761,1256,4.8
"39005",39,5,1996,25815,24212,1603,6.2
"39005",39,5,1997,25622,24257,1365,5.3
"39005",39,5,1998,25511,24357,1154,4.5
"39005",39,5,1999,25994,24820,1174,4.5
"39005",39,5,2000,27088,25957,1131,4.2
"39005",39,5,2001,27237,26013,1224,4.5
"39005",39,5,2002,27296,25568,1728,6.3
"39005",39,5,2003,27144,25230,1914,7.1
"39005",39,5,2004,27220,25244,1976,7.3
"39005",39,5,2005,27136,25384,1752,6.5
"39005",39,5,2006,27299,25791,1508,5.5
"39005",39,5,2007,27654,26000,1654,6
"39005",39,5,2008,27190,25163,2027,7.5
"39005",39,5,2009,27218,23813,3405,12.5
"39005",39,5,2010,26628,23460,3168,11.9
"39005",39,5,2011,26144,23560,2584,9.9
"39005",39,5,2012,25820,23745,2075,8
"39005",39,5,2013,25526,23459,2067,8.1
"39005",39,5,2014,25543,24019,1524,6
"39005",39,5,2015,25973,24670,1303,5
"39005",39,5,2016,26293,24965,1328,5.1
"39005",39,5,2017,26366,25073,1293,4.9
"39007",39,7,1990,45880,42364,3516,7.7
"39007",39,7,1991,45580,41475,4105,9
"39007",39,7,1992,45954,41229,4725,10.3
"39007",39,7,1993,45223,41240,3983,8.8
"39007",39,7,1994,45855,42053,3802,8.3
"39007",39,7,1995,45561,42337,3224,7.1
"39007",39,7,1996,46492,42921,3571,7.7
"39007",39,7,1997,46689,43623,3066,6.6
"39007",39,7,1998,47173,43904,3269,6.9
"39007",39,7,1999,47250,44258,2992,6.3
"39007",39,7,2000,50518,47951,2567,5.1
"39007",39,7,2001,49542,46561,2981,6
"39007",39,7,2002,50788,46989,3799,7.5
"39007",39,7,2003,50382,46332,4050,8
"39007",39,7,2004,50302,46491,3811,7.6
"39007",39,7,2005,50594,46872,3722,7.4
"39007",39,7,2006,49941,46599,3342,6.7
"39007",39,7,2007,49729,46259,3470,7
"39007",39,7,2008,49005,45083,3922,8
"39007",39,7,2009,48595,42000,6595,13.6
"39007",39,7,2010,48407,42139,6268,12.9
"39007",39,7,2011,47581,42405,5176,10.9
"39007",39,7,2012,46433,42062,4371,9.4
"39007",39,7,2013,46023,41653,4370,9.5
"39007",39,7,2014,44923,41700,3223,7.2
"39007",39,7,2015,44344,41699,2645,6
"39007",39,7,2016,44280,41585,2695,6.1
"39007",39,7,2017,44321,41696,2625,5.9
"39009",39,9,1990,24723,23301,1422,5.8
"39009",39,9,1991,24606,23086,1520,6.2
"39009",39,9,1992,24960,23178,1782,7.1
"39009",39,9,1993,24901,23308,1593,6.4
"39009",39,9,1994,25054,23718,1336,5.3
"39009",39,9,1995,25444,23995,1449,5.7
"39009",39,9,1996,26228,24605,1623,6.2
"39009",39,9,1997,26466,25015,1451,5.5
"39009",39,9,1998,26525,25113,1412,5.3
"39009",39,9,1999,26649,25235,1414,5.3
"39009",39,9,2000,27756,26225,1531,5.5
"39009",39,9,2001,28427,27039,1388,4.9
"39009",39,9,2002,29016,27213,1803,6.2
"39009",39,9,2003,29664,27685,1979,6.7
"39009",39,9,2004,29778,27733,2045,6.9
"39009",39,9,2005,30032,28052,1980,6.6
"39009",39,9,2006,30450,28644,1806,5.9
"39009",39,9,2007,30610,28746,1864,6.1
"39009",39,9,2008,30777,28723,2054,6.7
"39009",39,9,2009,31330,28575,2755,8.8
"39009",39,9,2010,28627,25591,3036,10.6
"39009",39,9,2011,27851,25090,2761,9.9
"39009",39,9,2012,27585,25235,2350,8.5
"39009",39,9,2013,27507,25027,2480,9
"39009",39,9,2014,27600,25705,1895,6.9
"39009",39,9,2015,27908,26172,1736,6.2
"39009",39,9,2016,28054,26263,1791,6.4
"39009",39,9,2017,28594,26863,1731,6.1
"39011",39,11,1990,23295,21899,1396,6
"39011",39,11,1991,23467,22040,1427,6.1
"39011",39,11,1992,23645,22024,1621,6.9
"39011",39,11,1993,23948,22156,1792,7.5
"39011",39,11,1994,23950,22528,1422,5.9
"39011",39,11,1995,24018,22749,1269,5.3
"39011",39,11,1996,24178,22864,1314,5.4
"39011",39,11,1997,23997,22896,1101,4.6
"39011",39,11,1998,24173,23072,1101,4.6
"39011",39,11,1999,24762,23704,1058,4.3
"39011",39,11,2000,25130,24240,890,3.5
"39011",39,11,2001,24957,23890,1067,4.3
"39011",39,11,2002,25050,23570,1480,5.9
"39011",39,11,2003,25290,23949,1341,5.3
"39011",39,11,2004,25374,24035,1339,5.3
"39011",39,11,2005,26238,25028,1210,4.6
"39011",39,11,2006,27122,25987,1135,4.2
"39011",39,11,2007,27156,25952,1204,4.4
"39011",39,11,2008,26868,25405,1463,5.4
"39011",39,11,2009,26527,23699,2828,10.7
"39011",39,11,2010,24560,22099,2461,10
"39011",39,11,2011,24128,22175,1953,8.1
"39011",39,11,2012,23945,22465,1480,6.2
"39011",39,11,2013,23963,22547,1416,5.9
"39011",39,11,2014,24133,23087,1046,4.3
"39011",39,11,2015,24452,23553,899,3.7
"39011",39,11,2016,24656,23739,917,3.7
"39011",39,11,2017,24734,23813,921,3.7
"39013",39,13,1990,30134,28213,1921,6.4
"39013",39,13,1991,30272,28187,2085,6.9
"39013",39,13,1992,30444,27877,2567,8.4
"39013",39,13,1993,30896,28082,2814,9.1
"39013",39,13,1994,30775,28447,2328,7.6
"39013",39,13,1995,30867,28699,2168,7
"39013",39,13,1996,31484,29082,2402,7.6
"39013",39,13,1997,31893,29383,2510,7.9
"39013",39,13,1998,32380,30472,1908,5.9
"39013",39,13,1999,32322,30378,1944,6
"39013",39,13,2000,31047,29053,1994,6.4
"39013",39,13,2001,30971,29250,1721,5.6
"39013",39,13,2002,31827,29613,2214,7
"39013",39,13,2003,31800,29586,2214,7
"39013",39,13,2004,32181,29895,2286,7.1
"39013",39,13,2005,32494,30344,2150,6.6
"39013",39,13,2006,32755,30842,1913,5.8
"39013",39,13,2007,32878,31038,1840,5.6
"39013",39,13,2008,33285,31257,2028,6.1
"39013",39,13,2009,33924,30800,3124,9.2
"39013",39,13,2010,33462,29682,3780,11.3
"39013",39,13,2011,32286,29203,3083,9.5
"39013",39,13,2012,31728,29111,2617,8.2
"39013",39,13,2013,31961,29328,2633,8.2
"39013",39,13,2014,31819,29679,2140,6.7
"39013",39,13,2015,31148,29174,1974,6.3
"39013",39,13,2016,31048,28737,2311,7.4
"39013",39,13,2017,30705,28764,1941,6.3
"39015",39,15,1990,16787,15729,1058,6.3
"39015",39,15,1991,17090,15741,1349,7.9
"39015",39,15,1992,17518,15943,1575,9
"39015",39,15,1993,17859,16198,1661,9.3
"39015",39,15,1994,17837,16718,1119,6.3
"39015",39,15,1995,18116,17016,1100,6.1
"39015",39,15,1996,18766,17571,1195,6.4
"39015",39,15,1997,19209,18067,1142,5.9
"39015",39,15,1998,19475,18394,1081,5.6
"39015",39,15,1999,19967,18798,1169,5.9
"39015",39,15,2000,20642,19531,1111,5.4
"39015",39,15,2001,20839,19619,1220,5.9
"39015",39,15,2002,21318,19817,1501,7
"39015",39,15,2003,21727,20127,1600,7.4
"39015",39,15,2004,21872,20289,1583,7.2
"39015",39,15,2005,22047,20504,1543,7
"39015",39,15,2006,22075,20555,1520,6.9
"39015",39,15,2007,21794,20381,1413,6.5
"39015",39,15,2008,21758,20099,1659,7.6
"39015",39,15,2009,21811,19028,2783,12.8
"39015",39,15,2010,21125,18315,2810,13.3
"39015",39,15,2011,20658,18210,2448,11.9
"39015",39,15,2012,20144,18130,2014,10
"39015",39,15,2013,20086,18043,2043,10.2
"39015",39,15,2014,19682,18212,1470,7.5
"39015",39,15,2015,19485,18272,1213,6.2
"39015",39,15,2016,19519,18391,1128,5.8
"39015",39,15,2017,19726,18600,1126,5.7
"39017",39,17,1990,149975,141384,8591,5.7
"39017",39,17,1991,152135,143207,8928,5.9
"39017",39,17,1992,155506,144982,10524,6.8
"39017",39,17,1993,157583,146791,10792,6.8
"39017",39,17,1994,160920,152152,8768,5.4
"39017",39,17,1995,165393,158493,6900,4.2
"39017",39,17,1996,167453,160099,7354,4.4
"39017",39,17,1997,174718,168236,6482,3.7
"39017",39,17,1998,180586,173955,6631,3.7
"39017",39,17,1999,185460,178974,6486,3.5
"39017",39,17,2000,173347,166834,6513,3.8
"39017",39,17,2001,175136,168168,6968,4
"39017",39,17,2002,178459,168895,9564,5.4
"39017",39,17,2003,181388,171343,10045,5.5
"39017",39,17,2004,183628,173319,10309,5.6
"39017",39,17,2005,186502,176383,10119,5.4
"39017",39,17,2006,189822,179024,10798,5.7
"39017",39,17,2007,190611,180864,9747,5.1
"39017",39,17,2008,191057,179773,11284,5.9
"39017",39,17,2009,189452,171172,18280,9.6
"39017",39,17,2010,190738,171600,19138,10
"39017",39,17,2011,188924,171787,17137,9.1
"39017",39,17,2012,186468,172183,14285,7.7
"39017",39,17,2013,186298,172339,13959,7.5
"39017",39,17,2014,186523,176166,10357,5.6
"39017",39,17,2015,187441,178844,8597,4.6
"39017",39,17,2016,189702,181180,8522,4.5
"39017",39,17,2017,192374,183840,8534,4.4
"39019",39,19,1990,12225,11460,765,6.3
"39019",39,19,1991,12484,11546,938,7.5
"39019",39,19,1992,12819,11548,1271,9.9
"39019",39,19,1993,12555,11601,954,7.6
"39019",39,19,1994,12570,11794,776,6.2
"39019",39,19,1995,12807,12159,648,5.1
"39019",39,19,1996,13158,12408,750,5.7
"39019",39,19,1997,13371,12652,719,5.4
"39019",39,19,1998,13568,12853,715,5.3
"39019",39,19,1999,13630,12836,794,5.8
"39019",39,19,2000,14163,13513,650,4.6
"39019",39,19,2001,14308,13620,688,4.8
"39019",39,19,2002,14445,13467,978,6.8
"39019",39,19,2003,14444,13293,1151,8
"39019",39,19,2004,14291,13195,1096,7.7
"39019",39,19,2005,14150,13178,972,6.9
"39019",39,19,2006,14035,13182,853,6.1
"39019",39,19,2007,13935,13074,861,6.2
"39019",39,19,2008,13943,12883,1060,7.6
"39019",39,19,2009,14124,12182,1942,13.7
"39019",39,19,2010,14373,12504,1869,13
"39019",39,19,2011,14111,12672,1439,10.2
"39019",39,19,2012,13791,12696,1095,7.9
"39019",39,19,2013,13701,12618,1083,7.9
"39019",39,19,2014,13569,12735,834,6.1
"39019",39,19,2015,13347,12552,795,6
"39019",39,19,2016,13455,12536,919,6.8
"39019",39,19,2017,13376,12592,784,5.9
"39021",39,21,1990,19055,17861,1194,6.3
"39021",39,21,1991,19019,17677,1342,7.1
"39021",39,21,1992,19472,18085,1387,7.1
"39021",39,21,1993,19363,17669,1694,8.7
"39021",39,21,1994,18478,17353,1125,6.1
"39021",39,21,1995,18567,17680,887,4.8
"39021",39,21,1996,18494,17349,1145,6.2
"39021",39,21,1997,18949,17983,966,5.1
"39021",39,21,1998,18848,18031,817,4.3
"39021",39,21,1999,18755,17980,775,4.1
"39021",39,21,2000,20516,19744,772,3.8
"39021",39,21,2001,20687,19756,931,4.5
"39021",39,21,2002,20624,19327,1297,6.3
"39021",39,21,2003,20629,19228,1401,6.8
"39021",39,21,2004,20769,19461,1308,6.3
"39021",39,21,2005,20848,19638,1210,5.8
"39021",39,21,2006,20811,19749,1062,5.1
"39021",39,21,2007,21041,19800,1241,5.9
"39021",39,21,2008,20481,19056,1425,7
"39021",39,21,2009,20290,17869,2421,11.9
"39021",39,21,2010,19979,17673,2306,11.5
"39021",39,21,2011,19527,17682,1845,9.4
"39021",39,21,2012,19372,17942,1430,7.4
"39021",39,21,2013,20016,18632,1384,6.9
"39021",39,21,2014,19928,18918,1010,5.1
"39021",39,21,2015,19873,19004,869,4.4
"39021",39,21,2016,19909,19015,894,4.5
"39021",39,21,2017,19859,19032,827,4.2
"39023",39,23,1990,71562,67307,4255,5.9
"39023",39,23,1991,70733,66062,4671,6.6
"39023",39,23,1992,70671,65224,5447,7.7
"39023",39,23,1993,69160,64872,4288,6.2
"39023",39,23,1994,69232,65871,3361,4.9
"39023",39,23,1995,69893,66692,3201,4.6
"39023",39,23,1996,71070,66775,4295,6
"39023",39,23,1997,70115,66614,3501,5
"39023",39,23,1998,68421,65162,3259,4.8
"39023",39,23,1999,68195,64900,3295,4.8
"39023",39,23,2000,72332,69042,3290,4.5
"39023",39,23,2001,72761,69062,3699,5.1
"39023",39,23,2002,72346,67210,5136,7.1
"39023",39,23,2003,71491,66141,5350,7.5
"39023",39,23,2004,71065,66119,4946,7
"39023",39,23,2005,70529,65964,4565,6.5
"39023",39,23,2006,70943,66960,3983,5.6
"39023",39,23,2007,71363,66921,4442,6.2
"39023",39,23,2008,71071,66324,4747,6.7
"39023",39,23,2009,70525,63068,7457,10.6
"39023",39,23,2010,68266,60736,7530,11
"39023",39,23,2011,67537,61130,6407,9.5
"39023",39,23,2012,65847,60730,5117,7.8
"39023",39,23,2013,65934,60980,4954,7.5
"39023",39,23,2014,64963,61199,3764,5.8
"39023",39,23,2015,64075,60875,3200,5
"39023",39,23,2016,63662,60335,3327,5.2
"39023",39,23,2017,63813,60721,3092,4.8
"39025",39,25,1990,80131,76396,3735,4.7
"39025",39,25,1991,81768,77084,4684,5.7
"39025",39,25,1992,83684,78133,5551,6.6
"39025",39,25,1993,84792,79392,5400,6.4
"39025",39,25,1994,85271,81001,4270,5
"39025",39,25,1995,86703,82838,3865,4.5
"39025",39,25,1996,89749,85471,4278,4.8
"39025",39,25,1997,91978,87946,4032,4.4
"39025",39,25,1998,93141,89524,3617,3.9
"39025",39,25,1999,95145,91315,3830,4
"39025",39,25,2000,95365,91711,3654,3.8
"39025",39,25,2001,96639,92727,3912,4
"39025",39,25,2002,99069,93608,5461,5.5
"39025",39,25,2003,101096,95333,5763,5.7
"39025",39,25,2004,102842,96984,5858,5.7
"39025",39,25,2005,104576,98800,5776,5.5
"39025",39,25,2006,105489,100086,5403,5.1
"39025",39,25,2007,106078,100704,5374,5.1
"39025",39,25,2008,106546,100271,6275,5.9
"39025",39,25,2009,105666,95312,10354,9.8
"39025",39,25,2010,104819,93967,10852,10.4
"39025",39,25,2011,103615,94143,9472,9.1
"39025",39,25,2012,102086,94484,7602,7.4
"39025",39,25,2013,102499,94956,7543,7.4
"39025",39,25,2014,102563,96937,5626,5.5
"39025",39,25,2015,102671,98041,4630,4.5
"39025",39,25,2016,104053,99444,4609,4.4
"39025",39,25,2017,105450,100835,4615,4.4
"39027",39,27,1990,18134,17078,1056,5.8
"39027",39,27,1991,19260,18081,1179,6.1
"39027",39,27,1992,19526,18070,1456,7.5
"39027",39,27,1993,20116,18765,1351,6.7
"39027",39,27,1994,21302,20242,1060,5
"39027",39,27,1995,22686,21642,1044,4.6
"39027",39,27,1996,23358,22364,994,4.3
"39027",39,27,1997,24095,23213,882,3.7
"39027",39,27,1998,25228,24409,819,3.2
"39027",39,27,1999,25200,24280,920,3.7
"39027",39,27,2000,21890,21072,818,3.7
"39027",39,27,2001,21841,21031,810,3.7
"39027",39,27,2002,21743,20636,1107,5.1
"39027",39,27,2003,21962,20688,1274,5.8
"39027",39,27,2004,22013,20631,1382,6.3
"39027",39,27,2005,22687,21416,1271,5.6
"39027",39,27,2006,24232,23061,1171,4.8
"39027",39,27,2007,24450,23287,1163,4.8
"39027",39,27,2008,23409,21995,1414,6
"39027",39,27,2009,21051,17945,3106,14.8
"39027",39,27,2010,19250,15973,3277,17
"39027",39,27,2011,18047,15611,2436,13.5
"39027",39,27,2012,17282,15425,1857,10.7
"39027",39,27,2013,17092,15306,1786,10.4
"39027",39,27,2014,16942,15637,1305,7.7
"39027",39,27,2015,16685,15650,1035,6.2
"39027",39,27,2016,17192,16193,999,5.8
"39027",39,27,2017,17593,16636,957,5.4
"39029",39,29,1990,49001,46119,2882,5.9
"39029",39,29,1991,49577,46147,3430,6.9
"39029",39,29,1992,51132,46228,4904,9.6
"39029",39,29,1993,50774,46403,4371,8.6
"39029",39,29,1994,51244,47359,3885,7.6
"39029",39,29,1995,51570,48636,2934,5.7
"39029",39,29,1996,51967,48547,3420,6.6
"39029",39,29,1997,52573,49304,3269,6.2
"39029",39,29,1998,52385,49195,3190,6.1
"39029",39,29,1999,52660,49322,3338,6.3
"39029",39,29,2000,54311,51564,2747,5.1
"39029",39,29,2001,53804,50908,2896,5.4
"39029",39,29,2002,54061,50301,3760,7
"39029",39,29,2003,54640,50423,4217,7.7
"39029",39,29,2004,53724,49624,4100,7.6
"39029",39,29,2005,53636,49745,3891,7.3
"39029",39,29,2006,53486,50021,3465,6.5
"39029",39,29,2007,53532,50208,3324,6.2
"39029",39,29,2008,52927,49094,3833,7.2
"39029",39,29,2009,53111,45999,7112,13.4
"39029",39,29,2010,52880,46218,6662,12.6
"39029",39,29,2011,51859,46595,5264,10.2
"39029",39,29,2012,50892,46694,4198,8.2
"39029",39,29,2013,50566,46402,4164,8.2
"39029",39,29,2014,50091,46850,3241,6.5
"39029",39,29,2015,49382,46486,2896,5.9
"39029",39,29,2016,48444,45214,3230,6.7
"39029",39,29,2017,48018,45151,2867,6
"39031",39,31,1990,16391,15400,991,6
"39031",39,31,1991,16529,15303,1226,7.4
"39031",39,31,1992,16472,15088,1384,8.4
"39031",39,31,1993,16359,15212,1147,7
"39031",39,31,1994,16624,15604,1020,6.1
"39031",39,31,1995,16773,15787,986,5.9
"39031",39,31,1996,17231,16070,1161,6.7
"39031",39,31,1997,17603,16437,1166,6.6
"39031",39,31,1998,17631,16599,1032,5.9
"39031",39,31,1999,17677,16516,1161,6.6
"39031",39,31,2000,18220,17393,827,4.5
"39031",39,31,2001,17809,16855,954,5.4
"39031",39,31,2002,17821,16649,1172,6.6
"39031",39,31,2003,17918,16568,1350,7.5
"39031",39,31,2004,17754,16101,1653,9.3
"39031",39,31,2005,18109,16583,1526,8.4
"39031",39,31,2006,17633,16404,1229,7
"39031",39,31,2007,17513,16314,1199,6.8
"39031",39,31,2008,17172,15700,1472,8.6
"39031",39,31,2009,17072,14762,2310,13.5
"39031",39,31,2010,17471,15259,2212,12.7
"39031",39,31,2011,16799,14872,1927,11.5
"39031",39,31,2012,16205,14575,1630,10.1
"39031",39,31,2013,16354,14756,1598,9.8
"39031",39,31,2014,15771,14580,1191,7.6
"39031",39,31,2015,15850,14841,1009,6.4
"39031",39,31,2016,15013,13951,1062,7.1
"39031",39,31,2017,14775,13768,1007,6.8
"39033",39,33,1990,23661,21357,2304,9.7
"39033",39,33,1991,22544,20171,2373,10.5
"39033",39,33,1992,22684,20209,2475,10.9
"39033",39,33,1993,22496,20620,1876,8.3
"39033",39,33,1994,22390,20758,1632,7.3
"39033",39,33,1995,22452,21002,1450,6.5
"39033",39,33,1996,22362,20839,1523,6.8
"39033",39,33,1997,22211,20803,1408,6.3
"39033",39,33,1998,21739,20319,1420,6.5
"39033",39,33,1999,21649,20316,1333,6.2
"39033",39,33,2000,23491,22428,1063,4.5
"39033",39,33,2001,23655,22306,1349,5.7
"39033",39,33,2002,23148,21454,1694,7.3
"39033",39,33,2003,23113,21287,1826,7.9
"39033",39,33,2004,23074,21254,1820,7.9
"39033",39,33,2005,22847,21295,1552,6.8
"39033",39,33,2006,22663,21195,1468,6.5
"39033",39,33,2007,22347,20787,1560,7
"39033",39,33,2008,21916,20017,1899,8.7
"39033",39,33,2009,21828,18596,3232,14.8
"39033",39,33,2010,20960,18266,2694,12.9
"39033",39,33,2011,20800,18400,2400,11.5
"39033",39,33,2012,20305,18466,1839,9.1
"39033",39,33,2013,19717,17910,1807,9.2
"39033",39,33,2014,19580,18264,1316,6.7
"39033",39,33,2015,19074,17968,1106,5.8
"39033",39,33,2016,19193,18041,1152,6
"39033",39,33,2017,19020,17927,1093,5.7
"39035",39,35,1990,675615,642367,33248,4.9
"39035",39,35,1991,675737,634222,41515,6.1
"39035",39,35,1992,679623,630146,49477,7.3
"39035",39,35,1993,676029,631674,44355,6.6
"39035",39,35,1994,678266,640306,37960,5.6
"39035",39,35,1995,678774,649052,29722,4.4
"39035",39,35,1996,679410,653056,26354,3.9
"39035",39,35,1997,686534,661400,25134,3.7
"39035",39,35,1998,680825,662569,18256,2.7
"39035",39,35,1999,685224,664781,20443,3
"39035",39,35,2000,683667,664303,19364,2.8
"39035",39,35,2001,685478,660597,24881,3.6
"39035",39,35,2002,677818,642765,35053,5.2
"39035",39,35,2003,672890,634730,38160,5.7
"39035",39,35,2004,661974,625075,36899,5.6
"39035",39,35,2005,654861,619785,35076,5.4
"39035",39,35,2006,652395,619269,33126,5.1
"39035",39,35,2007,653686,616532,37154,5.7
"39035",39,35,2008,644172,604178,39994,6.2
"39035",39,35,2009,625607,571110,54497,8.7
"39035",39,35,2010,631675,577866,53809,8.5
"39035",39,35,2011,623251,576023,47228,7.6
"39035",39,35,2012,619168,577178,41990,6.8
"39035",39,35,2013,621938,578643,43295,7
"39035",39,35,2014,616481,578054,38427,6.2
"39035",39,35,2015,608690,577037,31653,5.2
"39035",39,35,2016,610404,576199,34205,5.6
"39035",39,35,2017,610874,575119,35755,5.9
"39037",39,37,1990,27567,25677,1890,6.9
"39037",39,37,1991,27488,25681,1807,6.6
"39037",39,37,1992,27872,25661,2211,7.9
"39037",39,37,1993,28347,26591,1756,6.2
"39037",39,37,1994,28908,27419,1489,5.2
"39037",39,37,1995,29164,27869,1295,4.4
"39037",39,37,1996,29372,27778,1594,5.4
"39037",39,37,1997,29745,28016,1729,5.8
"39037",39,37,1998,29074,27559,1515,5.2
"39037",39,37,1999,29474,27890,1584,5.4
"39037",39,37,2000,27872,26707,1165,4.2
"39037",39,37,2001,28210,27001,1209,4.3
"39037",39,37,2002,28488,26701,1787,6.3
"39037",39,37,2003,28802,26865,1937,6.7
"39037",39,37,2004,28241,26471,1770,6.3
"39037",39,37,2005,28345,26653,1692,6
"39037",39,37,2006,28034,26449,1585,5.7
"39037",39,37,2007,28313,26722,1591,5.6
"39037",39,37,2008,27925,26125,1800,6.4
"39037",39,37,2009,27879,24708,3171,11.4
"39037",39,37,2010,27050,24008,3042,11.2
"39037",39,37,2011,26655,24188,2467,9.3
"39037",39,37,2012,26561,24638,1923,7.2
"39037",39,37,2013,26400,24550,1850,7
"39037",39,37,2014,26133,24738,1395,5.3
"39037",39,37,2015,26215,25098,1117,4.3
"39037",39,37,2016,26412,25327,1085,4.1
"39037",39,37,2017,26452,25340,1112,4.2
"39039",39,39,1990,20837,19187,1650,7.9
"39039",39,39,1991,20756,18997,1759,8.5
"39039",39,39,1992,19290,17832,1458,7.6
"39039",39,39,1993,20265,18880,1385,6.8
"39039",39,39,1994,20435,19290,1145,5.6
"39039",39,39,1995,21056,20066,990,4.7
"39039",39,39,1996,21586,20598,988,4.6
"39039",39,39,1997,21581,20560,1021,4.7
"39039",39,39,1998,21464,20264,1200,5.6
"39039",39,39,1999,21161,20188,973,4.6
"39039",39,39,2000,21230,20400,830,3.9
"39039",39,39,2001,20907,19904,1003,4.8
"39039",39,39,2002,20822,19598,1224,5.9
"39039",39,39,2003,20664,19348,1316,6.4
"39039",39,39,2004,20665,19355,1310,6.3
"39039",39,39,2005,20579,19298,1281,6.2
"39039",39,39,2006,20665,19509,1156,5.6
"39039",39,39,2007,20795,19625,1170,5.6
"39039",39,39,2008,20647,19100,1547,7.5
"39039",39,39,2009,20396,17513,2883,14.1
"39039",39,39,2010,19971,17539,2432,12.2
"39039",39,39,2011,19246,17389,1857,9.6
"39039",39,39,2012,18986,17531,1455,7.7
"39039",39,39,2013,18938,17518,1420,7.5
"39039",39,39,2014,18949,17907,1042,5.5
"39039",39,39,2015,18671,17756,915,4.9
"39039",39,39,2016,18405,17499,906,4.9
"39039",39,39,2017,18498,17596,902,4.9
"39041",39,41,1990,36789,35535,1254,3.4
"39041",39,41,1991,37491,36103,1388,3.7
"39041",39,41,1992,38831,36911,1920,4.9
"39041",39,41,1993,40065,38069,1996,5
"39041",39,41,1994,41672,40154,1518,3.6
"39041",39,41,1995,43370,42028,1342,3.1
"39041",39,41,1996,46141,44388,1753,3.8
"39041",39,41,1997,48749,47313,1436,2.9
"39041",39,41,1998,54342,53248,1094,2
"39041",39,41,1999,58033,56875,1158,2
"39041",39,41,2000,62688,60924,1764,2.8
"39041",39,41,2001,67098,65195,1903,2.8
"39041",39,41,2002,71808,68823,2985,4.2
"39041",39,41,2003,75679,72317,3362,4.4
"39041",39,41,2004,79357,75789,3568,4.5
"39041",39,41,2005,83514,79828,3686,4.4
"39041",39,41,2006,87929,84491,3438,3.9
"39041",39,41,2007,90447,86843,3604,4
"39041",39,41,2008,92156,87875,4281,4.6
"39041",39,41,2009,91919,85436,6483,7.1
"39041",39,41,2010,94233,87407,6826,7.2
"39041",39,41,2011,95206,89265,5941,6.2
"39041",39,41,2012,95949,90968,4981,5.2
"39041",39,41,2013,98089,92856,5233,5.3
"39041",39,41,2014,100376,96246,4130,4.1
"39041",39,41,2015,102340,98729,3611,3.5
"39041",39,41,2016,105007,101224,3783,3.6
"39041",39,41,2017,106926,103168,3758,3.5
"39043",39,43,1990,41358,38761,2597,6.3
"39043",39,43,1991,42023,38957,3066,7.3
"39043",39,43,1992,43124,39615,3509,8.1
"39043",39,43,1993,42456,39617,2839,6.7
"39043",39,43,1994,43439,41141,2298,5.3
"39043",39,43,1995,42867,40657,2210,5.2
"39043",39,43,1996,42775,40352,2423,5.7
"39043",39,43,1997,43091,40724,2367,5.5
"39043",39,43,1998,41757,39497,2260,5.4
"39043",39,43,1999,41946,39961,1985,4.7
"39043",39,43,2000,42130,40250,1880,4.5
"39043",39,43,2001,42374,40364,2010,4.7
"39043",39,43,2002,43308,40806,2502,5.8
"39043",39,43,2003,43194,40477,2717,6.3
"39043",39,43,2004,42874,39995,2879,6.7
"39043",39,43,2005,42843,40061,2782,6.5
"39043",39,43,2006,43005,40484,2521,5.9
"39043",39,43,2007,42673,40097,2576,6
"39043",39,43,2008,42664,39548,3116,7.3
"39043",39,43,2009,42595,37578,5017,11.8
"39043",39,43,2010,40163,35632,4531,11.3
"39043",39,43,2011,39811,36025,3786,9.5
"39043",39,43,2012,38623,35530,3093,8
"39043",39,43,2013,38552,35423,3129,8.1
"39043",39,43,2014,37405,35001,2404,6.4
"39043",39,43,2015,37356,35288,2068,5.5
"39043",39,43,2016,37467,35418,2049,5.5
"39043",39,43,2017,37920,35571,2349,6.2
"39045",39,45,1990,53609,50831,2778,5.2
"39045",39,45,1991,54212,51172,3040,5.6
"39045",39,45,1992,55979,52566,3413,6.1
"39045",39,45,1993,57162,53792,3370,5.9
"39045",39,45,1994,58696,55783,2913,5
"39045",39,45,1995,60259,57924,2335,3.9
"39045",39,45,1996,61395,59046,2349,3.8
"39045",39,45,1997,63141,61000,2141,3.4
"39045",39,45,1998,64496,62377,2119,3.3
"39045",39,45,1999,66579,64522,2057,3.1
"39045",39,45,2000,65550,63292,2258,3.4
"39045",39,45,2001,67221,64880,2341,3.5
"39045",39,45,2002,69222,65610,3612,5.2
"39045",39,45,2003,70491,66557,3934,5.6
"39045",39,45,2004,72018,67850,4168,5.8
"39045",39,45,2005,73172,69143,4029,5.5
"39045",39,45,2006,74892,71278,3614,4.8
"39045",39,45,2007,75513,71734,3779,5
"39045",39,45,2008,75533,71208,4325,5.7
"39045",39,45,2009,74973,68431,6542,8.7
"39045",39,45,2010,74265,67429,6836,9.2
"39045",39,45,2011,73970,68017,5953,8
"39045",39,45,2012,73311,68444,4867,6.6
"39045",39,45,2013,74047,69122,4925,6.7
"39045",39,45,2014,74646,70768,3878,5.2
"39045",39,45,2015,74877,71619,3258,4.4
"39045",39,45,2016,76063,72786,3277,4.3
"39045",39,45,2017,77449,74149,3300,4.3
"39047",39,47,1990,13000,12080,920,7.1
"39047",39,47,1991,13242,12327,915,6.9
"39047",39,47,1992,13727,12594,1133,8.3
"39047",39,47,1993,14185,13241,944,6.7
"39047",39,47,1994,14654,13909,745,5.1
"39047",39,47,1995,14406,13589,817,5.7
"39047",39,47,1996,14114,13291,823,5.8
"39047",39,47,1997,14645,13871,774,5.3
"39047",39,47,1998,14803,14181,622,4.2
"39047",39,47,1999,15654,15012,642,4.1
"39047",39,47,2000,14934,14320,614,4.1
"39047",39,47,2001,15527,14894,633,4.1
"39047",39,47,2002,15445,14559,886,5.7
"39047",39,47,2003,15675,14767,908,5.8
"39047",39,47,2004,16035,15088,947,5.9
"39047",39,47,2005,15939,14998,941,5.9
"39047",39,47,2006,16416,15604,812,4.9
"39047",39,47,2007,16895,16084,811,4.8
"39047",39,47,2008,16950,15981,969,5.7
"39047",39,47,2009,16770,14891,1879,11.2
"39047",39,47,2010,14903,12951,1952,13.1
"39047",39,47,2011,14367,12857,1510,10.5
"39047",39,47,2012,14112,12942,1170,8.3
"39047",39,47,2013,14379,13276,1103,7.7
"39047",39,47,2014,14133,13285,848,6
"39047",39,47,2015,14022,13330,692,4.9
"39047",39,47,2016,14507,13867,640,4.4
"39047",39,47,2017,14479,13866,613,4.2
"39049",39,49,1990,535980,518232,17748,3.3
"39049",39,49,1991,537349,517061,20288,3.8
"39049",39,49,1992,548803,522945,25858,4.7
"39049",39,49,1993,552370,526661,25709,4.7
"39049",39,49,1994,558509,537504,21005,3.8
"39049",39,49,1995,564979,547576,17403,3.1
"39049",39,49,1996,568105,550320,17785,3.1
"39049",39,49,1997,577505,560779,16726,2.9
"39049",39,49,1998,581236,564728,16508,2.8
"39049",39,49,1999,591149,574854,16295,2.8
"39049",39,49,2000,593207,573832,19375,3.3
"39049",39,49,2001,599424,579080,20344,3.4
"39049",39,49,2002,604280,573565,30715,5.1
"39049",39,49,2003,602224,569021,33203,5.5
"39049",39,49,2004,600875,567016,33859,5.6
"39049",39,49,2005,601304,569067,32237,5.4
"39049",39,49,2006,609068,580184,28884,4.7
"39049",39,49,2007,622081,592795,29286,4.7
"39049",39,49,2008,624952,590436,34516,5.5
"39049",39,49,2009,624988,571996,52992,8.5
"39049",39,49,2010,626837,571204,55633,8.9
"39049",39,49,2011,627448,578794,48654,7.8
"39049",39,49,2012,630055,589581,40474,6.4
"39049",39,49,2013,638834,597678,41156,6.4
"39049",39,49,2014,647277,615751,31526,4.9
"39049",39,49,2015,655826,629006,26820,4.1
"39049",39,49,2016,667760,640325,27435,4.1
"39049",39,49,2017,680584,653209,27375,4
"39051",39,51,1990,20861,19238,1623,7.8
"39051",39,51,1991,20817,18931,1886,9.1
"39051",39,51,1992,21279,19288,1991,9.4
"39051",39,51,1993,21329,19829,1500,7
"39051",39,51,1994,21672,20498,1174,5.4
"39051",39,51,1995,22085,20858,1227,5.6
"39051",39,51,1996,22554,21293,1261,5.6
"39051",39,51,1997,22750,21573,1177,5.2
"39051",39,51,1998,22777,21832,945,4.1
"39051",39,51,1999,23403,22378,1025,4.4
"39051",39,51,2000,22674,21717,957,4.2
"39051",39,51,2001,22668,21649,1019,4.5
"39051",39,51,2002,22680,21324,1356,6
"39051",39,51,2003,22714,21175,1539,6.8
"39051",39,51,2004,22927,21419,1508,6.6
"39051",39,51,2005,23151,21702,1449,6.3
"39051",39,51,2006,23518,22120,1398,5.9
"39051",39,51,2007,23293,21825,1468,6.3
"39051",39,51,2008,23205,21313,1892,8.2
"39051",39,51,2009,22374,19254,3120,13.9
"39051",39,51,2010,23144,20405,2739,11.8
"39051",39,51,2011,22636,20456,2180,9.6
"39051",39,51,2012,22419,20685,1734,7.7
"39051",39,51,2013,22451,20669,1782,7.9
"39051",39,51,2014,22360,21039,1321,5.9
"39051",39,51,2015,22435,21342,1093,4.9
"39051",39,51,2016,22708,21655,1053,4.6
"39051",39,51,2017,22640,21533,1107,4.9
"39053",39,53,1990,13213,12145,1068,8.1
"39053",39,53,1991,13180,12001,1179,8.9
"39053",39,53,1992,13494,12105,1389,10.3
"39053",39,53,1993,13518,12273,1245,9.2
"39053",39,53,1994,13796,12644,1152,8.4
"39053",39,53,1995,13823,12575,1248,9
"39053",39,53,1996,13984,12659,1325,9.5
"39053",39,53,1997,14030,12788,1242,8.9
"39053",39,53,1998,14543,13252,1291,8.9
"39053",39,53,1999,15059,13726,1333,8.9
"39053",39,53,2000,13350,12381,969,7.3
"39053",39,53,2001,13354,12517,837,6.3
"39053",39,53,2002,14044,13015,1029,7.3
"39053",39,53,2003,14214,12991,1223,8.6
"39053",39,53,2004,14243,13045,1198,8.4
"39053",39,53,2005,14112,13069,1043,7.4
"39053",39,53,2006,14731,13827,904,6.1
"39053",39,53,2007,14506,13608,898,6.2
"39053",39,53,2008,14134,13207,927,6.6
"39053",39,53,2009,14162,12813,1349,9.5
"39053",39,53,2010,13585,11981,1604,11.8
"39053",39,53,2011,13034,11573,1461,11.2
"39053",39,53,2012,12647,11424,1223,9.7
"39053",39,53,2013,12514,11301,1213,9.7
"39053",39,53,2014,12404,11447,957,7.7
"39053",39,53,2015,12204,11412,792,6.5
"39053",39,53,2016,12142,11316,826,6.8
"39053",39,53,2017,12174,11356,818,6.7
"39055",39,55,1990,42389,40768,1621,3.8
"39055",39,55,1991,42619,40680,1939,4.5
"39055",39,55,1992,43421,40901,2520,5.8
"39055",39,55,1993,42691,40590,2101,4.9
"39055",39,55,1994,43624,41786,1838,4.2
"39055",39,55,1995,44408,42929,1479,3.3
"39055",39,55,1996,45574,44367,1207,2.6
"39055",39,55,1997,47056,45903,1153,2.5
"39055",39,55,1998,47646,46812,834,1.8
"39055",39,55,1999,48797,47803,994,2
"39055",39,55,2000,48560,47500,1060,2.2
"39055",39,55,2001,49185,47819,1366,2.8
"39055",39,55,2002,49223,47329,1894,3.8
"39055",39,55,2003,50086,47832,2254,4.5
"39055",39,55,2004,49918,47749,2169,4.3
"39055",39,55,2005,50378,48208,2170,4.3
"39055",39,55,2006,51232,49176,2056,4
"39055",39,55,2007,51658,49313,2345,4.5
"39055",39,55,2008,51190,48637,2553,5
"39055",39,55,2009,51956,48374,3582,6.9
"39055",39,55,2010,48975,45609,3366,6.9
"39055",39,55,2011,48654,45721,2933,6
"39055",39,55,2012,48839,46234,2605,5.3
"39055",39,55,2013,49259,46455,2804,5.7
"39055",39,55,2014,49092,46630,2462,5
"39055",39,55,2015,48668,46625,2043,4.2
"39055",39,55,2016,48901,46693,2208,4.5
"39055",39,55,2017,48802,46476,2326,4.8
"39057",39,57,1990,68360,65205,3155,4.6
"39057",39,57,1991,68030,64586,3444,5.1
"39057",39,57,1992,68062,64150,3912,5.7
"39057",39,57,1993,67165,63882,3283,4.9
"39057",39,57,1994,68213,65194,3019,4.4
"39057",39,57,1995,69008,66353,2655,3.8
"39057",39,57,1996,69003,66119,2884,4.2
"39057",39,57,1997,72554,69811,2743,3.8
"39057",39,57,1998,71728,69164,2564,3.6
"39057",39,57,1999,72207,69592,2615,3.6
"39057",39,57,2000,76254,73279,2975,3.9
"39057",39,57,2001,76389,73420,2969,3.9
"39057",39,57,2002,76970,73003,3967,5.2
"39057",39,57,2003,77289,72888,4401,5.7
"39057",39,57,2004,77361,72822,4539,5.9
"39057",39,57,2005,77375,72943,4432,5.7
"39057",39,57,2006,78300,74308,3992,5.1
"39057",39,57,2007,79675,75499,4176,5.2
"39057",39,57,2008,81005,75988,5017,6.2
"39057",39,57,2009,80186,72361,7825,9.8
"39057",39,57,2010,82080,74255,7825,9.5
"39057",39,57,2011,81800,75046,6754,8.3
"39057",39,57,2012,80619,75067,5552,6.9
"39057",39,57,2013,79411,73867,5544,7
"39057",39,57,2014,79707,75525,4182,5.2
"39057",39,57,2015,80377,76871,3506,4.4
"39057",39,57,2016,81210,77689,3521,4.3
"39057",39,57,2017,82142,78636,3506,4.3
"39059",39,59,1990,17916,16377,1539,8.6
"39059",39,59,1991,18242,16444,1798,9.9
"39059",39,59,1992,19462,16490,2972,15.3
"39059",39,59,1993,18461,16207,2254,12.2
"39059",39,59,1994,18288,16509,1779,9.7
"39059",39,59,1995,18296,16797,1499,8.2
"39059",39,59,1996,18617,16942,1675,9
"39059",39,59,1997,18924,17348,1576,8.3
"39059",39,59,1998,18908,17222,1686,8.9
"39059",39,59,1999,19044,17238,1806,9.5
"39059",39,59,2000,18702,17458,1244,6.7
"39059",39,59,2001,18758,17709,1049,5.6
"39059",39,59,2002,19638,18326,1312,6.7
"39059",39,59,2003,20041,18487,1554,7.8
"39059",39,59,2004,19993,18345,1648,8.2
"39059",39,59,2005,20036,18558,1478,7.4
"39059",39,59,2006,19852,18556,1296,6.5
"39059",39,59,2007,19889,18613,1276,6.4
"39059",39,59,2008,19589,17904,1685,8.6
"39059",39,59,2009,19486,17113,2373,12.2
"39059",39,59,2010,18856,16452,2404,12.7
"39059",39,59,2011,18474,16475,1999,10.8
"39059",39,59,2012,18227,16592,1635,9
"39059",39,59,2013,18546,16937,1609,8.7
"39059",39,59,2014,19087,17801,1286,6.7
"39059",39,59,2015,19200,18011,1189,6.2
"39059",39,59,2016,18912,17576,1336,7.1
"39059",39,59,2017,18907,17758,1149,6.1
"39061",39,61,1990,441153,423609,17544,4
"39061",39,61,1991,439913,419304,20609,4.7
"39061",39,61,1992,442285,416995,25290,5.7
"39061",39,61,1993,439491,414520,24971,5.7
"39061",39,61,1994,435381,414113,21268,4.9
"39061",39,61,1995,431475,413203,18272,4.2
"39061",39,61,1996,435571,416340,19231,4.4
"39061",39,61,1997,435648,418694,16954,3.9
"39061",39,61,1998,433758,417056,16702,3.9
"39061",39,61,1999,431922,415010,16912,3.9
"39061",39,61,2000,428312,411751,16561,3.9
"39061",39,61,2001,425528,408575,16953,4
"39061",39,61,2002,426298,402965,23333,5.5
"39061",39,61,2003,425099,401250,23849,5.6
"39061",39,61,2004,422070,397607,24463,5.8
"39061",39,61,2005,419952,396252,23700,5.6
"39061",39,61,2006,426496,404843,21653,5.1
"39061",39,61,2007,437604,415449,22155,5.1
"39061",39,61,2008,438951,414088,24863,5.7
"39061",39,61,2009,432467,393288,39179,9.1
"39061",39,61,2010,413738,372982,40756,9.9
"39061",39,61,2011,407539,371426,36113,8.9
"39061",39,61,2012,401987,372343,29644,7.4
"39061",39,61,2013,402433,373075,29358,7.3
"39061",39,61,2014,401401,379421,21980,5.5
"39061",39,61,2015,401449,383393,18056,4.5
"39061",39,61,2016,405509,387608,17901,4.4
"39061",39,61,2017,411260,393259,18001,4.4
"39063",39,63,1990,34982,33395,1587,4.5
"39063",39,63,1991,36109,34155,1954,5.4
"39063",39,63,1992,37909,35566,2343,6.2
"39063",39,63,1993,38413,36549,1864,4.9
"39063",39,63,1994,39045,37482,1563,4
"39063",39,63,1995,39833,38361,1472,3.7
"39063",39,63,1996,40222,38718,1504,3.7
"39063",39,63,1997,40521,39017,1504,3.7
"39063",39,63,1998,40746,39342,1404,3.4
"39063",39,63,1999,41954,40672,1282,3.1
"39063",39,63,2000,38955,37592,1363,3.5
"39063",39,63,2001,39042,37600,1442,3.7
"39063",39,63,2002,39380,37587,1793,4.6
"39063",39,63,2003,38888,36806,2082,5.4
"39063",39,63,2004,39580,37445,2135,5.4
"39063",39,63,2005,40240,38199,2041,5.1
"39063",39,63,2006,41276,39446,1830,4.4
"39063",39,63,2007,41600,39728,1872,4.5
"39063",39,63,2008,40861,38454,2407,5.9
"39063",39,63,2009,39965,35793,4172,10.4
"39063",39,63,2010,40457,36778,3679,9.1
"39063",39,63,2011,40075,36960,3115,7.8
"39063",39,63,2012,39785,37240,2545,6.4
"39063",39,63,2013,40198,37697,2501,6.2
"39063",39,63,2014,40435,38633,1802,4.5
"39063",39,63,2015,40755,39264,1491,3.7
"39063",39,63,2016,41522,39995,1527,3.7
"39063",39,63,2017,41822,40307,1515,3.6
"39065",39,65,1990,14684,13600,1084,7.4
"39065",39,65,1991,14346,12911,1435,10
"39065",39,65,1992,14504,13130,1374,9.5
"39065",39,65,1993,14689,13570,1119,7.6
"39065",39,65,1994,14447,13702,745,5.2
"39065",39,65,1995,15070,14311,759,5
"39065",39,65,1996,15182,14287,895,5.9
"39065",39,65,1997,15176,14348,828,5.5
"39065",39,65,1998,15410,14763,647,4.2
"39065",39,65,1999,15492,14896,596,3.8
"39065",39,65,2000,15733,15052,681,4.3
"39065",39,65,2001,15558,14815,743,4.8
"39065",39,65,2002,15608,14679,929,6
"39065",39,65,2003,15590,14595,995,6.4
"39065",39,65,2004,15870,14814,1056,6.7
"39065",39,65,2005,16247,15265,982,6
"39065",39,65,2006,15951,15056,895,5.6
"39065",39,65,2007,15806,14863,943,6
"39065",39,65,2008,15033,13951,1082,7.2
"39065",39,65,2009,15080,13231,1849,12.3
"39065",39,65,2010,15479,13745,1734,11.2
"39065",39,65,2011,15104,13663,1441,9.5
"39065",39,65,2012,14887,13776,1111,7.5
"39065",39,65,2013,14935,13783,1152,7.7
"39065",39,65,2014,15104,14240,864,5.7
"39065",39,65,2015,14495,13797,698,4.8
"39065",39,65,2016,14397,13680,717,5
"39065",39,65,2017,14371,13658,713,5
"39067",39,67,1990,6480,5938,542,8.4
"39067",39,67,1991,6496,5891,605,9.3
"39067",39,67,1992,6949,6269,680,9.8
"39067",39,67,1993,7435,6789,646,8.7
"39067",39,67,1994,7230,6698,532,7.4
"39067",39,67,1995,7017,6440,577,8.2
"39067",39,67,1996,7000,6399,601,8.6
"39067",39,67,1997,6788,6240,548,8.1
"39067",39,67,1998,6706,6282,424,6.3
"39067",39,67,1999,6807,6323,484,7.1
"39067",39,67,2000,7186,6795,391,5.4
"39067",39,67,2001,7383,7024,359,4.9
"39067",39,67,2002,7485,6966,519,6.9
"39067",39,67,2003,7403,6827,576,7.8
"39067",39,67,2004,7464,6911,553,7.4
"39067",39,67,2005,7531,7030,501,6.7
"39067",39,67,2006,7455,7007,448,6
"39067",39,67,2007,7417,6956,461,6.2
"39067",39,67,2008,7340,6812,528,7.2
"39067",39,67,2009,7293,6442,851,11.7
"39067",39,67,2010,7241,6337,904,12.5
"39067",39,67,2011,7026,6277,749,10.7
"39067",39,67,2012,6973,6377,596,8.5
"39067",39,67,2013,7290,6712,578,7.9
"39067",39,67,2014,7352,6907,445,6.1
"39067",39,67,2015,7184,6732,452,6.3
"39067",39,67,2016,6978,6446,532,7.6
"39067",39,67,2017,7116,6689,427,6
"39069",39,69,1990,15287,14138,1149,7.5
"39069",39,69,1991,15993,14845,1148,7.2
"39069",39,69,1992,16274,14916,1358,8.3
"39069",39,69,1993,16511,15182,1329,8
"39069",39,69,1994,16011,15040,971,6.1
"39069",39,69,1995,16089,15171,918,5.7
"39069",39,69,1996,16061,15254,807,5
"39069",39,69,1997,15773,14843,930,5.9
"39069",39,69,1998,15290,14394,896,5.9
"39069",39,69,1999,15884,14919,965,6.1
"39069",39,69,2000,15259,14571,688,4.5
"39069",39,69,2001,15221,14490,731,4.8
"39069",39,69,2002,15580,14627,953,6.1
"39069",39,69,2003,16001,14915,1086,6.8
"39069",39,69,2004,16058,15005,1053,6.6
"39069",39,69,2005,15891,14885,1006,6.3
"39069",39,69,2006,16149,15170,979,6.1
"39069",39,69,2007,15931,14929,1002,6.3
"39069",39,69,2008,15696,14447,1249,8
"39069",39,69,2009,15709,13579,2130,13.6
"39069",39,69,2010,14635,12725,1910,13.1
"39069",39,69,2011,14399,12856,1543,10.7
"39069",39,69,2012,14117,12882,1235,8.7
"39069",39,69,2013,14026,12787,1239,8.8
"39069",39,69,2014,13746,12857,889,6.5
"39069",39,69,2015,13547,12790,757,5.6
"39069",39,69,2016,13624,12897,727,5.3
"39069",39,69,2017,13655,12946,709,5.2
"39071",39,71,1990,16235,15017,1218,7.5
"39071",39,71,1991,16202,14649,1553,9.6
"39071",39,71,1992,17030,15427,1603,9.4
"39071",39,71,1993,16857,15476,1381,8.2
"39071",39,71,1994,17142,16046,1096,6.4
"39071",39,71,1995,17539,16446,1093,6.2
"39071",39,71,1996,18400,17090,1310,7.1
"39071",39,71,1997,19282,18046,1236,6.4
"39071",39,71,1998,19160,18101,1059,5.5
"39071",39,71,1999,19232,18212,1020,5.3
"39071",39,71,2000,19572,18673,899,4.6
"39071",39,71,2001,19458,18477,981,5
"39071",39,71,2002,20017,18802,1215,6.1
"39071",39,71,2003,20331,18999,1332,6.6
"39071",39,71,2004,20535,19189,1346,6.6
"39071",39,71,2005,20973,19704,1269,6.1
"39071",39,71,2006,21544,20336,1208,5.6
"39071",39,71,2007,21567,20287,1280,5.9
"39071",39,71,2008,20651,19120,1531,7.4
"39071",39,71,2009,20552,17362,3190,15.5
"39071",39,71,2010,19185,15869,3316,17.3
"39071",39,71,2011,18111,15675,2436,13.5
"39071",39,71,2012,17605,15771,1834,10.4
"39071",39,71,2013,17509,15674,1835,10.5
"39071",39,71,2014,17321,15976,1345,7.8
"39071",39,71,2015,16935,15858,1077,6.4
"39071",39,71,2016,16952,15879,1073,6.3
"39071",39,71,2017,17154,16126,1028,6
"39073",39,73,1990,11756,10695,1061,9
"39073",39,73,1991,11723,10572,1151,9.8
"39073",39,73,1992,11864,10640,1224,10.3
"39073",39,73,1993,12122,10853,1269,10.5
"39073",39,73,1994,12061,10931,1130,9.4
"39073",39,73,1995,12083,11142,941,7.8
"39073",39,73,1996,12605,11662,943,7.5
"39073",39,73,1997,12453,11649,804,6.5
"39073",39,73,1998,12215,11394,821,6.7
"39073",39,73,1999,11974,11033,941,7.9
"39073",39,73,2000,13165,12303,862,6.5
"39073",39,73,2001,13281,12537,744,5.6
"39073",39,73,2002,13585,12731,854,6.3
"39073",39,73,2003,13573,12567,1006,7.4
"39073",39,73,2004,13775,12665,1110,8.1
"39073",39,73,2005,13850,12783,1067,7.7
"39073",39,73,2006,14086,13211,875,6.2
"39073",39,73,2007,14229,13321,908,6.4
"39073",39,73,2008,14229,13143,1086,7.6
"39073",39,73,2009,14270,12652,1618,11.3
"39073",39,73,2010,14036,12399,1637,11.7
"39073",39,73,2011,13803,12430,1373,9.9
"39073",39,73,2012,13547,12427,1120,8.3
"39073",39,73,2013,13199,12129,1070,8.1
"39073",39,73,2014,13175,12323,852,6.5
"39073",39,73,2015,13011,12285,726,5.6
"39073",39,73,2016,13029,12303,726,5.6
"39073",39,73,2017,13251,12538,713,5.4
"39075",39,75,1990,14814,14176,638,4.3
"39075",39,75,1991,14850,14128,722,4.9
"39075",39,75,1992,15348,14599,749,4.9
"39075",39,75,1993,15951,15364,587,3.7
"39075",39,75,1994,17338,16744,594,3.4
"39075",39,75,1995,17915,17325,590,3.3
"39075",39,75,1996,18043,17326,717,4
"39075",39,75,1997,18048,17402,646,3.6
"39075",39,75,1998,18112,17512,600,3.3
"39075",39,75,1999,18748,18137,611,3.3
"39075",39,75,2000,17736,17202,534,3
"39075",39,75,2001,18125,17593,532,2.9
"39075",39,75,2002,18290,17583,707,3.9
"39075",39,75,2003,18379,17605,774,4.2
"39075",39,75,2004,19035,18218,817,4.3
"39075",39,75,2005,19868,19056,812,4.1
"39075",39,75,2006,19446,18702,744,3.8
"39075",39,75,2007,19739,18942,797,4
"39075",39,75,2008,19425,18471,954,4.9
"39075",39,75,2009,19186,17667,1519,7.9
"39075",39,75,2010,19295,17819,1476,7.6
"39075",39,75,2011,19592,18355,1237,6.3
"39075",39,75,2012,19745,18730,1015,5.1
"39075",39,75,2013,20046,19000,1046,5.2
"39075",39,75,2014,19895,19094,801,4
"39075",39,75,2015,20625,19920,705,3.4
"39075",39,75,2016,21022,20266,756,3.6
"39075",39,75,2017,20813,20074,739,3.6
"39077",39,77,1990,29331,26240,3091,10.5
"39077",39,77,1991,29562,26133,3429,11.6
"39077",39,77,1992,30030,26100,3930,13.1
"39077",39,77,1993,29288,25965,3323,11.3
"39077",39,77,1994,29370,26801,2569,8.7
"39077",39,77,1995,29859,27241,2618,8.8
"39077",39,77,1996,30280,27223,3057,10.1
"39077",39,77,1997,30032,27298,2734,9.1
"39077",39,77,1998,30085,27375,2710,9
"39077",39,77,1999,30180,27762,2418,8
"39077",39,77,2000,30703,28948,1755,5.7
"39077",39,77,2001,30562,28721,1841,6
"39077",39,77,2002,30519,28301,2218,7.3
"39077",39,77,2003,30317,27905,2412,8
"39077",39,77,2004,30033,27595,2438,8.1
"39077",39,77,2005,30269,27892,2377,7.9
"39077",39,77,2006,30156,27926,2230,7.4
"39077",39,77,2007,29739,27327,2412,8.1
"39077",39,77,2008,29024,26184,2840,9.8
"39077",39,77,2009,28765,24232,4533,15.8
"39077",39,77,2010,30287,26289,3998,13.2
"39077",39,77,2011,29709,26329,3380,11.4
"39077",39,77,2012,28946,26079,2867,9.9
"39077",39,77,2013,28662,25729,2933,10.2
"39077",39,77,2014,27879,25647,2232,8
"39077",39,77,2015,27611,25796,1815,6.6
"39077",39,77,2016,28152,26324,1828,6.5
"39077",39,77,2017,28075,26259,1816,6.5
"39079",39,79,1990,12262,11128,1134,9.2
"39079",39,79,1991,12883,11799,1084,8.4
"39079",39,79,1992,13375,12130,1245,9.3
"39079",39,79,1993,13752,12505,1247,9.1
"39079",39,79,1994,13812,12694,1118,8.1
"39079",39,79,1995,13950,12932,1018,7.3
"39079",39,79,1996,14120,12937,1183,8.4
"39079",39,79,1997,14328,13067,1261,8.8
"39079",39,79,1998,14397,13277,1120,7.8
"39079",39,79,1999,14481,13366,1115,7.7
"39079",39,79,2000,14473,13584,889,6.1
"39079",39,79,2001,14591,13624,967,6.6
"39079",39,79,2002,14967,13790,1177,7.9
"39079",39,79,2003,15117,13819,1298,8.6
"39079",39,79,2004,15276,13937,1339,8.8
"39079",39,79,2005,15864,14667,1197,7.5
"39079",39,79,2006,16042,14845,1197,7.5
"39079",39,79,2007,15922,14658,1264,7.9
"39079",39,79,2008,15265,13969,1296,8.5
"39079",39,79,2009,15421,13673,1748,11.3
"39079",39,79,2010,14300,12513,1787,12.5
"39079",39,79,2011,13966,12312,1654,11.8
"39079",39,79,2012,13718,12301,1417,10.3
"39079",39,79,2013,13604,12173,1431,10.5
"39079",39,79,2014,13220,12054,1166,8.8
"39079",39,79,2015,13047,12067,980,7.5
"39079",39,79,2016,12817,11812,1005,7.8
"39079",39,79,2017,12956,12030,926,7.1
"39081",39,81,1990,32647,30631,2016,6.2
"39081",39,81,1991,32245,29911,2334,7.2
"39081",39,81,1992,32419,29419,3000,9.3
"39081",39,81,1993,31964,28863,3101,9.7
"39081",39,81,1994,31611,28970,2641,8.4
"39081",39,81,1995,31055,28750,2305,7.4
"39081",39,81,1996,31697,28391,3306,10.4
"39081",39,81,1997,31530,27393,4137,13.1
"39081",39,81,1998,30363,28313,2050,6.8
"39081",39,81,1999,29821,27593,2228,7.5
"39081",39,81,2000,31742,29822,1920,6
"39081",39,81,2001,31774,29899,1875,5.9
"39081",39,81,2002,32200,29992,2208,6.9
"39081",39,81,2003,32631,30175,2456,7.5
"39081",39,81,2004,32222,29528,2694,8.4
"39081",39,81,2005,31747,29298,2449,7.7
"39081",39,81,2006,31741,29538,2203,6.9
"39081",39,81,2007,32008,29969,2039,6.4
"39081",39,81,2008,32856,30542,2314,7
"39081",39,81,2009,32809,28768,4041,12.3
"39081",39,81,2010,33335,28517,4818,14.5
"39081",39,81,2011,32004,28157,3847,12
"39081",39,81,2012,31258,27863,3395,10.9
"39081",39,81,2013,30601,27268,3333,10.9
"39081",39,81,2014,29784,27358,2426,8.1
"39081",39,81,2015,29383,27204,2179,7.4
"39081",39,81,2016,28940,26527,2413,8.3
"39081",39,81,2017,28373,26313,2060,7.3
"39083",39,83,1990,23646,22223,1423,6
"39083",39,83,1991,24424,22917,1507,6.2
"39083",39,83,1992,24890,23219,1671,6.7
"39083",39,83,1993,25668,24120,1548,6
"39083",39,83,1994,26645,25337,1308,4.9
"39083",39,83,1995,26945,25638,1307,4.9
"39083",39,83,1996,27795,26223,1572,5.7
"39083",39,83,1997,26536,25262,1274,4.8
"39083",39,83,1998,26538,25145,1393,5.2
"39083",39,83,1999,26226,24823,1403,5.3
"39083",39,83,2000,27415,26224,1191,4.3
"39083",39,83,2001,27966,26805,1161,4.2
"39083",39,83,2002,28491,26937,1554,5.5
"39083",39,83,2003,28529,26687,1842,6.5
"39083",39,83,2004,29288,27496,1792,6.1
"39083",39,83,2005,30265,28521,1744,5.8
"39083",39,83,2006,30667,29114,1553,5.1
"39083",39,83,2007,31128,29451,1677,5.4
"39083",39,83,2008,30198,28258,1940,6.4
"39083",39,83,2009,29987,27039,2948,9.8
"39083",39,83,2010,30913,27924,2989,9.7
"39083",39,83,2011,30505,27841,2664,8.7
"39083",39,83,2012,30142,28047,2095,7
"39083",39,83,2013,30388,28293,2095,6.9
"39083",39,83,2014,31116,29466,1650,5.3
"39083",39,83,2015,31227,29779,1448,4.6
"39083",39,83,2016,31275,29831,1444,4.6
"39083",39,83,2017,31269,29860,1409,4.5
"39085",39,85,1990,117340,111756,5584,4.8
"39085",39,85,1991,118455,111362,7093,6
"39085",39,85,1992,120369,111626,8743,7.3
"39085",39,85,1993,120602,112689,7913,6.6
"39085",39,85,1994,121463,115038,6425,5.3
"39085",39,85,1995,121326,116532,4794,4
"39085",39,85,1996,122812,118713,4099,3.3
"39085",39,85,1997,124755,121012,3743,3
"39085",39,85,1998,126571,123845,2726,2.2
"39085",39,85,1999,128489,125225,3264,2.5
"39085",39,85,2000,127624,124593,3031,2.4
"39085",39,85,2001,129787,125514,4273,3.3
"39085",39,85,2002,129724,123699,6025,4.6
"39085",39,85,2003,130203,123491,6712,5.2
"39085",39,85,2004,129601,123301,6300,4.9
"39085",39,85,2005,129690,123744,5946,4.6
"39085",39,85,2006,131566,125854,5712,4.3
"39085",39,85,2007,133810,127339,6471,4.8
"39085",39,85,2008,133375,126301,7074,5.3
"39085",39,85,2009,132148,121566,10582,8
"39085",39,85,2010,126272,116301,9971,7.9
"39085",39,85,2011,125191,116647,8544,6.8
"39085",39,85,2012,124495,117089,7406,5.9
"39085",39,85,2013,125690,117860,7830,6.2
"39085",39,85,2014,124573,117702,6871,5.5
"39085",39,85,2015,123466,117878,5588,4.5
"39085",39,85,2016,124192,118046,6146,4.9
"39085",39,85,2017,124193,117784,6409,5.2
"39087",39,87,1990,24980,23245,1735,6.9
"39087",39,87,1991,25231,23190,2041,8.1
"39087",39,87,1992,25698,23697,2001,7.8
"39087",39,87,1993,25760,23584,2176,8.4
"39087",39,87,1994,25769,23877,1892,7.3
"39087",39,87,1995,25820,24081,1739,6.7
"39087",39,87,1996,26270,24406,1864,7.1
"39087",39,87,1997,26535,24705,1830,6.9
"39087",39,87,1998,26745,24830,1915,7.2
"39087",39,87,1999,26968,24868,2100,7.8
"39087",39,87,2000,26178,24149,2029,7.8
"39087",39,87,2001,26161,24508,1653,6.3
"39087",39,87,2002,26987,25176,1811,6.7
"39087",39,87,2003,28201,26276,1925,6.8
"39087",39,87,2004,28357,26486,1871,6.6
"39087",39,87,2005,28685,26903,1782,6.2
"39087",39,87,2006,29158,27616,1542,5.3
"39087",39,87,2007,29601,28052,1549,5.2
"39087",39,87,2008,29399,27794,1605,5.5
"39087",39,87,2009,29156,26740,2416,8.3
"39087",39,87,2010,27703,24854,2849,10.3
"39087",39,87,2011,27088,24518,2570,9.5
"39087",39,87,2012,26501,24251,2250,8.5
"39087",39,87,2013,26127,23831,2296,8.8
"39087",39,87,2014,25837,24111,1726,6.7
"39087",39,87,2015,24897,23438,1459,5.9
"39087",39,87,2016,24783,23174,1609,6.5
"39087",39,87,2017,24732,23288,1444,5.8
"39089",39,89,1990,65945,62341,3604,5.5
"39089",39,89,1991,65937,62192,3745,5.7
"39089",39,89,1992,66849,62746,4103,6.1
"39089",39,89,1993,67206,63363,3843,5.7
"39089",39,89,1994,68184,65035,3149,4.6
"39089",39,89,1995,69486,66703,2783,4
"39089",39,89,1996,70280,67442,2838,4
"39089",39,89,1997,70208,67280,2928,4.2
"39089",39,89,1998,70275,67215,3060,4.4
"39089",39,89,1999,71666,68772,2894,4
"39089",39,89,2000,77423,74446,2977,3.8
"39089",39,89,2001,78370,75313,3057,3.9
"39089",39,89,2002,79159,75021,4138,5.2
"39089",39,89,2003,80165,75174,4991,6.2
"39089",39,89,2004,80864,75818,5046,6.2
"39089",39,89,2005,81708,76862,4846,5.9
"39089",39,89,2006,83022,78759,4263,5.1
"39089",39,89,2007,83633,79207,4426,5.3
"39089",39,89,2008,83686,78494,5192,6.2
"39089",39,89,2009,82964,75014,7950,9.6
"39089",39,89,2010,87551,79133,8418,9.6
"39089",39,89,2011,86838,79550,7288,8.4
"39089",39,89,2012,86002,80186,5816,6.8
"39089",39,89,2013,86490,80506,5984,6.9
"39089",39,89,2014,86626,82072,4554,5.3
"39089",39,89,2015,86932,83077,3855,4.4
"39089",39,89,2016,88372,84507,3865,4.4
"39089",39,89,2017,89801,86043,3758,4.2
"39091",39,91,1990,21143,19906,1237,5.9
"39091",39,91,1991,21826,20395,1431,6.6
"39091",39,91,1992,22364,20722,1642,7.3
"39091",39,91,1993,22808,21143,1665,7.3
"39091",39,91,1994,23547,22429,1118,4.7
"39091",39,91,1995,24093,23075,1018,4.2
"39091",39,91,1996,26357,25138,1219,4.6
"39091",39,91,1997,26736,25556,1180,4.4
"39091",39,91,1998,26494,25528,966,3.6
"39091",39,91,1999,28316,27436,880,3.1
"39091",39,91,2000,24142,23229,913,3.8
"39091",39,91,2001,24305,23393,912,3.8
"39091",39,91,2002,24451,23107,1344,5.5
"39091",39,91,2003,24473,23121,1352,5.5
"39091",39,91,2004,24443,23044,1399,5.7
"39091",39,91,2005,24671,23355,1316,5.3
"39091",39,91,2006,24971,23804,1167,4.7
"39091",39,91,2007,25324,24067,1257,5
"39091",39,91,2008,25299,23773,1526,6
"39091",39,91,2009,24625,21673,2952,12
"39091",39,91,2010,23346,20589,2757,11.8
"39091",39,91,2011,22851,20621,2230,9.8
"39091",39,91,2012,22594,20979,1615,7.1
"39091",39,91,2013,23045,21468,1577,6.8
"39091",39,91,2014,23079,21918,1161,5
"39091",39,91,2015,23096,22124,972,4.2
"39091",39,91,2016,23355,22379,976,4.2
"39091",39,91,2017,23540,22571,969,4.1
"39093",39,93,1990,134546,125116,9430,7
"39093",39,93,1991,136831,124550,12281,9
"39093",39,93,1992,136991,124878,12113,8.8
"39093",39,93,1993,134728,126233,8495,6.3
"39093",39,93,1994,136893,129274,7619,5.6
"39093",39,93,1995,138605,130761,7844,5.7
"39093",39,93,1996,139815,133081,6734,4.8
"39093",39,93,1997,142189,135936,6253,4.4
"39093",39,93,1998,141270,136859,4411,3.1
"39093",39,93,1999,142834,138377,4457,3.1
"39093",39,93,2000,146681,142440,4241,2.9
"39093",39,93,2001,148983,143021,5962,4
"39093",39,93,2002,148862,141188,7674,5.2
"39093",39,93,2003,150844,142286,8558,5.7
"39093",39,93,2004,150249,142335,7914,5.3
"39093",39,93,2005,151819,143928,7891,5.2
"39093",39,93,2006,157117,148919,8198,5.2
"39093",39,93,2007,159594,150486,9108,5.7
"39093",39,93,2008,160099,149893,10206,6.4
"39093",39,93,2009,158356,143227,15129,9.6
"39093",39,93,2010,151082,137293,13789,9.1
"39093",39,93,2011,149725,137981,11744,7.8
"39093",39,93,2012,149175,138642,10533,7.1
"39093",39,93,2013,151036,139963,11073,7.3
"39093",39,93,2014,150438,140777,9661,6.4
"39093",39,93,2015,149794,141416,8378,5.6
"39093",39,93,2016,151827,142631,9196,6.1
"39093",39,93,2017,151638,142277,9361,6.2
"39095",39,95,1990,229705,211121,18584,8.1
"39095",39,95,1991,226492,205106,21386,9.4
"39095",39,95,1992,224831,205228,19603,8.7
"39095",39,95,1993,224765,208713,16052,7.1
"39095",39,95,1994,227579,214001,13578,6
"39095",39,95,1995,225062,213130,11932,5.3
"39095",39,95,1996,226969,214599,12370,5.5
"39095",39,95,1997,227611,214971,12640,5.6
"39095",39,95,1998,228565,214713,13852,6.1
"39095",39,95,1999,230043,216939,13104,5.7
"39095",39,95,2000,227177,216358,10819,4.8
"39095",39,95,2001,226796,215491,11305,5
"39095",39,95,2002,226970,211179,15791,7
"39095",39,95,2003,226158,208751,17407,7.7
"39095",39,95,2004,225175,207930,17245,7.7
"39095",39,95,2005,224694,209027,15667,7
"39095",39,95,2006,226280,211928,14352,6.3
"39095",39,95,2007,224338,209175,15163,6.8
"39095",39,95,2008,222286,203962,18324,8.2
"39095",39,95,2009,221862,194268,27594,12.4
"39095",39,95,2010,217424,192330,25094,11.5
"39095",39,95,2011,213380,192278,21102,9.9
"39095",39,95,2012,210372,192835,17537,8.3
"39095",39,95,2013,210736,192447,18289,8.7
"39095",39,95,2014,208834,195419,13415,6.4
"39095",39,95,2015,208736,197666,11070,5.3
"39095",39,95,2016,210702,199811,10891,5.2
"39095",39,95,2017,211724,199256,12468,5.9
"39097",39,97,1990,17962,17210,752,4.2
"39097",39,97,1991,18167,17286,881,4.8
"39097",39,97,1992,18790,17720,1070,5.7
"39097",39,97,1993,19260,17937,1323,6.9
"39097",39,97,1994,19434,18622,812,4.2
"39097",39,97,1995,19787,19166,621,3.1
"39097",39,97,1996,19964,19298,666,3.3
"39097",39,97,1997,20280,19656,624,3.1
"39097",39,97,1998,20181,19603,578,2.9
"39097",39,97,1999,20531,19959,572,2.8
"39097",39,97,2000,19333,18644,689,3.6
"39097",39,97,2001,19401,18688,713,3.7
"39097",39,97,2002,19547,18533,1014,5.2
"39097",39,97,2003,19591,18454,1137,5.8
"39097",39,97,2004,19714,18505,1209,6.1
"39097",39,97,2005,19828,18647,1181,6
"39097",39,97,2006,20078,19019,1059,5.3
"39097",39,97,2007,20097,19043,1054,5.2
"39097",39,97,2008,20202,18947,1255,6.2
"39097",39,97,2009,20235,18311,1924,9.5
"39097",39,97,2010,20665,18800,1865,9
"39097",39,97,2011,20331,18723,1608,7.9
"39097",39,97,2012,20082,18800,1282,6.4
"39097",39,97,2013,20234,18968,1266,6.3
"39097",39,97,2014,20453,19482,971,4.7
"39097",39,97,2015,20496,19670,826,4
"39097",39,97,2016,20367,19567,800,3.9
"39097",39,97,2017,20674,19880,794,3.8
"39099",39,99,1990,119042,110460,8582,7.2
"39099",39,99,1991,117737,109509,8228,7
"39099",39,99,1992,120444,108993,11451,9.5
"39099",39,99,1993,118991,108664,10327,8.7
"39099",39,99,1994,120158,109964,10194,8.5
"39099",39,99,1995,120037,111994,8043,6.7
"39099",39,99,1996,119347,110879,8468,7.1
"39099",39,99,1997,119564,111676,7888,6.6
"39099",39,99,1998,118684,110544,8140,6.9
"39099",39,99,1999,116836,109763,7073,6.1
"39099",39,99,2000,120261,113808,6453,5.4
"39099",39,99,2001,118315,111505,6810,5.8
"39099",39,99,2002,118781,110247,8534,7.2
"39099",39,99,2003,118721,109601,9120,7.7
"39099",39,99,2004,119878,110566,9312,7.8
"39099",39,99,2005,119944,111451,8493,7.1
"39099",39,99,2006,120024,112304,7720,6.4
"39099",39,99,2007,117091,109793,7298,6.2
"39099",39,99,2008,115824,107545,8279,7.1
"39099",39,99,2009,115543,101026,14517,12.6
"39099",39,99,2010,115100,101612,13488,11.7
"39099",39,99,2011,112957,101863,11094,9.8
"39099",39,99,2012,110705,101514,9191,8.3
"39099",39,99,2013,109548,100196,9352,8.5
"39099",39,99,2014,107951,100696,7255,6.7
"39099",39,99,2015,106925,100417,6508,6.1
"39099",39,99,2016,106092,99332,6760,6.4
"39099",39,99,2017,105154,97890,7264,6.9
"39101",39,101,1990,30566,28129,2437,8
"39101",39,101,1991,30525,28050,2475,8.1
"39101",39,101,1992,31725,29054,2671,8.4
"39101",39,101,1993,31399,29025,2374,7.6
"39101",39,101,1994,31810,29940,1870,5.9
"39101",39,101,1995,32827,30798,2029,6.2
"39101",39,101,1996,33013,30752,2261,6.8
"39101",39,101,1997,32431,30511,1920,5.9
"39101",39,101,1998,31591,30097,1494,4.7
"39101",39,101,1999,31381,30072,1309,4.2
"39101",39,101,2000,31762,30368,1394,4.4
"39101",39,101,2001,32024,30552,1472,4.6
"39101",39,101,2002,32328,30456,1872,5.8
"39101",39,101,2003,31918,29868,2050,6.4
"39101",39,101,2004,32103,29911,2192,6.8
"39101",39,101,2005,32193,30160,2033,6.3
"39101",39,101,2006,32431,30675,1756,5.4
"39101",39,101,2007,32970,31165,1805,5.5
"39101",39,101,2008,32555,30274,2281,7
"39101",39,101,2009,31589,27963,3626,11.5
"39101",39,101,2010,30255,26938,3317,11
"39101",39,101,2011,29582,26662,2920,9.9
"39101",39,101,2012,28880,26595,2285,7.9
"39101",39,101,2013,28132,25909,2223,7.9
"39101",39,101,2014,27860,26186,1674,6
"39101",39,101,2015,27771,26351,1420,5.1
"39101",39,101,2016,27778,26370,1408,5.1
"39101",39,101,2017,28031,26604,1427,5.1
"39103",39,103,1990,64888,61969,2919,4.5
"39103",39,103,1991,66224,62420,3804,5.7
"39103",39,103,1992,67958,63436,4522,6.7
"39103",39,103,1993,68642,64947,3695,5.4
"39103",39,103,1994,70644,67336,3308,4.7
"39103",39,103,1995,72222,69514,2708,3.7
"39103",39,103,1996,74422,71983,2439,3.3
"39103",39,103,1997,76959,74719,2240,2.9
"39103",39,103,1998,78054,76512,1542,2
"39103",39,103,1999,80984,79093,1891,2.3
"39103",39,103,2000,83930,82024,1906,2.3
"39103",39,103,2001,86298,83689,2609,3
"39103",39,103,2002,87628,83959,3669,4.2
"39103",39,103,2003,89523,85303,4220,4.7
"39103",39,103,2004,90461,86365,4096,4.5
"39103",39,103,2005,91736,87733,4003,4.4
"39103",39,103,2006,94369,90314,4055,4.3
"39103",39,103,2007,96074,91442,4632,4.8
"39103",39,103,2008,96274,91183,5091,5.3
"39103",39,103,2009,95582,88179,7403,7.7
"39103",39,103,2010,94041,87055,6986,7.4
"39103",39,103,2011,93801,87823,5978,6.4
"39103",39,103,2012,93623,88480,5143,5.5
"39103",39,103,2013,95022,89543,5479,5.8
"39103",39,103,2014,94993,90211,4782,5
"39103",39,103,2015,94463,90539,3924,4.2
"39103",39,103,2016,95599,91345,4254,4.4
"39103",39,103,2017,95615,91089,4526,4.7
"39105",39,105,1990,8635,7981,654,7.6
"39105",39,105,1991,8664,7848,816,9.4
"39105",39,105,1992,8812,7703,1109,12.6
"39105",39,105,1993,8494,7498,996,11.7
"39105",39,105,1994,8543,7611,932,10.9
"39105",39,105,1995,8728,7712,1016,11.6
"39105",39,105,1996,8651,7633,1018,11.8
"39105",39,105,1997,8599,7655,944,11
"39105",39,105,1998,8579,7569,1010,11.8
"39105",39,105,1999,8509,7453,1056,12.4
"39105",39,105,2000,9842,9095,747,7.6
"39105",39,105,2001,9774,9099,675,6.9
"39105",39,105,2002,9524,8658,866,9.1
"39105",39,105,2003,9210,8150,1060,11.5
"39105",39,105,2004,9075,8062,1013,11.2
"39105",39,105,2005,9068,8153,915,10.1
"39105",39,105,2006,9189,8418,771,8.4
"39105",39,105,2007,9274,8446,828,8.9
"39105",39,105,2008,9143,8225,918,10
"39105",39,105,2009,9383,7984,1399,14.9
"39105",39,105,2010,10050,8580,1470,14.6
"39105",39,105,2011,9814,8524,1290,13.1
"39105",39,105,2012,9502,8404,1098,11.6
"39105",39,105,2013,9414,8297,1117,11.9
"39105",39,105,2014,9184,8355,829,9
"39105",39,105,2015,9093,8345,748,8.2
"39105",39,105,2016,8964,8201,763,8.5
"39105",39,105,2017,8970,8239,731,8.1
"39107",39,107,1990,20061,18947,1114,5.6
"39107",39,107,1991,20023,18885,1138,5.7
"39107",39,107,1992,20279,18548,1731,8.5
"39107",39,107,1993,20189,18668,1521,7.5
"39107",39,107,1994,20579,19002,1577,7.7
"39107",39,107,1995,20939,18991,1948,9.3
"39107",39,107,1996,20400,18711,1689,8.3
"39107",39,107,1997,19880,18758,1122,5.6
"39107",39,107,1998,20174,18597,1577,7.8
"39107",39,107,1999,19920,18203,1717,8.6
"39107",39,107,2000,21712,20790,922,4.2
"39107",39,107,2001,21778,20795,983,4.5
"39107",39,107,2002,22104,20944,1160,5.2
"39107",39,107,2003,22228,21174,1054,4.7
"39107",39,107,2004,23032,21952,1080,4.7
"39107",39,107,2005,23806,22826,980,4.1
"39107",39,107,2006,24198,23290,908,3.8
"39107",39,107,2007,24591,23648,943,3.8
"39107",39,107,2008,24713,23497,1216,4.9
"39107",39,107,2009,24331,22149,2182,9
"39107",39,107,2010,22324,20435,1889,8.5
"39107",39,107,2011,22180,20683,1497,6.7
"39107",39,107,2012,22129,20999,1130,5.1
"39107",39,107,2013,22395,21248,1147,5.1
"39107",39,107,2014,22651,21787,864,3.8
"39107",39,107,2015,23003,22250,753,3.3
"39107",39,107,2016,23460,22695,765,3.3
"39107",39,107,2017,23707,22978,729,3.1
"39109",39,109,1990,49502,46593,2909,5.9
"39109",39,109,1991,49122,46063,3059,6.2
"39109",39,109,1992,49213,45847,3366,6.8
"39109",39,109,1993,49086,46041,3045,6.2
"39109",39,109,1994,49270,47181,2089,4.2
"39109",39,109,1995,49817,47917,1900,3.8
"39109",39,109,1996,50452,48191,2261,4.5
"39109",39,109,1997,51115,48762,2353,4.6
"39109",39,109,1998,50254,48244,2010,4
"39109",39,109,1999,50534,48403,2131,4.2
"39109",39,109,2000,53886,51893,1993,3.7
"39109",39,109,2001,54304,51978,2326,4.3
"39109",39,109,2002,54558,51463,3095,5.7
"39109",39,109,2003,54645,51292,3353,6.1
"39109",39,109,2004,54435,51183,3252,6
"39109",39,109,2005,54855,51691,3164,5.8
"39109",39,109,2006,55727,52706,3021,5.4
"39109",39,109,2007,55278,52280,2998,5.4
"39109",39,109,2008,54648,51145,3503,6.4
"39109",39,109,2009,55116,48592,6524,11.8
"39109",39,109,2010,54400,48365,6035,11.1
"39109",39,109,2011,53466,48585,4881,9.1
"39109",39,109,2012,52314,48510,3804,7.3
"39109",39,109,2013,51861,48121,3740,7.2
"39109",39,109,2014,52052,49240,2812,5.4
"39109",39,109,2015,52393,50091,2302,4.4
"39109",39,109,2016,53087,50779,2308,4.3
"39109",39,109,2017,53691,51411,2280,4.2
"39111",39,111,1990,6150,5616,534,8.7
"39111",39,111,1991,6149,5554,595,9.7
"39111",39,111,1992,6313,5545,768,12.2
"39111",39,111,1993,6338,5588,750,11.8
"39111",39,111,1994,6193,5598,595,9.6
"39111",39,111,1995,6110,5499,611,10
"39111",39,111,1996,6139,5420,719,11.7
"39111",39,111,1997,6087,5446,641,10.5
"39111",39,111,1998,6007,5417,590,9.8
"39111",39,111,1999,5901,5290,611,10.4
"39111",39,111,2000,6348,5874,474,7.5
"39111",39,111,2001,6022,5641,381,6.3
"39111",39,111,2002,6112,5630,482,7.9
"39111",39,111,2003,6090,5570,520,8.5
"39111",39,111,2004,6098,5411,687,11.3
"39111",39,111,2005,5483,4741,742,13.5
"39111",39,111,2006,5169,4592,577,11.2
"39111",39,111,2007,5571,5116,455,8.2
"39111",39,111,2008,5710,5222,488,8.5
"39111",39,111,2009,5664,4943,721,12.7
"39111",39,111,2010,6675,5858,817,12.2
"39111",39,111,2011,6600,5949,651,9.9
"39111",39,111,2012,6492,5947,545,8.4
"39111",39,111,2013,6483,5835,648,10
"39111",39,111,2014,5874,5226,648,11
"39111",39,111,2015,5541,4990,551,9.9
"39111",39,111,2016,5326,4735,591,11.1
"39111",39,111,2017,5152,4713,439,8.5
"39113",39,113,1990,289826,275172,14654,5.1
"39113",39,113,1991,286866,270466,16400,5.7
"39113",39,113,1992,286106,267475,18631,6.5
"39113",39,113,1993,281547,265839,15708,5.6
"39113",39,113,1994,282538,268696,13842,4.9
"39113",39,113,1995,282193,270372,11821,4.2
"39113",39,113,1996,282949,269616,13333,4.7
"39113",39,113,1997,281119,269001,12118,4.3
"39113",39,113,1998,281475,268843,12632,4.5
"39113",39,113,1999,277890,266310,11580,4.2
"39113",39,113,2000,279370,267628,11742,4.2
"39113",39,113,2001,278640,265836,12804,4.6
"39113",39,113,2002,278053,261155,16898,6.1
"39113",39,113,2003,276809,258382,18427,6.7
"39113",39,113,2004,273746,255120,18626,6.8
"39113",39,113,2005,272233,254552,17681,6.5
"39113",39,113,2006,272814,256344,16470,6
"39113",39,113,2007,271298,254523,16775,6.2
"39113",39,113,2008,267232,247269,19963,7.5
"39113",39,113,2009,264387,233627,30760,11.6
"39113",39,113,2010,265355,235205,30150,11.4
"39113",39,113,2011,260110,234828,25282,9.7
"39113",39,113,2012,254447,233575,20872,8.2
"39113",39,113,2013,251314,230464,20850,8.3
"39113",39,113,2014,249014,233702,15312,6.1
"39113",39,113,2015,249052,236593,12459,5
"39113",39,113,2016,250398,238072,12326,4.9
"39113",39,113,2017,253576,241211,12365,4.9
"39115",39,115,1990,5685,5154,531,9.3
"39115",39,115,1991,5817,5237,580,10
"39115",39,115,1992,5744,4993,751,13.1
"39115",39,115,1993,5490,4791,699,12.7
"39115",39,115,1994,5142,4465,677,13.2
"39115",39,115,1995,5131,4430,701,13.7
"39115",39,115,1996,4981,4199,782,15.7
"39115",39,115,1997,4946,4293,653,13.2
"39115",39,115,1998,4958,4229,729,14.7
"39115",39,115,1999,4752,4019,733,15.4
"39115",39,115,2000,6608,6146,462,7
"39115",39,115,2001,6681,6125,556,8.3
"39115",39,115,2002,6652,6052,600,9
"39115",39,115,2003,6542,5869,673,10.3
"39115",39,115,2004,6377,5683,694,10.9
"39115",39,115,2005,6213,5580,633,10.2
"39115",39,115,2006,5754,5228,526,9.1
"39115",39,115,2007,5757,5220,537,9.3
"39115",39,115,2008,5811,5216,595,10.2
"39115",39,115,2009,6004,5128,876,14.6
"39115",39,115,2010,6865,5949,916,13.3
"39115",39,115,2011,6788,6016,772,11.4
"39115",39,115,2012,6698,6035,663,9.9
"39115",39,115,2013,6692,6017,675,10.1
"39115",39,115,2014,6666,6145,521,7.8
"39115",39,115,2015,6703,6214,489,7.3
"39115",39,115,2016,6761,6201,560,8.3
"39115",39,115,2017,6675,6218,457,6.8
"39117",39,117,1990,13925,13015,910,6.5
"39117",39,117,1991,13465,12402,1063,7.9
"39117",39,117,1992,13442,12246,1196,8.9
"39117",39,117,1993,13853,12847,1006,7.3
"39117",39,117,1994,14106,13256,850,6
"39117",39,117,1995,13540,12714,826,6.1
"39117",39,117,1996,13535,12515,1020,7.5
"39117",39,117,1997,13441,12559,882,6.6
"39117",39,117,1998,13629,12784,845,6.2
"39117",39,117,1999,14199,13391,808,5.7
"39117",39,117,2000,16437,15787,650,4
"39117",39,117,2001,17036,16187,849,5
"39117",39,117,2002,17138,16194,944,5.5
"39117",39,117,2003,17413,16298,1115,6.4
"39117",39,117,2004,17591,16468,1123,6.4
"39117",39,117,2005,17738,16597,1141,6.4
"39117",39,117,2006,17968,16946,1022,5.7
"39117",39,117,2007,18013,16963,1050,5.8
"39117",39,117,2008,17970,16701,1269,7.1
"39117",39,117,2009,17985,15968,2017,11.2
"39117",39,117,2010,17309,15334,1975,11.4
"39117",39,117,2011,17138,15402,1736,10.1
"39117",39,117,2012,16894,15521,1373,8.1
"39117",39,117,2013,16896,15539,1357,8
"39117",39,117,2014,16797,15795,1002,6
"39117",39,117,2015,16684,15844,840,5
"39117",39,117,2016,16790,15944,846,5
"39117",39,117,2017,17053,16222,831,4.9
"39119",39,119,1990,40319,36475,3844,9.5
"39119",39,119,1991,39427,35446,3981,10.1
"39119",39,119,1992,40761,36568,4193,10.3
"39119",39,119,1993,41399,37635,3764,9.1
"39119",39,119,1994,41701,38327,3374,8.1
"39119",39,119,1995,42416,39222,3194,7.5
"39119",39,119,1996,42144,38544,3600,8.5
"39119",39,119,1997,41991,38697,3294,7.8
"39119",39,119,1998,42428,39467,2961,7
"39119",39,119,1999,43197,40066,3131,7.2
"39119",39,119,2000,42085,39785,2300,5.5
"39119",39,119,2001,42158,39735,2423,5.7
"39119",39,119,2002,42146,39275,2871,6.8
"39119",39,119,2003,41946,38734,3212,7.7
"39119",39,119,2004,41186,37624,3562,8.6
"39119",39,119,2005,40214,36782,3432,8.5
"39119",39,119,2006,39321,36499,2822,7.2
"39119",39,119,2007,39097,36062,3035,7.8
"39119",39,119,2008,38401,35078,3323,8.7
"39119",39,119,2009,38658,33766,4892,12.7
"39119",39,119,2010,41656,36417,5239,12.6
"39119",39,119,2011,41313,36810,4503,10.9
"39119",39,119,2012,40358,36657,3701,9.2
"39119",39,119,2013,39959,36308,3651,9.1
"39119",39,119,2014,39338,36535,2803,7.1
"39119",39,119,2015,38798,36393,2405,6.2
"39119",39,119,2016,39787,37396,2391,6
"39119",39,119,2017,39699,37426,2273,5.7
"39121",39,121,1990,4885,4507,378,7.7
"39121",39,121,1991,5066,4593,473,9.3
"39121",39,121,1992,5209,4608,601,11.5
"39121",39,121,1993,5056,4571,485,9.6
"39121",39,121,1994,5098,4634,464,9.1
"39121",39,121,1995,5203,4768,435,8.4
"39121",39,121,1996,5198,4775,423,8.1
"39121",39,121,1997,5355,4964,391,7.3
"39121",39,121,1998,5526,5070,456,8.3
"39121",39,121,1999,5598,5100,498,8.9
"39121",39,121,2000,5655,5276,379,6.7
"39121",39,121,2001,5737,5411,326,5.7
"39121",39,121,2002,5810,5382,428,7.4
"39121",39,121,2003,5873,5351,522,8.9
"39121",39,121,2004,5791,5273,518,8.9
"39121",39,121,2005,5907,5412,495,8.4
"39121",39,121,2006,5886,5462,424,7.2
"39121",39,121,2007,5830,5399,431,7.4
"39121",39,121,2008,5835,5336,499,8.6
"39121",39,121,2009,5863,5011,852,14.5
"39121",39,121,2010,5223,4387,836,16
"39121",39,121,2011,4989,4323,666,13.3
"39121",39,121,2012,4779,4253,526,11
"39121",39,121,2013,5289,4779,510,9.6
"39121",39,121,2014,5081,4694,387,7.6
"39121",39,121,2015,4972,4611,361,7.3
"39121",39,121,2016,4899,4472,427,8.7
"39121",39,121,2017,4806,4460,346,7.2
"39123",39,123,1990,21581,19846,1735,8
"39123",39,123,1991,21535,19454,2081,9.7
"39123",39,123,1992,21341,18810,2531,11.9
"39123",39,123,1993,20980,18959,2021,9.6
"39123",39,123,1994,20248,18567,1681,8.3
"39123",39,123,1995,19969,18568,1401,7
"39123",39,123,1996,20832,19293,1539,7.4
"39123",39,123,1997,20911,19348,1563,7.5
"39123",39,123,1998,20787,19328,1459,7
"39123",39,123,1999,20912,19456,1456,7
"39123",39,123,2000,21395,20256,1139,5.3
"39123",39,123,2001,21379,20173,1206,5.6
"39123",39,123,2002,21408,19833,1575,7.4
"39123",39,123,2003,21537,19737,1800,8.4
"39123",39,123,2004,21683,19858,1825,8.4
"39123",39,123,2005,21855,20137,1718,7.9
"39123",39,123,2006,21956,20427,1529,7
"39123",39,123,2007,21764,20195,1569,7.2
"39123",39,123,2008,21529,19631,1898,8.8
"39123",39,123,2009,20792,17822,2970,14.3
"39123",39,123,2010,22678,19881,2797,12.3
"39123",39,123,2011,22475,19987,2488,11.1
"39123",39,123,2012,21991,19896,2095,9.5
"39123",39,123,2013,21969,19837,2132,9.7
"39123",39,123,2014,21488,19843,1645,7.7
"39123",39,123,2015,21023,19635,1388,6.6
"39123",39,123,2016,21060,19702,1358,6.4
"39123",39,123,2017,21350,19922,1428,6.7
"39125",39,125,1990,9880,9207,673,6.8
"39125",39,125,1991,9858,9014,844,8.6
"39125",39,125,1992,9046,8405,641,7.1
"39125",39,125,1993,9554,8920,634,6.6
"39125",39,125,1994,9623,9113,510,5.3
"39125",39,125,1995,9826,9395,431,4.4
"39125",39,125,1996,10026,9570,456,4.5
"39125",39,125,1997,10072,9612,460,4.6
"39125",39,125,1998,9964,9433,531,5.3
"39125",39,125,1999,9926,9438,488,4.9
"39125",39,125,2000,10485,10065,420,4
"39125",39,125,2001,10723,10233,490,4.6
"39125",39,125,2002,10697,10101,596,5.6
"39125",39,125,2003,10464,9783,681,6.5
"39125",39,125,2004,10443,9817,626,6
"39125",39,125,2005,10750,10164,586,5.5
"39125",39,125,2006,10626,10105,521,4.9
"39125",39,125,2007,10970,10423,547,5
"39125",39,125,2008,10790,10021,769,7.1
"39125",39,125,2009,10426,8980,1446,13.9
"39125",39,125,2010,9696,8477,1219,12.6
"39125",39,125,2011,9458,8535,923,9.8
"39125",39,125,2012,9210,8502,708,7.7
"39125",39,125,2013,9021,8332,689,7.6
"39125",39,125,2014,9010,8514,496,5.5
"39125",39,125,2015,8904,8478,426,4.8
"39125",39,125,2016,8888,8480,408,4.6
"39125",39,125,2017,8862,8468,394,4.4
"39127",39,127,1990,14519,12670,1849,12.7
"39127",39,127,1991,14357,12374,1983,13.8
"39127",39,127,1992,14381,12485,1896,13.2
"39127",39,127,1993,14324,12612,1712,12
"39127",39,127,1994,14538,13078,1460,10
"39127",39,127,1995,14783,13474,1309,8.9
"39127",39,127,1996,15095,13665,1430,9.5
"39127",39,127,1997,14423,13243,1180,8.2
"39127",39,127,1998,14483,13302,1181,8.2
"39127",39,127,1999,14495,13214,1281,8.8
"39127",39,127,2000,16140,15243,897,5.6
"39127",39,127,2001,16353,15424,929,5.7
"39127",39,127,2002,16741,15574,1167,7
"39127",39,127,2003,16684,15321,1363,8.2
"39127",39,127,2004,16704,15163,1541,9.2
"39127",39,127,2005,16652,15253,1399,8.4
"39127",39,127,2006,16613,15384,1229,7.4
"39127",39,127,2007,16449,15243,1206,7.3
"39127",39,127,2008,16382,14986,1396,8.5
"39127",39,127,2009,16778,14518,2260,13.5
"39127",39,127,2010,16646,14414,2232,13.4
"39127",39,127,2011,16427,14524,1903,11.6
"39127",39,127,2012,16086,14512,1574,9.8
"39127",39,127,2013,16068,14527,1541,9.6
"39127",39,127,2014,15811,14644,1167,7.4
"39127",39,127,2015,15824,14791,1033,6.5
"39127",39,127,2016,15910,14898,1012,6.4
"39127",39,127,2017,16137,15171,966,6
"39129",39,129,1990,21691,20587,1104,5.1
"39129",39,129,1991,21710,20526,1184,5.5
"39129",39,129,1992,22446,21076,1370,6.1
"39129",39,129,1993,22563,21289,1274,5.6
"39129",39,129,1994,23075,21968,1107,4.8
"39129",39,129,1995,23450,22577,873,3.7
"39129",39,129,1996,23761,22761,1000,4.2
"39129",39,129,1997,24216,23269,947,3.9
"39129",39,129,1998,24296,23391,905,3.7
"39129",39,129,1999,24607,23732,875,3.6
"39129",39,129,2000,23870,22864,1006,4.2
"39129",39,129,2001,23786,22730,1056,4.4
"39129",39,129,2002,23598,22136,1462,6.2
"39129",39,129,2003,23574,21960,1614,6.8
"39129",39,129,2004,23701,21904,1797,7.6
"39129",39,129,2005,24055,22335,1720,7.2
"39129",39,129,2006,24347,22932,1415,5.8
"39129",39,129,2007,24536,23048,1488,6.1
"39129",39,129,2008,24810,23044,1766,7.1
"39129",39,129,2009,24742,21992,2750,11.1
"39129",39,129,2010,26100,23338,2762,10.6
"39129",39,129,2011,25885,23505,2380,9.2
"39129",39,129,2012,25692,23779,1913,7.4
"39129",39,129,2013,25657,23782,1875,7.3
"39129",39,129,2014,25794,24334,1460,5.7
"39129",39,129,2015,25741,24517,1224,4.8
"39129",39,129,2016,26239,24976,1263,4.8
"39129",39,129,2017,26635,25412,1223,4.6
"39131",39,131,1990,9359,8447,912,9.7
"39131",39,131,1991,9689,8580,1109,11.4
"39131",39,131,1992,10117,8919,1198,11.8
"39131",39,131,1993,10702,9272,1430,13.4
"39131",39,131,1994,10850,9624,1226,11.3
"39131",39,131,1995,11016,10009,1007,9.1
"39131",39,131,1996,11382,10269,1113,9.8
"39131",39,131,1997,11516,10392,1124,9.8
"39131",39,131,1998,11790,10640,1150,9.8
"39131",39,131,1999,11670,10592,1078,9.2
"39131",39,131,2000,11443,10616,827,7.2
"39131",39,131,2001,11567,10704,863,7.5
"39131",39,131,2002,11409,10323,1086,9.5
"39131",39,131,2003,11451,10244,1207,10.5
"39131",39,131,2004,11005,9830,1175,10.7
"39131",39,131,2005,10740,9632,1108,10.3
"39131",39,131,2006,10776,9820,956,8.9
"39131",39,131,2007,10922,9887,1035,9.5
"39131",39,131,2008,10857,9754,1103,10.2
"39131",39,131,2009,11089,9393,1696,15.3
"39131",39,131,2010,11586,9868,1718,14.8
"39131",39,131,2011,11035,9357,1678,15.2
"39131",39,131,2012,10566,9188,1378,13
"39131",39,131,2013,10768,9451,1317,12.2
"39131",39,131,2014,10500,9546,954,9.1
"39131",39,131,2015,10472,9706,766,7.3
"39131",39,131,2016,10821,10010,811,7.5
"39131",39,131,2017,10880,10124,756,6.9
"39133",39,133,1990,75687,71732,3955,5.2
"39133",39,133,1991,76327,71851,4476,5.9
"39133",39,133,1992,78615,73036,5579,7.1
"39133",39,133,1993,78813,74114,4699,6
"39133",39,133,1994,80075,75843,4232,5.3
"39133",39,133,1995,80951,77446,3505,4.3
"39133",39,133,1996,82627,78724,3903,4.7
"39133",39,133,1997,82147,78577,3570,4.3
"39133",39,133,1998,81880,78459,3421,4.2
"39133",39,133,1999,83001,79409,3592,4.3
"39133",39,133,2000,84675,81207,3468,4.1
"39133",39,133,2001,84822,81211,3611,4.3
"39133",39,133,2002,85504,80762,4742,5.5
"39133",39,133,2003,86956,81739,5217,6
"39133",39,133,2004,87967,82653,5314,6
"39133",39,133,2005,89469,84319,5150,5.8
"39133",39,133,2006,90460,85793,4667,5.2
"39133",39,133,2007,92197,87293,4904,5.3
"39133",39,133,2008,92880,87062,5818,6.3
"39133",39,133,2009,92179,82809,9370,10.2
"39133",39,133,2010,90710,81357,9353,10.3
"39133",39,133,2011,89382,81464,7918,8.9
"39133",39,133,2012,87954,81546,6408,7.3
"39133",39,133,2013,87710,80952,6758,7.7
"39133",39,133,2014,86810,81715,5095,5.9
"39133",39,133,2015,86817,82594,4223,4.9
"39133",39,133,2016,87246,82873,4373,5
"39133",39,133,2017,87688,83267,4421,5
"39135",39,135,1990,19860,18687,1173,5.9
"39135",39,135,1991,19715,18288,1427,7.2
"39135",39,135,1992,19938,18316,1622,8.1
"39135",39,135,1993,20458,19133,1325,6.5
"39135",39,135,1994,20968,19903,1065,5.1
"39135",39,135,1995,21342,20437,905,4.2
"39135",39,135,1996,21388,20320,1068,5
"39135",39,135,1997,21020,20109,911,4.3
"39135",39,135,1998,21741,20782,959,4.4
"39135",39,135,1999,21180,20239,941,4.4
"39135",39,135,2000,21897,21013,884,4
"39135",39,135,2001,21989,21021,968,4.4
"39135",39,135,2002,22160,20797,1363,6.2
"39135",39,135,2003,22008,20631,1377,6.3
"39135",39,135,2004,21830,20433,1397,6.4
"39135",39,135,2005,21776,20470,1306,6
"39135",39,135,2006,22117,20794,1323,6
"39135",39,135,2007,21688,20437,1251,5.8
"39135",39,135,2008,21422,19938,1484,6.9
"39135",39,135,2009,21450,18811,2639,12.3
"39135",39,135,2010,22383,19917,2466,11
"39135",39,135,2011,21728,19648,2080,9.6
"39135",39,135,2012,21470,19811,1659,7.7
"39135",39,135,2013,21306,19699,1607,7.5
"39135",39,135,2014,21129,19922,1207,5.7
"39135",39,135,2015,20983,19972,1011,4.8
"39135",39,135,2016,21046,20047,999,4.7
"39135",39,135,2017,21150,20199,951,4.5
"39137",39,137,1990,17296,16112,1184,6.8
"39137",39,137,1991,17129,15845,1284,7.5
"39137",39,137,1992,17643,16337,1306,7.4
"39137",39,137,1993,18476,17252,1224,6.6
"39137",39,137,1994,18772,17779,993,5.3
"39137",39,137,1995,19645,18742,903,4.6
"39137",39,137,1996,19904,18881,1023,5.1
"39137",39,137,1997,20289,19349,940,4.6
"39137",39,137,1998,20483,19589,894,4.4
"39137",39,137,1999,20573,19741,832,4
"39137",39,137,2000,18277,17645,632,3.5
"39137",39,137,2001,17935,17216,719,4
"39137",39,137,2002,18048,17197,851,4.7
"39137",39,137,2003,18054,16865,1189,6.6
"39137",39,137,2004,17647,16424,1223,6.9
"39137",39,137,2005,17744,16788,956,5.4
"39137",39,137,2006,17922,17078,844,4.7
"39137",39,137,2007,18282,17406,876,4.8
"39137",39,137,2008,18447,17381,1066,5.8
"39137",39,137,2009,18221,16273,1948,10.7
"39137",39,137,2010,19332,17531,1801,9.3
"39137",39,137,2011,19252,17820,1432,7.4
"39137",39,137,2012,18791,17700,1091,5.8
"39137",39,137,2013,18816,17684,1132,6
"39137",39,137,2014,18642,17794,848,4.5
"39137",39,137,2015,18663,17940,723,3.9
"39137",39,137,2016,18929,18237,692,3.7
"39137",39,137,2017,19006,18329,677,3.6
"39139",39,139,1990,62906,57857,5049,8
"39139",39,139,1991,61470,55099,6371,10.4
"39139",39,139,1992,61165,55499,5666,9.3
"39139",39,139,1993,61996,56805,5191,8.4
"39139",39,139,1994,62691,57463,5228,8.3
"39139",39,139,1995,62164,58215,3949,6.4
"39139",39,139,1996,61814,57859,3955,6.4
"39139",39,139,1997,61617,57756,3861,6.3
"39139",39,139,1998,61330,57329,4001,6.5
"39139",39,139,1999,61832,57494,4338,7
"39139",39,139,2000,63248,59883,3365,5.3
"39139",39,139,2001,63122,59840,3282,5.2
"39139",39,139,2002,63964,59599,4365,6.8
"39139",39,139,2003,64277,59496,4781,7.4
"39139",39,139,2004,63376,58634,4742,7.5
"39139",39,139,2005,62761,58534,4227,6.7
"39139",39,139,2006,62722,58914,3808,6.1
"39139",39,139,2007,62590,58534,4056,6.5
"39139",39,139,2008,62349,57713,4636,7.4
"39139",39,139,2009,61604,53646,7958,12.9
"39139",39,139,2010,59079,51908,7171,12.1
"39139",39,139,2011,58139,51964,6175,10.6
"39139",39,139,2012,55858,50987,4871,8.7
"39139",39,139,2013,54943,50214,4729,8.6
"39139",39,139,2014,54500,50935,3565,6.5
"39139",39,139,2015,53558,50571,2987,5.6
"39139",39,139,2016,53484,50526,2958,5.5
"39139",39,139,2017,53228,50297,2931,5.5
"39141",39,141,1990,29825,27390,2435,8.2
"39141",39,141,1991,30550,27926,2624,8.6
"39141",39,141,1992,31644,28694,2950,9.3
"39141",39,141,1993,32266,29622,2644,8.2
"39141",39,141,1994,33076,30742,2334,7.1
"39141",39,141,1995,33369,31363,2006,6
"39141",39,141,1996,34339,32094,2245,6.5
"39141",39,141,1997,34429,32276,2153,6.3
"39141",39,141,1998,35177,32912,2265,6.4
"39141",39,141,1999,34525,32603,1922,5.6
"39141",39,141,2000,33504,31726,1778,5.3
"39141",39,141,2001,33472,31669,1803,5.4
"39141",39,141,2002,34172,31846,2326,6.8
"39141",39,141,2003,34441,31735,2706,7.9
"39141",39,141,2004,34797,31994,2803,8.1
"39141",39,141,2005,34771,32180,2591,7.5
"39141",39,141,2006,34901,32720,2181,6.2
"39141",39,141,2007,35056,32642,2414,6.9
"39141",39,141,2008,34685,31931,2754,7.9
"39141",39,141,2009,34905,30651,4254,12.2
"39141",39,141,2010,34084,30016,4068,11.9
"39141",39,141,2011,34318,30901,3417,10
"39141",39,141,2012,34037,31175,2862,8.4
"39141",39,141,2013,33507,30593,2914,8.7
"39141",39,141,2014,33655,31498,2157,6.4
"39141",39,141,2015,33713,31907,1806,5.4
"39141",39,141,2016,33886,32020,1866,5.5
"39141",39,141,2017,34130,32377,1753,5.1
"39143",39,143,1990,31791,29288,2503,7.9
"39143",39,143,1991,32193,29325,2868,8.9
"39143",39,143,1992,31932,28837,3095,9.7
"39143",39,143,1993,31184,28875,2309,7.4
"39143",39,143,1994,31806,29842,1964,6.2
"39143",39,143,1995,31692,29902,1790,5.6
"39143",39,143,1996,31815,29703,2112,6.6
"39143",39,143,1997,32015,29617,2398,7.5
"39143",39,143,1998,32439,30311,2128,6.6
"39143",39,143,1999,32031,30170,1861,5.8
"39143",39,143,2000,32789,31352,1437,4.4
"39143",39,143,2001,32802,31282,1520,4.6
"39143",39,143,2002,33220,31234,1986,6
"39143",39,143,2003,33110,30881,2229,6.7
"39143",39,143,2004,33510,31268,2242,6.7
"39143",39,143,2005,33362,31242,2120,6.4
"39143",39,143,2006,33456,31527,1929,5.8
"39143",39,143,2007,33950,31887,2063,6.1
"39143",39,143,2008,33318,30917,2401,7.2
"39143",39,143,2009,32992,28972,4020,12.2
"39143",39,143,2010,33204,29627,3577,10.8
"39143",39,143,2011,32721,29723,2998,9.2
"39143",39,143,2012,31758,29368,2390,7.5
"39143",39,143,2013,31562,29173,2389,7.6
"39143",39,143,2014,31284,29489,1795,5.7
"39143",39,143,2015,31354,29845,1509,4.8
"39143",39,143,2016,31069,29606,1463,4.7
"39143",39,143,2017,31354,29866,1488,4.7
"39145",39,145,1990,29333,26594,2739,9.3
"39145",39,145,1991,30073,27034,3039,10.1
"39145",39,145,1992,31714,28000,3714,11.7
"39145",39,145,1993,31632,28132,3500,11.1
"39145",39,145,1994,31848,28609,3239,10.2
"39145",39,145,1995,32500,29213,3287,10.1
"39145",39,145,1996,32957,29456,3501,10.6
"39145",39,145,1997,33620,30086,3534,10.5
"39145",39,145,1998,33181,29703,3478,10.5
"39145",39,145,1999,32992,29938,3054,9.3
"39145",39,145,2000,32074,29625,2449,7.6
"39145",39,145,2001,32404,30188,2216,6.8
"39145",39,145,2002,33267,30526,2741,8.2
"39145",39,145,2003,32683,29751,2932,9
"39145",39,145,2004,32966,29913,3053,9.3
"39145",39,145,2005,32205,29355,2850,8.8
"39145",39,145,2006,31395,29007,2388,7.6
"39145",39,145,2007,32298,29898,2400,7.4
"39145",39,145,2008,32526,29811,2715,8.3
"39145",39,145,2009,32713,28620,4093,12.5
"39145",39,145,2010,32608,28260,4348,13.3
"39145",39,145,2011,31833,27843,3990,12.5
"39145",39,145,2012,31080,27567,3513,11.3
"39145",39,145,2013,30349,26730,3619,11.9
"39145",39,145,2014,29873,27254,2619,8.8
"39145",39,145,2015,29572,27310,2262,7.6
"39145",39,145,2016,29913,27603,2310,7.7
"39145",39,145,2017,29715,27606,2109,7.1
"39147",39,147,1990,29858,27476,2382,8
"39147",39,147,1991,30381,27645,2736,9
"39147",39,147,1992,29988,27187,2801,9.3
"39147",39,147,1993,30001,27578,2423,8.1
"39147",39,147,1994,29925,28040,1885,6.3
"39147",39,147,1995,29392,27620,1772,6
"39147",39,147,1996,29084,27239,1845,6.3
"39147",39,147,1997,28881,26920,1961,6.8
"39147",39,147,1998,29269,27387,1882,6.4
"39147",39,147,1999,28468,26821,1647,5.8
"39147",39,147,2000,30929,29534,1395,4.5
"39147",39,147,2001,31168,29620,1548,5
"39147",39,147,2002,30589,28478,2111,6.9
"39147",39,147,2003,31017,28953,2064,6.7
"39147",39,147,2004,31411,29205,2206,7
"39147",39,147,2005,31390,29442,1948,6.2
"39147",39,147,2006,31487,29827,1660,5.3
"39147",39,147,2007,31225,29440,1785,5.7
"39147",39,147,2008,30486,28333,2153,7.1
"39147",39,147,2009,30487,26600,3887,12.7
"39147",39,147,2010,29460,25942,3518,11.9
"39147",39,147,2011,28806,26029,2777,9.6
"39147",39,147,2012,27788,25575,2213,8
"39147",39,147,2013,27411,25285,2126,7.8
"39147",39,147,2014,27157,25596,1561,5.7
"39147",39,147,2015,27142,25831,1311,4.8
"39147",39,147,2016,27187,25859,1328,4.9
"39147",39,147,2017,27323,26020,1303,4.8
"39149",39,149,1990,23671,22436,1235,5.2
"39149",39,149,1991,25588,23821,1767,6.9
"39149",39,149,1992,26397,24182,2215,8.4
"39149",39,149,1993,25638,23708,1930,7.5
"39149",39,149,1994,26126,24768,1358,5.2
"39149",39,149,1995,27103,25851,1252,4.6
"39149",39,149,1996,27788,26506,1282,4.6
"39149",39,149,1997,28359,27042,1317,4.6
"39149",39,149,1998,28331,27174,1157,4.1
"39149",39,149,1999,28130,26882,1248,4.4
"39149",39,149,2000,25535,24497,1038,4.1
"39149",39,149,2001,25778,24709,1069,4.1
"39149",39,149,2002,26415,24982,1433,5.4
"39149",39,149,2003,26658,25141,1517,5.7
"39149",39,149,2004,27072,25655,1417,5.2
"39149",39,149,2005,27581,26248,1333,4.8
"39149",39,149,2006,28333,27126,1207,4.3
"39149",39,149,2007,28444,27077,1367,4.8
"39149",39,149,2008,27607,25897,1710,6.2
"39149",39,149,2009,26464,22822,3642,13.8
"39149",39,149,2010,24971,21866,3105,12.4
"39149",39,149,2011,24239,21895,2344,9.7
"39149",39,149,2012,23834,22097,1737,7.3
"39149",39,149,2013,23761,22169,1592,6.7
"39149",39,149,2014,23645,22437,1208,5.1
"39149",39,149,2015,24076,23042,1034,4.3
"39149",39,149,2016,24107,23109,998,4.1
"39149",39,149,2017,24143,23148,995,4.1
"39151",39,151,1990,184612,173021,11591,6.3
"39151",39,151,1991,185689,172543,13146,7.1
"39151",39,151,1992,187087,172101,14986,8
"39151",39,151,1993,184839,171404,13435,7.3
"39151",39,151,1994,184618,173167,11451,6.2
"39151",39,151,1995,185602,176038,9564,5.2
"39151",39,151,1996,188412,177592,10820,5.7
"39151",39,151,1997,188248,178528,9720,5.2
"39151",39,151,1998,188218,179614,8604,4.6
"39151",39,151,1999,187383,178233,9150,4.9
"39151",39,151,2000,192777,184367,8410,4.4
"39151",39,151,2001,193549,185161,8388,4.3
"39151",39,151,2002,193399,181803,11596,6
"39151",39,151,2003,191959,178584,13375,7
"39151",39,151,2004,190760,177627,13133,6.9
"39151",39,151,2005,190370,177864,12506,6.6
"39151",39,151,2006,190175,179113,11062,5.8
"39151",39,151,2007,192111,180927,11184,5.8
"39151",39,151,2008,192019,179027,12992,6.8
"39151",39,151,2009,190557,168800,21757,11.4
"39151",39,151,2010,191869,170218,21651,11.3
"39151",39,151,2011,189210,171558,17652,9.3
"39151",39,151,2012,187871,173824,14047,7.5
"39151",39,151,2013,189051,174746,14305,7.6
"39151",39,151,2014,188218,177282,10936,5.8
"39151",39,151,2015,186530,176711,9819,5.3
"39151",39,151,2016,186717,176559,10158,5.4
"39151",39,151,2017,187574,177765,9809,5.2
"39153",39,153,1990,259505,246178,13327,5.1
"39153",39,153,1991,261628,245922,15706,6
"39153",39,153,1992,266822,248035,18787,7
"39153",39,153,1993,267275,250677,16598,6.2
"39153",39,153,1994,272471,258278,14193,5.2
"39153",39,153,1995,275115,262112,13003,4.7
"39153",39,153,1996,278638,264732,13906,5
"39153",39,153,1997,279606,266320,13286,4.8
"39153",39,153,1998,277823,265421,12402,4.5
"39153",39,153,1999,280593,267650,12943,4.6
"39153",39,153,2000,280078,267841,12237,4.4
"39153",39,153,2001,280317,267469,12848,4.6
"39153",39,153,2002,282591,265385,17206,6.1
"39153",39,153,2003,284960,266835,18125,6.4
"39153",39,153,2004,287229,269071,18158,6.3
"39153",39,153,2005,291058,273787,17271,5.9
"39153",39,153,2006,295022,279340,15682,5.3
"39153",39,153,2007,297444,281395,16049,5.4
"39153",39,153,2008,298291,279954,18337,6.1
"39153",39,153,2009,292933,263600,29333,10
"39153",39,153,2010,281497,251683,29814,10.6
"39153",39,153,2011,276591,251471,25120,9.1
"39153",39,153,2012,272305,251990,20315,7.5
"39153",39,153,2013,271165,250484,20681,7.6
"39153",39,153,2014,272172,256090,16082,5.9
"39153",39,153,2015,271713,258212,13501,5
"39153",39,153,2016,272758,258884,13874,5.1
"39153",39,153,2017,274131,260247,13884,5.1
"39155",39,155,1990,110968,102501,8467,7.6
"39155",39,155,1991,110890,102140,8750,7.9
"39155",39,155,1992,113376,101747,11629,10.3
"39155",39,155,1993,111383,101605,9778,8.8
"39155",39,155,1994,111688,102971,8717,7.8
"39155",39,155,1995,112863,105214,7649,6.8
"39155",39,155,1996,111979,104598,7381,6.6
"39155",39,155,1997,112422,105809,6613,5.9
"39155",39,155,1998,113085,105769,7316,6.5
"39155",39,155,1999,112098,105665,6433,5.7
"39155",39,155,2000,107518,101853,5665,5.3
"39155",39,155,2001,106873,100260,6613,6.2
"39155",39,155,2002,107011,99507,7504,7
"39155",39,155,2003,107113,98802,8311,7.8
"39155",39,155,2004,105735,97411,8324,7.9
"39155",39,155,2005,105645,98291,7354,7
"39155",39,155,2006,106095,99440,6655,6.3
"39155",39,155,2007,106325,99690,6635,6.2
"39155",39,155,2008,105582,97654,7928,7.5
"39155",39,155,2009,106546,91710,14836,13.9
"39155",39,155,2010,99834,86624,13210,13.2
"39155",39,155,2011,97442,87035,10407,10.7
"39155",39,155,2012,95305,86681,8624,9
"39155",39,155,2013,94552,85711,8841,9.4
"39155",39,155,2014,92579,85855,6724,7.3
"39155",39,155,2015,91394,85504,5890,6.4
"39155",39,155,2016,90548,84433,6115,6.8
"39155",39,155,2017,89686,83207,6479,7.2
"39157",39,157,1990,40696,38031,2665,6.5
"39157",39,157,1991,41183,37879,3304,8
"39157",39,157,1992,43365,39395,3970,9.2
"39157",39,157,1993,43142,39974,3168,7.3
"39157",39,157,1994,43513,40718,2795,6.4
"39157",39,157,1995,44443,41926,2517,5.7
"39157",39,157,1996,44596,41978,2618,5.9
"39157",39,157,1997,44237,41773,2464,5.6
"39157",39,157,1998,44240,41719,2521,5.7
"39157",39,157,1999,44228,41748,2480,5.6
"39157",39,157,2000,46427,44388,2039,4.4
"39157",39,157,2001,46652,44533,2119,4.5
"39157",39,157,2002,46661,43952,2709,5.8
"39157",39,157,2003,47815,44746,3069,6.4
"39157",39,157,2004,47254,44274,2980,6.3
"39157",39,157,2005,47366,44603,2763,5.8
"39157",39,157,2006,48135,45693,2442,5.1
"39157",39,157,2007,48239,45658,2581,5.4
"39157",39,157,2008,47837,44847,2990,6.3
"39157",39,157,2009,47129,41790,5339,11.3
"39157",39,157,2010,46070,40889,5181,11.2
"39157",39,157,2011,45405,41189,4216,9.3
"39157",39,157,2012,44972,41665,3307,7.4
"39157",39,157,2013,45049,41768,3281,7.3
"39157",39,157,2014,45304,42791,2513,5.5
"39157",39,157,2015,45438,42998,2440,5.4
"39157",39,157,2016,45081,42495,2586,5.7
"39157",39,157,2017,45706,43416,2290,5
"39159",39,159,1990,16314,15661,653,4
"39159",39,159,1991,16055,15249,806,5
"39159",39,159,1992,16185,15124,1061,6.6
"39159",39,159,1993,15577,14727,850,5.5
"39159",39,159,1994,15696,15022,674,4.3
"39159",39,159,1995,16062,15435,627,3.9
"39159",39,159,1996,16676,15920,756,4.5
"39159",39,159,1997,17507,16823,684,3.9
"39159",39,159,1998,17672,17106,566,3.2
"39159",39,159,1999,17878,17324,554,3.1
"39159",39,159,2000,22181,21476,705,3.2
"39159",39,159,2001,22900,22189,711,3.1
"39159",39,159,2002,23160,22166,994,4.3
"39159",39,159,2003,23468,22321,1147,4.9
"39159",39,159,2004,23949,22699,1250,5.2
"39159",39,159,2005,24483,23232,1251,5.1
"39159",39,159,2006,25219,24070,1149,4.6
"39159",39,159,2007,25475,24373,1102,4.3
"39159",39,159,2008,25897,24544,1353,5.2
"39159",39,159,2009,25896,23672,2224,8.6
"39159",39,159,2010,26657,24421,2236,8.4
"39159",39,159,2011,26723,24807,1916,7.2
"39159",39,159,2012,26329,24816,1513,5.7
"39159",39,159,2013,26626,25075,1551,5.8
"39159",39,159,2014,26797,25601,1196,4.5
"39159",39,159,2015,27023,25986,1037,3.8
"39159",39,159,2016,27834,26773,1061,3.8
"39159",39,159,2017,28240,27189,1051,3.7
"39161",39,161,1990,15990,14945,1045,6.5
"39161",39,161,1991,15906,14747,1159,7.3
"39161",39,161,1992,16237,15176,1061,6.5
"39161",39,161,1993,16174,15263,911,5.6
"39161",39,161,1994,15891,15194,697,4.4
"39161",39,161,1995,16597,15848,749,4.5
"39161",39,161,1996,16519,15668,851,5.2
"39161",39,161,1997,16293,15688,605,3.7
"39161",39,161,1998,16251,15608,643,4
"39161",39,161,1999,16648,15995,653,3.9
"39161",39,161,2000,15648,14953,695,4.4
"39161",39,161,2001,15356,14531,825,5.4
"39161",39,161,2002,15227,14328,899,5.9
"39161",39,161,2003,14767,13840,927,6.3
"39161",39,161,2004,15054,14200,854,5.7
"39161",39,161,2005,15105,14307,798,5.3
"39161",39,161,2006,15614,14852,762,4.9
"39161",39,161,2007,15584,14726,858,5.5
"39161",39,161,2008,15407,14099,1308,8.5
"39161",39,161,2009,15172,12907,2265,14.9
"39161",39,161,2010,14954,13147,1807,12.1
"39161",39,161,2011,14541,13189,1352,9.3
"39161",39,161,2012,14150,13082,1068,7.5
"39161",39,161,2013,14212,13223,989,7
"39161",39,161,2014,14401,13697,704,4.9
"39161",39,161,2015,14326,13731,595,4.2
"39161",39,161,2016,14326,13748,578,4
"39161",39,161,2017,14436,13862,574,4
"39163",39,163,1990,4410,3978,432,9.8
"39163",39,163,1991,4203,3719,484,11.5
"39163",39,163,1992,3984,3449,535,13.4
"39163",39,163,1993,4037,3481,556,13.8
"39163",39,163,1994,3961,3506,455,11.5
"39163",39,163,1995,3924,3478,446,11.4
"39163",39,163,1996,3817,3359,458,12
"39163",39,163,1997,3824,3355,469,12.3
"39163",39,163,1998,3817,3357,460,12.1
"39163",39,163,1999,3768,3292,476,12.6
"39163",39,163,2000,5444,5052,392,7.2
"39163",39,163,2001,5521,5106,415,7.5
"39163",39,163,2002,5814,5310,504,8.7
"39163",39,163,2003,5635,5100,535,9.5
"39163",39,163,2004,5451,4961,490,9
"39163",39,163,2005,5635,5161,474,8.4
"39163",39,163,2006,5727,5273,454,7.9
"39163",39,163,2007,5895,5432,463,7.9
"39163",39,163,2008,5720,5194,526,9.2
"39163",39,163,2009,5728,4970,758,13.2
"39163",39,163,2010,5797,5015,782,13.5
"39163",39,163,2011,5733,5050,683,11.9
"39163",39,163,2012,5548,4948,600,10.8
"39163",39,163,2013,5578,4983,595,10.7
"39163",39,163,2014,5513,5071,442,8
"39163",39,163,2015,5459,5102,357,6.5
"39163",39,163,2016,5462,5078,384,7
"39163",39,163,2017,5464,5091,373,6.8
"39165",39,165,1990,60281,57539,2742,4.5
"39165",39,165,1991,60991,58006,2985,4.9
"39165",39,165,1992,62665,58772,3893,6.2
"39165",39,165,1993,64150,60206,3944,6.1
"39165",39,165,1994,65808,62472,3336,5.1
"39165",39,165,1995,67278,64609,2669,4
"39165",39,165,1996,70406,67579,2827,4
"39165",39,165,1997,73245,70835,2410,3.3
"39165",39,165,1998,76388,73910,2478,3.2
"39165",39,165,1999,80358,77827,2531,3.1
"39165",39,165,2000,83482,80568,2914,3.5
"39165",39,165,2001,86842,83667,3175,3.7
"39165",39,165,2002,91391,87054,4337,4.7
"39165",39,165,2003,96105,91178,4927,5.1
"39165",39,165,2004,100040,94918,5122,5.1
"39165",39,165,2005,103976,98874,5102,4.9
"39165",39,165,2006,106991,101704,5287,4.9
"39165",39,165,2007,108163,103190,4973,4.6
"39165",39,165,2008,109239,103225,6014,5.5
"39165",39,165,2009,108917,99213,9704,8.9
"39165",39,165,2010,110115,100188,9927,9
"39165",39,165,2011,109603,100969,8634,7.9
"39165",39,165,2012,109019,101929,7090,6.5
"39165",39,165,2013,109855,102770,7085,6.4
"39165",39,165,2014,110934,105410,5524,5
"39165",39,165,2015,112405,107739,4666,4.2
"39165",39,165,2016,114771,110010,4761,4.1
"39165",39,165,2017,116363,111581,4782,4.1
"39167",39,167,1990,30235,28344,1891,6.3
"39167",39,167,1991,30409,28359,2050,6.7
"39167",39,167,1992,31515,28922,2593,8.2
"39167",39,167,1993,31842,29167,2675,8.4
"39167",39,167,1994,31802,29638,2164,6.8
"39167",39,167,1995,31861,29800,2061,6.5
"39167",39,167,1996,32640,30368,2272,7
"39167",39,167,1997,32663,30585,2078,6.4
"39167",39,167,1998,32346,30346,2000,6.2
"39167",39,167,1999,32339,30257,2082,6.4
"39167",39,167,2000,31320,29521,1799,5.7
"39167",39,167,2001,31361,29870,1491,4.8
"39167",39,167,2002,32310,30419,1891,5.9
"39167",39,167,2003,33362,31232,2130,6.4
"39167",39,167,2004,33156,30985,2171,6.5
"39167",39,167,2005,32614,30618,1996,6.1
"39167",39,167,2006,33047,31308,1739,5.3
"39167",39,167,2007,33179,31462,1717,5.2
"39167",39,167,2008,33063,31249,1814,5.5
"39167",39,167,2009,32872,29721,3151,9.6
"39167",39,167,2010,29799,26397,3402,11.4
"39167",39,167,2011,29041,26123,2918,10
"39167",39,167,2012,28412,25954,2458,8.7
"39167",39,167,2013,28367,25927,2440,8.6
"39167",39,167,2014,28222,26415,1807,6.4
"39167",39,167,2015,28053,26368,1685,6
"39167",39,167,2016,27814,25876,1938,7
"39167",39,167,2017,27626,25910,1716,6.2
"39169",39,169,1990,52654,50100,2554,4.9
"39169",39,169,1991,52161,49153,3008,5.8
"39169",39,169,1992,52241,48824,3417,6.5
"39169",39,169,1993,53663,51029,2634,4.9
"39169",39,169,1994,54358,52190,2168,4
"39169",39,169,1995,56650,54574,2076,3.7
"39169",39,169,1996,57001,54354,2647,4.6
"39169",39,169,1997,57271,54679,2592,4.5
"39169",39,169,1998,56408,54361,2047,3.6
"39169",39,169,1999,57204,54997,2207,3.9
"39169",39,169,2000,58854,56789,2065,3.5
"39169",39,169,2001,59670,57357,2313,3.9
"39169",39,169,2002,60089,57073,3016,5
"39169",39,169,2003,60256,57084,3172,5.3
"39169",39,169,2004,60387,57036,3351,5.5
"39169",39,169,2005,61120,58018,3102,5.1
"39169",39,169,2006,60193,57394,2799,4.7
"39169",39,169,2007,60204,57299,2905,4.8
"39169",39,169,2008,59427,56039,3388,5.7
"39169",39,169,2009,58035,52193,5842,10.1
"39169",39,169,2010,60131,54546,5585,9.3
"39169",39,169,2011,59186,54654,4532,7.7
"39169",39,169,2012,59042,55431,3611,6.1
"39169",39,169,2013,59320,55625,3695,6.2
"39169",39,169,2014,59512,56745,2767,4.6
"39169",39,169,2015,59993,57632,2361,3.9
"39169",39,169,2016,61307,58870,2437,4
"39169",39,169,2017,61709,59274,2435,3.9
"39171",39,171,1990,20185,19014,1171,5.8
"39171",39,171,1991,20261,18463,1798,8.9
"39171",39,171,1992,20993,19284,1709,8.1
"39171",39,171,1993,21484,20230,1254,5.8
"39171",39,171,1994,22277,21364,913,4.1
"39171",39,171,1995,21987,21152,835,3.8
"39171",39,171,1996,21303,20170,1133,5.3
"39171",39,171,1997,21082,20095,987,4.7
"39171",39,171,1998,20981,19988,993,4.7
"39171",39,171,1999,21040,20004,1036,4.9
"39171",39,171,2000,21252,20463,789,3.7
"39171",39,171,2001,20782,19716,1066,5.1
"39171",39,171,2002,20284,18986,1298,6.4
"39171",39,171,2003,19880,18483,1397,7
"39171",39,171,2004,19725,18434,1291,6.5
"39171",39,171,2005,19597,18369,1228,6.3
"39171",39,171,2006,19881,18696,1185,6
"39171",39,171,2007,19786,18591,1195,6
"39171",39,171,2008,19903,18370,1533,7.7
"39171",39,171,2009,20109,16912,3197,15.9
"39171",39,171,2010,19538,16967,2571,13.2
"39171",39,171,2011,18932,16895,2037,10.8
"39171",39,171,2012,18853,17363,1490,7.9
"39171",39,171,2013,18654,17264,1390,7.5
"39171",39,171,2014,18779,17754,1025,5.5
"39171",39,171,2015,19010,18171,839,4.4
"39171",39,171,2016,19052,18193,859,4.5
"39171",39,171,2017,19061,18222,839,4.4
"39173",39,173,1990,61044,57471,3573,5.9
"39173",39,173,1991,60048,55939,4109,6.8
"39173",39,173,1992,60425,56437,3988,6.6
"39173",39,173,1993,61274,58057,3217,5.3
"39173",39,173,1994,62790,59939,2851,4.5
"39173",39,173,1995,63434,60864,2570,4.1
"39173",39,173,1996,64523,61978,2545,3.9
"39173",39,173,1997,65384,62961,2423,3.7
"39173",39,173,1998,65957,63523,2434,3.7
"39173",39,173,1999,67416,64879,2537,3.8
"39173",39,173,2000,66267,63823,2444,3.7
"39173",39,173,2001,66608,64000,2608,3.9
"39173",39,173,2002,66409,62850,3559,5.4
"39173",39,173,2003,66423,62475,3948,5.9
"39173",39,173,2004,67124,63079,4045,6
"39173",39,173,2005,67891,63983,3908,5.8
"39173",39,173,2006,69042,65433,3609,5.2
"39173",39,173,2007,69423,65714,3709,5.3
"39173",39,173,2008,68912,64258,4654,6.8
"39173",39,173,2009,65711,58180,7531,11.5
"39173",39,173,2010,68548,61753,6795,9.9
"39173",39,173,2011,68376,62697,5679,8.3
"39173",39,173,2012,68668,63951,4717,6.9
"39173",39,173,2013,69091,64239,4852,7
"39173",39,173,2014,69144,65537,3607,5.2
"39173",39,173,2015,69581,66610,2971,4.3
"39173",39,173,2016,70751,67803,2948,4.2
"39173",39,173,2017,70693,67581,3112,4.4
"39175",39,175,1990,11462,10683,779,6.8
"39175",39,175,1991,11383,10243,1140,10
"39175",39,175,1992,11440,10352,1088,9.5
"39175",39,175,1993,11616,10705,911,7.8
"39175",39,175,1994,11501,10817,684,5.9
"39175",39,175,1995,11997,11378,619,5.2
"39175",39,175,1996,12247,11608,639,5.2
"39175",39,175,1997,12254,11526,728,5.9
"39175",39,175,1998,12419,11808,611,4.9
"39175",39,175,1999,12297,11685,612,5
"39175",39,175,2000,12373,11858,515,4.2
"39175",39,175,2001,12808,12266,542,4.2
"39175",39,175,2002,12936,12218,718,5.6
"39175",39,175,2003,13430,12673,757,5.6
"39175",39,175,2004,13333,12554,779,5.8
"39175",39,175,2005,13035,12259,776,6
"39175",39,175,2006,12359,11626,733,5.9
"39175",39,175,2007,12245,11448,797,6.5
"39175",39,175,2008,11453,10549,904,7.9
"39175",39,175,2009,11177,9605,1572,14.1
"39175",39,175,2010,12178,10824,1354,11.1
"39175",39,175,2011,12120,11002,1118,9.2
"39175",39,175,2012,12133,11303,830,6.8
"39175",39,175,2013,12358,11576,782,6.3
"39175",39,175,2014,12351,11807,544,4.4
"39175",39,175,2015,12346,11895,451,3.7
"39175",39,175,2016,12693,12223,470,3.7
"39175",39,175,2017,12732,12260,472,3.7
"40001",40,1,1990,8589,8051,538,6.3
"40001",40,1,1991,9181,8600,581,6.3
"40001",40,1,1992,9511,8978,533,5.6
"40001",40,1,1993,9880,9353,527,5.3
"40001",40,1,1994,10265,9819,446,4.3
"40001",40,1,1995,9956,9454,502,5
"40001",40,1,1996,9973,9392,581,5.8
"40001",40,1,1997,8994,8466,528,5.9
"40001",40,1,1998,9225,8579,646,7
"40001",40,1,1999,8984,8488,496,5.5
"40001",40,1,2000,9216,8891,325,3.5
"40001",40,1,2001,9170,8792,378,4.1
"40001",40,1,2002,9191,8746,445,4.8
"40001",40,1,2003,9789,9027,762,7.8
"40001",40,1,2004,9890,9281,609,6.2
"40001",40,1,2005,9943,9465,478,4.8
"40001",40,1,2006,10400,9944,456,4.4
"40001",40,1,2007,10876,10360,516,4.7
"40001",40,1,2008,10849,10315,534,4.9
"40001",40,1,2009,11166,10273,893,8
"40001",40,1,2010,8906,7969,937,10.5
"40001",40,1,2011,8849,8039,810,9.2
"40001",40,1,2012,8503,7727,776,9.1
"40001",40,1,2013,8268,7458,810,9.8
"40001",40,1,2014,8085,7438,647,8
"40001",40,1,2015,8165,7669,496,6.1
"40001",40,1,2016,8152,7675,477,5.9
"40001",40,1,2017,8272,7857,415,5
"40003",40,3,1990,2852,2761,91,3.2
"40003",40,3,1991,2684,2617,67,2.5
"40003",40,3,1992,2680,2620,60,2.2
"40003",40,3,1993,2678,2625,53,2
"40003",40,3,1994,2681,2646,35,1.3
"40003",40,3,1995,2619,2579,40,1.5
"40003",40,3,1996,2496,2448,48,1.9
"40003",40,3,1997,2406,2374,32,1.3
"40003",40,3,1998,2572,2514,58,2.3
"40003",40,3,1999,2533,2489,44,1.7
"40003",40,3,2000,2616,2539,77,2.9
"40003",40,3,2001,2527,2451,76,3
"40003",40,3,2002,2507,2421,86,3.4
"40003",40,3,2003,2564,2463,101,3.9
"40003",40,3,2004,2494,2398,96,3.8
"40003",40,3,2005,2323,2222,101,4.3
"40003",40,3,2006,2277,2181,96,4.2
"40003",40,3,2007,2329,2227,102,4.4
"40003",40,3,2008,2479,2402,77,3.1
"40003",40,3,2009,2532,2410,122,4.8
"40003",40,3,2010,2497,2375,122,4.9
"40003",40,3,2011,2558,2453,105,4.1
"40003",40,3,2012,2919,2836,83,2.8
"40003",40,3,2013,2935,2839,96,3.3
"40003",40,3,2014,3087,3011,76,2.5
"40003",40,3,2015,3164,3070,94,3
"40003",40,3,2016,2965,2866,99,3.3
"40003",40,3,2017,2947,2868,79,2.7
"40005",40,5,1990,4820,4418,402,8.3
"40005",40,5,1991,4821,4425,396,8.2
"40005",40,5,1992,4741,4416,325,6.9
"40005",40,5,1993,4876,4559,317,6.5
"40005",40,5,1994,4844,4579,265,5.5
"40005",40,5,1995,4946,4692,254,5.1
"40005",40,5,1996,4881,4670,211,4.3
"40005",40,5,1997,4787,4593,194,4.1
"40005",40,5,1998,4892,4688,204,4.2
"40005",40,5,1999,4945,4770,175,3.5
"40005",40,5,2000,5192,5007,185,3.6
"40005",40,5,2001,5297,5064,233,4.4
"40005",40,5,2002,5410,5145,265,4.9
"40005",40,5,2003,5651,5252,399,7.1
"40005",40,5,2004,5490,5147,343,6.2
"40005",40,5,2005,5553,5260,293,5.3
"40005",40,5,2006,5692,5418,274,4.8
"40005",40,5,2007,5914,5593,321,5.4
"40005",40,5,2008,6046,5766,280,4.6
"40005",40,5,2009,6256,5741,515,8.2
"40005",40,5,2010,5113,4601,512,10
"40005",40,5,2011,5013,4585,428,8.5
"40005",40,5,2012,5004,4665,339,6.8
"40005",40,5,2013,4913,4575,338,6.9
"40005",40,5,2014,4794,4499,295,6.2
"40005",40,5,2015,4862,4546,316,6.5
"40005",40,5,2016,5059,4726,333,6.6
"40005",40,5,2017,5211,4934,277,5.3
"40007",40,7,1990,3110,3030,80,2.6
"40007",40,7,1991,3003,2903,100,3.3
"40007",40,7,1992,2911,2808,103,3.5
"40007",40,7,1993,2908,2815,93,3.2
"40007",40,7,1994,3049,2952,97,3.2
"40007",40,7,1995,2993,2908,85,2.8
"40007",40,7,1996,2846,2780,66,2.3
"40007",40,7,1997,2851,2780,71,2.5
"40007",40,7,1998,2868,2760,108,3.8
"40007",40,7,1999,2668,2569,99,3.7
"40007",40,7,2000,2943,2873,70,2.4
"40007",40,7,2001,3010,2931,79,2.6
"40007",40,7,2002,2946,2847,99,3.4
"40007",40,7,2003,3015,2900,115,3.8
"40007",40,7,2004,2958,2857,101,3.4
"40007",40,7,2005,2890,2796,94,3.3
"40007",40,7,2006,2941,2863,78,2.7
"40007",40,7,2007,3083,3001,82,2.7
"40007",40,7,2008,3263,3196,67,2.1
"40007",40,7,2009,3329,3214,115,3.5
"40007",40,7,2010,2889,2774,115,4
"40007",40,7,2011,2952,2845,107,3.6
"40007",40,7,2012,3129,3035,94,3
"40007",40,7,2013,3026,2924,102,3.4
"40007",40,7,2014,3094,3008,86,2.8
"40007",40,7,2015,3023,2941,82,2.7
"40007",40,7,2016,2885,2795,90,3.1
"40007",40,7,2017,3046,2967,79,2.6
"40009",40,9,1990,8474,7992,482,5.7
"40009",40,9,1991,8705,8090,615,7.1
"40009",40,9,1992,8804,8156,648,7.4
"40009",40,9,1993,9132,8606,526,5.8
"40009",40,9,1994,9405,8943,462,4.9
"40009",40,9,1995,9560,9079,481,5
"40009",40,9,1996,9304,8942,362,3.9
"40009",40,9,1997,9477,9151,326,3.4
"40009",40,9,1998,9610,9212,398,4.1
"40009",40,9,1999,9864,9393,471,4.8
"40009",40,9,2000,8640,8369,271,3.1
"40009",40,9,2001,8855,8576,279,3.2
"40009",40,9,2002,8932,8562,370,4.1
"40009",40,9,2003,9242,8899,343,3.7
"40009",40,9,2004,9399,9096,303,3.2
"40009",40,9,2005,9653,9354,299,3.1
"40009",40,9,2006,10405,10129,276,2.7
"40009",40,9,2007,11609,11328,281,2.4
"40009",40,9,2008,12476,12187,289,2.3
"40009",40,9,2009,12117,11407,710,5.9
"40009",40,9,2010,10339,9743,596,5.8
"40009",40,9,2011,11336,10918,418,3.7
"40009",40,9,2012,12561,12181,380,3
"40009",40,9,2013,12591,12178,413,3.3
"40009",40,9,2014,12737,12378,359,2.8
"40009",40,9,2015,12210,11587,623,5.1
"40009",40,9,2016,11030,10235,795,7.2
"40009",40,9,2017,11364,10915,449,4
"40011",40,11,1990,5196,4925,271,5.2
"40011",40,11,1991,4968,4671,297,6
"40011",40,11,1992,4827,4524,303,6.3
"40011",40,11,1993,5036,4801,235,4.7
"40011",40,11,1994,5065,4878,187,3.7
"40011",40,11,1995,4876,4715,161,3.3
"40011",40,11,1996,4905,4712,193,3.9
"40011",40,11,1997,4873,4725,148,3
"40011",40,11,1998,4664,4501,163,3.5
"40011",40,11,1999,4598,4433,165,3.6
"40011",40,11,2000,4803,4669,134,2.8
"40011",40,11,2001,4673,4471,202,4.3
"40011",40,11,2002,4662,4447,215,4.6
"40011",40,11,2003,4787,4555,232,4.8
"40011",40,11,2004,4721,4502,219,4.6
"40011",40,11,2005,4824,4589,235,4.9
"40011",40,11,2006,4840,4640,200,4.1
"40011",40,11,2007,4943,4734,209,4.2
"40011",40,11,2008,4995,4813,182,3.6
"40011",40,11,2009,4998,4718,280,5.6
"40011",40,11,2010,4473,4186,287,6.4
"40011",40,11,2011,4355,4123,232,5.3
"40011",40,11,2012,4378,4208,170,3.9
"40011",40,11,2013,4319,4146,173,4
"40011",40,11,2014,4478,4323,155,3.5
"40011",40,11,2015,4486,4314,172,3.8
"40011",40,11,2016,4389,4227,162,3.7
"40011",40,11,2017,4585,4453,132,2.9
"40013",40,13,1990,13788,12976,812,5.9
"40013",40,13,1991,13297,12311,986,7.4
"40013",40,13,1992,13351,12525,826,6.2
"40013",40,13,1993,13648,12926,722,5.3
"40013",40,13,1994,13802,13116,686,5
"40013",40,13,1995,13844,13284,560,4
"40013",40,13,1996,14528,13993,535,3.7
"40013",40,13,1997,14865,14350,515,3.5
"40013",40,13,1998,16827,16347,480,2.9
"40013",40,13,1999,16813,16396,417,2.5
"40013",40,13,2000,16769,16279,490,2.9
"40013",40,13,2001,17626,17036,590,3.3
"40013",40,13,2002,17951,17278,673,3.7
"40013",40,13,2003,18029,17206,823,4.6
"40013",40,13,2004,18544,17800,744,4
"40013",40,13,2005,19362,18623,739,3.8
"40013",40,13,2006,20169,19459,710,3.5
"40013",40,13,2007,20677,19953,724,3.5
"40013",40,13,2008,20342,19640,702,3.5
"40013",40,13,2009,20568,19495,1073,5.2
"40013",40,13,2010,18504,17362,1142,6.2
"40013",40,13,2011,17508,16471,1037,5.9
"40013",40,13,2012,17629,16684,945,5.4
"40013",40,13,2013,17738,16771,967,5.5
"40013",40,13,2014,17829,16966,863,4.8
"40013",40,13,2015,18340,17502,838,4.6
"40013",40,13,2016,19500,18659,841,4.3
"40013",40,13,2017,20496,19712,784,3.8
"40015",40,15,1990,12087,11127,960,7.9
"40015",40,15,1991,11986,11025,961,8
"40015",40,15,1992,12050,11253,797,6.6
"40015",40,15,1993,12103,11239,864,7.1
"40015",40,15,1994,11914,11218,696,5.8
"40015",40,15,1995,11842,11225,617,5.2
"40015",40,15,1996,11953,11398,555,4.6
"40015",40,15,1997,12244,11614,630,5.1
"40015",40,15,1998,12909,12232,677,5.2
"40015",40,15,1999,13054,12528,526,4
"40015",40,15,2000,12159,11707,452,3.7
"40015",40,15,2001,12266,11716,550,4.5
"40015",40,15,2002,12293,11717,576,4.7
"40015",40,15,2003,12477,11816,661,5.3
"40015",40,15,2004,12176,11493,683,5.6
"40015",40,15,2005,12077,11398,679,5.6
"40015",40,15,2006,11734,11088,646,5.5
"40015",40,15,2007,11938,11345,593,5
"40015",40,15,2008,12480,11972,508,4.1
"40015",40,15,2009,12922,12125,797,6.2
"40015",40,15,2010,11833,11011,822,6.9
"40015",40,15,2011,11619,10795,824,7.1
"40015",40,15,2012,11713,11012,701,6
"40015",40,15,2013,11382,10668,714,6.3
"40015",40,15,2014,11128,10525,603,5.4
"40015",40,15,2015,11836,11226,610,5.2
"40015",40,15,2016,11918,11286,632,5.3
"40015",40,15,2017,12367,11812,555,4.5
"40017",40,17,1990,39636,37895,1741,4.4
"40017",40,17,1991,39195,37429,1766,4.5
"40017",40,17,1992,39447,37743,1704,4.3
"40017",40,17,1993,39937,38429,1508,3.8
"40017",40,17,1994,40587,39238,1349,3.3
"40017",40,17,1995,41765,40690,1075,2.6
"40017",40,17,1996,43474,42553,921,2.1
"40017",40,17,1997,44450,43425,1025,2.3
"40017",40,17,1998,45460,44319,1141,2.5
"40017",40,17,1999,46777,45859,918,2
"40017",40,17,2000,46614,45525,1089,2.3
"40017",40,17,2001,47628,46159,1469,3.1
"40017",40,17,2002,48400,46379,2021,4.2
"40017",40,17,2003,48460,46206,2254,4.7
"40017",40,17,2004,49848,47863,1985,4
"40017",40,17,2005,51178,49306,1872,3.7
"40017",40,17,2006,51392,49638,1754,3.4
"40017",40,17,2007,50999,49067,1932,3.8
"40017",40,17,2008,52070,50300,1770,3.4
"40017",40,17,2009,53337,50379,2958,5.5
"40017",40,17,2010,60083,56985,3098,5.2
"40017",40,17,2011,61519,58827,2692,4.4
"40017",40,17,2012,63528,61050,2478,3.9
"40017",40,17,2013,64764,62100,2664,4.1
"40017",40,17,2014,65805,63469,2336,3.5
"40017",40,17,2015,68291,65822,2469,3.6
"40017",40,17,2016,69381,66608,2773,4
"40017",40,17,2017,69836,67347,2489,3.6
"40019",40,19,1990,19782,18560,1222,6.2
"40019",40,19,1991,19718,18306,1412,7.2
"40019",40,19,1992,19729,18454,1275,6.5
"40019",40,19,1993,20590,19324,1266,6.1
"40019",40,19,1994,20424,19176,1248,6.1
"40019",40,19,1995,20914,19539,1375,6.6
"40019",40,19,1996,20635,19533,1102,5.3
"40019",40,19,1997,20961,19791,1170,5.6
"40019",40,19,1998,20646,19307,1339,6.5
"40019",40,19,1999,20312,19279,1033,5.1
"40019",40,19,2000,20914,20136,778,3.7
"40019",40,19,2001,21475,20651,824,3.8
"40019",40,19,2002,21815,20785,1030,4.7
"40019",40,19,2003,22832,21745,1087,4.8
"40019",40,19,2004,23179,22088,1091,4.7
"40019",40,19,2005,23547,22513,1034,4.4
"40019",40,19,2006,24135,23223,912,3.8
"40019",40,19,2007,25602,24729,873,3.4
"40019",40,19,2008,26779,25910,869,3.2
"40019",40,19,2009,28565,26984,1581,5.5
"40019",40,19,2010,21187,19683,1504,7.1
"40019",40,19,2011,21652,20264,1388,6.4
"40019",40,19,2012,21939,20727,1212,5.5
"40019",40,19,2013,22035,20864,1171,5.3
"40019",40,19,2014,21991,21015,976,4.4
"40019",40,19,2015,22557,21530,1027,4.6
"40019",40,19,2016,22711,21533,1178,5.2
"40019",40,19,2017,22511,21476,1035,4.6
"40021",40,21,1990,15671,14434,1237,7.9
"40021",40,21,1991,15798,14450,1348,8.5
"40021",40,21,1992,16029,14880,1149,7.2
"40021",40,21,1993,16165,15007,1158,7.2
"40021",40,21,1994,16350,15296,1054,6.4
"40021",40,21,1995,16482,15614,868,5.3
"40021",40,21,1996,16755,15894,861,5.1
"40021",40,21,1997,17444,16626,818,4.7
"40021",40,21,1998,17880,17105,775,4.3
"40021",40,21,1999,18510,17880,630,3.4
"40021",40,21,2000,18840,18247,593,3.1
"40021",40,21,2001,19098,18444,654,3.4
"40021",40,21,2002,19785,19004,781,3.9
"40021",40,21,2003,20065,19003,1062,5.3
"40021",40,21,2004,20730,19779,951,4.6
"40021",40,21,2005,20757,19840,917,4.4
"40021",40,21,2006,21461,20569,892,4.2
"40021",40,21,2007,23189,22247,942,4.1
"40021",40,21,2008,22918,22047,871,3.8
"40021",40,21,2009,24711,23384,1327,5.4
"40021",40,21,2010,19464,17975,1489,7.7
"40021",40,21,2011,19236,17835,1401,7.3
"40021",40,21,2012,18987,17652,1335,7
"40021",40,21,2013,18732,17429,1303,7
"40021",40,21,2014,18500,17384,1116,6
"40021",40,21,2015,19267,18270,997,5.2
"40021",40,21,2016,19278,18216,1062,5.5
"40021",40,21,2017,19082,18040,1042,5.5
"40023",40,23,1990,5801,5200,601,10.4
"40023",40,23,1991,6015,5329,686,11.4
"40023",40,23,1992,5907,5137,770,13
"40023",40,23,1993,5912,5144,768,13
"40023",40,23,1994,5910,5259,651,11
"40023",40,23,1995,5584,4980,604,10.8
"40023",40,23,1996,5612,4976,636,11.3
"40023",40,23,1997,5645,4936,709,12.6
"40023",40,23,1998,5579,4982,597,10.7
"40023",40,23,1999,5527,5159,368,6.7
"40023",40,23,2000,6071,5784,287,4.7
"40023",40,23,2001,6304,5974,330,5.2
"40023",40,23,2002,6527,6121,406,6.2
"40023",40,23,2003,6460,5965,495,7.7
"40023",40,23,2004,6345,5898,447,7
"40023",40,23,2005,6466,6101,365,5.6
"40023",40,23,2006,6712,6382,330,4.9
"40023",40,23,2007,6841,6478,363,5.3
"40023",40,23,2008,6913,6560,353,5.1
"40023",40,23,2009,7297,6785,512,7
"40023",40,23,2010,6123,5566,557,9.1
"40023",40,23,2011,6028,5486,542,9
"40023",40,23,2012,5834,5341,493,8.5
"40023",40,23,2013,5976,5468,508,8.5
"40023",40,23,2014,5807,5326,481,8.3
"40023",40,23,2015,5915,5461,454,7.7
"40023",40,23,2016,5753,5313,440,7.6
"40023",40,23,2017,5731,5375,356,6.2
"40025",40,25,1990,1691,1650,41,2.4
"40025",40,25,1991,1795,1752,43,2.4
"40025",40,25,1992,1855,1813,42,2.3
"40025",40,25,1993,1774,1740,34,1.9
"40025",40,25,1994,1768,1731,37,2.1
"40025",40,25,1995,1724,1682,42,2.4
"40025",40,25,1996,1701,1664,37,2.2
"40025",40,25,1997,1636,1603,33,2
"40025",40,25,1998,1818,1764,54,3
"40025",40,25,1999,1757,1716,41,2.3
"40025",40,25,2000,1602,1567,35,2.2
"40025",40,25,2001,1534,1491,43,2.8
"40025",40,25,2002,1473,1419,54,3.7
"40025",40,25,2003,1537,1481,56,3.6
"40025",40,25,2004,1438,1395,43,3
"40025",40,25,2005,1320,1274,46,3.5
"40025",40,25,2006,1271,1229,42,3.3
"40025",40,25,2007,1262,1214,48,3.8
"40025",40,25,2008,1250,1213,37,3
"40025",40,25,2009,1289,1241,48,3.7
"40025",40,25,2010,1457,1406,51,3.5
"40025",40,25,2011,1371,1325,46,3.4
"40025",40,25,2012,1292,1250,42,3.3
"40025",40,25,2013,1233,1193,40,3.2
"40025",40,25,2014,1273,1237,36,2.8
"40025",40,25,2015,1375,1344,31,2.3
"40025",40,25,2016,1415,1380,35,2.5
"40025",40,25,2017,1414,1380,34,2.4
"40027",40,27,1990,95244,91193,4051,4.3
"40027",40,27,1991,93912,90046,3866,4.1
"40027",40,27,1992,94500,90983,3517,3.7
"40027",40,27,1993,95999,92712,3287,3.4
"40027",40,27,1994,98127,94854,3273,3.3
"40027",40,27,1995,100998,98173,2825,2.8
"40027",40,27,1996,104603,101874,2729,2.6
"40027",40,27,1997,107255,104452,2803,2.6
"40027",40,27,1998,110583,107265,3318,3
"40027",40,27,1999,113365,110964,2401,2.1
"40027",40,27,2000,111428,108892,2536,2.3
"40027",40,27,2001,114172,110609,3563,3.1
"40027",40,27,2002,115109,110940,4169,3.6
"40027",40,27,2003,114921,110168,4753,4.1
"40027",40,27,2004,116530,112157,4373,3.8
"40027",40,27,2005,118305,113795,4510,3.8
"40027",40,27,2006,117495,113419,4076,3.5
"40027",40,27,2007,117837,113477,4360,3.7
"40027",40,27,2008,119236,115154,4082,3.4
"40027",40,27,2009,120212,113806,6406,5.3
"40027",40,27,2010,131125,124196,6929,5.3
"40027",40,27,2011,133181,127129,6052,4.5
"40027",40,27,2012,136363,130724,5639,4.1
"40027",40,27,2013,137044,131186,5858,4.3
"40027",40,27,2014,135559,130576,4983,3.7
"40027",40,27,2015,138148,133260,4888,3.5
"40027",40,27,2016,139087,133763,5324,3.8
"40027",40,27,2017,140218,135278,4940,3.5
"40029",40,29,1990,2497,2190,307,12.3
"40029",40,29,1991,2466,2131,335,13.6
"40029",40,29,1992,2450,2174,276,11.3
"40029",40,29,1993,2556,2292,264,10.3
"40029",40,29,1994,2545,2304,241,9.5
"40029",40,29,1995,2722,2475,247,9.1
"40029",40,29,1996,2651,2431,220,8.3
"40029",40,29,1997,2657,2425,232,8.7
"40029",40,29,1998,2565,2344,221,8.6
"40029",40,29,1999,2520,2357,163,6.5
"40029",40,29,2000,2495,2389,106,4.2
"40029",40,29,2001,2518,2384,134,5.3
"40029",40,29,2002,2495,2336,159,6.4
"40029",40,29,2003,2483,2183,300,12.1
"40029",40,29,2004,2266,2031,235,10.4
"40029",40,29,2005,2218,2062,156,7
"40029",40,29,2006,2361,2224,137,5.8
"40029",40,29,2007,2499,2344,155,6.2
"40029",40,29,2008,2494,2372,122,4.9
"40029",40,29,2009,2634,2409,225,8.5
"40029",40,29,2010,2294,2085,209,9.1
"40029",40,29,2011,2352,2154,198,8.4
"40029",40,29,2012,2368,2200,168,7.1
"40029",40,29,2013,2253,2082,171,7.6
"40029",40,29,2014,2297,2142,155,6.7
"40029",40,29,2015,2320,2143,177,7.6
"40029",40,29,2016,2320,2150,170,7.3
"40029",40,29,2017,2292,2168,124,5.4
"40031",40,31,1990,42532,39593,2939,6.9
"40031",40,31,1991,41641,38785,2856,6.9
"40031",40,31,1992,42806,40346,2460,5.7
"40031",40,31,1993,42568,39987,2581,6.1
"40031",40,31,1994,41808,39246,2562,6.1
"40031",40,31,1995,40848,38686,2162,5.3
"40031",40,31,1996,41191,39274,1917,4.7
"40031",40,31,1997,40940,38864,2076,5.1
"40031",40,31,1998,40973,38998,1975,4.8
"40031",40,31,1999,41590,40054,1536,3.7
"40031",40,31,2000,43303,41751,1552,3.6
"40031",40,31,2001,42532,40886,1646,3.9
"40031",40,31,2002,44118,42333,1785,4
"40031",40,31,2003,45139,43219,1920,4.3
"40031",40,31,2004,45728,43762,1966,4.3
"40031",40,31,2005,45272,43231,2041,4.5
"40031",40,31,2006,45351,43492,1859,4.1
"40031",40,31,2007,44888,42939,1949,4.3
"40031",40,31,2008,45904,44154,1750,3.8
"40031",40,31,2009,47619,45136,2483,5.2
"40031",40,31,2010,51497,48534,2963,5.8
"40031",40,31,2011,50693,47787,2906,5.7
"40031",40,31,2012,50862,47845,3017,5.9
"40031",40,31,2013,50119,47228,2891,5.8
"40031",40,31,2014,49239,46941,2298,4.7
"40031",40,31,2015,49642,47478,2164,4.4
"40031",40,31,2016,49426,47143,2283,4.6
"40031",40,31,2017,49246,47061,2185,4.4
"40033",40,33,1990,2861,2537,324,11.3
"40033",40,33,1991,2412,2137,275,11.4
"40033",40,33,1992,2288,2158,130,5.7
"40033",40,33,1993,2330,2194,136,5.8
"40033",40,33,1994,2463,2297,166,6.7
"40033",40,33,1995,2352,2241,111,4.7
"40033",40,33,1996,2353,2231,122,5.2
"40033",40,33,1997,2352,2217,135,5.7
"40033",40,33,1998,2238,2107,131,5.9
"40033",40,33,1999,2194,2071,123,5.6
"40033",40,33,2000,2865,2774,91,3.2
"40033",40,33,2001,2806,2707,99,3.5
"40033",40,33,2002,2802,2683,119,4.2
"40033",40,33,2003,3073,2936,137,4.5
"40033",40,33,2004,3239,3110,129,4
"40033",40,33,2005,3301,3178,123,3.7
"40033",40,33,2006,3327,3220,107,3.2
"40033",40,33,2007,3964,3858,106,2.7
"40033",40,33,2008,3892,3783,109,2.8
"40033",40,33,2009,3613,3453,160,4.4
"40033",40,33,2010,3009,2808,201,6.7
"40033",40,33,2011,2915,2738,177,6.1
"40033",40,33,2012,2887,2724,163,5.6
"40033",40,33,2013,2862,2701,161,5.6
"40033",40,33,2014,2846,2715,131,4.6
"40033",40,33,2015,2861,2742,119,4.2
"40033",40,33,2016,2888,2750,138,4.8
"40033",40,33,2017,2858,2743,115,4
"40035",40,35,1990,6450,6135,315,4.9
"40035",40,35,1991,6402,6037,365,5.7
"40035",40,35,1992,6566,6209,357,5.4
"40035",40,35,1993,6419,6082,337,5.3
"40035",40,35,1994,6497,6150,347,5.3
"40035",40,35,1995,6449,6253,196,3
"40035",40,35,1996,6549,6363,186,2.8
"40035",40,35,1997,6900,6707,193,2.8
"40035",40,35,1998,6763,6571,192,2.8
"40035",40,35,1999,6709,6531,178,2.7
"40035",40,35,2000,6930,6685,245,3.5
"40035",40,35,2001,6770,6506,264,3.9
"40035",40,35,2002,6651,6314,337,5.1
"40035",40,35,2003,6681,6309,372,5.6
"40035",40,35,2004,6617,6298,319,4.8
"40035",40,35,2005,6638,6340,298,4.5
"40035",40,35,2006,6804,6517,287,4.2
"40035",40,35,2007,7404,7063,341,4.6
"40035",40,35,2008,7427,7142,285,3.8
"40035",40,35,2009,7546,7124,422,5.6
"40035",40,35,2010,6591,6150,441,6.7
"40035",40,35,2011,6347,5947,400,6.3
"40035",40,35,2012,6365,6006,359,5.6
"40035",40,35,2013,6245,5840,405,6.5
"40035",40,35,2014,6046,5712,334,5.5
"40035",40,35,2015,6261,5958,303,4.8
"40035",40,35,2016,6250,5947,303,4.8
"40035",40,35,2017,6082,5810,272,4.5
"40037",40,37,1990,29585,27893,1692,5.7
"40037",40,37,1991,29604,27616,1988,6.7
"40037",40,37,1992,29553,27640,1913,6.5
"40037",40,37,1993,29766,27751,2015,6.8
"40037",40,37,1994,30495,28431,2064,6.8
"40037",40,37,1995,30523,29075,1448,4.7
"40037",40,37,1996,31227,29898,1329,4.3
"40037",40,37,1997,32301,30993,1308,4
"40037",40,37,1998,33230,31952,1278,3.8
"40037",40,37,1999,33698,32483,1215,3.6
"40037",40,37,2000,31960,30942,1018,3.2
"40037",40,37,2001,32175,31015,1160,3.6
"40037",40,37,2002,32480,30751,1729,5.3
"40037",40,37,2003,32027,29898,2129,6.6
"40037",40,37,2004,31758,29939,1819,5.7
"40037",40,37,2005,32063,30248,1815,5.7
"40037",40,37,2006,31601,30279,1322,4.2
"40037",40,37,2007,30982,29624,1358,4.4
"40037",40,37,2008,31216,29889,1327,4.3
"40037",40,37,2009,31142,28664,2478,8
"40037",40,37,2010,31807,29076,2731,8.6
"40037",40,37,2011,31308,29105,2203,7
"40037",40,37,2012,31618,29712,1906,6
"40037",40,37,2013,31249,29367,1882,6
"40037",40,37,2014,30926,29386,1540,5
"40037",40,37,2015,31339,29781,1558,5
"40037",40,37,2016,31488,29654,1834,5.8
"40037",40,37,2017,31523,29941,1582,5
"40039",40,39,1990,13612,12781,831,6.1
"40039",40,39,1991,13435,12533,902,6.7
"40039",40,39,1992,13587,12894,693,5.1
"40039",40,39,1993,13270,12704,566,4.3
"40039",40,39,1994,13418,12832,586,4.4
"40039",40,39,1995,13265,12785,480,3.6
"40039",40,39,1996,12815,12330,485,3.8
"40039",40,39,1997,12573,12087,486,3.9
"40039",40,39,1998,12192,11690,502,4.1
"40039",40,39,1999,12029,11626,403,3.4
"40039",40,39,2000,13258,12933,325,2.5
"40039",40,39,2001,13153,12748,405,3.1
"40039",40,39,2002,12928,12486,442,3.4
"40039",40,39,2003,13104,12632,472,3.6
"40039",40,39,2004,13390,12955,435,3.2
"40039",40,39,2005,13463,13030,433,3.2
"40039",40,39,2006,13761,13349,412,3
"40039",40,39,2007,14502,14061,441,3
"40039",40,39,2008,14755,14362,393,2.7
"40039",40,39,2009,15372,14663,709,4.6
"40039",40,39,2010,14155,13426,729,5.2
"40039",40,39,2011,15181,14571,610,4
"40039",40,39,2012,15691,15132,559,3.6
"40039",40,39,2013,16021,15431,590,3.7
"40039",40,39,2014,15879,15386,493,3.1
"40039",40,39,2015,15655,15020,635,4.1
"40039",40,39,2016,15191,14498,693,4.6
"40039",40,39,2017,15362,14852,510,3.3
"40041",40,41,1990,12149,11360,789,6.5
"40041",40,41,1991,12708,11836,872,6.9
"40041",40,41,1992,13087,12290,797,6.1
"40041",40,41,1993,14195,13496,699,4.9
"40041",40,41,1994,14702,14067,635,4.3
"40041",40,41,1995,15720,15108,612,3.9
"40041",40,41,1996,15910,15228,682,4.3
"40041",40,41,1997,16404,15721,683,4.2
"40041",40,41,1998,17220,16446,774,4.5
"40041",40,41,1999,17615,16976,639,3.6
"40041",40,41,2000,15990,15417,573,3.6
"40041",40,41,2001,16241,15592,649,4
"40041",40,41,2002,16579,15778,801,4.8
"40041",40,41,2003,16817,15865,952,5.7
"40041",40,41,2004,17065,16192,873,5.1
"40041",40,41,2005,17197,16390,807,4.7
"40041",40,41,2006,17385,16605,780,4.5
"40041",40,41,2007,18393,17552,841,4.6
"40041",40,41,2008,18923,18131,792,4.2
"40041",40,41,2009,19663,18394,1269,6.5
"40041",40,41,2010,17181,15810,1371,8
"40041",40,41,2011,17318,16080,1238,7.1
"40041",40,41,2012,17140,16010,1130,6.6
"40041",40,41,2013,16990,15817,1173,6.9
"40041",40,41,2014,17081,16088,993,5.8
"40041",40,41,2015,17475,16609,866,5
"40041",40,41,2016,17962,17081,881,4.9
"40041",40,41,2017,18488,17674,814,4.4
"40043",40,43,1990,2323,2225,98,4.2
"40043",40,43,1991,2410,2312,98,4.1
"40043",40,43,1992,2436,2340,96,3.9
"40043",40,43,1993,2371,2284,87,3.7
"40043",40,43,1994,2352,2247,105,4.5
"40043",40,43,1995,2273,2177,96,4.2
"40043",40,43,1996,2154,2069,85,3.9
"40043",40,43,1997,2075,2005,70,3.4
"40043",40,43,1998,2085,2001,84,4
"40043",40,43,1999,1991,1912,79,4
"40043",40,43,2000,2276,2215,61,2.7
"40043",40,43,2001,2343,2277,66,2.8
"40043",40,43,2002,2349,2263,86,3.7
"40043",40,43,2003,2445,2357,88,3.6
"40043",40,43,2004,2414,2338,76,3.1
"40043",40,43,2005,2366,2287,79,3.3
"40043",40,43,2006,2401,2328,73,3
"40043",40,43,2007,2450,2375,75,3.1
"40043",40,43,2008,2638,2575,63,2.4
"40043",40,43,2009,2747,2628,119,4.3
"40043",40,43,2010,2310,2189,121,5.2
"40043",40,43,2011,2470,2374,96,3.9
"40043",40,43,2012,2383,2307,76,3.2
"40043",40,43,2013,2595,2505,90,3.5
"40043",40,43,2014,2399,2324,75,3.1
"40043",40,43,2015,2496,2406,90,3.6
"40043",40,43,2016,2674,2565,109,4.1
"40043",40,43,2017,2490,2416,74,3
"40045",40,45,1990,2198,2122,76,3.5
"40045",40,45,1991,2016,1912,104,5.2
"40045",40,45,1992,1903,1788,115,6
"40045",40,45,1993,1881,1810,71,3.8
"40045",40,45,1994,1931,1832,99,5.1
"40045",40,45,1995,1847,1776,71,3.8
"40045",40,45,1996,1729,1670,59,3.4
"40045",40,45,1997,1631,1569,62,3.8
"40045",40,45,1998,1687,1603,84,5
"40045",40,45,1999,1650,1578,72,4.4
"40045",40,45,2000,2110,2055,55,2.6
"40045",40,45,2001,2118,2061,57,2.7
"40045",40,45,2002,2098,2027,71,3.4
"40045",40,45,2003,2213,2148,65,2.9
"40045",40,45,2004,2165,2105,60,2.8
"40045",40,45,2005,2129,2066,63,3
"40045",40,45,2006,2212,2153,59,2.7
"40045",40,45,2007,2375,2316,59,2.5
"40045",40,45,2008,2538,2483,55,2.2
"40045",40,45,2009,2467,2354,113,4.6
"40045",40,45,2010,2061,1951,110,5.3
"40045",40,45,2011,2113,2033,80,3.8
"40045",40,45,2012,2282,2217,65,2.8
"40045",40,45,2013,2333,2260,73,3.1
"40045",40,45,2014,2334,2264,70,3
"40045",40,45,2015,2391,2294,97,4.1
"40045",40,45,2016,2253,2168,85,3.8
"40045",40,45,2017,2236,2163,73,3.3
"40047",40,47,1990,26988,25779,1209,4.5
"40047",40,47,1991,26591,25447,1144,4.3
"40047",40,47,1992,26504,25513,991,3.7
"40047",40,47,1993,27134,26097,1037,3.8
"40047",40,47,1994,27414,26343,1071,3.9
"40047",40,47,1995,27138,26130,1008,3.7
"40047",40,47,1996,27227,26302,925,3.4
"40047",40,47,1997,28275,27366,909,3.2
"40047",40,47,1998,28065,27046,1019,3.6
"40047",40,47,1999,27537,26688,849,3.1
"40047",40,47,2000,28105,27326,779,2.8
"40047",40,47,2001,27591,26750,841,3
"40047",40,47,2002,27684,26718,966,3.5
"40047",40,47,2003,27446,26317,1129,4.1
"40047",40,47,2004,27842,26825,1017,3.7
"40047",40,47,2005,28304,27291,1013,3.6
"40047",40,47,2006,29311,28423,888,3
"40047",40,47,2007,30294,29405,889,2.9
"40047",40,47,2008,31529,30718,811,2.6
"40047",40,47,2009,32040,30642,1398,4.4
"40047",40,47,2010,28519,26947,1572,5.5
"40047",40,47,2011,28821,27546,1275,4.4
"40047",40,47,2012,29555,28358,1197,4.1
"40047",40,47,2013,29436,28225,1211,4.1
"40047",40,47,2014,29610,28555,1055,3.6
"40047",40,47,2015,30082,28895,1187,3.9
"40047",40,47,2016,28986,27717,1269,4.4
"40047",40,47,2017,27936,26838,1098,3.9
"40049",40,49,1990,11629,10794,835,7.2
"40049",40,49,1991,11727,10869,858,7.3
"40049",40,49,1992,11260,10345,915,8.1
"40049",40,49,1993,11282,10476,806,7.1
"40049",40,49,1994,11607,10880,727,6.3
"40049",40,49,1995,11030,10459,571,5.2
"40049",40,49,1996,11473,10897,576,5
"40049",40,49,1997,11414,10822,592,5.2
"40049",40,49,1998,11373,10608,765,6.7
"40049",40,49,1999,10976,10315,661,6
"40049",40,49,2000,12495,12069,426,3.4
"40049",40,49,2001,12897,12419,478,3.7
"40049",40,49,2002,12972,12368,604,4.7
"40049",40,49,2003,13149,12509,640,4.9
"40049",40,49,2004,13216,12664,552,4.2
"40049",40,49,2005,13174,12636,538,4.1
"40049",40,49,2006,13600,13113,487,3.6
"40049",40,49,2007,14506,14031,475,3.3
"40049",40,49,2008,14874,14424,450,3
"40049",40,49,2009,15162,14304,858,5.7
"40049",40,49,2010,12162,11248,914,7.5
"40049",40,49,2011,12203,11494,709,5.8
"40049",40,49,2012,12526,11904,622,5
"40049",40,49,2013,12456,11835,621,5
"40049",40,49,2014,12610,12097,513,4.1
"40049",40,49,2015,12831,12227,604,4.7
"40049",40,49,2016,12710,12029,681,5.4
"40049",40,49,2017,12630,12101,529,4.2
"40051",40,51,1990,19650,18337,1313,6.7
"40051",40,51,1991,18535,17153,1382,7.5
"40051",40,51,1992,18961,17762,1199,6.3
"40051",40,51,1993,19516,18396,1120,5.7
"40051",40,51,1994,19877,18816,1061,5.3
"40051",40,51,1995,20445,19395,1050,5.1
"40051",40,51,1996,20596,19645,951,4.6
"40051",40,51,1997,20419,19542,877,4.3
"40051",40,51,1998,20337,19263,1074,5.3
"40051",40,51,1999,19427,18567,860,4.4
"40051",40,51,2000,21996,21360,636,2.9
"40051",40,51,2001,22158,21434,724,3.3
"40051",40,51,2002,22541,21640,901,4
"40051",40,51,2003,22442,21374,1068,4.8
"40051",40,51,2004,22975,21937,1038,4.5
"40051",40,51,2005,23447,22385,1062,4.5
"40051",40,51,2006,23596,22448,1148,4.9
"40051",40,51,2007,22769,21768,1001,4.4
"40051",40,51,2008,22887,21979,908,4
"40051",40,51,2009,23190,21536,1654,7.1
"40051",40,51,2010,25401,23741,1660,6.5
"40051",40,51,2011,25282,23942,1340,5.3
"40051",40,51,2012,25585,24367,1218,4.8
"40051",40,51,2013,25532,24317,1215,4.8
"40051",40,51,2014,25367,24351,1016,4
"40051",40,51,2015,26219,25040,1179,4.5
"40051",40,51,2016,26081,24783,1298,5
"40051",40,51,2017,26098,25035,1063,4.1
"40053",40,53,1990,2570,2494,76,3
"40053",40,53,1991,2538,2460,78,3.1
"40053",40,53,1992,2526,2462,64,2.5
"40053",40,53,1993,2481,2426,55,2.2
"40053",40,53,1994,2492,2430,62,2.5
"40053",40,53,1995,2537,2467,70,2.8
"40053",40,53,1996,2463,2395,68,2.8
"40053",40,53,1997,2436,2369,67,2.8
"40053",40,53,1998,2395,2332,63,2.6
"40053",40,53,1999,2240,2181,59,2.6
"40053",40,53,2000,2569,2506,63,2.5
"40053",40,53,2001,2493,2423,70,2.8
"40053",40,53,2002,2559,2472,87,3.4
"40053",40,53,2003,2617,2521,96,3.7
"40053",40,53,2004,2515,2426,89,3.5
"40053",40,53,2005,2422,2333,89,3.7
"40053",40,53,2006,2382,2295,87,3.7
"40053",40,53,2007,2539,2457,82,3.2
"40053",40,53,2008,2602,2537,65,2.5
"40053",40,53,2009,2688,2587,101,3.8
"40053",40,53,2010,2573,2458,115,4.5
"40053",40,53,2011,2545,2450,95,3.7
"40053",40,53,2012,2653,2563,90,3.4
"40053",40,53,2013,2661,2572,89,3.3
"40053",40,53,2014,2805,2731,74,2.6
"40053",40,53,2015,3289,3193,96,2.9
"40053",40,53,2016,3003,2906,97,3.2
"40053",40,53,2017,2909,2833,76,2.6
"40055",40,55,1990,2437,2345,92,3.8
"40055",40,55,1991,2285,2178,107,4.7
"40055",40,55,1992,2269,2201,68,3
"40055",40,55,1993,2388,2303,85,3.6
"40055",40,55,1994,2463,2383,80,3.2
"40055",40,55,1995,2432,2348,84,3.5
"40055",40,55,1996,2526,2462,64,2.5
"40055",40,55,1997,2570,2497,73,2.8
"40055",40,55,1998,2609,2510,99,3.8
"40055",40,55,1999,2498,2421,77,3.1
"40055",40,55,2000,2268,2179,89,3.9
"40055",40,55,2001,2284,2186,98,4.3
"40055",40,55,2002,2268,2153,115,5.1
"40055",40,55,2003,2306,2151,155,6.7
"40055",40,55,2004,2211,2072,139,6.3
"40055",40,55,2005,2082,1964,118,5.7
"40055",40,55,2006,2071,1971,100,4.8
"40055",40,55,2007,2002,1904,98,4.9
"40055",40,55,2008,2039,1950,89,4.4
"40055",40,55,2009,2097,1936,161,7.7
"40055",40,55,2010,2191,2023,168,7.7
"40055",40,55,2011,2144,2008,136,6.3
"40055",40,55,2012,2076,1965,111,5.3
"40055",40,55,2013,1998,1891,107,5.4
"40055",40,55,2014,2029,1935,94,4.6
"40055",40,55,2015,2169,2046,123,5.7
"40055",40,55,2016,2189,2027,162,7.4
"40055",40,55,2017,2081,1970,111,5.3
"40057",40,57,1990,1396,1329,67,4.8
"40057",40,57,1991,1369,1297,72,5.3
"40057",40,57,1992,1415,1351,64,4.5
"40057",40,57,1993,1356,1296,60,4.4
"40057",40,57,1994,1364,1317,47,3.4
"40057",40,57,1995,1361,1314,47,3.5
"40057",40,57,1996,1329,1270,59,4.4
"40057",40,57,1997,1337,1269,68,5.1
"40057",40,57,1998,1370,1304,66,4.8
"40057",40,57,1999,1263,1220,43,3.4
"40057",40,57,2000,1435,1396,39,2.7
"40057",40,57,2001,1435,1386,49,3.4
"40057",40,57,2002,1421,1362,59,4.2
"40057",40,57,2003,1439,1382,57,4
"40057",40,57,2004,1427,1377,50,3.5
"40057",40,57,2005,1359,1307,52,3.8
"40057",40,57,2006,1430,1380,50,3.5
"40057",40,57,2007,1338,1292,46,3.4
"40057",40,57,2008,1334,1289,45,3.4
"40057",40,57,2009,1381,1307,74,5.4
"40057",40,57,2010,1314,1237,77,5.9
"40057",40,57,2011,1319,1248,71,5.4
"40057",40,57,2012,1415,1349,66,4.7
"40057",40,57,2013,1348,1290,58,4.3
"40057",40,57,2014,1276,1225,51,4
"40057",40,57,2015,1302,1257,45,3.5
"40057",40,57,2016,1291,1242,49,3.8
"40057",40,57,2017,1288,1239,49,3.8
"40059",40,59,1990,2043,1976,67,3.3
"40059",40,59,1991,2012,1945,67,3.3
"40059",40,59,1992,2051,1997,54,2.6
"40059",40,59,1993,2018,1962,56,2.8
"40059",40,59,1994,2016,1942,74,3.7
"40059",40,59,1995,1922,1860,62,3.2
"40059",40,59,1996,1784,1731,53,3
"40059",40,59,1997,1681,1628,53,3.2
"40059",40,59,1998,1745,1688,57,3.3
"40059",40,59,1999,1749,1693,56,3.2
"40059",40,59,2000,1916,1876,40,2.1
"40059",40,59,2001,1926,1870,56,2.9
"40059",40,59,2002,1918,1856,62,3.2
"40059",40,59,2003,1983,1913,70,3.5
"40059",40,59,2004,1838,1783,55,3
"40059",40,59,2005,1815,1761,54,3
"40059",40,59,2006,1835,1779,56,3.1
"40059",40,59,2007,1878,1825,53,2.8
"40059",40,59,2008,2044,1998,46,2.3
"40059",40,59,2009,2061,1980,81,3.9
"40059",40,59,2010,1866,1782,84,4.5
"40059",40,59,2011,1869,1800,69,3.7
"40059",40,59,2012,1920,1859,61,3.2
"40059",40,59,2013,1919,1855,64,3.3
"40059",40,59,2014,1968,1914,54,2.7
"40059",40,59,2015,1986,1926,60,3
"40059",40,59,2016,1909,1836,73,3.8
"40059",40,59,2017,1849,1791,58,3.1
"40061",40,61,1990,4392,3811,581,13.2
"40061",40,61,1991,4408,3638,770,17.5
"40061",40,61,1992,4340,3675,665,15.3
"40061",40,61,1993,4319,3559,760,17.6
"40061",40,61,1994,4287,3607,680,15.9
"40061",40,61,1995,4181,3676,505,12.1
"40061",40,61,1996,4234,3761,473,11.2
"40061",40,61,1997,4715,4234,481,10.2
"40061",40,61,1998,4979,4414,565,11.3
"40061",40,61,1999,4916,4573,343,7
"40061",40,61,2000,5100,4878,222,4.4
"40061",40,61,2001,5501,5270,231,4.2
"40061",40,61,2002,5596,5296,300,5.4
"40061",40,61,2003,5616,5249,367,6.5
"40061",40,61,2004,5233,4946,287,5.5
"40061",40,61,2005,5255,5016,239,4.5
"40061",40,61,2006,5436,5209,227,4.2
"40061",40,61,2007,5651,5422,229,4.1
"40061",40,61,2008,5961,5738,223,3.7
"40061",40,61,2009,6174,5700,474,7.7
"40061",40,61,2010,4789,4321,468,9.8
"40061",40,61,2011,4677,4262,415,8.9
"40061",40,61,2012,4624,4213,411,8.9
"40061",40,61,2013,4475,4064,411,9.2
"40061",40,61,2014,4336,4013,323,7.4
"40061",40,61,2015,4480,4124,356,7.9
"40061",40,61,2016,4502,4129,373,8.3
"40061",40,61,2017,4372,4082,290,6.6
"40063",40,63,1990,5309,4754,555,10.5
"40063",40,63,1991,5338,4683,655,12.3
"40063",40,63,1992,5449,4745,704,12.9
"40063",40,63,1993,5628,4952,676,12
"40063",40,63,1994,5674,4936,738,13
"40063",40,63,1995,5452,4965,487,8.9
"40063",40,63,1996,5133,4711,422,8.2
"40063",40,63,1997,5111,4746,365,7.1
"40063",40,63,1998,5490,5043,447,8.1
"40063",40,63,1999,5439,5015,424,7.8
"40063",40,63,2000,5555,5270,285,5.1
"40063",40,63,2001,5321,5031,290,5.5
"40063",40,63,2002,5298,4924,374,7.1
"40063",40,63,2003,5364,4865,499,9.3
"40063",40,63,2004,5300,4848,452,8.5
"40063",40,63,2005,5132,4762,370,7.2
"40063",40,63,2006,5071,4764,307,6.1
"40063",40,63,2007,4858,4561,297,6.1
"40063",40,63,2008,5093,4819,274,5.4
"40063",40,63,2009,5763,5178,585,10.2
"40063",40,63,2010,5572,4964,608,10.9
"40063",40,63,2011,5474,4962,512,9.4
"40063",40,63,2012,5778,5314,464,8
"40063",40,63,2013,5739,5280,459,8
"40063",40,63,2014,5635,5241,394,7
"40063",40,63,2015,5735,5305,430,7.5
"40063",40,63,2016,5512,5111,401,7.3
"40063",40,63,2017,5435,5128,307,5.6
"40065",40,65,1990,10880,9988,892,8.2
"40065",40,65,1991,10232,9495,737,7.2
"40065",40,65,1992,10155,9621,534,5.3
"40065",40,65,1993,10687,10190,497,4.7
"40065",40,65,1994,10853,10397,456,4.2
"40065",40,65,1995,11282,10676,606,5.4
"40065",40,65,1996,11480,11007,473,4.1
"40065",40,65,1997,12375,11831,544,4.4
"40065",40,65,1998,12788,12201,587,4.6
"40065",40,65,1999,12846,12415,431,3.4
"40065",40,65,2000,11906,11551,355,3
"40065",40,65,2001,11990,11604,386,3.2
"40065",40,65,2002,12106,11676,430,3.6
"40065",40,65,2003,12632,12165,467,3.7
"40065",40,65,2004,12508,12030,478,3.8
"40065",40,65,2005,12225,11749,476,3.9
"40065",40,65,2006,12465,12051,414,3.3
"40065",40,65,2007,12580,12153,427,3.4
"40065",40,65,2008,12358,11964,394,3.2
"40065",40,65,2009,12252,11639,613,5
"40065",40,65,2010,11466,10787,679,5.9
"40065",40,65,2011,11348,10727,621,5.5
"40065",40,65,2012,11084,10516,568,5.1
"40065",40,65,2013,10828,10246,582,5.4
"40065",40,65,2014,10645,10187,458,4.3
"40065",40,65,2015,10874,10431,443,4.1
"40065",40,65,2016,10997,10514,483,4.4
"40065",40,65,2017,10898,10480,418,3.8
"40067",40,67,1990,2870,2641,229,8
"40067",40,67,1991,2826,2647,179,6.3
"40067",40,67,1992,3107,2899,208,6.7
"40067",40,67,1993,3219,3005,214,6.6
"40067",40,67,1994,3288,3097,191,5.8
"40067",40,67,1995,3310,3146,164,5
"40067",40,67,1996,3360,3233,127,3.8
"40067",40,67,1997,3454,3327,127,3.7
"40067",40,67,1998,3244,3092,152,4.7
"40067",40,67,1999,3145,3030,115,3.7
"40067",40,67,2000,2835,2735,100,3.5
"40067",40,67,2001,2627,2516,111,4.2
"40067",40,67,2002,2492,2346,146,5.9
"40067",40,67,2003,2483,2327,156,6.3
"40067",40,67,2004,2417,2275,142,5.9
"40067",40,67,2005,2246,2129,117,5.2
"40067",40,67,2006,2345,2243,102,4.3
"40067",40,67,2007,2354,2238,116,4.9
"40067",40,67,2008,2399,2297,102,4.3
"40067",40,67,2009,2543,2333,210,8.3
"40067",40,67,2010,2681,2479,202,7.5
"40067",40,67,2011,2660,2497,163,6.1
"40067",40,67,2012,2605,2477,128,4.9
"40067",40,67,2013,2582,2446,136,5.3
"40067",40,67,2014,2579,2460,119,4.6
"40067",40,67,2015,2680,2526,154,5.7
"40067",40,67,2016,2709,2515,194,7.2
"40067",40,67,2017,2506,2366,140,5.6
"40069",40,69,1990,4010,3732,278,6.9
"40069",40,69,1991,3887,3574,313,8.1
"40069",40,69,1992,4201,3952,249,5.9
"40069",40,69,1993,4518,4252,266,5.9
"40069",40,69,1994,4712,4467,245,5.2
"40069",40,69,1995,4835,4607,228,4.7
"40069",40,69,1996,4820,4536,284,5.9
"40069",40,69,1997,4515,4189,326,7.2
"40069",40,69,1998,4755,4461,294,6.2
"40069",40,69,1999,4929,4728,201,4.1
"40069",40,69,2000,4534,4372,162,3.6
"40069",40,69,2001,4562,4342,220,4.8
"40069",40,69,2002,4511,4303,208,4.6
"40069",40,69,2003,4888,4632,256,5.2
"40069",40,69,2004,4611,4344,267,5.8
"40069",40,69,2005,4850,4624,226,4.7
"40069",40,69,2006,4973,4761,212,4.3
"40069",40,69,2007,5097,4878,219,4.3
"40069",40,69,2008,5177,4954,223,4.3
"40069",40,69,2009,5249,4858,391,7.4
"40069",40,69,2010,3747,3359,388,10.4
"40069",40,69,2011,3713,3397,316,8.5
"40069",40,69,2012,3652,3368,284,7.8
"40069",40,69,2013,3587,3295,292,8.1
"40069",40,69,2014,3627,3373,254,7
"40069",40,69,2015,3971,3712,259,6.5
"40069",40,69,2016,4372,4115,257,5.9
"40069",40,69,2017,4986,4784,202,4.1
"40071",40,71,1990,23395,22125,1270,5.4
"40071",40,71,1991,23495,22204,1291,5.5
"40071",40,71,1992,23863,22421,1442,6
"40071",40,71,1993,23788,21810,1978,8.3
"40071",40,71,1994,23215,21112,2103,9.1
"40071",40,71,1995,23022,21370,1652,7.2
"40071",40,71,1996,22790,21350,1440,6.3
"40071",40,71,1997,22376,20827,1549,6.9
"40071",40,71,1998,22486,20862,1624,7.2
"40071",40,71,1999,22069,20602,1467,6.6
"40071",40,71,2000,22028,21093,935,4.2
"40071",40,71,2001,22836,21897,939,4.1
"40071",40,71,2002,22949,21660,1289,5.6
"40071",40,71,2003,21959,20488,1471,6.7
"40071",40,71,2004,22002,20660,1342,6.1
"40071",40,71,2005,20926,19744,1182,5.6
"40071",40,71,2006,21891,20845,1046,4.8
"40071",40,71,2007,22926,21962,964,4.2
"40071",40,71,2008,23917,23078,839,3.5
"40071",40,71,2009,23646,21887,1759,7.4
"40071",40,71,2010,20938,19007,1931,9.2
"40071",40,71,2011,20647,19042,1605,7.8
"40071",40,71,2012,20316,18874,1442,7.1
"40071",40,71,2013,19986,18607,1379,6.9
"40071",40,71,2014,19255,18157,1098,5.7
"40071",40,71,2015,19196,18103,1093,5.7
"40071",40,71,2016,18939,17741,1198,6.3
"40071",40,71,2017,19236,18177,1059,5.5
"40073",40,73,1990,6496,6214,282,4.3
"40073",40,73,1991,6478,6251,227,3.5
"40073",40,73,1992,6468,6175,293,4.5
"40073",40,73,1993,6601,6305,296,4.5
"40073",40,73,1994,6869,6592,277,4
"40073",40,73,1995,7039,6831,208,3
"40073",40,73,1996,6694,6498,196,2.9
"40073",40,73,1997,6985,6786,199,2.8
"40073",40,73,1998,7066,6856,210,3
"40073",40,73,1999,6745,6562,183,2.7
"40073",40,73,2000,7179,7022,157,2.2
"40073",40,73,2001,7286,7108,178,2.4
"40073",40,73,2002,7273,7042,231,3.2
"40073",40,73,2003,7391,7147,244,3.3
"40073",40,73,2004,7541,7300,241,3.2
"40073",40,73,2005,7642,7395,247,3.2
"40073",40,73,2006,7975,7756,219,2.7
"40073",40,73,2007,8357,8137,220,2.6
"40073",40,73,2008,8529,8329,200,2.3
"40073",40,73,2009,7773,7430,343,4.4
"40073",40,73,2010,7380,7006,374,5.1
"40073",40,73,2011,7580,7286,294,3.9
"40073",40,73,2012,7704,7446,258,3.3
"40073",40,73,2013,7786,7517,269,3.5
"40073",40,73,2014,7950,7705,245,3.1
"40073",40,73,2015,8276,8016,260,3.1
"40073",40,73,2016,8445,8165,280,3.3
"40073",40,73,2017,8662,8420,242,2.8
"40075",40,75,1990,4827,4609,218,4.5
"40075",40,75,1991,4745,4531,214,4.5
"40075",40,75,1992,4817,4634,183,3.8
"40075",40,75,1993,4894,4674,220,4.5
"40075",40,75,1994,4882,4697,185,3.8
"40075",40,75,1995,4764,4615,149,3.1
"40075",40,75,1996,4624,4430,194,4.2
"40075",40,75,1997,4577,4357,220,4.8
"40075",40,75,1998,4700,4484,216,4.6
"40075",40,75,1999,4757,4593,164,3.4
"40075",40,75,2000,4598,4471,127,2.8
"40075",40,75,2001,4557,4408,149,3.3
"40075",40,75,2002,4567,4396,171,3.7
"40075",40,75,2003,4479,4263,216,4.8
"40075",40,75,2004,4298,4100,198,4.6
"40075",40,75,2005,4052,3865,187,4.6
"40075",40,75,2006,3919,3736,183,4.7
"40075",40,75,2007,3963,3789,174,4.4
"40075",40,75,2008,4037,3884,153,3.8
"40075",40,75,2009,4149,3892,257,6.2
"40075",40,75,2010,4316,4056,260,6
"40075",40,75,2011,4268,4048,220,5.2
"40075",40,75,2012,4275,4074,201,4.7
"40075",40,75,2013,4150,3947,203,4.9
"40075",40,75,2014,4050,3886,164,4
"40075",40,75,2015,4163,3969,194,4.7
"40075",40,75,2016,4107,3888,219,5.3
"40075",40,75,2017,3948,3736,212,5.4
"40077",40,77,1990,4125,3697,428,10.4
"40077",40,77,1991,4348,3711,637,14.7
"40077",40,77,1992,4107,3501,606,14.8
"40077",40,77,1993,4117,3435,682,16.6
"40077",40,77,1994,4291,3664,627,14.6
"40077",40,77,1995,4346,3879,467,10.7
"40077",40,77,1996,4594,4189,405,8.8
"40077",40,77,1997,4848,4380,468,9.7
"40077",40,77,1998,4476,3877,599,13.4
"40077",40,77,1999,4638,4255,383,8.3
"40077",40,77,2000,4431,4224,207,4.7
"40077",40,77,2001,4644,4417,227,4.9
"40077",40,77,2002,4078,3791,287,7
"40077",40,77,2003,4085,3815,270,6.6
"40077",40,77,2004,4155,3915,240,5.8
"40077",40,77,2005,4023,3796,227,5.6
"40077",40,77,2006,4116,3911,205,5
"40077",40,77,2007,4210,4000,210,5
"40077",40,77,2008,4692,4489,203,4.3
"40077",40,77,2009,4485,4005,480,10.7
"40077",40,77,2010,4574,4115,459,10
"40077",40,77,2011,4436,3995,441,9.9
"40077",40,77,2012,4555,4168,387,8.5
"40077",40,77,2013,4145,3777,368,8.9
"40077",40,77,2014,3955,3662,293,7.4
"40077",40,77,2015,3862,3548,314,8.1
"40077",40,77,2016,3724,3402,322,8.6
"40077",40,77,2017,3419,3162,257,7.5
"40079",40,79,1990,18666,16794,1872,10
"40079",40,79,1991,17763,15299,2464,13.9
"40079",40,79,1992,17722,15872,1850,10.4
"40079",40,79,1993,18472,16788,1684,9.1
"40079",40,79,1994,19095,17579,1516,7.9
"40079",40,79,1995,19693,18264,1429,7.3
"40079",40,79,1996,19486,18162,1324,6.8
"40079",40,79,1997,19319,18007,1312,6.8
"40079",40,79,1998,19828,18363,1465,7.4
"40079",40,79,1999,20078,18971,1107,5.5
"40079",40,79,2000,20730,19855,875,4.2
"40079",40,79,2001,20935,19847,1088,5.2
"40079",40,79,2002,21187,19920,1267,6
"40079",40,79,2003,21356,19966,1390,6.5
"40079",40,79,2004,21224,20047,1177,5.5
"40079",40,79,2005,21322,20232,1090,5.1
"40079",40,79,2006,21697,20595,1102,5.1
"40079",40,79,2007,21178,20003,1175,5.5
"40079",40,79,2008,20859,19766,1093,5.2
"40079",40,79,2009,20818,18784,2034,9.8
"40079",40,79,2010,20766,18804,1962,9.4
"40079",40,79,2011,20136,18340,1796,8.9
"40079",40,79,2012,20119,18383,1736,8.6
"40079",40,79,2013,19765,18009,1756,8.9
"40079",40,79,2014,19338,18010,1328,6.9
"40079",40,79,2015,19636,18276,1360,6.9
"40079",40,79,2016,19749,18385,1364,6.9
"40079",40,79,2017,19373,18247,1126,5.8
"40081",40,81,1990,13236,12363,873,6.6
"40081",40,81,1991,13517,12664,853,6.3
"40081",40,81,1992,14133,13304,829,5.9
"40081",40,81,1993,14858,14088,770,5.2
"40081",40,81,1994,14618,13936,682,4.7
"40081",40,81,1995,14820,14204,616,4.2
"40081",40,81,1996,14628,13948,680,4.6
"40081",40,81,1997,14533,13813,720,5
"40081",40,81,1998,14042,13363,679,4.8
"40081",40,81,1999,14286,13688,598,4.2
"40081",40,81,2000,14889,14456,433,2.9
"40081",40,81,2001,14989,14412,577,3.8
"40081",40,81,2002,15043,14315,728,4.8
"40081",40,81,2003,14745,13964,781,5.3
"40081",40,81,2004,14822,14091,731,4.9
"40081",40,81,2005,14775,14064,711,4.8
"40081",40,81,2006,14530,13933,597,4.1
"40081",40,81,2007,13908,13323,585,4.2
"40081",40,81,2008,13836,13285,551,4
"40081",40,81,2009,13868,12889,979,7.1
"40081",40,81,2010,15657,14635,1022,6.5
"40081",40,81,2011,15504,14658,846,5.5
"40081",40,81,2012,15570,14796,774,5
"40081",40,81,2013,15467,14672,795,5.1
"40081",40,81,2014,15469,14769,700,4.5
"40081",40,81,2015,15877,15135,742,4.7
"40081",40,81,2016,15874,15028,846,5.3
"40081",40,81,2017,15870,15176,694,4.4
"40083",40,83,1990,13489,12959,530,3.9
"40083",40,83,1991,13316,12669,647,4.9
"40083",40,83,1992,13260,12689,571,4.3
"40083",40,83,1993,13452,12862,590,4.4
"40083",40,83,1994,13715,13210,505,3.7
"40083",40,83,1995,14060,13599,461,3.3
"40083",40,83,1996,14115,13696,419,3
"40083",40,83,1997,14333,13885,448,3.1
"40083",40,83,1998,14253,13741,512,3.6
"40083",40,83,1999,14572,14206,366,2.5
"40083",40,83,2000,17005,16582,423,2.5
"40083",40,83,2001,17347,16852,495,2.9
"40083",40,83,2002,17397,16805,592,3.4
"40083",40,83,2003,17498,16750,748,4.3
"40083",40,83,2004,18012,17302,710,3.9
"40083",40,83,2005,18151,17440,711,3.9
"40083",40,83,2006,17795,17137,658,3.7
"40083",40,83,2007,16991,16336,655,3.9
"40083",40,83,2008,17735,17096,639,3.6
"40083",40,83,2009,18107,17084,1023,5.6
"40083",40,83,2010,19805,18684,1121,5.7
"40083",40,83,2011,20211,19228,983,4.9
"40083",40,83,2012,20619,19718,901,4.4
"40083",40,83,2013,20749,19807,942,4.5
"40083",40,83,2014,20959,20119,840,4
"40083",40,83,2015,21473,20655,818,3.8
"40083",40,83,2016,21568,20693,875,4.1
"40083",40,83,2017,21719,20913,806,3.7
"40085",40,85,1990,3677,3467,210,5.7
"40085",40,85,1991,3694,3480,214,5.8
"40085",40,85,1992,3727,3529,198,5.3
"40085",40,85,1993,3934,3660,274,7
"40085",40,85,1994,3971,3704,267,6.7
"40085",40,85,1995,3899,3652,247,6.3
"40085",40,85,1996,3913,3733,180,4.6
"40085",40,85,1997,3922,3761,161,4.1
"40085",40,85,1998,3843,3656,187,4.9
"40085",40,85,1999,3800,3649,151,4
"40085",40,85,2000,4214,4066,148,3.5
"40085",40,85,2001,4312,4143,169,3.9
"40085",40,85,2002,4363,4175,188,4.3
"40085",40,85,2003,4596,4372,224,4.9
"40085",40,85,2004,4745,4460,285,6
"40085",40,85,2005,4751,4548,203,4.3
"40085",40,85,2006,4840,4672,168,3.5
"40085",40,85,2007,5098,4940,158,3.1
"40085",40,85,2008,5311,5157,154,2.9
"40085",40,85,2009,5603,5314,289,5.2
"40085",40,85,2010,4772,4500,272,5.7
"40085",40,85,2011,4915,4668,247,5
"40085",40,85,2012,5116,4899,217,4.2
"40085",40,85,2013,5251,5022,229,4.4
"40085",40,85,2014,5426,5231,195,3.6
"40085",40,85,2015,5978,5765,213,3.6
"40085",40,85,2016,6568,6361,207,3.2
"40085",40,85,2017,6607,6410,197,3
"40087",40,87,1990,11298,10708,590,5.2
"40087",40,87,1991,11061,10502,559,5.1
"40087",40,87,1992,11101,10575,526,4.7
"40087",40,87,1993,11274,10808,466,4.1
"40087",40,87,1994,11541,11089,452,3.9
"40087",40,87,1995,12044,11619,425,3.5
"40087",40,87,1996,12439,12012,427,3.4
"40087",40,87,1997,12624,12257,367,2.9
"40087",40,87,1998,12968,12549,419,3.2
"40087",40,87,1999,13389,13069,320,2.4
"40087",40,87,2000,13848,13498,350,2.5
"40087",40,87,2001,13975,13469,506,3.6
"40087",40,87,2002,14025,13420,605,4.3
"40087",40,87,2003,14041,13378,663,4.7
"40087",40,87,2004,14316,13692,624,4.4
"40087",40,87,2005,14736,14119,617,4.2
"40087",40,87,2006,14820,14278,542,3.7
"40087",40,87,2007,14734,14172,562,3.8
"40087",40,87,2008,14956,14413,543,3.6
"40087",40,87,2009,15172,14310,862,5.7
"40087",40,87,2010,17180,16223,957,5.6
"40087",40,87,2011,17256,16442,814,4.7
"40087",40,87,2012,17588,16852,736,4.2
"40087",40,87,2013,17828,17050,778,4.4
"40087",40,87,2014,18092,17425,667,3.7
"40087",40,87,2015,18756,18058,698,3.7
"40087",40,87,2016,18952,18171,781,4.1
"40087",40,87,2017,19030,18348,682,3.6
"40089",40,89,1990,13962,12686,1276,9.1
"40089",40,89,1991,14263,12558,1705,12
"40089",40,89,1992,14692,13438,1254,8.5
"40089",40,89,1993,14640,13376,1264,8.6
"40089",40,89,1994,14883,13509,1374,9.2
"40089",40,89,1995,14954,13583,1371,9.2
"40089",40,89,1996,14883,13505,1378,9.3
"40089",40,89,1997,14746,13397,1349,9.1
"40089",40,89,1998,15184,13950,1234,8.1
"40089",40,89,1999,15523,14491,1032,6.6
"40089",40,89,2000,14843,14142,701,4.7
"40089",40,89,2001,15629,14804,825,5.3
"40089",40,89,2002,14927,13948,979,6.6
"40089",40,89,2003,14739,13423,1316,8.9
"40089",40,89,2004,14675,13563,1112,7.6
"40089",40,89,2005,13953,13030,923,6.6
"40089",40,89,2006,13970,13113,857,6.1
"40089",40,89,2007,13853,12967,886,6.4
"40089",40,89,2008,14133,13194,939,6.6
"40089",40,89,2009,14761,13220,1541,10.4
"40089",40,89,2010,14544,12882,1662,11.4
"40089",40,89,2011,14754,13246,1508,10.2
"40089",40,89,2012,14471,13096,1375,9.5
"40089",40,89,2013,14336,12992,1344,9.4
"40089",40,89,2014,14136,12994,1142,8.1
"40089",40,89,2015,14740,13568,1172,8
"40089",40,89,2016,14805,13744,1061,7.2
"40089",40,89,2017,14830,13892,938,6.3
"40091",40,91,1990,6554,6149,405,6.2
"40091",40,91,1991,6592,5969,623,9.5
"40091",40,91,1992,6608,6044,564,8.5
"40091",40,91,1993,7003,6293,710,10.1
"40091",40,91,1994,7184,6448,736,10.2
"40091",40,91,1995,7124,6507,617,8.7
"40091",40,91,1996,7304,6750,554,7.6
"40091",40,91,1997,7420,6897,523,7
"40091",40,91,1998,7854,7221,633,8.1
"40091",40,91,1999,8055,7548,507,6.3
"40091",40,91,2000,7930,7572,358,4.5
"40091",40,91,2001,8058,7653,405,5
"40091",40,91,2002,8087,7584,503,6.2
"40091",40,91,2003,8245,7627,618,7.5
"40091",40,91,2004,8473,7903,570,6.7
"40091",40,91,2005,8398,7907,491,5.8
"40091",40,91,2006,8247,7824,423,5.1
"40091",40,91,2007,8498,8037,461,5.4
"40091",40,91,2008,8593,8180,413,4.8
"40091",40,91,2009,8914,8207,707,7.9
"40091",40,91,2010,7403,6592,811,11
"40091",40,91,2011,7394,6611,783,10.6
"40091",40,91,2012,7432,6677,755,10.2
"40091",40,91,2013,7397,6670,727,9.8
"40091",40,91,2014,7030,6383,647,9.2
"40091",40,91,2015,7085,6472,613,8.7
"40091",40,91,2016,7059,6428,631,8.9
"40091",40,91,2017,6934,6392,542,7.8
"40093",40,93,1990,3715,3559,156,4.2
"40093",40,93,1991,3686,3565,121,3.3
"40093",40,93,1992,3751,3607,144,3.8
"40093",40,93,1993,3737,3601,136,3.6
"40093",40,93,1994,3835,3709,126,3.3
"40093",40,93,1995,3939,3824,115,2.9
"40093",40,93,1996,3986,3859,127,3.2
"40093",40,93,1997,4034,3906,128,3.2
"40093",40,93,1998,4031,3889,142,3.5
"40093",40,93,1999,3933,3811,122,3.1
"40093",40,93,2000,4003,3910,93,2.3
"40093",40,93,2001,3841,3735,106,2.8
"40093",40,93,2002,3770,3648,122,3.2
"40093",40,93,2003,3843,3708,135,3.5
"40093",40,93,2004,3722,3604,118,3.2
"40093",40,93,2005,3659,3539,120,3.3
"40093",40,93,2006,3834,3727,107,2.8
"40093",40,93,2007,3967,3857,110,2.8
"40093",40,93,2008,4296,4195,101,2.4
"40093",40,93,2009,4335,4142,193,4.5
"40093",40,93,2010,3941,3743,198,5
"40093",40,93,2011,4051,3889,162,4
"40093",40,93,2012,4078,3935,143,3.5
"40093",40,93,2013,4130,3991,139,3.4
"40093",40,93,2014,4351,4239,112,2.6
"40093",40,93,2015,4298,4157,141,3.3
"40093",40,93,2016,3992,3827,165,4.1
"40093",40,93,2017,4011,3882,129,3.2
"40095",40,95,1990,4565,4283,282,6.2
"40095",40,95,1991,4494,4236,258,5.7
"40095",40,95,1992,4892,4592,300,6.1
"40095",40,95,1993,4995,4680,315,6.3
"40095",40,95,1994,5151,4854,297,5.8
"40095",40,95,1995,5197,4916,281,5.4
"40095",40,95,1996,5023,4790,233,4.6
"40095",40,95,1997,5046,4801,245,4.9
"40095",40,95,1998,5204,4907,297,5.7
"40095",40,95,1999,5419,5193,226,4.2
"40095",40,95,2000,5716,5507,209,3.7
"40095",40,95,2001,5679,5444,235,4.1
"40095",40,95,2002,5781,5510,271,4.7
"40095",40,95,2003,5925,5636,289,4.9
"40095",40,95,2004,6098,5801,297,4.9
"40095",40,95,2005,6110,5813,297,4.9
"40095",40,95,2006,6288,6030,258,4.1
"40095",40,95,2007,6379,6102,277,4.3
"40095",40,95,2008,6559,6294,265,4
"40095",40,95,2009,6564,6032,532,8.1
"40095",40,95,2010,6512,6043,469,7.2
"40095",40,95,2011,6687,6285,402,6
"40095",40,95,2012,6820,6423,397,5.8
"40095",40,95,2013,6956,6555,401,5.8
"40095",40,95,2014,6924,6591,333,4.8
"40095",40,95,2015,6783,6412,371,5.5
"40095",40,95,2016,6613,6278,335,5.1
"40095",40,95,2017,6548,6240,308,4.7
"40097",40,97,1990,14858,13774,1084,7.3
"40097",40,97,1991,14710,13270,1440,9.8
"40097",40,97,1992,14451,13129,1322,9.1
"40097",40,97,1993,14594,13395,1199,8.2
"40097",40,97,1994,14933,13902,1031,6.9
"40097",40,97,1995,15371,14576,795,5.2
"40097",40,97,1996,15716,15029,687,4.4
"40097",40,97,1997,14520,13839,681,4.7
"40097",40,97,1998,14964,14287,677,4.5
"40097",40,97,1999,16072,15417,655,4.1
"40097",40,97,2000,18004,17412,592,3.3
"40097",40,97,2001,17870,17124,746,4.2
"40097",40,97,2002,16826,15678,1148,6.8
"40097",40,97,2003,16491,15263,1228,7.4
"40097",40,97,2004,16385,15403,982,6
"40097",40,97,2005,16576,15756,820,4.9
"40097",40,97,2006,17274,16541,733,4.2
"40097",40,97,2007,18255,17468,787,4.3
"40097",40,97,2008,18542,17757,785,4.2
"40097",40,97,2009,18502,16929,1573,8.5
"40097",40,97,2010,18110,16516,1594,8.8
"40097",40,97,2011,18145,16768,1377,7.6
"40097",40,97,2012,18499,17368,1131,6.1
"40097",40,97,2013,18855,17764,1091,5.8
"40097",40,97,2014,18750,17836,914,4.9
"40097",40,97,2015,19402,18562,840,4.3
"40097",40,97,2016,19435,18443,992,5.1
"40097",40,97,2017,19145,18225,920,4.8
"40099",40,99,1990,5472,5016,456,8.3
"40099",40,99,1991,5608,5068,540,9.6
"40099",40,99,1992,5718,5098,620,10.8
"40099",40,99,1993,5624,5107,517,9.2
"40099",40,99,1994,5543,5042,501,9
"40099",40,99,1995,5680,5304,376,6.6
"40099",40,99,1996,5654,5277,377,6.7
"40099",40,99,1997,5748,5346,402,7
"40099",40,99,1998,5610,5232,378,6.7
"40099",40,99,1999,5441,5090,351,6.5
"40099",40,99,2000,6018,5810,208,3.5
"40099",40,99,2001,6026,5782,244,4
"40099",40,99,2002,5992,5701,291,4.9
"40099",40,99,2003,6053,5743,310,5.1
"40099",40,99,2004,6501,6210,291,4.5
"40099",40,99,2005,6999,6734,265,3.8
"40099",40,99,2006,7750,7517,233,3
"40099",40,99,2007,8113,7881,232,2.9
"40099",40,99,2008,8527,8300,227,2.7
"40099",40,99,2009,9250,8860,390,4.2
"40099",40,99,2010,6319,5929,390,6.2
"40099",40,99,2011,6484,6165,319,4.9
"40099",40,99,2012,6682,6374,308,4.6
"40099",40,99,2013,6474,6149,325,5
"40099",40,99,2014,6540,6266,274,4.2
"40099",40,99,2015,6765,6479,286,4.2
"40099",40,99,2016,6341,6055,286,4.5
"40099",40,99,2017,6428,6188,240,3.7
"40101",40,101,1990,29644,27787,1857,6.3
"40101",40,101,1991,29348,26859,2489,8.5
"40101",40,101,1992,29150,26968,2182,7.5
"40101",40,101,1993,29777,27416,2361,7.9
"40101",40,101,1994,30063,27544,2519,8.4
"40101",40,101,1995,29087,27140,1947,6.7
"40101",40,101,1996,29793,28080,1713,5.7
"40101",40,101,1997,30299,28477,1822,6
"40101",40,101,1998,31673,29625,2048,6.5
"40101",40,101,1999,31951,30546,1405,4.4
"40101",40,101,2000,28945,27838,1107,3.8
"40101",40,101,2001,28947,27712,1235,4.3
"40101",40,101,2002,30037,28483,1554,5.2
"40101",40,101,2003,28927,26868,2059,7.1
"40101",40,101,2004,28682,26695,1987,6.9
"40101",40,101,2005,29223,27483,1740,6
"40101",40,101,2006,29279,27783,1496,5.1
"40101",40,101,2007,29586,27955,1631,5.5
"40101",40,101,2008,29724,28319,1405,4.7
"40101",40,101,2009,31039,28697,2342,7.5
"40101",40,101,2010,29871,27410,2461,8.2
"40101",40,101,2011,29891,27680,2211,7.4
"40101",40,101,2012,30141,28116,2025,6.7
"40101",40,101,2013,29712,27790,1922,6.5
"40101",40,101,2014,29257,27582,1675,5.7
"40101",40,101,2015,29580,28057,1523,5.1
"40101",40,101,2016,29620,28002,1618,5.5
"40101",40,101,2017,29534,28007,1527,5.2
"40103",40,103,1990,5398,5175,223,4.1
"40103",40,103,1991,5364,5132,232,4.3
"40103",40,103,1992,5197,4978,219,4.2
"40103",40,103,1993,5295,5069,226,4.3
"40103",40,103,1994,5693,5502,191,3.4
"40103",40,103,1995,5622,5419,203,3.6
"40103",40,103,1996,5587,5400,187,3.3
"40103",40,103,1997,5835,5635,200,3.4
"40103",40,103,1998,5862,5668,194,3.3
"40103",40,103,1999,5734,5592,142,2.5
"40103",40,103,2000,5740,5609,131,2.3
"40103",40,103,2001,5531,5315,216,3.9
"40103",40,103,2002,5379,5139,240,4.5
"40103",40,103,2003,5288,5060,228,4.3
"40103",40,103,2004,5252,5045,207,3.9
"40103",40,103,2005,5400,5190,210,3.9
"40103",40,103,2006,5654,5457,197,3.5
"40103",40,103,2007,5932,5732,200,3.4
"40103",40,103,2008,5759,5571,188,3.3
"40103",40,103,2009,5903,5449,454,7.7
"40103",40,103,2010,5249,4894,355,6.8
"40103",40,103,2011,5340,5066,274,5.1
"40103",40,103,2012,5497,5254,243,4.4
"40103",40,103,2013,5474,5232,242,4.4
"40103",40,103,2014,5532,5329,203,3.7
"40103",40,103,2015,5640,5439,201,3.6
"40103",40,103,2016,5758,5554,204,3.5
"40103",40,103,2017,5784,5592,192,3.3
"40105",40,105,1990,4438,4218,220,5
"40105",40,105,1991,4311,3992,319,7.4
"40105",40,105,1992,4214,3922,292,6.9
"40105",40,105,1993,3990,3705,285,7.1
"40105",40,105,1994,3907,3640,267,6.8
"40105",40,105,1995,3801,3561,240,6.3
"40105",40,105,1996,3706,3423,283,7.6
"40105",40,105,1997,4066,3861,205,5
"40105",40,105,1998,3667,3466,201,5.5
"40105",40,105,1999,3754,3569,185,4.9
"40105",40,105,2000,4865,4700,165,3.4
"40105",40,105,2001,4832,4625,207,4.3
"40105",40,105,2002,4912,4637,275,5.6
"40105",40,105,2003,4937,4635,302,6.1
"40105",40,105,2004,4885,4606,279,5.7
"40105",40,105,2005,4859,4607,252,5.2
"40105",40,105,2006,4786,4568,218,4.6
"40105",40,105,2007,4912,4668,244,5
"40105",40,105,2008,5027,4811,216,4.3
"40105",40,105,2009,5225,4770,455,8.7
"40105",40,105,2010,4905,4449,456,9.3
"40105",40,105,2011,4910,4518,392,8
"40105",40,105,2012,4921,4585,336,6.8
"40105",40,105,2013,4820,4494,326,6.8
"40105",40,105,2014,4748,4458,290,6.1
"40105",40,105,2015,4798,4524,274,5.7
"40105",40,105,2016,4686,4400,286,6.1
"40105",40,105,2017,4618,4365,253,5.5
"40107",40,107,1990,4420,4090,330,7.5
"40107",40,107,1991,4319,3938,381,8.8
"40107",40,107,1992,4557,4159,398,8.7
"40107",40,107,1993,4495,4074,421,9.4
"40107",40,107,1994,4363,4020,343,7.9
"40107",40,107,1995,4303,4027,276,6.4
"40107",40,107,1996,4396,4146,250,5.7
"40107",40,107,1997,4548,4309,239,5.3
"40107",40,107,1998,4166,3882,284,6.8
"40107",40,107,1999,3719,3502,217,5.8
"40107",40,107,2000,4537,4363,174,3.8
"40107",40,107,2001,4749,4550,199,4.2
"40107",40,107,2002,4816,4544,272,5.6
"40107",40,107,2003,4658,4278,380,8.2
"40107",40,107,2004,4574,4179,395,8.6
"40107",40,107,2005,4482,4162,320,7.1
"40107",40,107,2006,4479,4234,245,5.5
"40107",40,107,2007,4665,4434,231,5
"40107",40,107,2008,4596,4405,191,4.2
"40107",40,107,2009,4804,4416,388,8.1
"40107",40,107,2010,4354,3928,426,9.8
"40107",40,107,2011,4420,4042,378,8.6
"40107",40,107,2012,4416,4079,337,7.6
"40107",40,107,2013,4423,4110,313,7.1
"40107",40,107,2014,4447,4179,268,6
"40107",40,107,2015,4543,4276,267,5.9
"40107",40,107,2016,4552,4274,278,6.1
"40107",40,107,2017,4473,4201,272,6.1
"40109",40,109,1990,310403,292669,17734,5.7
"40109",40,109,1991,303441,286310,17131,5.6
"40109",40,109,1992,304810,287191,17619,5.8
"40109",40,109,1993,305784,289415,16369,5.4
"40109",40,109,1994,308078,293241,14837,4.8
"40109",40,109,1995,312365,300212,12153,3.9
"40109",40,109,1996,320149,308456,11693,3.7
"40109",40,109,1997,323339,312008,11331,3.5
"40109",40,109,1998,327705,315606,12099,3.7
"40109",40,109,1999,333712,324395,9317,2.8
"40109",40,109,2000,326691,317386,9305,2.8
"40109",40,109,2001,330780,317977,12803,3.9
"40109",40,109,2002,333340,317810,15530,4.7
"40109",40,109,2003,330607,312633,17974,5.4
"40109",40,109,2004,332239,316240,15999,4.8
"40109",40,109,2005,333282,317817,15465,4.6
"40109",40,109,2006,328518,314706,13812,4.2
"40109",40,109,2007,323354,309044,14310,4.4
"40109",40,109,2008,324124,311404,12720,3.9
"40109",40,109,2009,325899,305990,19909,6.1
"40109",40,109,2010,354254,332486,21768,6.1
"40109",40,109,2011,357336,338450,18886,5.3
"40109",40,109,2012,365892,348402,17490,4.8
"40109",40,109,2013,368547,350727,17820,4.8
"40109",40,109,2014,369067,353620,15447,4.2
"40109",40,109,2015,374832,360036,14796,3.9
"40109",40,109,2016,374974,358861,16113,4.3
"40109",40,109,2017,378076,362857,15219,4
"40111",40,111,1990,15401,13977,1424,9.2
"40111",40,111,1991,15132,13610,1522,10.1
"40111",40,111,1992,14757,13184,1573,10.7
"40111",40,111,1993,15032,13408,1624,10.8
"40111",40,111,1994,15267,13707,1560,10.2
"40111",40,111,1995,14939,13379,1560,10.4
"40111",40,111,1996,14662,13383,1279,8.7
"40111",40,111,1997,15026,13768,1258,8.4
"40111",40,111,1998,14685,13354,1331,9.1
"40111",40,111,1999,14374,13315,1059,7.4
"40111",40,111,2000,17104,16350,754,4.4
"40111",40,111,2001,17067,16263,804,4.7
"40111",40,111,2002,16999,16014,985,5.8
"40111",40,111,2003,16876,15581,1295,7.7
"40111",40,111,2004,16810,15616,1194,7.1
"40111",40,111,2005,16816,15751,1065,6.3
"40111",40,111,2006,16548,15642,906,5.5
"40111",40,111,2007,16063,15177,886,5.5
"40111",40,111,2008,15956,15117,839,5.3
"40111",40,111,2009,15877,14437,1440,9.1
"40111",40,111,2010,16887,15235,1652,9.8
"40111",40,111,2011,16537,15045,1492,9
"40111",40,111,2012,16557,15245,1312,7.9
"40111",40,111,2013,16247,15017,1230,7.6
"40111",40,111,2014,15971,14887,1084,6.8
"40111",40,111,2015,16221,15136,1085,6.7
"40111",40,111,2016,16150,14988,1162,7.2
"40111",40,111,2017,16147,15131,1016,6.3
"40113",40,113,1990,19133,18253,880,4.6
"40113",40,113,1991,18797,17884,913,4.9
"40113",40,113,1992,18824,17901,923,4.9
"40113",40,113,1993,19054,18024,1030,5.4
"40113",40,113,1994,19128,18202,926,4.8
"40113",40,113,1995,18986,18269,717,3.8
"40113",40,113,1996,19291,18604,687,3.6
"40113",40,113,1997,19840,19024,816,4.1
"40113",40,113,1998,20326,19557,769,3.8
"40113",40,113,1999,20359,19609,750,3.7
"40113",40,113,2000,20837,20183,654,3.1
"40113",40,113,2001,21001,20287,714,3.4
"40113",40,113,2002,21074,20010,1064,5
"40113",40,113,2003,20684,19421,1263,6.1
"40113",40,113,2004,20530,19442,1088,5.3
"40113",40,113,2005,20773,19775,998,4.8
"40113",40,113,2006,20576,19727,849,4.1
"40113",40,113,2007,20153,19310,843,4.2
"40113",40,113,2008,20095,19259,836,4.2
"40113",40,113,2009,19661,18182,1479,7.5
"40113",40,113,2010,21250,19601,1649,7.8
"40113",40,113,2011,21263,19824,1439,6.8
"40113",40,113,2012,21335,20089,1246,5.8
"40113",40,113,2013,21114,19885,1229,5.8
"40113",40,113,2014,20940,19866,1074,5.1
"40113",40,113,2015,21221,20101,1120,5.3
"40113",40,113,2016,21061,19848,1213,5.8
"40113",40,113,2017,21127,20043,1084,5.1
"40115",40,115,1990,13617,12372,1245,9.1
"40115",40,115,1991,13061,11870,1191,9.1
"40115",40,115,1992,12933,11866,1067,8.3
"40115",40,115,1993,13370,12398,972,7.3
"40115",40,115,1994,13123,12291,832,6.3
"40115",40,115,1995,13399,12579,820,6.1
"40115",40,115,1996,13226,12343,883,6.7
"40115",40,115,1997,13438,12479,959,7.1
"40115",40,115,1998,13108,12214,894,6.8
"40115",40,115,1999,13393,12728,665,5
"40115",40,115,2000,15603,14899,704,4.5
"40115",40,115,2001,15581,14707,874,5.6
"40115",40,115,2002,15092,14050,1042,6.9
"40115",40,115,2003,15119,14014,1105,7.3
"40115",40,115,2004,15505,14601,904,5.8
"40115",40,115,2005,15985,15178,807,5
"40115",40,115,2006,16504,15737,767,4.6
"40115",40,115,2007,16941,16105,836,4.9
"40115",40,115,2008,17833,17082,751,4.2
"40115",40,115,2009,18667,17508,1159,6.2
"40115",40,115,2010,14559,13386,1173,8.1
"40115",40,115,2011,14313,13234,1079,7.5
"40115",40,115,2012,14573,13429,1144,7.9
"40115",40,115,2013,14143,13005,1138,8
"40115",40,115,2014,13787,12855,932,6.8
"40115",40,115,2015,14372,13634,738,5.1
"40115",40,115,2016,14462,13734,728,5
"40115",40,115,2017,14461,13819,642,4.4
"40117",40,117,1990,7449,7000,449,6
"40117",40,117,1991,6694,6098,596,8.9
"40117",40,117,1992,6799,6155,644,9.5
"40117",40,117,1993,6857,6140,717,10.5
"40117",40,117,1994,6802,6085,717,10.5
"40117",40,117,1995,6594,6086,508,7.7
"40117",40,117,1996,6648,6230,418,6.3
"40117",40,117,1997,6334,5929,405,6.4
"40117",40,117,1998,6264,5892,372,5.9
"40117",40,117,1999,6443,6105,338,5.2
"40117",40,117,2000,7924,7634,290,3.7
"40117",40,117,2001,7975,7661,314,3.9
"40117",40,117,2002,7962,7526,436,5.5
"40117",40,117,2003,7853,7325,528,6.7
"40117",40,117,2004,7762,7311,451,5.8
"40117",40,117,2005,7798,7410,388,5
"40117",40,117,2006,7681,7364,317,4.1
"40117",40,117,2007,7376,7042,334,4.5
"40117",40,117,2008,7295,6969,326,4.5
"40117",40,117,2009,7314,6689,625,8.5
"40117",40,117,2010,7675,6975,700,9.1
"40117",40,117,2011,7606,7010,596,7.8
"40117",40,117,2012,7508,7015,493,6.6
"40117",40,117,2013,7389,6942,447,6
"40117",40,117,2014,7294,6908,386,5.3
"40117",40,117,2015,7472,7035,437,5.8
"40117",40,117,2016,7490,6992,498,6.6
"40117",40,117,2017,7453,7053,400,5.4
"40119",40,119,1990,30838,29237,1601,5.2
"40119",40,119,1991,30060,28640,1420,4.7
"40119",40,119,1992,32684,31717,967,3
"40119",40,119,1993,33237,32286,951,2.9
"40119",40,119,1994,33833,32812,1021,3
"40119",40,119,1995,34571,33817,754,2.2
"40119",40,119,1996,35342,34680,662,1.9
"40119",40,119,1997,35030,34375,655,1.9
"40119",40,119,1998,35864,35219,645,1.8
"40119",40,119,1999,37676,37195,481,1.3
"40119",40,119,2000,36200,35314,886,2.4
"40119",40,119,2001,35058,34070,988,2.8
"40119",40,119,2002,34813,33622,1191,3.4
"40119",40,119,2003,34808,33393,1415,4.1
"40119",40,119,2004,34477,33145,1332,3.9
"40119",40,119,2005,35044,33658,1386,4
"40119",40,119,2006,35561,34276,1285,3.6
"40119",40,119,2007,37680,36285,1395,3.7
"40119",40,119,2008,35070,33687,1383,3.9
"40119",40,119,2009,35291,33145,2146,6.1
"40119",40,119,2010,36872,34758,2114,5.7
"40119",40,119,2011,36823,34988,1835,5
"40119",40,119,2012,37929,36149,1780,4.7
"40119",40,119,2013,37539,35878,1661,4.4
"40119",40,119,2014,38328,36893,1435,3.7
"40119",40,119,2015,38386,37031,1355,3.5
"40119",40,119,2016,38895,37447,1448,3.7
"40119",40,119,2017,38565,37164,1401,3.6
"40121",40,121,1990,17406,15856,1550,8.9
"40121",40,121,1991,18340,16375,1965,10.7
"40121",40,121,1992,17959,15874,2085,11.6
"40121",40,121,1993,18337,16330,2007,10.9
"40121",40,121,1994,17993,16051,1942,10.8
"40121",40,121,1995,17660,16164,1496,8.5
"40121",40,121,1996,17480,16260,1220,7
"40121",40,121,1997,17893,16556,1337,7.5
"40121",40,121,1998,17486,16081,1405,8
"40121",40,121,1999,18066,16924,1142,6.3
"40121",40,121,2000,17692,16912,780,4.4
"40121",40,121,2001,17941,17160,781,4.4
"40121",40,121,2002,18540,17431,1109,6
"40121",40,121,2003,19488,18255,1233,6.3
"40121",40,121,2004,19702,18613,1089,5.5
"40121",40,121,2005,20192,19201,991,4.9
"40121",40,121,2006,21424,20556,868,4.1
"40121",40,121,2007,22653,21777,876,3.9
"40121",40,121,2008,23856,23090,766,3.2
"40121",40,121,2009,23615,22159,1456,6.2
"40121",40,121,2010,18930,17385,1545,8.2
"40121",40,121,2011,19051,17653,1398,7.3
"40121",40,121,2012,19047,17719,1328,7
"40121",40,121,2013,17988,16675,1313,7.3
"40121",40,121,2014,17136,16084,1052,6.1
"40121",40,121,2015,17434,16438,996,5.7
"40121",40,121,2016,17627,16542,1085,6.2
"40121",40,121,2017,17645,16699,946,5.4
"40123",40,123,1990,15943,14885,1058,6.6
"40123",40,123,1991,15818,14548,1270,8
"40123",40,123,1992,15823,14671,1152,7.3
"40123",40,123,1993,16191,15151,1040,6.4
"40123",40,123,1994,15992,15103,889,5.6
"40123",40,123,1995,16358,15288,1070,6.5
"40123",40,123,1996,16298,15428,870,5.3
"40123",40,123,1997,16657,15862,795,4.8
"40123",40,123,1998,16906,16035,871,5.2
"40123",40,123,1999,17254,16674,580,3.4
"40123",40,123,2000,16705,16162,543,3.3
"40123",40,123,2001,16690,16037,653,3.9
"40123",40,123,2002,16837,16039,798,4.7
"40123",40,123,2003,17894,17004,890,5
"40123",40,123,2004,17725,16692,1033,5.8
"40123",40,123,2005,18664,17853,811,4.3
"40123",40,123,2006,20081,19367,714,3.6
"40123",40,123,2007,20008,19289,719,3.6
"40123",40,123,2008,20294,19652,642,3.2
"40123",40,123,2009,20817,19694,1123,5.4
"40123",40,123,2010,17733,16637,1096,6.2
"40123",40,123,2011,18124,17141,983,5.4
"40123",40,123,2012,18279,17351,928,5.1
"40123",40,123,2013,17768,16797,971,5.5
"40123",40,123,2014,17736,16969,767,4.3
"40123",40,123,2015,18244,17516,728,4
"40123",40,123,2016,18450,17697,753,4.1
"40123",40,123,2017,18730,18019,711,3.8
"40125",40,125,1990,26737,25082,1655,6.2
"40125",40,125,1991,26270,24389,1881,7.2
"40125",40,125,1992,26046,24431,1615,6.2
"40125",40,125,1993,26172,24707,1465,5.6
"40125",40,125,1994,26284,24841,1443,5.5
"40125",40,125,1995,26774,25593,1181,4.4
"40125",40,125,1996,27885,26556,1329,4.8
"40125",40,125,1997,28052,26730,1322,4.7
"40125",40,125,1998,28617,27172,1445,5
"40125",40,125,1999,29012,27928,1084,3.7
"40125",40,125,2000,30199,29245,954,3.2
"40125",40,125,2001,30029,28709,1320,4.4
"40125",40,125,2002,29975,28515,1460,4.9
"40125",40,125,2003,30090,28376,1714,5.7
"40125",40,125,2004,30410,28739,1671,5.5
"40125",40,125,2005,30845,29211,1634,5.3
"40125",40,125,2006,31979,30567,1412,4.4
"40125",40,125,2007,32774,31409,1365,4.2
"40125",40,125,2008,33003,31730,1273,3.9
"40125",40,125,2009,33761,31635,2126,6.3
"40125",40,125,2010,30998,28845,2153,6.9
"40125",40,125,2011,31369,29492,1877,6
"40125",40,125,2012,32072,30370,1702,5.3
"40125",40,125,2013,32121,30370,1751,5.5
"40125",40,125,2014,32075,30558,1517,4.7
"40125",40,125,2015,32739,31263,1476,4.5
"40125",40,125,2016,33050,31518,1532,4.6
"40125",40,125,2017,33062,31685,1377,4.2
"40127",40,127,1990,4303,3907,396,9.2
"40127",40,127,1991,4311,3848,463,10.7
"40127",40,127,1992,4571,4167,404,8.8
"40127",40,127,1993,4906,4507,399,8.1
"40127",40,127,1994,4973,4566,407,8.2
"40127",40,127,1995,5012,4622,390,7.8
"40127",40,127,1996,5245,4924,321,6.1
"40127",40,127,1997,4992,4690,302,6
"40127",40,127,1998,5124,4781,343,6.7
"40127",40,127,1999,5005,4739,266,5.3
"40127",40,127,2000,4656,4457,199,4.3
"40127",40,127,2001,4771,4486,285,6
"40127",40,127,2002,4753,4423,330,6.9
"40127",40,127,2003,5235,4853,382,7.3
"40127",40,127,2004,5014,4694,320,6.4
"40127",40,127,2005,5299,5033,266,5
"40127",40,127,2006,5512,5277,235,4.3
"40127",40,127,2007,5226,4969,257,4.9
"40127",40,127,2008,5253,5000,253,4.8
"40127",40,127,2009,5537,5078,459,8.3
"40127",40,127,2010,4984,4495,489,9.8
"40127",40,127,2011,4952,4523,429,8.7
"40127",40,127,2012,4866,4514,352,7.2
"40127",40,127,2013,4709,4291,418,8.9
"40127",40,127,2014,4690,4340,350,7.5
"40127",40,127,2015,4913,4530,383,7.8
"40127",40,127,2016,4875,4519,356,7.3
"40127",40,127,2017,4774,4479,295,6.2
"40129",40,129,1990,2003,1912,91,4.5
"40129",40,129,1991,1970,1870,100,5.1
"40129",40,129,1992,1998,1915,83,4.2
"40129",40,129,1993,2106,2027,79,3.8
"40129",40,129,1994,2083,2010,73,3.5
"40129",40,129,1995,1980,1922,58,2.9
"40129",40,129,1996,1954,1900,54,2.8
"40129",40,129,1997,1991,1932,59,3
"40129",40,129,1998,2059,1971,88,4.3
"40129",40,129,1999,1980,1912,68,3.4
"40129",40,129,2000,1831,1787,44,2.4
"40129",40,129,2001,1814,1771,43,2.4
"40129",40,129,2002,1828,1770,58,3.2
"40129",40,129,2003,1949,1897,52,2.7
"40129",40,129,2004,1877,1826,51,2.7
"40129",40,129,2005,1829,1778,51,2.8
"40129",40,129,2006,1791,1744,47,2.6
"40129",40,129,2007,1869,1818,51,2.7
"40129",40,129,2008,1943,1898,45,2.3
"40129",40,129,2009,1943,1856,87,4.5
"40129",40,129,2010,1797,1715,82,4.6
"40129",40,129,2011,1902,1841,61,3.2
"40129",40,129,2012,2107,2047,60,2.8
"40129",40,129,2013,1878,1818,60,3.2
"40129",40,129,2014,1792,1742,50,2.8
"40129",40,129,2015,1838,1760,78,4.2
"40129",40,129,2016,1811,1718,93,5.1
"40129",40,129,2017,1872,1811,61,3.3
"40131",40,131,1990,28655,26988,1667,5.8
"40131",40,131,1991,29123,26918,2205,7.6
"40131",40,131,1992,29225,27260,1965,6.7
"40131",40,131,1993,30053,27930,2123,7.1
"40131",40,131,1994,30932,28849,2083,6.7
"40131",40,131,1995,31053,29675,1378,4.4
"40131",40,131,1996,32109,31015,1094,3.4
"40131",40,131,1997,33764,32653,1111,3.3
"40131",40,131,1998,35570,34406,1164,3.3
"40131",40,131,1999,36860,35731,1129,3.1
"40131",40,131,2000,36130,35173,957,2.6
"40131",40,131,2001,37014,35892,1122,3
"40131",40,131,2002,37929,36248,1681,4.4
"40131",40,131,2003,38305,36151,2154,5.6
"40131",40,131,2004,38844,37089,1755,4.5
"40131",40,131,2005,39849,38256,1593,4
"40131",40,131,2006,40320,38843,1477,3.7
"40131",40,131,2007,39870,38352,1518,3.8
"40131",40,131,2008,40243,38831,1412,3.5
"40131",40,131,2009,40405,37610,2795,6.9
"40131",40,131,2010,43377,40402,2975,6.9
"40131",40,131,2011,43070,40594,2476,5.7
"40131",40,131,2012,43833,41652,2181,5
"40131",40,131,2013,43827,41595,2232,5.1
"40131",40,131,2014,43648,41814,1834,4.2
"40131",40,131,2015,44610,42651,1959,4.4
"40131",40,131,2016,44867,42612,2255,5
"40131",40,131,2017,45043,43053,1990,4.4
"40133",40,133,1990,10446,9491,955,9.1
"40133",40,133,1991,10421,9323,1098,10.5
"40133",40,133,1992,10763,9698,1065,9.9
"40133",40,133,1993,10906,9965,941,8.6
"40133",40,133,1994,10778,9775,1003,9.3
"40133",40,133,1995,10526,9656,870,8.3
"40133",40,133,1996,10446,9613,833,8
"40133",40,133,1997,10310,9490,820,8
"40133",40,133,1998,10142,9181,961,9.5
"40133",40,133,1999,10063,9347,716,7.1
"40133",40,133,2000,10424,9982,442,4.2
"40133",40,133,2001,10655,10149,506,4.7
"40133",40,133,2002,10605,9889,716,6.8
"40133",40,133,2003,10600,9664,936,8.8
"40133",40,133,2004,10218,9213,1005,9.8
"40133",40,133,2005,10067,9365,702,7
"40133",40,133,2006,10296,9712,584,5.7
"40133",40,133,2007,10568,9991,577,5.5
"40133",40,133,2008,11033,10538,495,4.5
"40133",40,133,2009,11155,10198,957,8.6
"40133",40,133,2010,9927,8974,953,9.6
"40133",40,133,2011,9974,9144,830,8.3
"40133",40,133,2012,10003,9219,784,7.8
"40133",40,133,2013,9739,8943,796,8.2
"40133",40,133,2014,9554,8900,654,6.8
"40133",40,133,2015,9606,8949,657,6.8
"40133",40,133,2016,9439,8785,654,6.9
"40133",40,133,2017,9338,8791,547,5.9
"40135",40,135,1990,15568,14292,1276,8.2
"40135",40,135,1991,15501,13960,1541,9.9
"40135",40,135,1992,15539,14267,1272,8.2
"40135",40,135,1993,15959,14616,1343,8.4
"40135",40,135,1994,16382,14998,1384,8.4
"40135",40,135,1995,16395,15237,1158,7.1
"40135",40,135,1996,16577,15486,1091,6.6
"40135",40,135,1997,17201,15822,1379,8
"40135",40,135,1998,17534,15970,1564,8.9
"40135",40,135,1999,17411,16525,886,5.1
"40135",40,135,2000,17195,16460,735,4.3
"40135",40,135,2001,17387,16534,853,4.9
"40135",40,135,2002,17681,16614,1067,6
"40135",40,135,2003,17876,16694,1182,6.6
"40135",40,135,2004,18000,16905,1095,6.1
"40135",40,135,2005,18051,17065,986,5.5
"40135",40,135,2006,18381,17385,996,5.4
"40135",40,135,2007,17912,16872,1040,5.8
"40135",40,135,2008,17693,16646,1047,5.9
"40135",40,135,2009,17613,15937,1676,9.5
"40135",40,135,2010,18100,16363,1737,9.6
"40135",40,135,2011,17481,15871,1610,9.2
"40135",40,135,2012,17245,15807,1438,8.3
"40135",40,135,2013,16866,15454,1412,8.4
"40135",40,135,2014,16660,15520,1140,6.8
"40135",40,135,2015,16778,15711,1067,6.4
"40135",40,135,2016,16837,15781,1056,6.3
"40135",40,135,2017,16575,15662,913,5.5
"40137",40,137,1990,18731,17805,926,4.9
"40137",40,137,1991,19293,17997,1296,6.7
"40137",40,137,1992,18748,17369,1379,7.4
"40137",40,137,1993,18401,17253,1148,6.2
"40137",40,137,1994,18455,16825,1630,8.8
"40137",40,137,1995,17684,16405,1279,7.2
"40137",40,137,1996,17510,16748,762,4.4
"40137",40,137,1997,17896,17163,733,4.1
"40137",40,137,1998,18194,17206,988,5.4
"40137",40,137,1999,17976,16839,1137,6.3
"40137",40,137,2000,19298,18659,639,3.3
"40137",40,137,2001,19410,18717,693,3.6
"40137",40,137,2002,19444,18511,933,4.8
"40137",40,137,2003,19631,18645,986,5
"40137",40,137,2004,19423,18534,889,4.6
"40137",40,137,2005,20015,19212,803,4
"40137",40,137,2006,20861,20137,724,3.5
"40137",40,137,2007,21561,20776,785,3.6
"40137",40,137,2008,22202,21435,767,3.5
"40137",40,137,2009,22197,20552,1645,7.4
"40137",40,137,2010,19981,18420,1561,7.8
"40137",40,137,2011,20405,19214,1191,5.8
"40137",40,137,2012,20591,19580,1011,4.9
"40137",40,137,2013,20607,19493,1114,5.4
"40137",40,137,2014,20268,19364,904,4.5
"40137",40,137,2015,20278,19061,1217,6
"40137",40,137,2016,19022,17212,1810,9.5
"40137",40,137,2017,18256,17115,1141,6.3
"40139",40,139,1990,8517,8155,362,4.3
"40139",40,139,1991,8340,8013,327,3.9
"40139",40,139,1992,8545,8244,301,3.5
"40139",40,139,1993,8685,8422,263,3
"40139",40,139,1994,8993,8717,276,3.1
"40139",40,139,1995,9544,9286,258,2.7
"40139",40,139,1996,11668,11392,276,2.4
"40139",40,139,1997,13479,13170,309,2.3
"40139",40,139,1998,13937,13568,369,2.6
"40139",40,139,1999,14236,13925,311,2.2
"40139",40,139,2000,10605,10330,275,2.6
"40139",40,139,2001,10612,10322,290,2.7
"40139",40,139,2002,10343,10007,336,3.2
"40139",40,139,2003,10447,10088,359,3.4
"40139",40,139,2004,10050,9712,338,3.4
"40139",40,139,2005,9352,9011,341,3.6
"40139",40,139,2006,9095,8792,303,3.3
"40139",40,139,2007,9376,9081,295,3.1
"40139",40,139,2008,9752,9486,266,2.7
"40139",40,139,2009,7689,7291,398,5.2
"40139",40,139,2010,8600,8181,419,4.9
"40139",40,139,2011,8837,8448,389,4.4
"40139",40,139,2012,8991,8617,374,4.2
"40139",40,139,2013,9289,8882,407,4.4
"40139",40,139,2014,9332,8988,344,3.7
"40139",40,139,2015,9692,9379,313,3.2
"40139",40,139,2016,9397,9078,319,3.4
"40139",40,139,2017,9385,9090,295,3.1
"40141",40,141,1990,4320,4068,252,5.8
"40141",40,141,1991,4279,3941,338,7.9
"40141",40,141,1992,4309,4021,288,6.7
"40141",40,141,1993,4183,3903,280,6.7
"40141",40,141,1994,4257,4027,230,5.4
"40141",40,141,1995,4053,3833,220,5.4
"40141",40,141,1996,3937,3759,178,4.5
"40141",40,141,1997,3833,3630,203,5.3
"40141",40,141,1998,3714,3518,196,5.3
"40141",40,141,1999,3539,3391,148,4.2
"40141",40,141,2000,3802,3681,121,3.2
"40141",40,141,2001,3697,3546,151,4.1
"40141",40,141,2002,3805,3649,156,4.1
"40141",40,141,2003,3765,3595,170,4.5
"40141",40,141,2004,3617,3449,168,4.6
"40141",40,141,2005,3481,3313,168,4.8
"40141",40,141,2006,3485,3336,149,4.3
"40141",40,141,2007,3456,3295,161,4.7
"40141",40,141,2008,3521,3377,144,4.1
"40141",40,141,2009,3567,3318,249,7
"40141",40,141,2010,3407,3195,212,6.2
"40141",40,141,2011,3356,3160,196,5.8
"40141",40,141,2012,3415,3250,165,4.8
"40141",40,141,2013,3369,3187,182,5.4
"40141",40,141,2014,3290,3137,153,4.7
"40141",40,141,2015,3358,3214,144,4.3
"40141",40,141,2016,3311,3164,147,4.4
"40141",40,141,2017,3263,3123,140,4.3
"40143",40,143,1990,270249,258527,11722,4.3
"40143",40,143,1991,270354,256219,14135,5.2
"40143",40,143,1992,271512,256839,14673,5.4
"40143",40,143,1993,273424,256949,16475,6
"40143",40,143,1994,276348,261388,14960,5.4
"40143",40,143,1995,274852,263907,10945,4
"40143",40,143,1996,280396,271348,9048,3.2
"40143",40,143,1997,289746,280008,9738,3.4
"40143",40,143,1998,298233,288852,9381,3.1
"40143",40,143,1999,301682,291713,9969,3.3
"40143",40,143,2000,296763,288526,8237,2.8
"40143",40,143,2001,297963,288031,9932,3.3
"40143",40,143,2002,299478,285118,14360,4.8
"40143",40,143,2003,293867,276855,17012,5.8
"40143",40,143,2004,291106,277094,14012,4.8
"40143",40,143,2005,293516,281404,12112,4.1
"40143",40,143,2006,293841,282712,11129,3.8
"40143",40,143,2007,291603,280376,11227,3.9
"40143",40,143,2008,293722,283155,10567,3.6
"40143",40,143,2009,293653,274468,19185,6.5
"40143",40,143,2010,306671,285120,21551,7
"40143",40,143,2011,304059,285655,18404,6.1
"40143",40,143,2012,310018,294043,15975,5.2
"40143",40,143,2013,311042,295184,15858,5.1
"40143",40,143,2014,311137,297777,13360,4.3
"40143",40,143,2015,317847,304659,13188,4.1
"40143",40,143,2016,318096,303249,14847,4.7
"40143",40,143,2017,319989,306261,13728,4.3
"40145",40,145,1990,24388,23280,1108,4.5
"40145",40,145,1991,24399,23045,1354,5.5
"40145",40,145,1992,24579,23149,1430,5.8
"40145",40,145,1993,24950,23596,1354,5.4
"40145",40,145,1994,25619,24352,1267,4.9
"40145",40,145,1995,25835,24845,990,3.8
"40145",40,145,1996,26677,25854,823,3.1
"40145",40,145,1997,27602,26775,827,3
"40145",40,145,1998,28694,27794,900,3.1
"40145",40,145,1999,29065,28269,796,2.7
"40145",40,145,2000,29473,28723,750,2.5
"40145",40,145,2001,30011,29122,889,3
"40145",40,145,2002,30709,29432,1277,4.2
"40145",40,145,2003,30818,29150,1668,5.4
"40145",40,145,2004,31214,29747,1467,4.7
"40145",40,145,2005,31999,30692,1307,4.1
"40145",40,145,2006,32728,31542,1186,3.6
"40145",40,145,2007,32564,31324,1240,3.8
"40145",40,145,2008,33266,32065,1201,3.6
"40145",40,145,2009,33375,31202,2173,6.5
"40145",40,145,2010,35268,32877,2391,6.8
"40145",40,145,2011,35134,33069,2065,5.9
"40145",40,145,2012,36015,34148,1867,5.2
"40145",40,145,2013,35929,34108,1821,5.1
"40145",40,145,2014,35533,34024,1509,4.2
"40145",40,145,2015,36246,34719,1527,4.2
"40145",40,145,2016,36601,34853,1748,4.8
"40145",40,145,2017,36823,35200,1623,4.4
"40147",40,147,1990,23161,22412,749,3.2
"40147",40,147,1991,22335,21505,830,3.7
"40147",40,147,1992,22540,21058,1482,6.6
"40147",40,147,1993,21046,19612,1434,6.8
"40147",40,147,1994,20489,19237,1252,6.1
"40147",40,147,1995,19814,18714,1100,5.6
"40147",40,147,1996,18895,18000,895,4.7
"40147",40,147,1997,21092,20291,801,3.8
"40147",40,147,1998,18738,18046,692,3.7
"40147",40,147,1999,19238,18457,781,4.1
"40147",40,147,2000,22852,22156,696,3
"40147",40,147,2001,23383,22647,736,3.1
"40147",40,147,2002,23195,22202,993,4.3
"40147",40,147,2003,24027,22781,1246,5.2
"40147",40,147,2004,24115,22914,1201,5
"40147",40,147,2005,24875,23847,1028,4.1
"40147",40,147,2006,25571,24692,879,3.4
"40147",40,147,2007,26923,25994,929,3.5
"40147",40,147,2008,27426,26590,836,3
"40147",40,147,2009,28235,26691,1544,5.5
"40147",40,147,2010,24142,22522,1620,6.7
"40147",40,147,2011,24203,22815,1388,5.7
"40147",40,147,2012,24602,23416,1186,4.8
"40147",40,147,2013,24628,23441,1187,4.8
"40147",40,147,2014,24425,23388,1037,4.2
"40147",40,147,2015,24453,23398,1055,4.3
"40147",40,147,2016,23924,22753,1171,4.9
"40147",40,147,2017,23143,22079,1064,4.6
"40149",40,149,1990,5182,4883,299,5.8
"40149",40,149,1991,5158,4866,292,5.7
"40149",40,149,1992,5233,4996,237,4.5
"40149",40,149,1993,5129,4914,215,4.2
"40149",40,149,1994,5263,5019,244,4.6
"40149",40,149,1995,5264,5092,172,3.3
"40149",40,149,1996,5140,4976,164,3.2
"40149",40,149,1997,5057,4896,161,3.2
"40149",40,149,1998,5042,4841,201,4
"40149",40,149,1999,4941,4753,188,3.8
"40149",40,149,2000,5561,5415,146,2.6
"40149",40,149,2001,5891,5723,168,2.9
"40149",40,149,2002,5777,5572,205,3.5
"40149",40,149,2003,5875,5660,215,3.7
"40149",40,149,2004,5817,5623,194,3.3
"40149",40,149,2005,5784,5590,194,3.4
"40149",40,149,2006,5795,5607,188,3.2
"40149",40,149,2007,5957,5777,180,3
"40149",40,149,2008,6140,5974,166,2.7
"40149",40,149,2009,6305,5952,353,5.6
"40149",40,149,2010,5459,5127,332,6.1
"40149",40,149,2011,5511,5264,247,4.5
"40149",40,149,2012,5651,5426,225,4
"40149",40,149,2013,5576,5342,234,4.2
"40149",40,149,2014,5594,5403,191,3.4
"40149",40,149,2015,5606,5294,312,5.6
"40149",40,149,2016,5320,4951,369,6.9
"40149",40,149,2017,5437,5195,242,4.5
"40151",40,151,1990,4354,4220,134,3.1
"40151",40,151,1991,4315,4196,119,2.8
"40151",40,151,1992,4381,4289,92,2.1
"40151",40,151,1993,4312,4200,112,2.6
"40151",40,151,1994,4415,4277,138,3.1
"40151",40,151,1995,4264,4175,89,2.1
"40151",40,151,1996,4247,4139,108,2.5
"40151",40,151,1997,4388,4275,113,2.6
"40151",40,151,1998,4491,4366,125,2.8
"40151",40,151,1999,4421,4336,85,1.9
"40151",40,151,2000,4569,4456,113,2.5
"40151",40,151,2001,4530,4409,121,2.7
"40151",40,151,2002,4631,4261,370,8
"40151",40,151,2003,4740,4296,444,9.4
"40151",40,151,2004,4613,4288,325,7
"40151",40,151,2005,4396,4093,303,6.9
"40151",40,151,2006,4276,4042,234,5.5
"40151",40,151,2007,4424,4163,261,5.9
"40151",40,151,2008,4343,4221,122,2.8
"40151",40,151,2009,4570,4378,192,4.2
"40151",40,151,2010,4289,4107,182,4.2
"40151",40,151,2011,4490,4336,154,3.4
"40151",40,151,2012,5075,4934,141,2.8
"40151",40,151,2013,5141,4974,167,3.2
"40151",40,151,2014,5281,5138,143,2.7
"40151",40,151,2015,5367,5219,148,2.8
"40151",40,151,2016,5217,5049,168,3.2
"40151",40,151,2017,4928,4797,131,2.7
"40153",40,153,1990,9387,8943,444,4.7
"40153",40,153,1991,8902,8393,509,5.7
"40153",40,153,1992,8828,8249,579,6.6
"40153",40,153,1993,9016,8510,506,5.6
"40153",40,153,1994,9221,8729,492,5.3
"40153",40,153,1995,9024,8591,433,4.8
"40153",40,153,1996,9177,8779,398,4.3
"40153",40,153,1997,9200,8819,381,4.1
"40153",40,153,1998,9511,9049,462,4.9
"40153",40,153,1999,8897,8374,523,5.9
"40153",40,153,2000,9189,8918,271,2.9
"40153",40,153,2001,9561,9282,279,2.9
"40153",40,153,2002,9490,9104,386,4.1
"40153",40,153,2003,9590,9171,419,4.4
"40153",40,153,2004,9708,9353,355,3.7
"40153",40,153,2005,10192,9850,342,3.4
"40153",40,153,2006,11190,10893,297,2.7
"40153",40,153,2007,12002,11686,316,2.6
"40153",40,153,2008,12604,12322,282,2.2
"40153",40,153,2009,11673,10952,721,6.2
"40153",40,153,2010,9355,8710,645,6.9
"40153",40,153,2011,9919,9457,462,4.7
"40153",40,153,2012,10597,10225,372,3.5
"40153",40,153,2013,10735,10355,380,3.5
"40153",40,153,2014,10748,10415,333,3.1
"40153",40,153,2015,10303,9769,534,5.2
"40153",40,153,2016,9514,8923,591,6.2
"40153",40,153,2017,9414,9018,396,4.2
"41001",41,1,1990,7055,6532,523,7.4
"41001",41,1,1991,7050,6481,569,8.1
"41001",41,1,1992,7224,6526,698,9.7
"41001",41,1,1993,7341,6660,681,9.3
"41001",41,1,1994,7486,6883,603,8.1
"41001",41,1,1995,7499,6891,608,8.1
"41001",41,1,1996,7626,6784,842,11
"41001",41,1,1997,7619,6866,753,9.9
"41001",41,1,1998,7664,6964,700,9.1
"41001",41,1,1999,7431,6809,622,8.4
"41001",41,1,2000,7304,6787,517,7.1
"41001",41,1,2001,7304,6682,622,8.5
"41001",41,1,2002,7361,6696,665,9
"41001",41,1,2003,7319,6626,693,9.5
"41001",41,1,2004,7225,6584,641,8.9
"41001",41,1,2005,7112,6585,527,7.4
"41001",41,1,2006,7215,6757,458,6.3
"41001",41,1,2007,7292,6870,422,5.8
"41001",41,1,2008,7442,6910,532,7.1
"41001",41,1,2009,7628,6836,792,10.4
"41001",41,1,2010,7361,6606,755,10.3
"41001",41,1,2011,7317,6523,794,10.9
"41001",41,1,2012,7096,6347,749,10.6
"41001",41,1,2013,6798,6142,656,9.6
"41001",41,1,2014,6704,6145,559,8.3
"41001",41,1,2015,6672,6222,450,6.7
"41001",41,1,2016,6957,6521,436,6.3
"41001",41,1,2017,7070,6684,386,5.5
"41003",41,3,1990,36175,34373,1802,5
"41003",41,3,1991,36193,34638,1555,4.3
"41003",41,3,1992,36454,34958,1496,4.1
"41003",41,3,1993,37653,36423,1230,3.3
"41003",41,3,1994,39577,38563,1014,2.6
"41003",41,3,1995,41648,40721,927,2.2
"41003",41,3,1996,42742,41631,1111,2.6
"41003",41,3,1997,42865,41835,1030,2.4
"41003",41,3,1998,42558,41180,1378,3.2
"41003",41,3,1999,40192,39014,1178,2.9
"41003",41,3,2000,41419,39828,1591,3.8
"41003",41,3,2001,41638,39775,1863,4.5
"41003",41,3,2002,41998,39782,2216,5.3
"41003",41,3,2003,42214,39771,2443,5.8
"41003",41,3,2004,42112,39822,2290,5.4
"41003",41,3,2005,41922,39870,2052,4.9
"41003",41,3,2006,42034,40070,1964,4.7
"41003",41,3,2007,42323,40576,1747,4.1
"41003",41,3,2008,43100,41076,2024,4.7
"41003",41,3,2009,43653,40175,3478,8
"41003",41,3,2010,45075,41873,3202,7.1
"41003",41,3,2011,45957,43019,2938,6.4
"41003",41,3,2012,44962,42263,2699,6
"41003",41,3,2013,43861,41356,2505,5.7
"41003",41,3,2014,44283,42041,2242,5.1
"41003",41,3,2015,45433,43515,1918,4.2
"41003",41,3,2016,46834,45004,1830,3.9
"41003",41,3,2017,48126,46556,1570,3.3
"41005",41,5,1990,156560,151147,5413,3.5
"41005",41,5,1991,160621,153542,7079,4.4
"41005",41,5,1992,164626,155485,9141,5.6
"41005",41,5,1993,170322,161461,8861,5.2
"41005",41,5,1994,177153,170582,6571,3.7
"41005",41,5,1995,180830,174970,5860,3.2
"41005",41,5,1996,187438,180324,7114,3.8
"41005",41,5,1997,193309,185881,7428,3.8
"41005",41,5,1998,195710,188571,7139,3.6
"41005",41,5,1999,197578,189846,7732,3.9
"41005",41,5,2000,188587,180982,7605,4
"41005",41,5,2001,188360,178475,9885,5.2
"41005",41,5,2002,188872,175866,13006,6.9
"41005",41,5,2003,188891,174728,14163,7.5
"41005",41,5,2004,189007,176395,12612,6.7
"41005",41,5,2005,190177,179708,10469,5.5
"41005",41,5,2006,194473,185211,9262,4.8
"41005",41,5,2007,196402,187434,8968,4.6
"41005",41,5,2008,200201,188750,11451,5.7
"41005",41,5,2009,202261,181250,21011,10.4
"41005",41,5,2010,202654,182280,20374,10.1
"41005",41,5,2011,204119,186047,18072,8.9
"41005",41,5,2012,200407,184288,16119,8
"41005",41,5,2013,196842,182940,13902,7.1
"41005",41,5,2014,200582,188244,12338,6.2
"41005",41,5,2015,205170,194664,10506,5.1
"41005",41,5,2016,212842,203624,9218,4.3
"41005",41,5,2017,218947,210756,8191,3.7
"41007",41,7,1990,16373,15224,1149,7
"41007",41,7,1991,16321,15087,1234,7.6
"41007",41,7,1992,16741,15313,1428,8.5
"41007",41,7,1993,17426,15978,1448,8.3
"41007",41,7,1994,17454,16347,1107,6.3
"41007",41,7,1995,17449,16562,887,5.1
"41007",41,7,1996,17525,16454,1071,6.1
"41007",41,7,1997,17854,16693,1161,6.5
"41007",41,7,1998,17835,16745,1090,6.1
"41007",41,7,1999,17634,16663,971,5.5
"41007",41,7,2000,17999,17104,895,5
"41007",41,7,2001,17988,16951,1037,5.8
"41007",41,7,2002,18088,16841,1247,6.9
"41007",41,7,2003,18450,17070,1380,7.5
"41007",41,7,2004,18724,17446,1278,6.8
"41007",41,7,2005,19123,18023,1100,5.8
"41007",41,7,2006,19151,18195,956,5
"41007",41,7,2007,19891,18962,929,4.7
"41007",41,7,2008,20373,19302,1071,5.3
"41007",41,7,2009,20725,18831,1894,9.1
"41007",41,7,2010,19078,17174,1904,10
"41007",41,7,2011,19036,17243,1793,9.4
"41007",41,7,2012,18539,16918,1621,8.7
"41007",41,7,2013,17859,16470,1389,7.8
"41007",41,7,2014,17998,16810,1188,6.6
"41007",41,7,2015,18351,17350,1001,5.5
"41007",41,7,2016,19037,18143,894,4.7
"41007",41,7,2017,19248,18453,795,4.1
"41009",41,9,1990,18404,17233,1171,6.4
"41009",41,9,1991,18833,17507,1326,7
"41009",41,9,1992,19581,17738,1843,9.4
"41009",41,9,1993,20252,18376,1876,9.3
"41009",41,9,1994,20735,19386,1349,6.5
"41009",41,9,1995,20900,19887,1013,4.8
"41009",41,9,1996,21858,20565,1293,5.9
"41009",41,9,1997,22442,21104,1338,6
"41009",41,9,1998,22821,21611,1210,5.3
"41009",41,9,1999,23315,21947,1368,5.9
"41009",41,9,2000,22582,21346,1236,5.5
"41009",41,9,2001,22764,21010,1754,7.7
"41009",41,9,2002,22969,20814,2155,9.4
"41009",41,9,2003,23176,20777,2399,10.4
"41009",41,9,2004,23061,20969,2092,9.1
"41009",41,9,2005,23209,21505,1704,7.3
"41009",41,9,2006,23671,22321,1350,5.7
"41009",41,9,2007,23745,22391,1354,5.7
"41009",41,9,2008,24202,22480,1722,7.1
"41009",41,9,2009,24640,21355,3285,13.3
"41009",41,9,2010,23649,20599,3050,12.9
"41009",41,9,2011,23569,20906,2663,11.3
"41009",41,9,2012,22920,20464,2456,10.7
"41009",41,9,2013,22297,20150,2147,9.6
"41009",41,9,2014,22351,20469,1882,8.4
"41009",41,9,2015,22682,21060,1622,7.2
"41009",41,9,2016,23635,22199,1436,6.1
"41009",41,9,2017,24224,22971,1253,5.2
"41011",41,11,1990,26775,24540,2235,8.3
"41011",41,11,1991,27028,24504,2524,9.3
"41011",41,11,1992,27392,24406,2986,10.9
"41011",41,11,1993,28063,25115,2948,10.5
"41011",41,11,1994,27979,25574,2405,8.6
"41011",41,11,1995,27805,25734,2071,7.4
"41011",41,11,1996,28259,25745,2514,8.9
"41011",41,11,1997,27927,25298,2629,9.4
"41011",41,11,1998,27929,25004,2925,10.5
"41011",41,11,1999,27497,25124,2373,8.6
"41011",41,11,2000,27415,25402,2013,7.3
"41011",41,11,2001,26594,24348,2246,8.4
"41011",41,11,2002,27412,25005,2407,8.8
"41011",41,11,2003,27921,25360,2561,9.2
"41011",41,11,2004,28401,25848,2553,9
"41011",41,11,2005,28530,26375,2155,7.6
"41011",41,11,2006,28615,26692,1923,6.7
"41011",41,11,2007,28219,26364,1855,6.6
"41011",41,11,2008,28103,25771,2332,8.3
"41011",41,11,2009,28572,24850,3722,13
"41011",41,11,2010,27740,24215,3525,12.7
"41011",41,11,2011,27968,24726,3242,11.6
"41011",41,11,2012,27096,24091,3005,11.1
"41011",41,11,2013,26336,23640,2696,10.2
"41011",41,11,2014,26024,23690,2334,9
"41011",41,11,2015,25947,24020,1927,7.4
"41011",41,11,2016,26459,24776,1683,6.4
"41011",41,11,2017,26645,25174,1471,5.5
"41013",41,13,1990,6768,6298,470,6.9
"41013",41,13,1991,6953,6371,582,8.4
"41013",41,13,1992,7350,6726,624,8.5
"41013",41,13,1993,7710,6981,729,9.5
"41013",41,13,1994,8034,7428,606,7.5
"41013",41,13,1995,7877,7255,622,7.9
"41013",41,13,1996,7826,6951,875,11.2
"41013",41,13,1997,7699,6941,758,9.8
"41013",41,13,1998,7667,6910,757,9.9
"41013",41,13,1999,7878,7203,675,8.6
"41013",41,13,2000,8775,8143,632,7.2
"41013",41,13,2001,8738,7999,739,8.5
"41013",41,13,2002,8773,7963,810,9.2
"41013",41,13,2003,8839,7987,852,9.6
"41013",41,13,2004,9022,8271,751,8.3
"41013",41,13,2005,9305,8656,649,7
"41013",41,13,2006,9676,9107,569,5.9
"41013",41,13,2007,9790,9183,607,6.2
"41013",41,13,2008,9800,8826,974,9.9
"41013",41,13,2009,9547,7812,1735,18.2
"41013",41,13,2010,9582,8055,1527,15.9
"41013",41,13,2011,9451,8101,1350,14.3
"41013",41,13,2012,9226,7975,1251,13.6
"41013",41,13,2013,8908,7830,1078,12.1
"41013",41,13,2014,9002,8119,883,9.8
"41013",41,13,2015,9022,8269,753,8.3
"41013",41,13,2016,9348,8704,644,6.9
"41013",41,13,2017,9563,8964,599,6.3
"41015",41,15,1990,8163,7641,522,6.4
"41015",41,15,1991,8253,7666,587,7.1
"41015",41,15,1992,8128,7390,738,9.1
"41015",41,15,1993,8175,7456,719,8.8
"41015",41,15,1994,8399,7752,647,7.7
"41015",41,15,1995,8303,7673,630,7.6
"41015",41,15,1996,8553,7764,789,9.2
"41015",41,15,1997,8491,7718,773,9.1
"41015",41,15,1998,8575,7764,811,9.5
"41015",41,15,1999,8591,7976,615,7.2
"41015",41,15,2000,8836,8218,618,7
"41015",41,15,2001,8786,8157,629,7.2
"41015",41,15,2002,8816,8109,707,8
"41015",41,15,2003,9245,8468,777,8.4
"41015",41,15,2004,9510,8796,714,7.5
"41015",41,15,2005,9584,8918,666,6.9
"41015",41,15,2006,9547,8897,650,6.8
"41015",41,15,2007,9510,8889,621,6.5
"41015",41,15,2008,9518,8746,772,8.1
"41015",41,15,2009,9483,8233,1250,13.2
"41015",41,15,2010,9395,8209,1186,12.6
"41015",41,15,2011,9213,8105,1108,12
"41015",41,15,2012,8951,7897,1054,11.8
"41015",41,15,2013,8639,7722,917,10.6
"41015",41,15,2014,8613,7741,872,10.1
"41015",41,15,2015,8712,7994,718,8.2
"41015",41,15,2016,9051,8443,608,6.7
"41015",41,15,2017,9049,8498,551,6.1
"41017",41,17,1990,41087,38845,2242,5.5
"41017",41,17,1991,43107,40157,2950,6.8
"41017",41,17,1992,44646,40958,3688,8.3
"41017",41,17,1993,47352,43362,3990,8.4
"41017",41,17,1994,49377,45813,3564,7.2
"41017",41,17,1995,51034,47657,3377,6.6
"41017",41,17,1996,53531,49147,4384,8.2
"41017",41,17,1997,55406,51121,4285,7.7
"41017",41,17,1998,56971,52789,4182,7.3
"41017",41,17,1999,59013,55362,3651,6.2
"41017",41,17,2000,62089,58778,3311,5.3
"41017",41,17,2001,63423,59328,4095,6.5
"41017",41,17,2002,65462,60414,5048,7.7
"41017",41,17,2003,68261,62951,5310,7.8
"41017",41,17,2004,71159,66314,4845,6.8
"41017",41,17,2005,74532,70250,4282,5.7
"41017",41,17,2006,79324,75654,3670,4.6
"41017",41,17,2007,81675,77625,4050,5
"41017",41,17,2008,81766,75061,6705,8.2
"41017",41,17,2009,81747,69567,12180,14.9
"41017",41,17,2010,81238,69995,11243,13.8
"41017",41,17,2011,80559,70657,9902,12.3
"41017",41,17,2012,78730,69871,8859,11.3
"41017",41,17,2013,78225,70780,7445,9.5
"41017",41,17,2014,80928,74670,6258,7.7
"41017",41,17,2015,84757,79773,4984,5.9
"41017",41,17,2016,89945,85592,4353,4.8
"41017",41,17,2017,93470,89533,3937,4.2
"41019",41,19,1990,43566,39987,3579,8.2
"41019",41,19,1991,43330,38691,4639,10.7
"41019",41,19,1992,42740,37621,5119,12
"41019",41,19,1993,43041,38131,4910,11.4
"41019",41,19,1994,43175,39230,3945,9.1
"41019",41,19,1995,43811,40256,3555,8.1
"41019",41,19,1996,44450,40610,3840,8.6
"41019",41,19,1997,45691,41798,3893,8.5
"41019",41,19,1998,46468,41930,4538,9.8
"41019",41,19,1999,45973,41985,3988,8.7
"41019",41,19,2000,46318,42933,3385,7.3
"41019",41,19,2001,46284,42397,3887,8.4
"41019",41,19,2002,47019,42873,4146,8.8
"41019",41,19,2003,47653,42966,4687,9.8
"41019",41,19,2004,47400,42999,4401,9.3
"41019",41,19,2005,46794,42948,3846,8.2
"41019",41,19,2006,47253,43740,3513,7.4
"41019",41,19,2007,47035,43421,3614,7.7
"41019",41,19,2008,46549,41935,4614,9.9
"41019",41,19,2009,47157,39763,7394,15.7
"41019",41,19,2010,47878,41184,6694,14
"41019",41,19,2011,47485,41453,6032,12.7
"41019",41,19,2012,45703,40242,5461,11.9
"41019",41,19,2013,44120,39463,4657,10.6
"41019",41,19,2014,43992,39963,4029,9.2
"41019",41,19,2015,44369,41043,3326,7.5
"41019",41,19,2016,45736,42880,2856,6.2
"41019",41,19,2017,46572,44080,2492,5.4
"41021",41,21,1990,907,873,34,3.7
"41021",41,21,1991,1084,1048,36,3.3
"41021",41,21,1992,1119,1074,45,4
"41021",41,21,1993,1132,1077,55,4.9
"41021",41,21,1994,1109,1068,41,3.7
"41021",41,21,1995,1111,1075,36,3.2
"41021",41,21,1996,1222,1176,46,3.8
"41021",41,21,1997,1265,1197,68,5.4
"41021",41,21,1998,1238,1168,70,5.7
"41021",41,21,1999,1210,1144,66,5.5
"41021",41,21,2000,1011,962,49,4.8
"41021",41,21,2001,1020,959,61,6
"41021",41,21,2002,1060,991,69,6.5
"41021",41,21,2003,1041,970,71,6.8
"41021",41,21,2004,1046,982,64,6.1
"41021",41,21,2005,991,934,57,5.8
"41021",41,21,2006,994,946,48,4.8
"41021",41,21,2007,1046,999,47,4.5
"41021",41,21,2008,1200,1148,52,4.3
"41021",41,21,2009,1226,1142,84,6.9
"41021",41,21,2010,959,873,86,9
"41021",41,21,2011,973,879,94,9.7
"41021",41,21,2012,937,842,95,10.1
"41021",41,21,2013,849,768,81,9.5
"41021",41,21,2014,823,757,66,8
"41021",41,21,2015,809,757,52,6.4
"41021",41,21,2016,838,789,49,5.8
"41021",41,21,2017,865,829,36,4.2
"41023",41,23,1990,4224,3857,367,8.7
"41023",41,23,1991,4312,3859,453,10.5
"41023",41,23,1992,4428,3951,477,10.8
"41023",41,23,1993,4359,3850,509,11.7
"41023",41,23,1994,4329,3912,417,9.6
"41023",41,23,1995,4236,3797,439,10.4
"41023",41,23,1996,4317,3818,499,11.6
"41023",41,23,1997,4270,3709,561,13.1
"41023",41,23,1998,4293,3685,608,14.2
"41023",41,23,1999,4056,3576,480,11.8
"41023",41,23,2000,3799,3435,364,9.6
"41023",41,23,2001,3751,3403,348,9.3
"41023",41,23,2002,3745,3394,351,9.4
"41023",41,23,2003,3798,3403,395,10.4
"41023",41,23,2004,3802,3428,374,9.8
"41023",41,23,2005,3625,3272,353,9.7
"41023",41,23,2006,3513,3223,290,8.3
"41023",41,23,2007,3437,3161,276,8
"41023",41,23,2008,3379,3021,358,10.6
"41023",41,23,2009,3461,2988,473,13.7
"41023",41,23,2010,3398,2933,465,13.7
"41023",41,23,2011,3422,2950,472,13.8
"41023",41,23,2012,3306,2843,463,14
"41023",41,23,2013,3188,2794,394,12.4
"41023",41,23,2014,3132,2803,329,10.5
"41023",41,23,2015,3090,2822,268,8.7
"41023",41,23,2016,3109,2874,235,7.6
"41023",41,23,2017,3162,2946,216,6.8
"41025",41,25,1990,3703,3372,331,8.9
"41025",41,25,1991,3745,3433,312,8.3
"41025",41,25,1992,3684,3319,365,9.9
"41025",41,25,1993,3796,3355,441,11.6
"41025",41,25,1994,3778,3400,378,10
"41025",41,25,1995,3586,3181,405,11.3
"41025",41,25,1996,3746,3275,471,12.6
"41025",41,25,1997,3806,3441,365,9.6
"41025",41,25,1998,4032,3714,318,7.9
"41025",41,25,1999,4106,3797,309,7.5
"41025",41,25,2000,3875,3550,325,8.4
"41025",41,25,2001,3687,3230,457,12.4
"41025",41,25,2002,3597,3252,345,9.6
"41025",41,25,2003,3520,3136,384,10.9
"41025",41,25,2004,3416,3092,324,9.5
"41025",41,25,2005,3397,3099,298,8.8
"41025",41,25,2006,3334,3067,267,8
"41025",41,25,2007,3317,3075,242,7.3
"41025",41,25,2008,3350,3031,319,9.5
"41025",41,25,2009,3537,2959,578,16.3
"41025",41,25,2010,3836,3290,546,14.2
"41025",41,25,2011,3727,3231,496,13.3
"41025",41,25,2012,3516,3102,414,11.8
"41025",41,25,2013,3323,2939,384,11.6
"41025",41,25,2014,3276,2962,314,9.6
"41025",41,25,2015,3304,3067,237,7.2
"41025",41,25,2016,3425,3213,212,6.2
"41025",41,25,2017,3438,3223,215,6.3
"41027",41,27,1990,9221,8469,752,8.2
"41027",41,27,1991,9559,8655,904,9.5
"41027",41,27,1992,9610,8615,995,10.4
"41027",41,27,1993,10229,9184,1045,10.2
"41027",41,27,1994,10229,9421,808,7.9
"41027",41,27,1995,10413,9537,876,8.4
"41027",41,27,1996,10586,9501,1085,10.2
"41027",41,27,1997,11147,9984,1163,10.4
"41027",41,27,1998,11296,10237,1059,9.4
"41027",41,27,1999,11123,10175,948,8.5
"41027",41,27,2000,11511,10757,754,6.6
"41027",41,27,2001,11688,10795,893,7.6
"41027",41,27,2002,12035,11051,984,8.2
"41027",41,27,2003,12171,11131,1040,8.5
"41027",41,27,2004,12275,11368,907,7.4
"41027",41,27,2005,12253,11478,775,6.3
"41027",41,27,2006,12560,11876,684,5.4
"41027",41,27,2007,12884,12303,581,4.5
"41027",41,27,2008,13351,12634,717,5.4
"41027",41,27,2009,13956,12815,1141,8.2
"41027",41,27,2010,14196,13023,1173,8.3
"41027",41,27,2011,14329,13195,1134,7.9
"41027",41,27,2012,14039,13021,1018,7.3
"41027",41,27,2013,13728,12859,869,6.3
"41027",41,27,2014,13711,12964,747,5.4
"41027",41,27,2015,13526,12889,637,4.7
"41027",41,27,2016,13920,13347,573,4.1
"41027",41,27,2017,14359,13841,518,3.6
"41029",41,29,1990,73122,68282,4840,6.6
"41029",41,29,1991,74809,68790,6019,8
"41029",41,29,1992,77105,70700,6405,8.3
"41029",41,29,1993,79668,73036,6632,8.3
"41029",41,29,1994,82733,77183,5550,6.7
"41029",41,29,1995,83533,77996,5537,6.6
"41029",41,29,1996,86230,79379,6851,7.9
"41029",41,29,1997,87772,81300,6472,7.4
"41029",41,29,1998,89444,82960,6484,7.2
"41029",41,29,1999,90628,84766,5862,6.5
"41029",41,29,2000,90977,85902,5075,5.6
"41029",41,29,2001,92188,86137,6051,6.6
"41029",41,29,2002,93388,86458,6930,7.4
"41029",41,29,2003,96636,89209,7427,7.7
"41029",41,29,2004,97815,90826,6989,7.1
"41029",41,29,2005,98727,92614,6113,6.2
"41029",41,29,2006,99946,94267,5679,5.7
"41029",41,29,2007,101473,95750,5723,5.6
"41029",41,29,2008,101904,93823,8081,7.9
"41029",41,29,2009,102309,89199,13110,12.8
"41029",41,29,2010,100968,88392,12576,12.5
"41029",41,29,2011,100467,88693,11774,11.7
"41029",41,29,2012,98382,87465,10917,11.1
"41029",41,29,2013,95941,86594,9347,9.7
"41029",41,29,2014,96538,88427,8111,8.4
"41029",41,29,2015,98035,91391,6644,6.8
"41029",41,29,2016,101475,95673,5802,5.7
"41029",41,29,2017,103952,98993,4959,4.8
"41031",41,31,1990,6565,6142,423,6.4
"41031",41,31,1991,6538,6053,485,7.4
"41031",41,31,1992,7271,6657,614,8.4
"41031",41,31,1993,7335,6703,632,8.6
"41031",41,31,1994,7858,7346,512,6.5
"41031",41,31,1995,8045,7552,493,6.1
"41031",41,31,1996,8389,7761,628,7.5
"41031",41,31,1997,8285,7745,540,6.5
"41031",41,31,1998,8534,7944,590,6.9
"41031",41,31,1999,8752,8202,550,6.3
"41031",41,31,2000,8813,8346,467,5.3
"41031",41,31,2001,8720,8131,589,6.8
"41031",41,31,2002,8781,8185,596,6.8
"41031",41,31,2003,8819,8198,621,7
"41031",41,31,2004,8935,8371,564,6.3
"41031",41,31,2005,9062,8520,542,6
"41031",41,31,2006,9198,8684,514,5.6
"41031",41,31,2007,9289,8662,627,6.7
"41031",41,31,2008,9353,8412,941,10.1
"41031",41,31,2009,9350,7945,1405,15
"41031",41,31,2010,9629,8314,1315,13.7
"41031",41,31,2011,9598,8375,1223,12.7
"41031",41,31,2012,9588,8456,1132,11.8
"41031",41,31,2013,9215,8253,962,10.4
"41031",41,31,2014,9375,8541,834,8.9
"41031",41,31,2015,9644,8939,705,7.3
"41031",41,31,2016,9867,9219,648,6.6
"41031",41,31,2017,10041,9481,560,5.6
"41033",41,33,1990,26457,24579,1878,7.1
"41033",41,33,1991,26332,24054,2278,8.7
"41033",41,33,1992,27324,24603,2721,10
"41033",41,33,1993,28339,25373,2966,10.5
"41033",41,33,1994,28600,25994,2606,9.1
"41033",41,33,1995,28474,26067,2407,8.5
"41033",41,33,1996,28861,26095,2766,9.6
"41033",41,33,1997,29060,26397,2663,9.2
"41033",41,33,1998,29215,26505,2710,9.3
"41033",41,33,1999,29613,27152,2461,8.3
"41033",41,33,2000,31473,29281,2192,7
"41033",41,33,2001,31697,29045,2652,8.4
"41033",41,33,2002,32391,29559,2832,8.7
"41033",41,33,2003,33481,30464,3017,9
"41033",41,33,2004,33929,31116,2813,8.3
"41033",41,33,2005,34300,31812,2488,7.3
"41033",41,33,2006,35050,32744,2306,6.6
"41033",41,33,2007,34862,32405,2457,7
"41033",41,33,2008,34991,31769,3222,9.2
"41033",41,33,2009,35332,30209,5123,14.5
"41033",41,33,2010,34491,29652,4839,14
"41033",41,33,2011,34489,30133,4356,12.6
"41033",41,33,2012,33355,29299,4056,12.2
"41033",41,33,2013,32200,28636,3564,11.1
"41033",41,33,2014,32729,29660,3069,9.4
"41033",41,33,2015,33271,30702,2569,7.7
"41033",41,33,2016,34311,32101,2210,6.4
"41033",41,33,2017,35392,33487,1905,5.4
"41035",41,35,1990,27160,24703,2457,9
"41035",41,35,1991,26810,24233,2577,9.6
"41035",41,35,1992,28065,25199,2866,10.2
"41035",41,35,1993,28520,25521,2999,10.5
"41035",41,35,1994,28524,26058,2466,8.6
"41035",41,35,1995,28720,26579,2141,7.5
"41035",41,35,1996,29765,27260,2505,8.4
"41035",41,35,1997,29518,26702,2816,9.5
"41035",41,35,1998,29064,26212,2852,9.8
"41035",41,35,1999,28988,26513,2475,8.5
"41035",41,35,2000,29824,27632,2192,7.3
"41035",41,35,2001,29798,27236,2562,8.6
"41035",41,35,2002,29668,27018,2650,8.9
"41035",41,35,2003,29889,26970,2919,9.8
"41035",41,35,2004,29743,26958,2785,9.4
"41035",41,35,2005,30045,27746,2299,7.7
"41035",41,35,2006,30352,28334,2018,6.6
"41035",41,35,2007,30573,28458,2115,6.9
"41035",41,35,2008,30867,28035,2832,9.2
"41035",41,35,2009,31261,26847,4414,14.1
"41035",41,35,2010,31221,27186,4035,12.9
"41035",41,35,2011,31289,27533,3756,12
"41035",41,35,2012,29978,26465,3513,11.7
"41035",41,35,2013,28848,25741,3107,10.8
"41035",41,35,2014,28557,25890,2667,9.3
"41035",41,35,2015,28661,26427,2234,7.8
"41035",41,35,2016,29245,27277,1968,6.7
"41035",41,35,2017,29880,28120,1760,5.9
"41037",41,37,1990,3724,3393,331,8.9
"41037",41,37,1991,3723,3409,314,8.4
"41037",41,37,1992,3779,3447,332,8.8
"41037",41,37,1993,3852,3498,354,9.2
"41037",41,37,1994,3946,3619,327,8.3
"41037",41,37,1995,3752,3428,324,8.6
"41037",41,37,1996,3881,3442,439,11.3
"41037",41,37,1997,3803,3367,436,11.5
"41037",41,37,1998,3505,3068,437,12.5
"41037",41,37,1999,3404,3064,340,10
"41037",41,37,2000,3389,3109,280,8.3
"41037",41,37,2001,3434,3114,320,9.3
"41037",41,37,2002,3515,3205,310,8.8
"41037",41,37,2003,3606,3259,347,9.6
"41037",41,37,2004,3553,3206,347,9.8
"41037",41,37,2005,3549,3247,302,8.5
"41037",41,37,2006,3682,3407,275,7.5
"41037",41,37,2007,3639,3375,264,7.3
"41037",41,37,2008,3585,3275,310,8.6
"41037",41,37,2009,3689,3223,466,12.6
"41037",41,37,2010,3720,3219,501,13.5
"41037",41,37,2011,3753,3261,492,13.1
"41037",41,37,2012,3627,3157,470,13
"41037",41,37,2013,3467,3073,394,11.4
"41037",41,37,2014,3488,3154,334,9.6
"41037",41,37,2015,3436,3173,263,7.7
"41037",41,37,2016,3454,3236,218,6.3
"41037",41,37,2017,3545,3343,202,5.7
"41039",41,39,1990,146662,137559,9103,6.2
"41039",41,39,1991,146026,135760,10266,7
"41039",41,39,1992,147107,136257,10850,7.4
"41039",41,39,1993,150977,139845,11132,7.4
"41039",41,39,1994,155936,147455,8481,5.4
"41039",41,39,1995,157392,149060,8332,5.3
"41039",41,39,1996,159975,151066,8909,5.6
"41039",41,39,1997,159556,150713,8843,5.5
"41039",41,39,1998,164837,155321,9516,5.8
"41039",41,39,1999,166351,157496,8855,5.3
"41039",41,39,2000,170474,161349,9125,5.4
"41039",41,39,2001,169887,158313,11574,6.8
"41039",41,39,2002,172011,159826,12185,7.1
"41039",41,39,2003,172432,158631,13801,8
"41039",41,39,2004,172192,159675,12517,7.3
"41039",41,39,2005,173600,162936,10664,6.1
"41039",41,39,2006,177402,167795,9607,5.4
"41039",41,39,2007,181463,172060,9403,5.2
"41039",41,39,2008,183901,171498,12403,6.7
"41039",41,39,2009,183890,161255,22635,12.3
"41039",41,39,2010,178303,158655,19648,11
"41039",41,39,2011,177473,160315,17158,9.7
"41039",41,39,2012,172255,156906,15349,8.9
"41039",41,39,2013,167538,154123,13415,8
"41039",41,39,2014,169066,157391,11675,6.9
"41039",41,39,2015,172546,162505,10041,5.8
"41039",41,39,2016,178622,169574,9048,5.1
"41039",41,39,2017,182399,174281,8118,4.5
"41041",41,41,1990,18983,17845,1138,6
"41041",41,41,1991,19627,18418,1209,6.2
"41041",41,41,1992,20542,19062,1480,7.2
"41041",41,41,1993,20576,19054,1522,7.4
"41041",41,41,1994,21076,19798,1278,6.1
"41041",41,41,1995,21295,19783,1512,7.1
"41041",41,41,1996,21713,20149,1564,7.2
"41041",41,41,1997,21783,19962,1821,8.4
"41041",41,41,1998,21922,20112,1810,8.3
"41041",41,41,1999,21429,19808,1621,7.6
"41041",41,41,2000,21265,19904,1361,6.4
"41041",41,41,2001,21180,19660,1520,7.2
"41041",41,41,2002,21423,19698,1725,8.1
"41041",41,41,2003,21690,19744,1946,9
"41041",41,41,2004,22060,20273,1787,8.1
"41041",41,41,2005,21930,20410,1520,6.9
"41041",41,41,2006,22073,20756,1317,6
"41041",41,41,2007,22510,21272,1238,5.5
"41041",41,41,2008,22850,21339,1511,6.6
"41041",41,41,2009,23252,20785,2467,10.6
"41041",41,41,2010,22117,19679,2438,11
"41041",41,41,2011,21942,19651,2291,10.4
"41041",41,41,2012,21344,19226,2118,9.9
"41041",41,41,2013,20605,18792,1813,8.8
"41041",41,41,2014,20523,18917,1606,7.8
"41041",41,41,2015,20521,19157,1364,6.6
"41041",41,41,2016,20913,19746,1167,5.6
"41041",41,41,2017,21197,20191,1006,4.7
"41043",41,43,1990,44203,40860,3343,7.6
"41043",41,43,1991,44627,40765,3862,8.7
"41043",41,43,1992,45140,40737,4403,9.8
"41043",41,43,1993,46655,42353,4302,9.2
"41043",41,43,1994,48087,44704,3383,7
"41043",41,43,1995,49818,46760,3058,6.1
"41043",41,43,1996,52191,48673,3518,6.7
"41043",41,43,1997,52714,48952,3762,7.1
"41043",41,43,1998,54039,49205,4834,8.9
"41043",41,43,1999,53356,49162,4194,7.9
"41043",41,43,2000,51531,48154,3377,6.6
"41043",41,43,2001,52038,48042,3996,7.7
"41043",41,43,2002,52444,47729,4715,9
"41043",41,43,2003,52496,47209,5287,10.1
"41043",41,43,2004,51702,46983,4719,9.1
"41043",41,43,2005,51945,48046,3899,7.5
"41043",41,43,2006,52770,49321,3449,6.5
"41043",41,43,2007,53653,50267,3386,6.3
"41043",41,43,2008,55235,50937,4298,7.8
"41043",41,43,2009,56197,48351,7846,14
"41043",41,43,2010,57072,49751,7321,12.8
"41043",41,43,2011,56637,50197,6440,11.4
"41043",41,43,2012,55287,49347,5940,10.7
"41043",41,43,2013,53526,48355,5171,9.7
"41043",41,43,2014,54021,49637,4384,8.1
"41043",41,43,2015,55192,51482,3710,6.7
"41043",41,43,2016,56869,53641,3228,5.7
"41043",41,43,2017,57998,55235,2763,4.8
"41045",41,45,1990,13790,13098,692,5
"41045",41,45,1991,14364,13382,982,6.8
"41045",41,45,1992,14602,13367,1235,8.5
"41045",41,45,1993,14895,13613,1282,8.6
"41045",41,45,1994,14646,13627,1019,7
"41045",41,45,1995,14503,13540,963,6.6
"41045",41,45,1996,14632,13412,1220,8.3
"41045",41,45,1997,14611,13376,1235,8.5
"41045",41,45,1998,14813,13436,1377,9.3
"41045",41,45,1999,14740,13377,1363,9.2
"41045",41,45,2000,13105,12113,992,7.6
"41045",41,45,2001,13056,11970,1086,8.3
"41045",41,45,2002,12968,11810,1158,8.9
"41045",41,45,2003,13249,11955,1294,9.8
"41045",41,45,2004,12996,11716,1280,9.8
"41045",41,45,2005,12570,11477,1093,8.7
"41045",41,45,2006,12510,11717,793,6.3
"41045",41,45,2007,12719,12003,716,5.6
"41045",41,45,2008,12760,11800,960,7.5
"41045",41,45,2009,13156,11721,1435,10.9
"41045",41,45,2010,13474,12172,1302,9.7
"41045",41,45,2011,13373,12111,1262,9.4
"41045",41,45,2012,12825,11624,1201,9.4
"41045",41,45,2013,12329,11284,1045,8.5
"41045",41,45,2014,12020,11067,953,7.9
"41045",41,45,2015,11956,11195,761,6.4
"41045",41,45,2016,12488,11802,686,5.5
"41045",41,45,2017,12618,12028,590,4.7
"41047",41,47,1990,117012,110646,6366,5.4
"41047",41,47,1991,118708,111607,7101,6
"41047",41,47,1992,122439,113921,8518,7
"41047",41,47,1993,127803,118726,9077,7.1
"41047",41,47,1994,130806,123599,7207,5.5
"41047",41,47,1995,132256,125881,6375,4.8
"41047",41,47,1996,135419,127718,7701,5.7
"41047",41,47,1997,136649,128693,7956,5.8
"41047",41,47,1998,140207,131730,8477,6
"41047",41,47,1999,142922,134324,8598,6
"41047",41,47,2000,145246,137280,7966,5.5
"41047",41,47,2001,144866,135571,9295,6.4
"41047",41,47,2002,146636,136029,10607,7.2
"41047",41,47,2003,148494,136675,11819,8
"41047",41,47,2004,148129,136940,11189,7.6
"41047",41,47,2005,147824,138232,9592,6.5
"41047",41,47,2006,149931,141466,8465,5.6
"41047",41,47,2007,151768,143586,8182,5.4
"41047",41,47,2008,155375,145070,10305,6.6
"41047",41,47,2009,158101,140497,17604,11.1
"41047",41,47,2010,155350,138026,17324,11.2
"41047",41,47,2011,154593,138379,16214,10.5
"41047",41,47,2012,150568,135549,15019,10
"41047",41,47,2013,147319,134308,13011,8.8
"41047",41,47,2014,149071,138096,10975,7.4
"41047",41,47,2015,152637,143478,9159,6
"41047",41,47,2016,157531,149584,7947,5
"41047",41,47,2017,162450,155459,6991,4.3
"41049",41,49,1990,3851,3547,304,7.9
"41049",41,49,1991,3513,3163,350,10
"41049",41,49,1992,3821,3417,404,10.6
"41049",41,49,1993,4003,3598,405,10.1
"41049",41,49,1994,3888,3566,322,8.3
"41049",41,49,1995,3881,3592,289,7.4
"41049",41,49,1996,4098,3731,367,9
"41049",41,49,1997,4278,3906,372,8.7
"41049",41,49,1998,4298,3901,397,9.2
"41049",41,49,1999,4154,3710,444,10.7
"41049",41,49,2000,5490,5070,420,7.7
"41049",41,49,2001,5546,5121,425,7.7
"41049",41,49,2002,5790,5353,437,7.5
"41049",41,49,2003,5753,5285,468,8.1
"41049",41,49,2004,5620,5163,457,8.1
"41049",41,49,2005,5454,5041,413,7.6
"41049",41,49,2006,5539,5179,360,6.5
"41049",41,49,2007,5326,5036,290,5.4
"41049",41,49,2008,5447,5100,347,6.4
"41049",41,49,2009,5805,5262,543,9.4
"41049",41,49,2010,5729,5194,535,9.3
"41049",41,49,2011,5792,5316,476,8.2
"41049",41,49,2012,5642,5185,457,8.1
"41049",41,49,2013,5530,5105,425,7.7
"41049",41,49,2014,5470,5093,377,6.9
"41049",41,49,2015,5541,5224,317,5.7
"41049",41,49,2016,5771,5492,279,4.8
"41049",41,49,2017,5856,5597,259,4.4
"41051",41,51,1990,319389,303159,16230,5.1
"41051",41,51,1991,326726,307964,18762,5.7
"41051",41,51,1992,336459,312504,23955,7.1
"41051",41,51,1993,342375,320662,21713,6.3
"41051",41,51,1994,349896,332916,16980,4.9
"41051",41,51,1995,353176,338366,14810,4.2
"41051",41,51,1996,360698,342589,18109,5
"41051",41,51,1997,367941,350218,17723,4.8
"41051",41,51,1998,369624,352057,17567,4.8
"41051",41,51,1999,370965,352268,18697,5
"41051",41,51,2000,381239,363518,17721,4.6
"41051",41,51,2001,380121,356323,23798,6.3
"41051",41,51,2002,377757,347528,30229,8
"41051",41,51,2003,373523,342005,31518,8.4
"41051",41,51,2004,363822,336779,27043,7.4
"41051",41,51,2005,360354,338487,21867,6.1
"41051",41,51,2006,366637,347849,18788,5.1
"41051",41,51,2007,379156,360681,18475,4.9
"41051",41,51,2008,388379,365522,22857,5.9
"41051",41,51,2009,393391,351886,41505,10.6
"41051",41,51,2010,418838,378511,40327,9.6
"41051",41,51,2011,424717,389294,35423,8.3
"41051",41,51,2012,419500,387585,31915,7.6
"41051",41,51,2013,411694,383774,27920,6.8
"41051",41,51,2014,419052,394312,24740,5.9
"41051",41,51,2015,429671,408592,21079,4.9
"41051",41,51,2016,444268,425547,18721,4.2
"41051",41,51,2017,457151,440545,16606,3.6
"41053",41,53,1990,24929,23542,1387,5.6
"41053",41,53,1991,25178,23747,1431,5.7
"41053",41,53,1992,25870,24329,1541,6
"41053",41,53,1993,26882,25284,1598,5.9
"41053",41,53,1994,27918,26634,1284,4.6
"41053",41,53,1995,28330,27206,1124,4
"41053",41,53,1996,29089,27753,1336,4.6
"41053",41,53,1997,29652,28212,1440,4.9
"41053",41,53,1998,30727,29139,1588,5.2
"41053",41,53,1999,31371,29767,1604,5.1
"41053",41,53,2000,33329,31743,1586,4.8
"41053",41,53,2001,33431,31524,1907,5.7
"41053",41,53,2002,33632,31520,2112,6.3
"41053",41,53,2003,34266,31926,2340,6.8
"41053",41,53,2004,34774,32475,2299,6.6
"41053",41,53,2005,35556,33556,2000,5.6
"41053",41,53,2006,36936,35112,1824,4.9
"41053",41,53,2007,38469,36579,1890,4.9
"41053",41,53,2008,39707,37465,2242,5.6
"41053",41,53,2009,40198,36388,3810,9.5
"41053",41,53,2010,36385,32848,3537,9.7
"41053",41,53,2011,36294,32929,3365,9.3
"41053",41,53,2012,35226,32092,3134,8.9
"41053",41,53,2013,34690,31889,2801,8.1
"41053",41,53,2014,35467,33046,2421,6.8
"41053",41,53,2015,36584,34526,2058,5.6
"41053",41,53,2016,38358,36430,1928,5
"41053",41,53,2017,39548,37832,1716,4.3
"41055",41,55,1990,909,860,49,5.4
"41055",41,55,1991,999,929,70,7
"41055",41,55,1992,1002,915,87,8.7
"41055",41,55,1993,944,849,95,10.1
"41055",41,55,1994,965,904,61,6.3
"41055",41,55,1995,905,840,65,7.2
"41055",41,55,1996,1042,965,77,7.4
"41055",41,55,1997,1067,1007,60,5.6
"41055",41,55,1998,1078,1019,59,5.5
"41055",41,55,1999,1056,1000,56,5.3
"41055",41,55,2000,891,836,55,6.2
"41055",41,55,2001,907,815,92,10.1
"41055",41,55,2002,916,824,92,10
"41055",41,55,2003,947,845,102,10.8
"41055",41,55,2004,887,806,81,9.1
"41055",41,55,2005,882,822,60,6.8
"41055",41,55,2006,885,833,52,5.9
"41055",41,55,2007,930,885,45,4.8
"41055",41,55,2008,974,917,57,5.9
"41055",41,55,2009,1050,954,96,9.1
"41055",41,55,2010,905,799,106,11.7
"41055",41,55,2011,920,818,102,11.1
"41055",41,55,2012,895,799,96,10.7
"41055",41,55,2013,864,784,80,9.3
"41055",41,55,2014,880,814,66,7.5
"41055",41,55,2015,888,834,54,6.1
"41055",41,55,2016,895,854,41,4.6
"41055",41,55,2017,897,854,43,4.8
"41057",41,57,1990,9560,9000,560,5.9
"41057",41,57,1991,9842,9213,629,6.4
"41057",41,57,1992,10191,9487,704,6.9
"41057",41,57,1993,10263,9631,632,6.2
"41057",41,57,1994,10875,10349,526,4.8
"41057",41,57,1995,11035,10480,555,5
"41057",41,57,1996,11429,10770,659,5.8
"41057",41,57,1997,11264,10548,716,6.4
"41057",41,57,1998,11343,10612,731,6.4
"41057",41,57,1999,11470,10881,589,5.1
"41057",41,57,2000,11595,10994,601,5.2
"41057",41,57,2001,11736,11012,724,6.2
"41057",41,57,2002,12049,11245,804,6.7
"41057",41,57,2003,12072,11180,892,7.4
"41057",41,57,2004,12186,11325,861,7.1
"41057",41,57,2005,12262,11504,758,6.2
"41057",41,57,2006,12419,11737,682,5.5
"41057",41,57,2007,12433,11821,612,4.9
"41057",41,57,2008,12603,11910,693,5.5
"41057",41,57,2009,12870,11639,1231,9.6
"41057",41,57,2010,11768,10538,1230,10.5
"41057",41,57,2011,11647,10493,1154,9.9
"41057",41,57,2012,11169,10085,1084,9.7
"41057",41,57,2013,10924,10010,914,8.4
"41057",41,57,2014,11151,10379,772,6.9
"41057",41,57,2015,11390,10749,641,5.6
"41057",41,57,2016,11649,11080,569,4.9
"41057",41,57,2017,11786,11285,501,4.3
"41059",41,59,1990,29801,27324,2477,8.3
"41059",41,59,1991,30351,27697,2654,8.7
"41059",41,59,1992,30977,28179,2798,9
"41059",41,59,1993,31950,29167,2783,8.7
"41059",41,59,1994,32430,30129,2301,7.1
"41059",41,59,1995,32927,30624,2303,7
"41059",41,59,1996,33266,30577,2689,8.1
"41059",41,59,1997,33906,31260,2646,7.8
"41059",41,59,1998,35345,33068,2277,6.4
"41059",41,59,1999,37106,34707,2399,6.5
"41059",41,59,2000,36053,33859,2194,6.1
"41059",41,59,2001,36501,33938,2563,7
"41059",41,59,2002,37609,34719,2890,7.7
"41059",41,59,2003,37734,34639,3095,8.2
"41059",41,59,2004,36892,33930,2962,8
"41059",41,59,2005,36204,33347,2857,7.9
"41059",41,59,2006,35967,33567,2400,6.7
"41059",41,59,2007,36645,34522,2123,5.8
"41059",41,59,2008,37635,35163,2472,6.6
"41059",41,59,2009,38738,34960,3778,9.8
"41059",41,59,2010,36689,32916,3773,10.3
"41059",41,59,2011,37378,33818,3560,9.5
"41059",41,59,2012,36674,33354,3320,9.1
"41059",41,59,2013,35210,32108,3102,8.8
"41059",41,59,2014,35235,32504,2731,7.8
"41059",41,59,2015,35248,33007,2241,6.4
"41059",41,59,2016,36041,34127,1914,5.3
"41059",41,59,2017,36924,35139,1785,4.8
"41061",41,61,1990,11782,10966,816,6.9
"41061",41,61,1991,11753,10885,868,7.4
"41061",41,61,1992,12076,11072,1004,8.3
"41061",41,61,1993,12334,11404,930,7.5
"41061",41,61,1994,12548,11755,793,6.3
"41061",41,61,1995,12457,11665,792,6.4
"41061",41,61,1996,12623,11676,947,7.5
"41061",41,61,1997,12602,11635,967,7.7
"41061",41,61,1998,12674,11751,923,7.3
"41061",41,61,1999,12443,11721,722,5.8
"41061",41,61,2000,12035,11373,662,5.5
"41061",41,61,2001,12106,11338,768,6.3
"41061",41,61,2002,12332,11536,796,6.5
"41061",41,61,2003,12312,11408,904,7.3
"41061",41,61,2004,12068,11190,878,7.3
"41061",41,61,2005,11737,10936,801,6.8
"41061",41,61,2006,11977,11276,701,5.9
"41061",41,61,2007,12235,11562,673,5.5
"41061",41,61,2008,12320,11322,998,8.1
"41061",41,61,2009,12634,11166,1468,11.6
"41061",41,61,2010,12486,11196,1290,10.3
"41061",41,61,2011,12458,11216,1242,10
"41061",41,61,2012,12211,11060,1151,9.4
"41061",41,61,2013,11733,10744,989,8.4
"41061",41,61,2014,11574,10735,839,7.2
"41061",41,61,2015,11702,10982,720,6.2
"41061",41,61,2016,11983,11280,703,5.9
"41061",41,61,2017,12068,11430,638,5.3
"41063",41,63,1990,3535,3270,265,7.5
"41063",41,63,1991,3652,3331,321,8.8
"41063",41,63,1992,3686,3312,374,10.1
"41063",41,63,1993,3643,3275,368,10.1
"41063",41,63,1994,3626,3287,339,9.3
"41063",41,63,1995,3463,3092,371,10.7
"41063",41,63,1996,3590,3186,404,11.3
"41063",41,63,1997,3631,3253,378,10.4
"41063",41,63,1998,3658,3269,389,10.6
"41063",41,63,1999,3549,3242,307,8.7
"41063",41,63,2000,3514,3251,263,7.5
"41063",41,63,2001,3541,3215,326,9.2
"41063",41,63,2002,3668,3356,312,8.5
"41063",41,63,2003,3615,3262,353,9.8
"41063",41,63,2004,3549,3231,318,9
"41063",41,63,2005,3526,3263,263,7.5
"41063",41,63,2006,3622,3386,236,6.5
"41063",41,63,2007,3648,3427,221,6.1
"41063",41,63,2008,3671,3392,279,7.6
"41063",41,63,2009,3762,3309,453,12
"41063",41,63,2010,3505,3053,452,12.9
"41063",41,63,2011,3487,3061,426,12.2
"41063",41,63,2012,3351,2966,385,11.5
"41063",41,63,2013,3222,2863,359,11.1
"41063",41,63,2014,3203,2884,319,10
"41063",41,63,2015,3242,2990,252,7.8
"41063",41,63,2016,3316,3095,221,6.7
"41063",41,63,2017,3359,3172,187,5.6
"41065",41,65,1990,10974,10208,766,7
"41065",41,65,1991,11389,10506,883,7.8
"41065",41,65,1992,11572,10521,1051,9.1
"41065",41,65,1993,11848,10782,1066,9
"41065",41,65,1994,11592,10742,850,7.3
"41065",41,65,1995,11455,10646,809,7.1
"41065",41,65,1996,11612,10635,977,8.4
"41065",41,65,1997,11595,10595,1000,8.6
"41065",41,65,1998,12234,11261,973,8
"41065",41,65,1999,12401,11476,925,7.5
"41065",41,65,2000,12608,11838,770,6.1
"41065",41,65,2001,12731,11626,1105,8.7
"41065",41,65,2002,12711,11565,1146,9
"41065",41,65,2003,12837,11594,1243,9.7
"41065",41,65,2004,12823,11718,1105,8.6
"41065",41,65,2005,12656,11763,893,7.1
"41065",41,65,2006,13154,12439,715,5.4
"41065",41,65,2007,13239,12589,650,4.9
"41065",41,65,2008,13338,12527,811,6.1
"41065",41,65,2009,14132,12849,1283,9.1
"41065",41,65,2010,13682,12375,1307,9.6
"41065",41,65,2011,13905,12681,1224,8.8
"41065",41,65,2012,13801,12639,1162,8.4
"41065",41,65,2013,13690,12655,1035,7.6
"41065",41,65,2014,13555,12665,890,6.6
"41065",41,65,2015,13024,12295,729,5.6
"41065",41,65,2016,13702,13047,655,4.8
"41065",41,65,2017,13955,13378,577,4.1
"41067",41,67,1990,186179,179960,6219,3.3
"41067",41,67,1991,191801,182813,8988,4.7
"41067",41,67,1992,197219,185535,11684,5.9
"41067",41,67,1993,204567,194124,10443,5.1
"41067",41,67,1994,214805,206753,8052,3.7
"41067",41,67,1995,222028,215116,6912,3.1
"41067",41,67,1996,230917,222398,8519,3.7
"41067",41,67,1997,238867,229953,8914,3.7
"41067",41,67,1998,245408,235952,9456,3.9
"41067",41,67,1999,249884,240145,9739,3.9
"41067",41,67,2000,259502,249497,10005,3.9
"41067",41,67,2001,263932,249533,14399,5.5
"41067",41,67,2002,264155,246005,18150,6.9
"41067",41,67,2003,264657,245189,19468,7.4
"41067",41,67,2004,263918,247561,16357,6.2
"41067",41,67,2005,268325,254482,13843,5.2
"41067",41,67,2006,277908,265718,12190,4.4
"41067",41,67,2007,283981,271750,12231,4.3
"41067",41,67,2008,289385,274019,15366,5.3
"41067",41,67,2009,290888,263307,27581,9.5
"41067",41,67,2010,289670,263707,25963,9
"41067",41,67,2011,294384,271644,22740,7.7
"41067",41,67,2012,291013,270395,20618,7.1
"41067",41,67,2013,287115,269048,18067,6.3
"41067",41,67,2014,292797,276400,16397,5.6
"41067",41,67,2015,301641,287484,14157,4.7
"41067",41,67,2016,313669,300850,12819,4.1
"41067",41,67,2017,323022,311718,11304,3.5
"41069",41,69,1990,590,528,62,10.5
"41069",41,69,1991,528,457,71,13.4
"41069",41,69,1992,524,474,50,9.5
"41069",41,69,1993,535,472,63,11.8
"41069",41,69,1994,551,490,61,11.1
"41069",41,69,1995,556,516,40,7.2
"41069",41,69,1996,617,565,52,8.4
"41069",41,69,1997,647,573,74,11.4
"41069",41,69,1998,618,560,58,9.4
"41069",41,69,1999,600,543,57,9.5
"41069",41,69,2000,725,673,52,7.2
"41069",41,69,2001,709,651,58,8.2
"41069",41,69,2002,728,672,56,7.7
"41069",41,69,2003,735,678,57,7.8
"41069",41,69,2004,669,617,52,7.8
"41069",41,69,2005,664,622,42,6.3
"41069",41,69,2006,635,594,41,6.5
"41069",41,69,2007,611,577,34,5.6
"41069",41,69,2008,617,580,37,6
"41069",41,69,2009,656,596,60,9.1
"41069",41,69,2010,777,703,74,9.5
"41069",41,69,2011,767,702,65,8.5
"41069",41,69,2012,781,727,54,6.9
"41069",41,69,2013,731,685,46,6.3
"41069",41,69,2014,728,683,45,6.2
"41069",41,69,2015,692,656,36,5.2
"41069",41,69,2016,687,658,29,4.2
"41069",41,69,2017,743,714,29,3.9
"41071",41,71,1990,32560,30823,1737,5.3
"41071",41,71,1991,33195,31312,1883,5.7
"41071",41,71,1992,34107,31755,2352,6.9
"41071",41,71,1993,35022,33000,2022,5.8
"41071",41,71,1994,36731,35105,1626,4.4
"41071",41,71,1995,38189,36678,1511,4
"41071",41,71,1996,39912,38057,1855,4.6
"41071",41,71,1997,41292,39289,2003,4.9
"41071",41,71,1998,42336,40387,1949,4.6
"41071",41,71,1999,42920,40934,1986,4.6
"41071",41,71,2000,43964,41801,2163,4.9
"41071",41,71,2001,43772,41084,2688,6.1
"41071",41,71,2002,43546,40347,3199,7.3
"41071",41,71,2003,43808,40240,3568,8.1
"41071",41,71,2004,43693,40534,3159,7.2
"41071",41,71,2005,44039,41362,2677,6.1
"41071",41,71,2006,45428,43104,2324,5.1
"41071",41,71,2007,46583,44255,2328,5
"41071",41,71,2008,47894,44786,3108,6.5
"41071",41,71,2009,48389,42762,5627,11.6
"41071",41,71,2010,51226,45885,5341,10.4
"41071",41,71,2011,51404,46668,4736,9.2
"41071",41,71,2012,50544,46248,4296,8.5
"41071",41,71,2013,49342,45625,3717,7.5
"41071",41,71,2014,49966,46744,3222,6.4
"41071",41,71,2015,50864,48176,2688,5.3
"41071",41,71,2016,53234,50797,2437,4.6
"41071",41,71,2017,54567,52507,2060,3.8
"42001",42,1,1990,41476,39484,1992,4.8
"42001",42,1,1991,41628,39453,2175,5.2
"42001",42,1,1992,42712,40187,2525,5.9
"42001",42,1,1993,41883,39695,2188,5.2
"42001",42,1,1994,41418,39527,1891,4.6
"42001",42,1,1995,43255,41409,1846,4.3
"42001",42,1,1996,44162,42091,2071,4.7
"42001",42,1,1997,43361,41311,2050,4.7
"42001",42,1,1998,42590,40846,1744,4.1
"42001",42,1,1999,42798,41242,1556,3.6
"42001",42,1,2000,49605,48043,1562,3.1
"42001",42,1,2001,51103,49124,1979,3.9
"42001",42,1,2002,52239,50051,2188,4.2
"42001",42,1,2003,51479,49332,2147,4.2
"42001",42,1,2004,52737,50635,2102,4
"42001",42,1,2005,54495,52517,1978,3.6
"42001",42,1,2006,55265,53390,1875,3.4
"42001",42,1,2007,55892,54028,1864,3.3
"42001",42,1,2008,56402,53970,2432,4.3
"42001",42,1,2009,54978,50893,4085,7.4
"42001",42,1,2010,54589,50374,4215,7.7
"42001",42,1,2011,54083,50471,3612,6.7
"42001",42,1,2012,54755,51251,3504,6.4
"42001",42,1,2013,55378,52135,3243,5.9
"42001",42,1,2014,55132,52601,2531,4.6
"42001",42,1,2015,54988,52677,2311,4.2
"42001",42,1,2016,55412,53213,2199,4
"42001",42,1,2017,55457,53419,2038,3.7
"42003",42,3,1990,644783,616696,28087,4.4
"42003",42,3,1991,650951,615916,35035,5.4
"42003",42,3,1992,661966,620541,41425,6.3
"42003",42,3,1993,663330,621843,41487,6.3
"42003",42,3,1994,657345,619676,37669,5.7
"42003",42,3,1995,652917,618593,34324,5.3
"42003",42,3,1996,655928,625581,30347,4.6
"42003",42,3,1997,660612,632046,28566,4.3
"42003",42,3,1998,658758,631998,26760,4.1
"42003",42,3,1999,658119,632694,25425,3.9
"42003",42,3,2000,638137,612461,25676,4
"42003",42,3,2001,644520,616135,28385,4.4
"42003",42,3,2002,644104,609509,34595,5.4
"42003",42,3,2003,638132,602885,35247,5.5
"42003",42,3,2004,633975,600414,33561,5.3
"42003",42,3,2005,628051,596886,31165,5
"42003",42,3,2006,627923,599910,28013,4.5
"42003",42,3,2007,633672,607439,26233,4.1
"42003",42,3,2008,643395,612419,30976,4.8
"42003",42,3,2009,639381,595899,43482,6.8
"42003",42,3,2010,636080,587878,48202,7.6
"42003",42,3,2011,643084,597429,45655,7.1
"42003",42,3,2012,653215,607810,45405,7
"42003",42,3,2013,651455,608833,42622,6.5
"42003",42,3,2014,646617,611956,34661,5.4
"42003",42,3,2015,647492,615407,32085,5
"42003",42,3,2016,647671,614123,33548,5.2
"42003",42,3,2017,645906,615193,30713,4.8
"42005",42,5,1990,30754,28430,2324,7.6
"42005",42,5,1991,30690,27572,3118,10.2
"42005",42,5,1992,31973,28483,3490,10.9
"42005",42,5,1993,31994,28712,3282,10.3
"42005",42,5,1994,32938,29327,3611,11
"42005",42,5,1995,32370,29316,3054,9.4
"42005",42,5,1996,32194,29687,2507,7.8
"42005",42,5,1997,32100,29668,2432,7.6
"42005",42,5,1998,32106,29883,2223,6.9
"42005",42,5,1999,31805,29796,2009,6.3
"42005",42,5,2000,33253,31374,1879,5.7
"42005",42,5,2001,33813,31608,2205,6.5
"42005",42,5,2002,33608,31344,2264,6.7
"42005",42,5,2003,33375,31110,2265,6.8
"42005",42,5,2004,33489,31140,2349,7
"42005",42,5,2005,32901,30906,1995,6.1
"42005",42,5,2006,32891,31160,1731,5.3
"42005",42,5,2007,32834,31192,1642,5
"42005",42,5,2008,33403,31430,1973,5.9
"42005",42,5,2009,33102,30082,3020,9.1
"42005",42,5,2010,33637,30578,3059,9.1
"42005",42,5,2011,33635,30875,2760,8.2
"42005",42,5,2012,33903,31181,2722,8
"42005",42,5,2013,33613,31035,2578,7.7
"42005",42,5,2014,33153,31015,2138,6.4
"42005",42,5,2015,33025,30832,2193,6.6
"42005",42,5,2016,33101,30619,2482,7.5
"42005",42,5,2017,32676,30667,2009,6.1
"42007",42,7,1990,82320,77488,4832,5.9
"42007",42,7,1991,83902,77823,6079,7.2
"42007",42,7,1992,85592,78882,6710,7.8
"42007",42,7,1993,86035,79566,6469,7.5
"42007",42,7,1994,85531,79679,5852,6.8
"42007",42,7,1995,85164,80040,5124,6
"42007",42,7,1996,85802,81442,4360,5.1
"42007",42,7,1997,86864,82520,4344,5
"42007",42,7,1998,87103,82770,4333,5
"42007",42,7,1999,87042,82871,4171,4.8
"42007",42,7,2000,89156,85361,3795,4.3
"42007",42,7,2001,90338,85777,4561,5
"42007",42,7,2002,90479,84939,5540,6.1
"42007",42,7,2003,89915,84371,5544,6.2
"42007",42,7,2004,89561,84410,5151,5.8
"42007",42,7,2005,89335,84353,4982,5.6
"42007",42,7,2006,89104,84849,4255,4.8
"42007",42,7,2007,88933,84904,4029,4.5
"42007",42,7,2008,90548,85593,4955,5.5
"42007",42,7,2009,89935,82665,7270,8.1
"42007",42,7,2010,85609,78261,7348,8.6
"42007",42,7,2011,85921,79210,6711,7.8
"42007",42,7,2012,86889,80346,6543,7.5
"42007",42,7,2013,86545,80291,6254,7.2
"42007",42,7,2014,85927,80357,5570,6.5
"42007",42,7,2015,85780,80594,5186,6
"42007",42,7,2016,85343,80061,5282,6.2
"42007",42,7,2017,84912,80204,4708,5.5
"42009",42,9,1990,21879,19924,1955,8.9
"42009",42,9,1991,22077,19716,2361,10.7
"42009",42,9,1992,23347,20792,2555,10.9
"42009",42,9,1993,23684,21464,2220,9.4
"42009",42,9,1994,23706,21567,2139,9
"42009",42,9,1995,24503,22509,1994,8.1
"42009",42,9,1996,24862,22946,1916,7.7
"42009",42,9,1997,25136,23305,1831,7.3
"42009",42,9,1998,25595,23993,1602,6.3
"42009",42,9,1999,26421,24847,1574,6
"42009",42,9,2000,24685,23335,1350,5.5
"42009",42,9,2001,24240,22520,1720,7.1
"42009",42,9,2002,24816,22940,1876,7.6
"42009",42,9,2003,23730,21761,1969,8.3
"42009",42,9,2004,24022,22174,1848,7.7
"42009",42,9,2005,23378,21713,1665,7.1
"42009",42,9,2006,23130,21803,1327,5.7
"42009",42,9,2007,23545,22215,1330,5.6
"42009",42,9,2008,24468,22801,1667,6.8
"42009",42,9,2009,24282,21639,2643,10.9
"42009",42,9,2010,25366,22810,2556,10.1
"42009",42,9,2011,24974,22705,2269,9.1
"42009",42,9,2012,25078,22915,2163,8.6
"42009",42,9,2013,24715,22645,2070,8.4
"42009",42,9,2014,24263,22659,1604,6.6
"42009",42,9,2015,24125,22660,1465,6.1
"42009",42,9,2016,24058,22650,1408,5.9
"42009",42,9,2017,23757,22527,1230,5.2
"42011",42,11,1990,177303,167939,9364,5.3
"42011",42,11,1991,175668,164281,11387,6.5
"42011",42,11,1992,178842,166872,11970,6.7
"42011",42,11,1993,177838,167574,10264,5.8
"42011",42,11,1994,177476,168728,8748,4.9
"42011",42,11,1995,179480,170968,8512,4.7
"42011",42,11,1996,182513,174450,8063,4.4
"42011",42,11,1997,187024,179127,7897,4.2
"42011",42,11,1998,186505,178487,8018,4.3
"42011",42,11,1999,186266,178705,7561,4.1
"42011",42,11,2000,195287,187690,7597,3.9
"42011",42,11,2001,196976,187597,9379,4.8
"42011",42,11,2002,198134,186317,11817,6
"42011",42,11,2003,193110,181673,11437,5.9
"42011",42,11,2004,195697,185424,10273,5.2
"42011",42,11,2005,198712,189015,9697,4.9
"42011",42,11,2006,201350,192567,8783,4.4
"42011",42,11,2007,203068,194447,8621,4.2
"42011",42,11,2008,206505,195467,11038,5.3
"42011",42,11,2009,203891,186095,17796,8.7
"42011",42,11,2010,210144,191914,18230,8.7
"42011",42,11,2011,210158,193585,16573,7.9
"42011",42,11,2012,211794,195561,16233,7.7
"42011",42,11,2013,211343,196271,15072,7.1
"42011",42,11,2014,211004,199415,11589,5.5
"42011",42,11,2015,212498,202014,10484,4.9
"42011",42,11,2016,213262,202663,10599,5
"42011",42,11,2017,212082,202309,9773,4.6
"42013",42,13,1990,60851,56358,4493,7.4
"42013",42,13,1991,61309,55540,5769,9.4
"42013",42,13,1992,62214,56595,5619,9
"42013",42,13,1993,63052,58500,4552,7.2
"42013",42,13,1994,62846,58656,4190,6.7
"42013",42,13,1995,62254,58300,3954,6.4
"42013",42,13,1996,62929,59246,3683,5.9
"42013",42,13,1997,63894,60362,3532,5.5
"42013",42,13,1998,63687,60490,3197,5
"42013",42,13,1999,64333,61408,2925,4.5
"42013",42,13,2000,62587,59692,2895,4.6
"42013",42,13,2001,63815,60211,3604,5.6
"42013",42,13,2002,64530,60686,3844,6
"42013",42,13,2003,64164,60689,3475,5.4
"42013",42,13,2004,65004,61510,3494,5.4
"42013",42,13,2005,64786,61435,3351,5.2
"42013",42,13,2006,64548,61653,2895,4.5
"42013",42,13,2007,65094,62365,2729,4.2
"42013",42,13,2008,65574,62177,3397,5.2
"42013",42,13,2009,65096,60447,4649,7.1
"42013",42,13,2010,61779,56831,4948,8
"42013",42,13,2011,61523,57040,4483,7.3
"42013",42,13,2012,61847,57248,4599,7.4
"42013",42,13,2013,61529,57239,4290,7
"42013",42,13,2014,60948,57452,3496,5.7
"42013",42,13,2015,60989,57845,3144,5.2
"42013",42,13,2016,60866,57654,3212,5.3
"42013",42,13,2017,60219,57300,2919,4.8
"42015",42,15,1990,28158,26557,1601,5.7
"42015",42,15,1991,27734,25672,2062,7.4
"42015",42,15,1992,27775,25582,2193,7.9
"42015",42,15,1993,27437,25550,1887,6.9
"42015",42,15,1994,27969,26186,1783,6.4
"42015",42,15,1995,28645,26942,1703,5.9
"42015",42,15,1996,28907,27285,1622,5.6
"42015",42,15,1997,28933,27337,1596,5.5
"42015",42,15,1998,28148,26820,1328,4.7
"42015",42,15,1999,28071,26907,1164,4.1
"42015",42,15,2000,30349,29262,1087,3.6
"42015",42,15,2001,31824,30243,1581,5
"42015",42,15,2002,32797,31062,1735,5.3
"42015",42,15,2003,31490,29815,1675,5.3
"42015",42,15,2004,32214,30554,1660,5.2
"42015",42,15,2005,32179,30567,1612,5
"42015",42,15,2006,30684,29241,1443,4.7
"42015",42,15,2007,30827,29368,1459,4.7
"42015",42,15,2008,31147,29509,1638,5.3
"42015",42,15,2009,31343,28724,2619,8.4
"42015",42,15,2010,30819,28590,2229,7.2
"42015",42,15,2011,32015,29942,2073,6.5
"42015",42,15,2012,32637,30393,2244,6.9
"42015",42,15,2013,31861,29538,2323,7.3
"42015",42,15,2014,31627,29908,1719,5.4
"42015",42,15,2015,31366,29509,1857,5.9
"42015",42,15,2016,30182,28210,1972,6.5
"42015",42,15,2017,29363,27854,1509,5.1
"42017",42,17,1990,300358,287462,12896,4.3
"42017",42,17,1991,304267,282670,21597,7.1
"42017",42,17,1992,305522,282942,22580,7.4
"42017",42,17,1993,305358,285931,19427,6.4
"42017",42,17,1994,307025,290791,16234,5.3
"42017",42,17,1995,309080,293466,15614,5.1
"42017",42,17,1996,316975,302652,14323,4.5
"42017",42,17,1997,324035,310729,13306,4.1
"42017",42,17,1998,328708,316888,11820,3.6
"42017",42,17,1999,333410,322019,11391,3.4
"42017",42,17,2000,330239,319083,11156,3.4
"42017",42,17,2001,336091,322673,13418,4
"42017",42,17,2002,339091,322654,16437,4.8
"42017",42,17,2003,336864,321104,15760,4.7
"42017",42,17,2004,338208,322681,15527,4.6
"42017",42,17,2005,341282,327163,14119,4.1
"42017",42,17,2006,346039,332632,13407,3.9
"42017",42,17,2007,347367,334141,13226,3.8
"42017",42,17,2008,353465,336821,16644,4.7
"42017",42,17,2009,343918,318801,25117,7.3
"42017",42,17,2010,337143,311416,25727,7.6
"42017",42,17,2011,336338,311776,24562,7.3
"42017",42,17,2012,338741,314424,24317,7.2
"42017",42,17,2013,337185,314947,22238,6.6
"42017",42,17,2014,335296,317708,17588,5.2
"42017",42,17,2015,337571,321809,15762,4.7
"42017",42,17,2016,340936,325193,15743,4.6
"42017",42,17,2017,341433,326960,14473,4.2
"42019",42,19,1990,74526,70431,4095,5.5
"42019",42,19,1991,76578,71387,5191,6.8
"42019",42,19,1992,78378,72895,5483,7
"42019",42,19,1993,80003,74678,5325,6.7
"42019",42,19,1994,81280,76006,5274,6.5
"42019",42,19,1995,82796,78231,4565,5.5
"42019",42,19,1996,85345,81029,4316,5.1
"42019",42,19,1997,87482,83306,4176,4.8
"42019",42,19,1998,88868,85096,3772,4.2
"42019",42,19,1999,90554,86813,3741,4.1
"42019",42,19,2000,89406,85772,3634,4.1
"42019",42,19,2001,91778,87527,4251,4.6
"42019",42,19,2002,93084,88058,5026,5.4
"42019",42,19,2003,93618,88374,5244,5.6
"42019",42,19,2004,94507,89264,5243,5.5
"42019",42,19,2005,94848,90283,4565,4.8
"42019",42,19,2006,96207,92073,4134,4.3
"42019",42,19,2007,96948,93055,3893,4
"42019",42,19,2008,99234,94635,4599,4.6
"42019",42,19,2009,99691,92726,6965,7
"42019",42,19,2010,95779,88723,7056,7.4
"42019",42,19,2011,96647,90202,6445,6.7
"42019",42,19,2012,97980,91687,6293,6.4
"42019",42,19,2013,97875,91851,6024,6.2
"42019",42,19,2014,97441,92512,4929,5.1
"42019",42,19,2015,98098,93467,4631,4.7
"42019",42,19,2016,98638,93646,4992,5.1
"42019",42,19,2017,98326,93801,4525,4.6
"42021",42,21,1990,66922,61935,4987,7.5
"42021",42,21,1991,68127,61852,6275,9.2
"42021",42,21,1992,69811,62114,7697,11
"42021",42,21,1993,70077,62166,7911,11.3
"42021",42,21,1994,69463,62845,6618,9.5
"42021",42,21,1995,69497,63769,5728,8.2
"42021",42,21,1996,69551,63773,5778,8.3
"42021",42,21,1997,69145,63686,5459,7.9
"42021",42,21,1998,67067,62589,4478,6.7
"42021",42,21,1999,66515,62652,3863,5.8
"42021",42,21,2000,66867,62811,4056,6.1
"42021",42,21,2001,66701,62270,4431,6.6
"42021",42,21,2002,66242,61516,4726,7.1
"42021",42,21,2003,66740,62090,4650,7
"42021",42,21,2004,67007,62404,4603,6.9
"42021",42,21,2005,67122,63007,4115,6.1
"42021",42,21,2006,67882,64258,3624,5.3
"42021",42,21,2007,68335,64702,3633,5.3
"42021",42,21,2008,69579,65313,4266,6.1
"42021",42,21,2009,69068,63172,5896,8.5
"42021",42,21,2010,66749,60459,6290,9.4
"42021",42,21,2011,66182,60428,5754,8.7
"42021",42,21,2012,65981,60185,5796,8.8
"42021",42,21,2013,64644,59005,5639,8.7
"42021",42,21,2014,63007,58607,4400,7
"42021",42,21,2015,62331,58242,4089,6.6
"42021",42,21,2016,61359,57192,4167,6.8
"42021",42,21,2017,59765,56138,3627,6.1
"42023",42,23,1990,2607,2420,187,7.2
"42023",42,23,1991,2520,2290,230,9.1
"42023",42,23,1992,2504,2250,254,10.1
"42023",42,23,1993,2524,2312,212,8.4
"42023",42,23,1994,2590,2418,172,6.6
"42023",42,23,1995,2614,2444,170,6.5
"42023",42,23,1996,2641,2442,199,7.5
"42023",42,23,1997,2679,2503,176,6.6
"42023",42,23,1998,2794,2606,188,6.7
"42023",42,23,1999,2847,2617,230,8.1
"42023",42,23,2000,2793,2610,183,6.6
"42023",42,23,2001,2643,2417,226,8.6
"42023",42,23,2002,2595,2387,208,8
"42023",42,23,2003,2607,2413,194,7.4
"42023",42,23,2004,2647,2460,187,7.1
"42023",42,23,2005,2617,2434,183,7
"42023",42,23,2006,2607,2447,160,6.1
"42023",42,23,2007,2555,2401,154,6
"42023",42,23,2008,2536,2308,228,9
"42023",42,23,2009,2364,1960,404,17.1
"42023",42,23,2010,2555,2233,322,12.6
"42023",42,23,2011,2510,2242,268,10.7
"42023",42,23,2012,2454,2202,252,10.3
"42023",42,23,2013,2355,2127,228,9.7
"42023",42,23,2014,2299,2137,162,7
"42023",42,23,2015,2263,2101,162,7.2
"42023",42,23,2016,2232,2068,164,7.3
"42023",42,23,2017,2201,2049,152,6.9
"42025",42,25,1990,26468,24478,1990,7.5
"42025",42,25,1991,27027,24397,2630,9.7
"42025",42,25,1992,27152,24223,2929,10.8
"42025",42,25,1993,26637,24392,2245,8.4
"42025",42,25,1994,26484,24350,2134,8.1
"42025",42,25,1995,26342,24346,1996,7.6
"42025",42,25,1996,26722,24669,2053,7.7
"42025",42,25,1997,27353,25383,1970,7.2
"42025",42,25,1998,27543,25573,1970,7.2
"42025",42,25,1999,27676,25829,1847,6.7
"42025",42,25,2000,29091,27608,1483,5.1
"42025",42,25,2001,29572,27872,1700,5.7
"42025",42,25,2002,29788,27742,2046,6.9
"42025",42,25,2003,29884,27696,2188,7.3
"42025",42,25,2004,29841,27929,1912,6.4
"42025",42,25,2005,30223,28420,1803,6
"42025",42,25,2006,30726,28939,1787,5.8
"42025",42,25,2007,31081,29413,1668,5.4
"42025",42,25,2008,31601,29475,2126,6.7
"42025",42,25,2009,31454,28281,3173,10.1
"42025",42,25,2010,31792,28427,3365,10.6
"42025",42,25,2011,31879,28676,3203,10
"42025",42,25,2012,32315,29083,3232,10
"42025",42,25,2013,32230,29228,3002,9.3
"42025",42,25,2014,31594,29352,2242,7.1
"42025",42,25,2015,31454,29549,1905,6.1
"42025",42,25,2016,31570,29689,1881,6
"42025",42,25,2017,31500,29747,1753,5.6
"42027",42,27,1990,60985,58419,2566,4.2
"42027",42,27,1991,61077,58353,2724,4.5
"42027",42,27,1992,62439,59591,2848,4.6
"42027",42,27,1993,63010,60338,2672,4.2
"42027",42,27,1994,62499,60219,2280,3.6
"42027",42,27,1995,63674,61556,2118,3.3
"42027",42,27,1996,66014,64030,1984,3
"42027",42,27,1997,66821,64827,1994,3
"42027",42,27,1998,66773,64916,1857,2.8
"42027",42,27,1999,66191,64406,1785,2.7
"42027",42,27,2000,68658,66308,2350,3.4
"42027",42,27,2001,70583,67899,2684,3.8
"42027",42,27,2002,72043,68966,3077,4.3
"42027",42,27,2003,70740,67666,3074,4.3
"42027",42,27,2004,71848,68626,3222,4.5
"42027",42,27,2005,72388,69492,2896,4
"42027",42,27,2006,72814,70098,2716,3.7
"42027",42,27,2007,73700,71112,2588,3.5
"42027",42,27,2008,75538,72293,3245,4.3
"42027",42,27,2009,75320,70944,4376,5.8
"42027",42,27,2010,77337,72738,4599,5.9
"42027",42,27,2011,77398,73197,4201,5.4
"42027",42,27,2012,77565,73311,4254,5.5
"42027",42,27,2013,78021,73911,4110,5.3
"42027",42,27,2014,77636,74299,3337,4.3
"42027",42,27,2015,77805,74712,3093,4
"42027",42,27,2016,78955,75660,3295,4.2
"42027",42,27,2017,78636,75729,2907,3.7
"42029",42,29,1990,208022,201219,6803,3.3
"42029",42,29,1991,207942,198033,9909,4.8
"42029",42,29,1992,210119,198881,11238,5.3
"42029",42,29,1993,211266,201403,9863,4.7
"42029",42,29,1994,213509,204860,8649,4.1
"42029",42,29,1995,217026,208558,8468,3.9
"42029",42,29,1996,223093,215582,7511,3.4
"42029",42,29,1997,230069,222910,7159,3.1
"42029",42,29,1998,235124,228756,6368,2.7
"42029",42,29,1999,240698,234473,6225,2.6
"42029",42,29,2000,236657,229523,7134,3
"42029",42,29,2001,242002,233753,8249,3.4
"42029",42,29,2002,245876,235797,10079,4.1
"42029",42,29,2003,247448,237295,10153,4.1
"42029",42,29,2004,250462,241076,9386,3.7
"42029",42,29,2005,256305,246961,9344,3.6
"42029",42,29,2006,263375,254609,8766,3.3
"42029",42,29,2007,267222,258865,8357,3.1
"42029",42,29,2008,274238,263491,10747,3.9
"42029",42,29,2009,268122,251383,16739,6.2
"42029",42,29,2010,269534,252693,16841,6.2
"42029",42,29,2011,270047,254455,15592,5.8
"42029",42,29,2012,272976,257623,15353,5.6
"42029",42,29,2013,273546,259098,14448,5.3
"42029",42,29,2014,273880,262490,11390,4.2
"42029",42,29,2015,277062,266506,10556,3.8
"42029",42,29,2016,280415,269548,10867,3.9
"42029",42,29,2017,281136,271053,10083,3.6
"42031",42,31,1990,18155,16695,1460,8
"42031",42,31,1991,18194,16541,1653,9.1
"42031",42,31,1992,18602,16872,1730,9.3
"42031",42,31,1993,18384,16902,1482,8.1
"42031",42,31,1994,18416,16856,1560,8.5
"42031",42,31,1995,18388,16873,1515,8.2
"42031",42,31,1996,18567,17206,1361,7.3
"42031",42,31,1997,19128,17890,1238,6.5
"42031",42,31,1998,19309,18279,1030,5.3
"42031",42,31,1999,19391,18438,953,4.9
"42031",42,31,2000,19418,18440,978,5
"42031",42,31,2001,19670,18692,978,5
"42031",42,31,2002,19935,18897,1038,5.2
"42031",42,31,2003,19748,18620,1128,5.7
"42031",42,31,2004,20360,19207,1153,5.7
"42031",42,31,2005,20827,19805,1022,4.9
"42031",42,31,2006,20668,19652,1016,4.9
"42031",42,31,2007,20286,19319,967,4.8
"42031",42,31,2008,20835,19537,1298,6.2
"42031",42,31,2009,20658,18702,1956,9.5
"42031",42,31,2010,19574,17571,2003,10.2
"42031",42,31,2011,19104,17208,1896,9.9
"42031",42,31,2012,19001,17296,1705,9
"42031",42,31,2013,18681,17167,1514,8.1
"42031",42,31,2014,18439,17283,1156,6.3
"42031",42,31,2015,18269,17177,1092,6
"42031",42,31,2016,18031,16922,1109,6.2
"42031",42,31,2017,17723,16722,1001,5.6
"42033",42,33,1990,34766,31428,3338,9.6
"42033",42,33,1991,35813,31516,4297,12
"42033",42,33,1992,36122,32198,3924,10.9
"42033",42,33,1993,36556,33061,3495,9.6
"42033",42,33,1994,37152,33920,3232,8.7
"42033",42,33,1995,37753,34531,3222,8.5
"42033",42,33,1996,38718,35476,3242,8.4
"42033",42,33,1997,38935,35795,3140,8.1
"42033",42,33,1998,38602,35494,3108,8.1
"42033",42,33,1999,38057,35138,2919,7.7
"42033",42,33,2000,39499,37299,2200,5.6
"42033",42,33,2001,40311,37521,2790,6.9
"42033",42,33,2002,41257,38235,3022,7.3
"42033",42,33,2003,41003,38047,2956,7.2
"42033",42,33,2004,41228,38394,2834,6.9
"42033",42,33,2005,40734,38359,2375,5.8
"42033",42,33,2006,40968,38765,2203,5.4
"42033",42,33,2007,40780,38551,2229,5.5
"42033",42,33,2008,40775,38038,2737,6.7
"42033",42,33,2009,40730,36674,4056,10
"42033",42,33,2010,38076,34101,3975,10.4
"42033",42,33,2011,38041,34474,3567,9.4
"42033",42,33,2012,38232,34657,3575,9.4
"42033",42,33,2013,37793,34383,3410,9
"42033",42,33,2014,36700,34052,2648,7.2
"42033",42,33,2015,36412,33990,2422,6.7
"42033",42,33,2016,36318,33672,2646,7.3
"42033",42,33,2017,35854,33714,2140,6
"42035",42,35,1990,17098,15396,1702,10
"42035",42,35,1991,17360,15395,1965,11.3
"42035",42,35,1992,17678,15930,1748,9.9
"42035",42,35,1993,17470,15865,1605,9.2
"42035",42,35,1994,17609,15732,1877,10.7
"42035",42,35,1995,17408,15720,1688,9.7
"42035",42,35,1996,17306,15876,1430,8.3
"42035",42,35,1997,17496,16177,1319,7.5
"42035",42,35,1998,17616,16408,1208,6.9
"42035",42,35,1999,18104,17082,1022,5.6
"42035",42,35,2000,18264,17327,937,5.1
"42035",42,35,2001,18484,17308,1176,6.4
"42035",42,35,2002,19175,17701,1474,7.7
"42035",42,35,2003,18628,17295,1333,7.2
"42035",42,35,2004,18865,17622,1243,6.6
"42035",42,35,2005,18968,17814,1154,6.1
"42035",42,35,2006,18851,17812,1039,5.5
"42035",42,35,2007,19149,18145,1004,5.2
"42035",42,35,2008,19460,18258,1202,6.2
"42035",42,35,2009,19338,17629,1709,8.8
"42035",42,35,2010,18749,16987,1762,9.4
"42035",42,35,2011,19180,17575,1605,8.4
"42035",42,35,2012,19461,17741,1720,8.8
"42035",42,35,2013,19289,17545,1744,9
"42035",42,35,2014,18968,17585,1383,7.3
"42035",42,35,2015,18762,17470,1292,6.9
"42035",42,35,2016,18560,17247,1313,7.1
"42035",42,35,2017,18317,17182,1135,6.2
"42037",42,37,1990,31489,29272,2217,7
"42037",42,37,1991,31915,29068,2847,8.9
"42037",42,37,1992,32340,29317,3023,9.3
"42037",42,37,1993,32251,29619,2632,8.2
"42037",42,37,1994,32314,30077,2237,6.9
"42037",42,37,1995,32946,30520,2426,7.4
"42037",42,37,1996,33529,31039,2490,7.4
"42037",42,37,1997,33955,31531,2424,7.1
"42037",42,37,1998,33581,31651,1930,5.7
"42037",42,37,1999,33396,31655,1741,5.2
"42037",42,37,2000,32060,30394,1666,5.2
"42037",42,37,2001,32041,30176,1865,5.8
"42037",42,37,2002,32719,30649,2070,6.3
"42037",42,37,2003,32688,30500,2188,6.7
"42037",42,37,2004,33575,31363,2212,6.6
"42037",42,37,2005,34035,32045,1990,5.8
"42037",42,37,2006,34631,32737,1894,5.5
"42037",42,37,2007,35206,33429,1777,5
"42037",42,37,2008,36409,34273,2136,5.9
"42037",42,37,2009,36446,33328,3118,8.6
"42037",42,37,2010,34736,31496,3240,9.3
"42037",42,37,2011,34786,31779,3007,8.6
"42037",42,37,2012,35512,32550,2962,8.3
"42037",42,37,2013,35337,32620,2717,7.7
"42037",42,37,2014,34233,32105,2128,6.2
"42037",42,37,2015,33735,31827,1908,5.7
"42037",42,37,2016,33905,32028,1877,5.5
"42037",42,37,2017,33804,32039,1765,5.2
"42039",42,39,1990,39341,36447,2894,7.4
"42039",42,39,1991,40414,36602,3812,9.4
"42039",42,39,1992,39952,36198,3754,9.4
"42039",42,39,1993,40134,37022,3112,7.8
"42039",42,39,1994,41001,37948,3053,7.4
"42039",42,39,1995,41192,38546,2646,6.4
"42039",42,39,1996,41733,39258,2475,5.9
"42039",42,39,1997,42224,39869,2355,5.6
"42039",42,39,1998,42571,40441,2130,5
"42039",42,39,1999,42508,40196,2312,5.4
"42039",42,39,2000,42892,40809,2083,4.9
"42039",42,39,2001,43035,40309,2726,6.3
"42039",42,39,2002,43385,40351,3034,7
"42039",42,39,2003,41650,38802,2848,6.8
"42039",42,39,2004,42250,39511,2739,6.5
"42039",42,39,2005,42855,40394,2461,5.7
"42039",42,39,2006,42623,40411,2212,5.2
"42039",42,39,2007,42787,40674,2113,4.9
"42039",42,39,2008,43562,41116,2446,5.6
"42039",42,39,2009,42885,38649,4236,9.9
"42039",42,39,2010,41696,37748,3948,9.5
"42039",42,39,2011,41531,38207,3324,8
"42039",42,39,2012,41984,38782,3202,7.6
"42039",42,39,2013,41792,38772,3020,7.2
"42039",42,39,2014,41255,38863,2392,5.8
"42039",42,39,2015,41044,38908,2136,5.2
"42039",42,39,2016,40512,38079,2433,6
"42039",42,39,2017,39398,37231,2167,5.5
"42041",42,41,1990,109175,105083,4092,3.7
"42041",42,41,1991,110963,106146,4817,4.3
"42041",42,41,1992,112492,107556,4936,4.4
"42041",42,41,1993,113213,109212,4001,3.5
"42041",42,41,1994,114307,110694,3613,3.2
"42041",42,41,1995,116447,112735,3712,3.2
"42041",42,41,1996,120415,116886,3529,2.9
"42041",42,41,1997,122439,118987,3452,2.8
"42041",42,41,1998,123619,120439,3180,2.6
"42041",42,41,1999,123175,119788,3387,2.7
"42041",42,41,2000,114198,110638,3560,3.1
"42041",42,41,2001,115926,111492,4434,3.8
"42041",42,41,2002,118149,113143,5006,4.2
"42041",42,41,2003,117295,112428,4867,4.1
"42041",42,41,2004,118432,113832,4600,3.9
"42041",42,41,2005,119810,115331,4479,3.7
"42041",42,41,2006,122144,118044,4100,3.4
"42041",42,41,2007,123188,119168,4020,3.3
"42041",42,41,2008,125832,120498,5334,4.2
"42041",42,41,2009,124899,116621,8278,6.6
"42041",42,41,2010,124446,115938,8508,6.8
"42041",42,41,2011,124438,116524,7914,6.4
"42041",42,41,2012,125779,117989,7790,6.2
"42041",42,41,2013,125782,118596,7186,5.7
"42041",42,41,2014,126113,120455,5658,4.5
"42041",42,41,2015,128389,123266,5123,4
"42041",42,41,2016,130153,124869,5284,4.1
"42041",42,41,2017,129985,125031,4954,3.8
"42043",42,43,1990,130472,124191,6281,4.8
"42043",42,43,1991,131256,124384,6872,5.2
"42043",42,43,1992,132694,125609,7085,5.3
"42043",42,43,1993,133645,127351,6294,4.7
"42043",42,43,1994,134722,128945,5777,4.3
"42043",42,43,1995,136227,130868,5359,3.9
"42043",42,43,1996,139699,134696,5003,3.6
"42043",42,43,1997,141473,136599,4874,3.4
"42043",42,43,1998,141350,136928,4422,3.1
"42043",42,43,1999,140878,135575,5303,3.8
"42043",42,43,2000,131742,127162,4580,3.5
"42043",42,43,2001,133012,127334,5678,4.3
"42043",42,43,2002,134983,128348,6635,4.9
"42043",42,43,2003,133198,126655,6543,4.9
"42043",42,43,2004,133586,127215,6371,4.8
"42043",42,43,2005,133946,128233,5713,4.3
"42043",42,43,2006,134968,129584,5384,4
"42043",42,43,2007,135823,130509,5314,3.9
"42043",42,43,2008,138090,131631,6459,4.7
"42043",42,43,2009,137073,126848,10225,7.5
"42043",42,43,2010,140563,129288,11275,8
"42043",42,43,2011,140465,129834,10631,7.6
"42043",42,43,2012,141151,130682,10469,7.4
"42043",42,43,2013,140471,130890,9581,6.8
"42043",42,43,2014,139336,131892,7444,5.3
"42043",42,43,2015,140983,134421,6562,4.7
"42043",42,43,2016,142150,135382,6768,4.8
"42043",42,43,2017,141982,135578,6404,4.5
"42045",42,45,1990,279722,268592,11130,4
"42045",42,45,1991,278071,261593,16478,5.9
"42045",42,45,1992,278996,259430,19566,7
"42045",42,45,1993,276611,259335,17276,6.2
"42045",42,45,1994,275626,260574,15052,5.5
"42045",42,45,1995,275070,259948,15122,5.5
"42045",42,45,1996,278307,264573,13734,4.9
"42045",42,45,1997,281243,268591,12652,4.5
"42045",42,45,1998,281959,270938,11021,3.9
"42045",42,45,1999,282431,271913,10518,3.7
"42045",42,45,2000,278014,267671,10343,3.7
"42045",42,45,2001,280794,269017,11777,4.2
"42045",42,45,2002,281187,266962,14225,5.1
"42045",42,45,2003,278832,264475,14357,5.1
"42045",42,45,2004,277985,263972,14013,5
"42045",42,45,2005,279252,266447,12805,4.6
"42045",42,45,2006,282338,270261,12077,4.3
"42045",42,45,2007,283132,271606,11526,4.1
"42045",42,45,2008,287490,273179,14311,5
"42045",42,45,2009,280088,258803,21285,7.6
"42045",42,45,2010,286181,263281,22900,8
"42045",42,45,2011,286902,264651,22251,7.8
"42045",42,45,2012,289577,267287,22290,7.7
"42045",42,45,2013,290490,270005,20485,7.1
"42045",42,45,2014,290198,274167,16031,5.5
"42045",42,45,2015,291513,277251,14262,4.9
"42045",42,45,2016,294250,279941,14309,4.9
"42045",42,45,2017,294762,281424,13338,4.5
"42047",42,47,1990,16375,15371,1004,6.1
"42047",42,47,1991,16797,15203,1594,9.5
"42047",42,47,1992,16872,15638,1234,7.3
"42047",42,47,1993,17130,16216,914,5.3
"42047",42,47,1994,17825,16889,936,5.3
"42047",42,47,1995,18324,17280,1044,5.7
"42047",42,47,1996,18556,17389,1167,6.3
"42047",42,47,1997,18494,17391,1103,6
"42047",42,47,1998,18475,17365,1110,6
"42047",42,47,1999,18137,17043,1094,6
"42047",42,47,2000,18257,17376,881,4.8
"42047",42,47,2001,18051,16752,1299,7.2
"42047",42,47,2002,17632,16442,1190,6.7
"42047",42,47,2003,17240,16128,1112,6.5
"42047",42,47,2004,17536,16571,965,5.5
"42047",42,47,2005,17583,16710,873,5
"42047",42,47,2006,17540,16723,817,4.7
"42047",42,47,2007,17483,16659,824,4.7
"42047",42,47,2008,17578,16531,1047,6
"42047",42,47,2009,17103,14945,2158,12.6
"42047",42,47,2010,16686,15075,1611,9.7
"42047",42,47,2011,16866,15620,1246,7.4
"42047",42,47,2012,16887,15712,1175,7
"42047",42,47,2013,16465,15341,1124,6.8
"42047",42,47,2014,16358,15518,840,5.1
"42047",42,47,2015,16329,15524,805,4.9
"42047",42,47,2016,16335,15435,900,5.5
"42047",42,47,2017,15996,15218,778,4.9
"42049",42,49,1990,133603,125797,7806,5.8
"42049",42,49,1991,136056,126121,9935,7.3
"42049",42,49,1992,139077,128331,10746,7.7
"42049",42,49,1993,140401,130601,9800,7
"42049",42,49,1994,139411,129983,9428,6.8
"42049",42,49,1995,140523,131552,8971,6.4
"42049",42,49,1996,141279,132868,8411,6
"42049",42,49,1997,142422,134188,8234,5.8
"42049",42,49,1998,141745,134412,7333,5.2
"42049",42,49,1999,142894,135750,7144,5
"42049",42,49,2000,140747,134452,6295,4.5
"42049",42,49,2001,140237,132515,7722,5.5
"42049",42,49,2002,140848,131361,9487,6.7
"42049",42,49,2003,138178,129079,9099,6.6
"42049",42,49,2004,139492,130956,8536,6.1
"42049",42,49,2005,140605,133043,7562,5.4
"42049",42,49,2006,140301,133215,7086,5.1
"42049",42,49,2007,140590,133805,6785,4.8
"42049",42,49,2008,141912,133934,7978,5.6
"42049",42,49,2009,139893,127432,12461,8.9
"42049",42,49,2010,136359,123672,12687,9.3
"42049",42,49,2011,137284,126097,11187,8.1
"42049",42,49,2012,137421,126706,10715,7.8
"42049",42,49,2013,136002,125897,10105,7.4
"42049",42,49,2014,134640,126306,8334,6.2
"42049",42,49,2015,134748,127337,7411,5.5
"42049",42,49,2016,133626,124927,8699,6.5
"42049",42,49,2017,130755,123192,7563,5.8
"42051",42,51,1990,54889,50194,4695,8.6
"42051",42,51,1991,55989,50355,5634,10.1
"42051",42,51,1992,56913,50867,6046,10.6
"42051",42,51,1993,56812,51313,5499,9.7
"42051",42,51,1994,57046,51500,5546,9.7
"42051",42,51,1995,57247,51752,5495,9.6
"42051",42,51,1996,57429,52736,4693,8.2
"42051",42,51,1997,58377,53576,4801,8.2
"42051",42,51,1998,57977,53832,4145,7.1
"42051",42,51,1999,58124,54149,3975,6.8
"42051",42,51,2000,64754,61105,3649,5.6
"42051",42,51,2001,65390,61306,4084,6.2
"42051",42,51,2002,65406,60736,4670,7.1
"42051",42,51,2003,65216,60226,4990,7.7
"42051",42,51,2004,65754,60759,4995,7.6
"42051",42,51,2005,65225,60682,4543,7
"42051",42,51,2006,65601,61448,4153,6.3
"42051",42,51,2007,65659,61917,3742,5.7
"42051",42,51,2008,66718,62362,4356,6.5
"42051",42,51,2009,66011,59957,6054,9.2
"42051",42,51,2010,59532,53133,6399,10.7
"42051",42,51,2011,59674,53676,5998,10.1
"42051",42,51,2012,60256,54272,5984,9.9
"42051",42,51,2013,59731,53986,5745,9.6
"42051",42,51,2014,58474,53870,4604,7.9
"42051",42,51,2015,58364,53985,4379,7.5
"42051",42,51,2016,58453,53717,4736,8.1
"42051",42,51,2017,57811,53806,4005,6.9
"42053",42,53,1990,2058,1888,170,8.3
"42053",42,53,1991,2035,1796,239,11.7
"42053",42,53,1992,2046,1783,263,12.9
"42053",42,53,1993,2070,1835,235,11.4
"42053",42,53,1994,1867,1602,265,14.2
"42053",42,53,1995,1837,1626,211,11.5
"42053",42,53,1996,1866,1679,187,10
"42053",42,53,1997,1810,1631,179,9.9
"42053",42,53,1998,1756,1604,152,8.7
"42053",42,53,1999,1846,1707,139,7.5
"42053",42,53,2000,2018,1877,141,7
"42053",42,53,2001,2230,1946,284,12.7
"42053",42,53,2002,2276,1963,313,13.8
"42053",42,53,2003,2235,1915,320,14.3
"42053",42,53,2004,2259,2031,228,10.1
"42053",42,53,2005,2277,2073,204,9
"42053",42,53,2006,2226,2067,159,7.1
"42053",42,53,2007,2394,2237,157,6.6
"42053",42,53,2008,2392,2209,183,7.7
"42053",42,53,2009,2382,2122,260,10.9
"42053",42,53,2010,2155,1911,244,11.3
"42053",42,53,2011,2034,1842,192,9.4
"42053",42,53,2012,2015,1817,198,9.8
"42053",42,53,2013,1975,1779,196,9.9
"42053",42,53,2014,1929,1774,155,8
"42053",42,53,2015,1899,1750,149,7.8
"42053",42,53,2016,1892,1743,149,7.9
"42053",42,53,2017,1832,1709,123,6.7
"42055",42,55,1990,62833,59690,3143,5
"42055",42,55,1991,62305,58398,3907,6.3
"42055",42,55,1992,62431,58694,3737,6
"42055",42,55,1993,62160,58796,3364,5.4
"42055",42,55,1994,61352,58457,2895,4.7
"42055",42,55,1995,64087,61202,2885,4.5
"42055",42,55,1996,65584,62299,3285,5
"42055",42,55,1997,66796,63601,3195,4.8
"42055",42,55,1998,67148,64550,2598,3.9
"42055",42,55,1999,65849,62829,3020,4.6
"42055",42,55,2000,67744,65231,2513,3.7
"42055",42,55,2001,67952,64834,3118,4.6
"42055",42,55,2002,69217,65935,3282,4.7
"42055",42,55,2003,70648,67602,3046,4.3
"42055",42,55,2004,74077,71332,2745,3.7
"42055",42,55,2005,76938,74296,2642,3.4
"42055",42,55,2006,78825,76240,2585,3.3
"42055",42,55,2007,80752,78014,2738,3.4
"42055",42,55,2008,82775,79218,3557,4.3
"42055",42,55,2009,80943,74404,6539,8.1
"42055",42,55,2010,75710,69255,6455,8.5
"42055",42,55,2011,75527,69996,5531,7.3
"42055",42,55,2012,76335,70982,5353,7
"42055",42,55,2013,76619,71558,5061,6.6
"42055",42,55,2014,76516,72353,4163,5.4
"42055",42,55,2015,77850,73988,3862,5
"42055",42,55,2016,77509,73517,3992,5.2
"42055",42,55,2017,76656,73242,3414,4.5
"42057",42,57,1990,6610,6135,475,7.2
"42057",42,57,1991,6571,6000,571,8.7
"42057",42,57,1992,6546,6027,519,7.9
"42057",42,57,1993,6428,5997,431,6.7
"42057",42,57,1994,6439,5972,467,7.3
"42057",42,57,1995,6634,6267,367,5.5
"42057",42,57,1996,6713,6341,372,5.5
"42057",42,57,1997,6980,6436,544,7.8
"42057",42,57,1998,6884,6583,301,4.4
"42057",42,57,1999,6699,6419,280,4.2
"42057",42,57,2000,7282,7005,277,3.8
"42057",42,57,2001,7438,6989,449,6
"42057",42,57,2002,7344,6860,484,6.6
"42057",42,57,2003,7136,6709,427,6
"42057",42,57,2004,7568,7199,369,4.9
"42057",42,57,2005,8196,7846,350,4.3
"42057",42,57,2006,8265,7899,366,4.4
"42057",42,57,2007,8104,7652,452,5.6
"42057",42,57,2008,8146,7559,587,7.2
"42057",42,57,2009,7641,6617,1024,13.4
"42057",42,57,2010,7434,6522,912,12.3
"42057",42,57,2011,7352,6609,743,10.1
"42057",42,57,2012,7441,6755,686,9.2
"42057",42,57,2013,7406,6722,684,9.2
"42057",42,57,2014,7302,6785,517,7.1
"42057",42,57,2015,7440,6977,463,6.2
"42057",42,57,2016,7303,6841,462,6.3
"42057",42,57,2017,7191,6821,370,5.1
"42059",42,59,1990,14836,13598,1238,8.3
"42059",42,59,1991,15630,13922,1708,10.9
"42059",42,59,1992,15650,13774,1876,12
"42059",42,59,1993,15537,13694,1843,11.9
"42059",42,59,1994,15427,13721,1706,11.1
"42059",42,59,1995,15705,14078,1627,10.4
"42059",42,59,1996,16103,14656,1447,9
"42059",42,59,1997,16750,15266,1484,8.9
"42059",42,59,1998,16645,15311,1334,8
"42059",42,59,1999,16339,15142,1197,7.3
"42059",42,59,2000,16738,15762,976,5.8
"42059",42,59,2001,17067,16091,976,5.7
"42059",42,59,2002,17287,16205,1082,6.3
"42059",42,59,2003,16939,15802,1137,6.7
"42059",42,59,2004,17143,16021,1122,6.5
"42059",42,59,2005,17247,16168,1079,6.3
"42059",42,59,2006,17478,16474,1004,5.7
"42059",42,59,2007,18128,17223,905,5
"42059",42,59,2008,18622,17546,1076,5.8
"42059",42,59,2009,19109,17687,1422,7.4
"42059",42,59,2010,17411,15954,1457,8.4
"42059",42,59,2011,18191,16802,1389,7.6
"42059",42,59,2012,19074,17683,1391,7.3
"42059",42,59,2013,18766,17412,1354,7.2
"42059",42,59,2014,18517,17486,1031,5.6
"42059",42,59,2015,18161,17072,1089,6
"42059",42,59,2016,17302,15962,1340,7.7
"42059",42,59,2017,16835,15838,997,5.9
"42061",42,61,1990,19292,17382,1910,9.9
"42061",42,61,1991,19662,17187,2475,12.6
"42061",42,61,1992,19908,17273,2635,13.2
"42061",42,61,1993,19690,17409,2281,11.6
"42061",42,61,1994,19452,17294,2158,11.1
"42061",42,61,1995,19271,17301,1970,10.2
"42061",42,61,1996,19062,17059,2003,10.5
"42061",42,61,1997,19540,17538,2002,10.2
"42061",42,61,1998,19045,17477,1568,8.2
"42061",42,61,1999,19135,17526,1609,8.4
"42061",42,61,2000,20871,19618,1253,6
"42061",42,61,2001,21609,19944,1665,7.7
"42061",42,61,2002,21994,20136,1858,8.4
"42061",42,61,2003,21248,19616,1632,7.7
"42061",42,61,2004,21692,20196,1496,6.9
"42061",42,61,2005,22120,20788,1332,6
"42061",42,61,2006,22045,20902,1143,5.2
"42061",42,61,2007,22187,21044,1143,5.2
"42061",42,61,2008,22631,21148,1483,6.6
"42061",42,61,2009,22738,20355,2383,10.5
"42061",42,61,2010,21116,18851,2265,10.7
"42061",42,61,2011,21006,18886,2120,10.1
"42061",42,61,2012,20773,18710,2063,9.9
"42061",42,61,2013,20338,18340,1998,9.8
"42061",42,61,2014,19862,18293,1569,7.9
"42061",42,61,2015,19668,18287,1381,7
"42061",42,61,2016,19677,18303,1374,7
"42061",42,61,2017,19739,18552,1187,6
"42063",42,63,1990,38740,35919,2821,7.3
"42063",42,63,1991,38950,35236,3714,9.5
"42063",42,63,1992,38355,34096,4259,11.1
"42063",42,63,1993,37346,33233,4113,11
"42063",42,63,1994,37061,33255,3806,10.3
"42063",42,63,1995,37543,34096,3447,9.2
"42063",42,63,1996,37795,34574,3221,8.5
"42063",42,63,1997,38193,35153,3040,8
"42063",42,63,1998,37663,34883,2780,7.4
"42063",42,63,1999,36877,34364,2513,6.8
"42063",42,63,2000,41102,38740,2362,5.7
"42063",42,63,2001,43051,40764,2287,5.3
"42063",42,63,2002,43716,41030,2686,6.1
"42063",42,63,2003,43332,40679,2653,6.1
"42063",42,63,2004,44413,41665,2748,6.2
"42063",42,63,2005,45202,42762,2440,5.4
"42063",42,63,2006,45443,43120,2323,5.1
"42063",42,63,2007,45705,43578,2127,4.7
"42063",42,63,2008,46969,44497,2472,5.3
"42063",42,63,2009,47201,43681,3520,7.5
"42063",42,63,2010,44078,40250,3828,8.7
"42063",42,63,2011,44025,40571,3454,7.8
"42063",42,63,2012,44757,41130,3627,8.1
"42063",42,63,2013,44097,40686,3411,7.7
"42063",42,63,2014,43208,40585,2623,6.1
"42063",42,63,2015,41757,39117,2640,6.3
"42063",42,63,2016,40229,37304,2925,7.3
"42063",42,63,2017,39219,36896,2323,5.9
"42065",42,65,1990,20159,18713,1446,7.2
"42065",42,65,1991,20784,18822,1962,9.4
"42065",42,65,1992,21390,19184,2206,10.3
"42065",42,65,1993,21331,19691,1640,7.7
"42065",42,65,1994,21683,20082,1601,7.4
"42065",42,65,1995,22040,20383,1657,7.5
"42065",42,65,1996,22413,20636,1777,7.9
"42065",42,65,1997,22349,20755,1594,7.1
"42065",42,65,1998,22019,20486,1533,7
"42065",42,65,1999,21750,20235,1515,7
"42065",42,65,2000,21564,20432,1132,5.2
"42065",42,65,2001,21436,20039,1397,6.5
"42065",42,65,2002,21887,20524,1363,6.2
"42065",42,65,2003,21802,20443,1359,6.2
"42065",42,65,2004,22125,20779,1346,6.1
"42065",42,65,2005,22577,21359,1218,5.4
"42065",42,65,2006,22755,21650,1105,4.9
"42065",42,65,2007,23094,22027,1067,4.6
"42065",42,65,2008,23301,22009,1292,5.5
"42065",42,65,2009,22837,20692,2145,9.4
"42065",42,65,2010,21606,19429,2177,10.1
"42065",42,65,2011,21791,19889,1902,8.7
"42065",42,65,2012,21756,19946,1810,8.3
"42065",42,65,2013,21099,19365,1734,8.2
"42065",42,65,2014,20855,19519,1336,6.4
"42065",42,65,2015,20970,19690,1280,6.1
"42065",42,65,2016,20707,19290,1417,6.8
"42065",42,65,2017,20572,19418,1154,5.6
"42067",42,67,1990,10441,9479,962,9.2
"42067",42,67,1991,10519,9473,1046,9.9
"42067",42,67,1992,10421,9129,1292,12.4
"42067",42,67,1993,10194,9265,929,9.1
"42067",42,67,1994,10008,9218,790,7.9
"42067",42,67,1995,10096,9222,874,8.7
"42067",42,67,1996,10230,9299,931,9.1
"42067",42,67,1997,10341,9537,804,7.8
"42067",42,67,1998,10194,9387,807,7.9
"42067",42,67,1999,10483,9862,621,5.9
"42067",42,67,2000,11524,11046,478,4.1
"42067",42,67,2001,11717,11169,548,4.7
"42067",42,67,2002,12105,11491,614,5.1
"42067",42,67,2003,12173,11560,613,5
"42067",42,67,2004,12953,12363,590,4.6
"42067",42,67,2005,13179,12622,557,4.2
"42067",42,67,2006,12633,12101,532,4.2
"42067",42,67,2007,12488,11962,526,4.2
"42067",42,67,2008,12451,11788,663,5.3
"42067",42,67,2009,12157,11198,959,7.9
"42067",42,67,2010,12087,11126,961,8
"42067",42,67,2011,12009,11125,884,7.4
"42067",42,67,2012,12048,11174,874,7.3
"42067",42,67,2013,12032,11175,857,7.1
"42067",42,67,2014,11857,11186,671,5.7
"42067",42,67,2015,11990,11396,594,5
"42067",42,67,2016,12203,11549,654,5.4
"42067",42,67,2017,12394,11820,574,4.6
"42069",42,69,1990,106134,98550,7584,7.1
"42069",42,69,1991,106200,97257,8943,8.4
"42069",42,69,1992,107201,97610,9591,8.9
"42069",42,69,1993,107081,97977,9104,8.5
"42069",42,69,1994,106597,98507,8090,7.6
"42069",42,69,1995,106686,99417,7269,6.8
"42069",42,69,1996,107319,99677,7642,7.1
"42069",42,69,1997,108357,100768,7589,7
"42069",42,69,1998,106541,100411,6130,5.8
"42069",42,69,1999,105352,99883,5469,5.2
"42069",42,69,2000,104017,99375,4642,4.5
"42069",42,69,2001,105059,99240,5819,5.5
"42069",42,69,2002,104136,97782,6354,6.1
"42069",42,69,2003,103854,97754,6100,5.9
"42069",42,69,2004,104691,98463,6228,5.9
"42069",42,69,2005,105324,99776,5548,5.3
"42069",42,69,2006,105955,100766,5189,4.9
"42069",42,69,2007,106909,101792,5117,4.8
"42069",42,69,2008,108526,102231,6295,5.8
"42069",42,69,2009,107192,98396,8796,8.2
"42069",42,69,2010,106990,97405,9585,9
"42069",42,69,2011,107274,97814,9460,8.8
"42069",42,69,2012,107640,98121,9519,8.8
"42069",42,69,2013,107645,98710,8935,8.3
"42069",42,69,2014,106718,99692,7026,6.6
"42069",42,69,2015,106408,100205,6203,5.8
"42069",42,69,2016,106792,100755,6037,5.7
"42069",42,69,2017,106305,100852,5453,5.1
"42071",42,71,1990,226764,217242,9522,4.2
"42071",42,71,1991,225402,214848,10554,4.7
"42071",42,71,1992,228543,217617,10926,4.8
"42071",42,71,1993,228613,219178,9435,4.1
"42071",42,71,1994,230375,221654,8721,3.8
"42071",42,71,1995,234465,226183,8282,3.5
"42071",42,71,1996,239036,231005,8031,3.4
"42071",42,71,1997,245386,238151,7235,2.9
"42071",42,71,1998,246878,239777,7101,2.9
"42071",42,71,1999,247934,241220,6714,2.7
"42071",42,71,2000,251460,244446,7014,2.8
"42071",42,71,2001,255424,246660,8764,3.4
"42071",42,71,2002,260329,250063,10266,3.9
"42071",42,71,2003,257851,247222,10629,4.1
"42071",42,71,2004,264391,254205,10186,3.9
"42071",42,71,2005,267575,257802,9773,3.7
"42071",42,71,2006,267104,257754,9350,3.5
"42071",42,71,2007,269595,260379,9216,3.4
"42071",42,71,2008,274555,262878,11677,4.3
"42071",42,71,2009,269564,250126,19438,7.2
"42071",42,71,2010,268009,247920,20089,7.5
"42071",42,71,2011,265997,247727,18270,6.9
"42071",42,71,2012,269189,251655,17534,6.5
"42071",42,71,2013,270471,254188,16283,6
"42071",42,71,2014,272597,260021,12576,4.6
"42071",42,71,2015,275981,264626,11355,4.1
"42071",42,71,2016,279894,268337,11557,4.1
"42071",42,71,2017,280293,269590,10703,3.8
"42073",42,73,1990,41092,38414,2678,6.5
"42073",42,73,1991,41383,37510,3873,9.4
"42073",42,73,1992,41506,37165,4341,10.5
"42073",42,73,1993,40943,36933,4010,9.8
"42073",42,73,1994,40444,36898,3546,8.8
"42073",42,73,1995,39765,36969,2796,7
"42073",42,73,1996,40284,37666,2618,6.5
"42073",42,73,1997,40916,38348,2568,6.3
"42073",42,73,1998,41018,38617,2401,5.9
"42073",42,73,1999,40999,38669,2330,5.7
"42073",42,73,2000,44793,42606,2187,4.9
"42073",42,73,2001,44344,41856,2488,5.6
"42073",42,73,2002,44311,41529,2782,6.3
"42073",42,73,2003,43991,41273,2718,6.2
"42073",42,73,2004,44115,41362,2753,6.2
"42073",42,73,2005,43929,41335,2594,5.9
"42073",42,73,2006,43827,41469,2358,5.4
"42073",42,73,2007,44068,41769,2299,5.2
"42073",42,73,2008,43950,41240,2710,6.2
"42073",42,73,2009,43579,39523,4056,9.3
"42073",42,73,2010,43135,39153,3982,9.2
"42073",42,73,2011,43050,39434,3616,8.4
"42073",42,73,2012,43330,39905,3425,7.9
"42073",42,73,2013,43047,39809,3238,7.5
"42073",42,73,2014,42611,39962,2649,6.2
"42073",42,73,2015,42110,39454,2656,6.3
"42073",42,73,2016,41513,38728,2785,6.7
"42073",42,73,2017,40603,38132,2471,6.1
"42075",42,75,1990,61580,58584,2996,4.9
"42075",42,75,1991,62269,58722,3547,5.7
"42075",42,75,1992,62644,59283,3361,5.4
"42075",42,75,1993,62891,59788,3103,4.9
"42075",42,75,1994,63189,60371,2818,4.5
"42075",42,75,1995,63969,61241,2728,4.3
"42075",42,75,1996,65748,63183,2565,3.9
"42075",42,75,1997,66413,64236,2177,3.3
"42075",42,75,1998,67031,64711,2320,3.5
"42075",42,75,1999,66200,64162,2038,3.1
"42075",42,75,2000,64373,62355,2018,3.1
"42075",42,75,2001,65926,63542,2384,3.6
"42075",42,75,2002,66956,64115,2841,4.2
"42075",42,75,2003,66870,64023,2847,4.3
"42075",42,75,2004,68885,66124,2761,4
"42075",42,75,2005,70117,67598,2519,3.6
"42075",42,75,2006,71166,68764,2402,3.4
"42075",42,75,2007,72124,69628,2496,3.5
"42075",42,75,2008,73369,70324,3045,4.2
"42075",42,75,2009,72763,67885,4878,6.7
"42075",42,75,2010,70061,64825,5236,7.5
"42075",42,75,2011,69836,65003,4833,6.9
"42075",42,75,2012,70907,66176,4731,6.7
"42075",42,75,2013,70739,66342,4397,6.2
"42075",42,75,2014,70133,66657,3476,5
"42075",42,75,2015,70063,66890,3173,4.5
"42075",42,75,2016,70599,67435,3164,4.5
"42075",42,75,2017,70550,67635,2915,4.1
"42077",42,77,1990,152986,145203,7783,5.1
"42077",42,77,1991,154585,144600,9985,6.5
"42077",42,77,1992,154353,143488,10865,7
"42077",42,77,1993,153551,143913,9638,6.3
"42077",42,77,1994,152056,143584,8472,5.6
"42077",42,77,1995,151596,143415,8181,5.4
"42077",42,77,1996,153270,145144,8126,5.3
"42077",42,77,1997,156615,149449,7166,4.6
"42077",42,77,1998,158071,151305,6766,4.3
"42077",42,77,1999,159421,153188,6233,3.9
"42077",42,77,2000,163039,157140,5899,3.6
"42077",42,77,2001,166059,158719,7340,4.4
"42077",42,77,2002,167288,157815,9473,5.7
"42077",42,77,2003,167631,158147,9484,5.7
"42077",42,77,2004,168571,159594,8977,5.3
"42077",42,77,2005,170760,162363,8397,4.9
"42077",42,77,2006,174194,166251,7943,4.6
"42077",42,77,2007,175800,168063,7737,4.4
"42077",42,77,2008,178950,168895,10055,5.6
"42077",42,77,2009,178430,162952,15478,8.7
"42077",42,77,2010,177192,160908,16284,9.2
"42077",42,77,2011,179493,163972,15521,8.6
"42077",42,77,2012,182868,167357,15511,8.5
"42077",42,77,2013,183305,168957,14348,7.8
"42077",42,77,2014,183072,171963,11109,6.1
"42077",42,77,2015,185778,175869,9909,5.3
"42077",42,77,2016,189074,178969,10105,5.3
"42077",42,77,2017,188781,179294,9487,5
"42079",42,79,1990,156736,144919,11817,7.5
"42079",42,79,1991,158125,143542,14583,9.2
"42079",42,79,1992,161432,144693,16739,10.4
"42079",42,79,1993,160012,145726,14286,8.9
"42079",42,79,1994,159679,146142,13537,8.5
"42079",42,79,1995,160197,146776,13421,8.4
"42079",42,79,1996,159001,147360,11641,7.3
"42079",42,79,1997,160290,148823,11467,7.2
"42079",42,79,1998,158839,148636,10203,6.4
"42079",42,79,1999,157163,147957,9206,5.9
"42079",42,79,2000,156008,148047,7961,5.1
"42079",42,79,2001,155935,147130,8805,5.6
"42079",42,79,2002,155322,145166,10156,6.5
"42079",42,79,2003,155325,145306,10019,6.5
"42079",42,79,2004,156593,146190,10403,6.6
"42079",42,79,2005,157434,148332,9102,5.8
"42079",42,79,2006,158249,149736,8513,5.4
"42079",42,79,2007,159118,151181,7937,5
"42079",42,79,2008,161744,151642,10102,6.2
"42079",42,79,2009,161298,146781,14517,9
"42079",42,79,2010,159763,143863,15900,10
"42079",42,79,2011,159843,144500,15343,9.6
"42079",42,79,2012,160855,145103,15752,9.8
"42079",42,79,2013,160767,145691,15076,9.4
"42079",42,79,2014,159038,147381,11657,7.3
"42079",42,79,2015,158764,148514,10250,6.5
"42079",42,79,2016,158791,148775,10016,6.3
"42079",42,79,2017,158265,148913,9352,5.9
"42081",42,81,1990,57597,53331,4266,7.4
"42081",42,81,1991,57530,52700,4830,8.4
"42081",42,81,1992,58137,53125,5012,8.6
"42081",42,81,1993,57580,52805,4775,8.3
"42081",42,81,1994,57655,53380,4275,7.4
"42081",42,81,1995,57647,53436,4211,7.3
"42081",42,81,1996,58658,54754,3904,6.7
"42081",42,81,1997,58770,55002,3768,6.4
"42081",42,81,1998,58161,54820,3341,5.7
"42081",42,81,1999,57472,54583,2889,5
"42081",42,81,2000,59454,56907,2547,4.3
"42081",42,81,2001,60205,56953,3252,5.4
"42081",42,81,2002,59609,55892,3717,6.2
"42081",42,81,2003,59002,55460,3542,6
"42081",42,81,2004,59965,56339,3626,6
"42081",42,81,2005,59297,56082,3215,5.4
"42081",42,81,2006,58982,55914,3068,5.2
"42081",42,81,2007,59328,56408,2920,4.9
"42081",42,81,2008,60703,57136,3567,5.9
"42081",42,81,2009,60009,54723,5286,8.8
"42081",42,81,2010,59484,54171,5313,8.9
"42081",42,81,2011,61091,56364,4727,7.7
"42081",42,81,2012,62752,57815,4937,7.9
"42081",42,81,2013,61870,57029,4841,7.8
"42081",42,81,2014,61533,57751,3782,6.1
"42081",42,81,2015,60904,57216,3688,6.1
"42081",42,81,2016,58735,54841,3894,6.6
"42081",42,81,2017,57623,54369,3254,5.6
"42083",42,83,1990,20875,19487,1388,6.6
"42083",42,83,1991,20846,19149,1697,8.1
"42083",42,83,1992,21324,19388,1936,9.1
"42083",42,83,1993,21209,19418,1791,8.4
"42083",42,83,1994,21374,19699,1675,7.8
"42083",42,83,1995,21633,20269,1364,6.3
"42083",42,83,1996,22040,20699,1341,6.1
"42083",42,83,1997,21997,20571,1426,6.5
"42083",42,83,1998,21723,20325,1398,6.4
"42083",42,83,1999,21493,20349,1144,5.3
"42083",42,83,2000,21930,20890,1040,4.7
"42083",42,83,2001,22114,20885,1229,5.6
"42083",42,83,2002,22060,20733,1327,6
"42083",42,83,2003,21596,20283,1313,6.1
"42083",42,83,2004,21759,20465,1294,5.9
"42083",42,83,2005,21773,20586,1187,5.5
"42083",42,83,2006,21725,20575,1150,5.3
"42083",42,83,2007,21676,20591,1085,5
"42083",42,83,2008,21938,20594,1344,6.1
"42083",42,83,2009,21188,19016,2172,10.3
"42083",42,83,2010,20048,18031,2017,10.1
"42083",42,83,2011,20113,18357,1756,8.7
"42083",42,83,2012,20270,18570,1700,8.4
"42083",42,83,2013,19696,18087,1609,8.2
"42083",42,83,2014,19317,18080,1237,6.4
"42083",42,83,2015,18979,17825,1154,6.1
"42083",42,83,2016,18496,17272,1224,6.6
"42083",42,83,2017,18148,17029,1119,6.2
"42085",42,85,1990,53749,50811,2938,5.5
"42085",42,85,1991,55215,51112,4103,7.4
"42085",42,85,1992,56530,51372,5158,9.1
"42085",42,85,1993,55332,49459,5873,10.6
"42085",42,85,1994,55262,51405,3857,7
"42085",42,85,1995,55405,52608,2797,5
"42085",42,85,1996,56279,53731,2548,4.5
"42085",42,85,1997,57498,54496,3002,5.2
"42085",42,85,1998,58450,55980,2470,4.2
"42085",42,85,1999,58831,55884,2947,5
"42085",42,85,2000,56823,54020,2803,4.9
"42085",42,85,2001,55798,52817,2981,5.3
"42085",42,85,2002,55552,52388,3164,5.7
"42085",42,85,2003,55697,52261,3436,6.2
"42085",42,85,2004,55191,51686,3505,6.4
"42085",42,85,2005,55664,52181,3483,6.3
"42085",42,85,2006,55367,52319,3048,5.5
"42085",42,85,2007,55433,52359,3074,5.5
"42085",42,85,2008,55808,52070,3738,6.7
"42085",42,85,2009,54749,48642,6107,11.2
"42085",42,85,2010,53628,48517,5111,9.5
"42085",42,85,2011,53349,49143,4206,7.9
"42085",42,85,2012,53939,49863,4076,7.6
"42085",42,85,2013,53737,49854,3883,7.2
"42085",42,85,2014,53070,49958,3112,5.9
"42085",42,85,2015,52997,50107,2890,5.5
"42085",42,85,2016,52544,49412,3132,6
"42085",42,85,2017,50990,48200,2790,5.5
"42087",42,87,1990,22493,20708,1785,7.9
"42087",42,87,1991,22832,20701,2131,9.3
"42087",42,87,1992,22746,20358,2388,10.5
"42087",42,87,1993,22035,20340,1695,7.7
"42087",42,87,1994,22161,20674,1487,6.7
"42087",42,87,1995,22988,21370,1618,7
"42087",42,87,1996,22765,20816,1949,8.6
"42087",42,87,1997,22464,20882,1582,7
"42087",42,87,1998,22223,20788,1435,6.5
"42087",42,87,1999,22161,20673,1488,6.7
"42087",42,87,2000,22243,21298,945,4.2
"42087",42,87,2001,22013,20632,1381,6.3
"42087",42,87,2002,22457,20762,1695,7.5
"42087",42,87,2003,22096,20605,1491,6.7
"42087",42,87,2004,22773,21273,1500,6.6
"42087",42,87,2005,23056,21714,1342,5.8
"42087",42,87,2006,22468,21345,1123,5
"42087",42,87,2007,22514,21338,1176,5.2
"42087",42,87,2008,22790,21297,1493,6.6
"42087",42,87,2009,22558,20328,2230,9.9
"42087",42,87,2010,21265,19086,2179,10.2
"42087",42,87,2011,20998,19129,1869,8.9
"42087",42,87,2012,21130,19302,1828,8.7
"42087",42,87,2013,21390,19644,1746,8.2
"42087",42,87,2014,21095,19743,1352,6.4
"42087",42,87,2015,20913,19706,1207,5.8
"42087",42,87,2016,20810,19621,1189,5.7
"42087",42,87,2017,20630,19527,1103,5.3
"42089",42,89,1990,49696,46247,3449,6.9
"42089",42,89,1991,48865,44060,4805,9.8
"42089",42,89,1992,48937,43578,5359,11
"42089",42,89,1993,49000,44195,4805,9.8
"42089",42,89,1994,49754,45362,4392,8.8
"42089",42,89,1995,49917,45615,4302,8.6
"42089",42,89,1996,50231,46166,4065,8.1
"42089",42,89,1997,51998,47953,4045,7.8
"42089",42,89,1998,52772,49324,3448,6.5
"42089",42,89,1999,53294,50037,3257,6.1
"42089",42,89,2000,69483,66602,2881,4.1
"42089",42,89,2001,71393,67996,3397,4.8
"42089",42,89,2002,73770,69496,4274,5.8
"42089",42,89,2003,74292,69908,4384,5.9
"42089",42,89,2004,76400,71993,4407,5.8
"42089",42,89,2005,77999,73678,4321,5.5
"42089",42,89,2006,80137,75991,4146,5.2
"42089",42,89,2007,81613,77608,4005,4.9
"42089",42,89,2008,84017,78991,5026,6
"42089",42,89,2009,82859,75360,7499,9.1
"42089",42,89,2010,82725,74676,8049,9.7
"42089",42,89,2011,82214,74236,7978,9.7
"42089",42,89,2012,82422,74374,8048,9.8
"42089",42,89,2013,81588,73955,7633,9.4
"42089",42,89,2014,79848,73823,6025,7.5
"42089",42,89,2015,80768,75552,5216,6.5
"42089",42,89,2016,81912,76791,5121,6.3
"42089",42,89,2017,81955,77141,4814,5.9
"42091",42,91,1990,377075,362587,14488,3.8
"42091",42,91,1991,376033,355380,20653,5.5
"42091",42,91,1992,378695,354952,23743,6.3
"42091",42,91,1993,377994,357142,20852,5.5
"42091",42,91,1994,380442,361481,18961,5
"42091",42,91,1995,380203,363347,16856,4.4
"42091",42,91,1996,389062,373764,15298,3.9
"42091",42,91,1997,397864,383469,14395,3.6
"42091",42,91,1998,403933,391005,12928,3.2
"42091",42,91,1999,407804,395670,12134,3
"42091",42,91,2000,410178,397383,12795,3.1
"42091",42,91,2001,418261,402667,15594,3.7
"42091",42,91,2002,422025,402460,19565,4.6
"42091",42,91,2003,420500,401387,19113,4.5
"42091",42,91,2004,419558,401982,17576,4.2
"42091",42,91,2005,422571,406172,16399,3.9
"42091",42,91,2006,426868,411623,15245,3.6
"42091",42,91,2007,430052,415122,14930,3.5
"42091",42,91,2008,438010,419127,18883,4.3
"42091",42,91,2009,425087,396105,28982,6.8
"42091",42,91,2010,430378,400485,29893,6.9
"42091",42,91,2011,430366,402414,27952,6.5
"42091",42,91,2012,435595,407899,27696,6.4
"42091",42,91,2013,435621,410086,25535,5.9
"42091",42,91,2014,436596,416265,20331,4.7
"42091",42,91,2015,440895,422542,18353,4.2
"42091",42,91,2016,447537,428999,18538,4.1
"42091",42,91,2017,448710,431390,17320,3.9
"42093",42,93,1990,8806,8366,440,5
"42093",42,93,1991,8674,8190,484,5.6
"42093",42,93,1992,8920,8395,525,5.9
"42093",42,93,1993,8954,8574,380,4.2
"42093",42,93,1994,8814,8507,307,3.5
"42093",42,93,1995,8773,8461,312,3.6
"42093",42,93,1996,8651,8260,391,4.5
"42093",42,93,1997,8670,8293,377,4.3
"42093",42,93,1998,8671,8406,265,3.1
"42093",42,93,1999,8788,8563,225,2.6
"42093",42,93,2000,8630,8332,298,3.5
"42093",42,93,2001,8636,8269,367,4.2
"42093",42,93,2002,8754,8320,434,5
"42093",42,93,2003,8618,8214,404,4.7
"42093",42,93,2004,8822,8366,456,5.2
"42093",42,93,2005,8963,8567,396,4.4
"42093",42,93,2006,9057,8694,363,4
"42093",42,93,2007,9214,8859,355,3.9
"42093",42,93,2008,9438,8988,450,4.8
"42093",42,93,2009,9341,8729,612,6.6
"42093",42,93,2010,9079,8469,610,6.7
"42093",42,93,2011,9191,8617,574,6.2
"42093",42,93,2012,9444,8894,550,5.8
"42093",42,93,2013,9465,8947,518,5.5
"42093",42,93,2014,9241,8810,431,4.7
"42093",42,93,2015,9147,8752,395,4.3
"42093",42,93,2016,9128,8739,389,4.3
"42093",42,93,2017,9096,8744,352,3.9
"42095",42,95,1990,125558,118814,6744,5.4
"42095",42,95,1991,126391,118275,8116,6.4
"42095",42,95,1992,127049,117573,9476,7.5
"42095",42,95,1993,126308,118198,8110,6.4
"42095",42,95,1994,125737,118304,7433,5.9
"42095",42,95,1995,125796,119063,6733,5.4
"42095",42,95,1996,127976,120907,7069,5.5
"42095",42,95,1997,130779,124300,6479,5
"42095",42,95,1998,131870,126152,5718,4.3
"42095",42,95,1999,133121,127844,5277,4
"42095",42,95,2000,138653,133478,5175,3.7
"42095",42,95,2001,141091,134945,6146,4.4
"42095",42,95,2002,142811,135199,7612,5.3
"42095",42,95,2003,143850,135918,7932,5.5
"42095",42,95,2004,145728,137904,7824,5.4
"42095",42,95,2005,147760,140396,7364,5
"42095",42,95,2006,150123,143309,6814,4.5
"42095",42,95,2007,151894,145194,6700,4.4
"42095",42,95,2008,153803,145401,8402,5.5
"42095",42,95,2009,153711,140823,12888,8.4
"42095",42,95,2010,151874,138549,13325,8.8
"42095",42,95,2011,152641,140054,12587,8.2
"42095",42,95,2012,155425,142832,12593,8.1
"42095",42,95,2013,155780,144263,11517,7.4
"42095",42,95,2014,155369,146129,9240,5.9
"42095",42,95,2015,156593,148341,8252,5.3
"42095",42,95,2016,158885,150671,8214,5.2
"42095",42,95,2017,158727,150948,7779,4.9
"42097",42,97,1990,46253,42052,4201,9.1
"42097",42,97,1991,45387,40794,4593,10.1
"42097",42,97,1992,45680,41307,4373,9.6
"42097",42,97,1993,45750,41688,4062,8.9
"42097",42,97,1994,45226,41857,3369,7.4
"42097",42,97,1995,44542,41419,3123,7
"42097",42,97,1996,43775,40715,3060,7
"42097",42,97,1997,43846,40780,3066,7
"42097",42,97,1998,44164,41498,2666,6
"42097",42,97,1999,44171,41950,2221,5
"42097",42,97,2000,45577,43531,2046,4.5
"42097",42,97,2001,45582,43116,2466,5.4
"42097",42,97,2002,45747,42715,3032,6.6
"42097",42,97,2003,45060,41993,3067,6.8
"42097",42,97,2004,46313,43344,2969,6.4
"42097",42,97,2005,47156,44544,2612,5.5
"42097",42,97,2006,47148,44685,2463,5.2
"42097",42,97,2007,47308,44904,2404,5.1
"42097",42,97,2008,48029,44896,3133,6.5
"42097",42,97,2009,47323,42748,4575,9.7
"42097",42,97,2010,45371,40859,4512,9.9
"42097",42,97,2011,44956,40834,4122,9.2
"42097",42,97,2012,45086,40980,4106,9.1
"42097",42,97,2013,44731,40819,3912,8.7
"42097",42,97,2014,43931,40978,2953,6.7
"42097",42,97,2015,43432,40780,2652,6.1
"42097",42,97,2016,43962,41219,2743,6.2
"42097",42,97,2017,43683,41201,2482,5.7
"42099",42,99,1990,22015,20768,1247,5.7
"42099",42,99,1991,22367,20932,1435,6.4
"42099",42,99,1992,22599,21165,1434,6.3
"42099",42,99,1993,22625,21526,1099,4.9
"42099",42,99,1994,22976,21875,1101,4.8
"42099",42,99,1995,23350,22322,1028,4.4
"42099",42,99,1996,24098,23100,998,4.1
"42099",42,99,1997,24606,23669,937,3.8
"42099",42,99,1998,24661,23817,844,3.4
"42099",42,99,1999,24504,23575,929,3.8
"42099",42,99,2000,23378,22517,861,3.7
"42099",42,99,2001,23713,22659,1054,4.4
"42099",42,99,2002,24013,22813,1200,5
"42099",42,99,2003,23858,22650,1208,5.1
"42099",42,99,2004,24069,22895,1174,4.9
"42099",42,99,2005,24104,23085,1019,4.2
"42099",42,99,2006,24439,23499,940,3.8
"42099",42,99,2007,24560,23565,995,4.1
"42099",42,99,2008,25003,23700,1303,5.2
"42099",42,99,2009,24730,22788,1942,7.9
"42099",42,99,2010,24988,22965,2023,8.1
"42099",42,99,2011,24722,22895,1827,7.4
"42099",42,99,2012,24658,22870,1788,7.3
"42099",42,99,2013,24261,22674,1587,6.5
"42099",42,99,2014,24013,22773,1240,5.2
"42099",42,99,2015,24107,23030,1077,4.5
"42099",42,99,2016,24290,23169,1121,4.6
"42099",42,99,2017,24239,23198,1041,4.3
"42101",42,101,1990,700120,655800,44320,6.3
"42101",42,101,1991,693145,631369,61776,8.9
"42101",42,101,1992,685029,620597,64432,9.4
"42101",42,101,1993,678420,615224,63196,9.3
"42101",42,101,1994,664351,610632,53719,8.1
"42101",42,101,1995,651975,601734,50241,7.7
"42101",42,101,1996,650232,603199,47033,7.2
"42101",42,101,1997,650851,606355,44496,6.8
"42101",42,101,1998,646373,606105,40268,6.2
"42101",42,101,1999,641087,602132,38955,6.1
"42101",42,101,2000,637072,602049,35023,5.5
"42101",42,101,2001,637214,598088,39126,6.1
"42101",42,101,2002,635301,588476,46825,7.4
"42101",42,101,2003,625101,578304,46797,7.5
"42101",42,101,2004,619946,574770,45176,7.3
"42101",42,101,2005,617131,575746,41385,6.7
"42101",42,101,2006,615906,577682,38224,6.2
"42101",42,101,2007,620518,582727,37791,6.1
"42101",42,101,2008,630620,586024,44596,7.1
"42101",42,101,2009,652401,588815,63586,9.7
"42101",42,101,2010,687795,615059,72736,10.6
"42101",42,101,2011,690922,617204,73718,10.7
"42101",42,101,2012,699324,623246,76078,10.9
"42101",42,101,2013,698324,626430,71894,10.3
"42101",42,101,2014,691042,634989,56053,8.1
"42101",42,101,2015,695540,646080,49460,7.1
"42101",42,101,2016,703565,655996,47569,6.8
"42101",42,101,2017,704053,660073,43980,6.2
"42103",42,103,1990,13752,12965,787,5.7
"42103",42,103,1991,14835,13611,1224,8.3
"42103",42,103,1992,15536,14226,1310,8.4
"42103",42,103,1993,16157,14922,1235,7.6
"42103",42,103,1994,16485,15260,1225,7.4
"42103",42,103,1995,16730,15726,1004,6
"42103",42,103,1996,17371,16490,881,5.1
"42103",42,103,1997,18055,17131,924,5.1
"42103",42,103,1998,18382,17584,798,4.3
"42103",42,103,1999,19079,18419,660,3.5
"42103",42,103,2000,21255,20457,798,3.8
"42103",42,103,2001,22270,21199,1071,4.8
"42103",42,103,2002,23104,21802,1302,5.6
"42103",42,103,2003,24161,22762,1399,5.8
"42103",42,103,2004,24929,23449,1480,5.9
"42103",42,103,2005,25838,24321,1517,5.9
"42103",42,103,2006,27006,25473,1533,5.7
"42103",42,103,2007,27631,26134,1497,5.4
"42103",42,103,2008,28443,26736,1707,6
"42103",42,103,2009,28396,25821,2575,9.1
"42103",42,103,2010,26119,23580,2539,9.7
"42103",42,103,2011,26087,23503,2584,9.9
"42103",42,103,2012,26054,23421,2633,10.1
"42103",42,103,2013,25878,23383,2495,9.6
"42103",42,103,2014,25135,23230,1905,7.6
"42103",42,103,2015,24964,23330,1634,6.5
"42103",42,103,2016,24918,23328,1590,6.4
"42103",42,103,2017,24836,23365,1471,5.9
"42105",42,105,1990,7136,6616,520,7.3
"42105",42,105,1991,7854,7161,693,8.8
"42105",42,105,1992,7964,7156,808,10.1
"42105",42,105,1993,8345,7618,727,8.7
"42105",42,105,1994,8321,7685,636,7.6
"42105",42,105,1995,8523,7889,634,7.4
"42105",42,105,1996,8518,7908,610,7.2
"42105",42,105,1997,8873,8226,647,7.3
"42105",42,105,1998,8741,8127,614,7
"42105",42,105,1999,9323,8834,489,5.2
"42105",42,105,2000,8520,8139,381,4.5
"42105",42,105,2001,8993,8549,444,4.9
"42105",42,105,2002,9340,8806,534,5.7
"42105",42,105,2003,8468,7843,625,7.4
"42105",42,105,2004,8553,7986,567,6.6
"42105",42,105,2005,8632,8083,549,6.4
"42105",42,105,2006,8252,7764,488,5.9
"42105",42,105,2007,7756,7196,560,7.2
"42105",42,105,2008,7784,7228,556,7.1
"42105",42,105,2009,7716,6860,856,11.1
"42105",42,105,2010,7802,6991,811,10.4
"42105",42,105,2011,7834,7117,717,9.2
"42105",42,105,2012,7929,7206,723,9.1
"42105",42,105,2013,7750,7029,721,9.3
"42105",42,105,2014,7570,7011,559,7.4
"42105",42,105,2015,7375,6856,519,7
"42105",42,105,2016,7382,6803,579,7.8
"42105",42,105,2017,7228,6754,474,6.6
"42107",42,107,1990,69749,64281,5468,7.8
"42107",42,107,1991,69678,62718,6960,10
"42107",42,107,1992,70832,63957,6875,9.7
"42107",42,107,1993,69738,63642,6096,8.7
"42107",42,107,1994,69221,63504,5717,8.3
"42107",42,107,1995,68504,63098,5406,7.9
"42107",42,107,1996,68965,63140,5825,8.4
"42107",42,107,1997,68887,63672,5215,7.6
"42107",42,107,1998,67953,63323,4630,6.8
"42107",42,107,1999,68516,63844,4672,6.8
"42107",42,107,2000,70184,66106,4078,5.8
"42107",42,107,2001,70146,65567,4579,6.5
"42107",42,107,2002,70070,65188,4882,7
"42107",42,107,2003,69460,64554,4906,7.1
"42107",42,107,2004,69970,65212,4758,6.8
"42107",42,107,2005,70578,66437,4141,5.9
"42107",42,107,2006,71572,67700,3872,5.4
"42107",42,107,2007,73592,69906,3686,5
"42107",42,107,2008,74496,69866,4630,6.2
"42107",42,107,2009,73928,66625,7303,9.9
"42107",42,107,2010,70688,63196,7492,10.6
"42107",42,107,2011,70052,63219,6833,9.8
"42107",42,107,2012,70983,64077,6906,9.7
"42107",42,107,2013,70245,63785,6460,9.2
"42107",42,107,2014,68984,64095,4889,7.1
"42107",42,107,2015,68186,63898,4288,6.3
"42107",42,107,2016,67579,63409,4170,6.2
"42107",42,107,2017,66298,62412,3886,5.9
"42109",42,109,1990,18840,17360,1480,7.9
"42109",42,109,1991,18366,16981,1385,7.5
"42109",42,109,1992,18771,17405,1366,7.3
"42109",42,109,1993,18736,17653,1083,5.8
"42109",42,109,1994,18574,17698,876,4.7
"42109",42,109,1995,18607,17577,1030,5.5
"42109",42,109,1996,18803,17592,1211,6.4
"42109",42,109,1997,18687,17780,907,4.9
"42109",42,109,1998,19125,18196,929,4.9
"42109",42,109,1999,19305,18505,800,4.1
"42109",42,109,2000,19080,18396,684,3.6
"42109",42,109,2001,19097,18291,806,4.2
"42109",42,109,2002,19616,18666,950,4.8
"42109",42,109,2003,19178,18237,941,4.9
"42109",42,109,2004,19842,18929,913,4.6
"42109",42,109,2005,20279,19396,883,4.4
"42109",42,109,2006,20038,19221,817,4.1
"42109",42,109,2007,19834,18913,921,4.6
"42109",42,109,2008,19821,18615,1206,6.1
"42109",42,109,2009,19376,17634,1742,9
"42109",42,109,2010,20112,18424,1688,8.4
"42109",42,109,2011,19813,18288,1525,7.7
"42109",42,109,2012,19836,18329,1507,7.6
"42109",42,109,2013,19745,18389,1356,6.9
"42109",42,109,2014,19861,18836,1025,5.2
"42109",42,109,2015,20064,19122,942,4.7
"42109",42,109,2016,20496,19536,960,4.7
"42109",42,109,2017,20541,19630,911,4.4
"42111",42,111,1990,34929,32433,2496,7.1
"42111",42,111,1991,35940,32658,3282,9.1
"42111",42,111,1992,36503,32880,3623,9.9
"42111",42,111,1993,36726,33103,3623,9.9
"42111",42,111,1994,37354,33973,3381,9.1
"42111",42,111,1995,38204,34953,3251,8.5
"42111",42,111,1996,38274,35322,2952,7.7
"42111",42,111,1997,38348,35539,2809,7.3
"42111",42,111,1998,37585,35193,2392,6.4
"42111",42,111,1999,37735,35573,2162,5.7
"42111",42,111,2000,38179,36186,1993,5.2
"42111",42,111,2001,38224,35978,2246,5.9
"42111",42,111,2002,38434,35814,2620,6.8
"42111",42,111,2003,38646,36040,2606,6.7
"42111",42,111,2004,39145,36654,2491,6.4
"42111",42,111,2005,39459,37108,2351,6
"42111",42,111,2006,38958,36821,2137,5.5
"42111",42,111,2007,38870,36732,2138,5.5
"42111",42,111,2008,39439,36942,2497,6.3
"42111",42,111,2009,38857,35545,3312,8.5
"42111",42,111,2010,37151,33593,3558,9.6
"42111",42,111,2011,36949,33653,3296,8.9
"42111",42,111,2012,36584,33343,3241,8.9
"42111",42,111,2013,35811,32504,3307,9.2
"42111",42,111,2014,35001,32447,2554,7.3
"42111",42,111,2015,34463,32110,2353,6.8
"42111",42,111,2016,34184,31728,2456,7.2
"42111",42,111,2017,33582,31536,2046,6.1
"42113",42,113,1990,2645,2452,193,7.3
"42113",42,113,1991,2603,2270,333,12.8
"42113",42,113,1992,2577,2295,282,10.9
"42113",42,113,1993,2733,2544,189,6.9
"42113",42,113,1994,2670,2520,150,5.6
"42113",42,113,1995,2695,2532,163,6
"42113",42,113,1996,2742,2559,183,6.7
"42113",42,113,1997,2711,2525,186,6.9
"42113",42,113,1998,2765,2584,181,6.5
"42113",42,113,1999,2565,2406,159,6.2
"42113",42,113,2000,2989,2846,143,4.8
"42113",42,113,2001,3081,2915,166,5.4
"42113",42,113,2002,3195,3006,189,5.9
"42113",42,113,2003,3049,2864,185,6.1
"42113",42,113,2004,3113,2925,188,6
"42113",42,113,2005,3115,2931,184,5.9
"42113",42,113,2006,3020,2861,159,5.3
"42113",42,113,2007,2996,2858,138,4.6
"42113",42,113,2008,3006,2835,171,5.7
"42113",42,113,2009,3023,2768,255,8.4
"42113",42,113,2010,2960,2723,237,8
"42113",42,113,2011,3039,2818,221,7.3
"42113",42,113,2012,3102,2860,242,7.8
"42113",42,113,2013,3058,2805,253,8.3
"42113",42,113,2014,3060,2873,187,6.1
"42113",42,113,2015,3034,2847,187,6.2
"42113",42,113,2016,2863,2659,204,7.1
"42113",42,113,2017,2783,2622,161,5.8
"42115",42,115,1990,18234,16988,1246,6.8
"42115",42,115,1991,18228,16642,1586,8.7
"42115",42,115,1992,18823,17013,1810,9.6
"42115",42,115,1993,19164,17460,1704,8.9
"42115",42,115,1994,18986,17448,1538,8.1
"42115",42,115,1995,19226,17839,1387,7.2
"42115",42,115,1996,19138,17744,1394,7.3
"42115",42,115,1997,19114,17753,1361,7.1
"42115",42,115,1998,18557,17589,968,5.2
"42115",42,115,1999,19122,18184,938,4.9
"42115",42,115,2000,20432,19638,794,3.9
"42115",42,115,2001,21181,19980,1201,5.7
"42115",42,115,2002,21766,20404,1362,6.3
"42115",42,115,2003,20698,19452,1246,6
"42115",42,115,2004,21532,20325,1207,5.6
"42115",42,115,2005,21559,20489,1070,5
"42115",42,115,2006,21357,20335,1022,4.8
"42115",42,115,2007,21647,20707,940,4.3
"42115",42,115,2008,22028,20783,1245,5.7
"42115",42,115,2009,21794,19942,1852,8.5
"42115",42,115,2010,21623,19737,1886,8.7
"42115",42,115,2011,21927,20185,1742,7.9
"42115",42,115,2012,22508,20797,1711,7.6
"42115",42,115,2013,22342,20749,1593,7.1
"42115",42,115,2014,21444,20172,1272,5.9
"42115",42,115,2015,21400,20205,1195,5.6
"42115",42,115,2016,20870,19685,1185,5.7
"42115",42,115,2017,20651,19674,977,4.7
"42117",42,117,1990,18738,17295,1443,7.7
"42117",42,117,1991,18805,17248,1557,8.3
"42117",42,117,1992,18677,17235,1442,7.7
"42117",42,117,1993,19176,17741,1435,7.5
"42117",42,117,1994,19480,18233,1247,6.4
"42117",42,117,1995,19674,18288,1386,7
"42117",42,117,1996,19651,18189,1462,7.4
"42117",42,117,1997,20216,18886,1330,6.6
"42117",42,117,1998,19936,18826,1110,5.6
"42117",42,117,1999,19755,18834,921,4.7
"42117",42,117,2000,20065,19185,880,4.4
"42117",42,117,2001,20507,19217,1290,6.3
"42117",42,117,2002,20798,19447,1351,6.5
"42117",42,117,2003,20323,19054,1269,6.2
"42117",42,117,2004,21177,19951,1226,5.8
"42117",42,117,2005,20978,19755,1223,5.8
"42117",42,117,2006,20220,19119,1101,5.4
"42117",42,117,2007,20374,19259,1115,5.5
"42117",42,117,2008,20623,19374,1249,6.1
"42117",42,117,2009,20410,18431,1979,9.7
"42117",42,117,2010,20194,18516,1678,8.3
"42117",42,117,2011,21193,19711,1482,7
"42117",42,117,2012,21727,20071,1656,7.6
"42117",42,117,2013,21268,19445,1823,8.6
"42117",42,117,2014,20456,19038,1418,6.9
"42117",42,117,2015,20330,19006,1324,6.5
"42117",42,117,2016,19856,18440,1416,7.1
"42117",42,117,2017,19220,18069,1151,6
"42119",42,119,1990,16835,15833,1002,6
"42119",42,119,1991,16742,15446,1296,7.7
"42119",42,119,1992,16948,15771,1177,6.9
"42119",42,119,1993,17063,16116,947,5.6
"42119",42,119,1994,18469,17741,728,3.9
"42119",42,119,1995,18369,17561,808,4.4
"42119",42,119,1996,18756,17838,918,4.9
"42119",42,119,1997,18806,17979,827,4.4
"42119",42,119,1998,18585,17884,701,3.8
"42119",42,119,1999,18925,18357,568,3
"42119",42,119,2000,17344,16679,665,3.8
"42119",42,119,2001,17663,16847,816,4.6
"42119",42,119,2002,17837,16830,1007,5.6
"42119",42,119,2003,17375,16418,957,5.5
"42119",42,119,2004,17780,16815,965,5.4
"42119",42,119,2005,17926,16967,959,5.3
"42119",42,119,2006,17852,16943,909,5.1
"42119",42,119,2007,17676,16746,930,5.3
"42119",42,119,2008,17849,16733,1116,6.3
"42119",42,119,2009,17681,16081,1600,9
"42119",42,119,2010,19192,17711,1481,7.7
"42119",42,119,2011,19063,17775,1288,6.8
"42119",42,119,2012,19130,17901,1229,6.4
"42119",42,119,2013,19150,17936,1214,6.3
"42119",42,119,2014,19129,18176,953,5
"42119",42,119,2015,19307,18443,864,4.5
"42119",42,119,2016,19802,18856,946,4.8
"42119",42,119,2017,19834,18966,868,4.4
"42121",42,121,1990,25714,24247,1467,5.7
"42121",42,121,1991,25503,23371,2132,8.4
"42121",42,121,1992,25459,23061,2398,9.4
"42121",42,121,1993,25562,23319,2243,8.8
"42121",42,121,1994,25833,23578,2255,8.7
"42121",42,121,1995,25985,24085,1900,7.3
"42121",42,121,1996,26409,24496,1913,7.2
"42121",42,121,1997,26667,24901,1766,6.6
"42121",42,121,1998,26683,25253,1430,5.4
"42121",42,121,1999,26619,25068,1551,5.8
"42121",42,121,2000,26869,25514,1355,5
"42121",42,121,2001,26586,25187,1399,5.3
"42121",42,121,2002,26239,24709,1530,5.8
"42121",42,121,2003,26139,24551,1588,6.1
"42121",42,121,2004,26410,24808,1602,6.1
"42121",42,121,2005,26640,25194,1446,5.4
"42121",42,121,2006,26588,25209,1379,5.2
"42121",42,121,2007,26073,24791,1282,4.9
"42121",42,121,2008,26447,24947,1500,5.7
"42121",42,121,2009,26339,24053,2286,8.7
"42121",42,121,2010,26428,24182,2246,8.5
"42121",42,121,2011,26398,24448,1950,7.4
"42121",42,121,2012,26300,24284,2016,7.7
"42121",42,121,2013,25270,23307,1963,7.8
"42121",42,121,2014,24692,23232,1460,5.9
"42121",42,121,2015,24461,23005,1456,6
"42121",42,121,2016,23720,22000,1720,7.3
"42121",42,121,2017,23056,21645,1411,6.1
"42123",42,123,1990,21685,20707,978,4.5
"42123",42,123,1991,22615,21107,1508,6.7
"42123",42,123,1992,22700,20918,1782,7.9
"42123",42,123,1993,22436,20884,1552,6.9
"42123",42,123,1994,22202,20947,1255,5.7
"42123",42,123,1995,21925,20858,1067,4.9
"42123",42,123,1996,21775,20636,1139,5.2
"42123",42,123,1997,21450,20333,1117,5.2
"42123",42,123,1998,21028,20059,969,4.6
"42123",42,123,1999,20537,19718,819,4
"42123",42,123,2000,22203,21379,824,3.7
"42123",42,123,2001,22574,21523,1051,4.7
"42123",42,123,2002,22549,21237,1312,5.8
"42123",42,123,2003,21297,19969,1328,6.2
"42123",42,123,2004,21286,20087,1199,5.6
"42123",42,123,2005,21162,20105,1057,5
"42123",42,123,2006,21066,20009,1057,5
"42123",42,123,2007,21423,20447,976,4.6
"42123",42,123,2008,21823,20690,1133,5.2
"42123",42,123,2009,21898,20186,1712,7.8
"42123",42,123,2010,20898,19170,1728,8.3
"42123",42,123,2011,20445,18910,1535,7.5
"42123",42,123,2012,20588,19179,1409,6.8
"42123",42,123,2013,20427,19126,1301,6.4
"42123",42,123,2014,20174,19110,1064,5.3
"42123",42,123,2015,19955,18959,996,5
"42123",42,123,2016,19781,18698,1083,5.5
"42123",42,123,2017,19337,18315,1022,5.3
"42125",42,125,1990,90610,85360,5250,5.8
"42125",42,125,1991,92124,85540,6584,7.1
"42125",42,125,1992,93811,86701,7110,7.6
"42125",42,125,1993,94979,87693,7286,7.7
"42125",42,125,1994,95120,88213,6907,7.3
"42125",42,125,1995,94882,88499,6383,6.7
"42125",42,125,1996,95560,90224,5336,5.6
"42125",42,125,1997,96836,91688,5148,5.3
"42125",42,125,1998,97414,92482,4932,5.1
"42125",42,125,1999,97871,93200,4671,4.8
"42125",42,125,2000,98726,94219,4507,4.6
"42125",42,125,2001,100729,95555,5174,5.1
"42125",42,125,2002,101245,95140,6105,6
"42125",42,125,2003,101301,95142,6159,6.1
"42125",42,125,2004,101646,95821,5825,5.7
"42125",42,125,2005,102273,96666,5607,5.5
"42125",42,125,2006,103239,98156,5083,4.9
"42125",42,125,2007,104070,99305,4765,4.6
"42125",42,125,2008,106420,100875,5545,5.2
"42125",42,125,2009,106457,98347,8110,7.6
"42125",42,125,2010,105278,96763,8515,8.1
"42125",42,125,2011,105890,98107,7783,7.4
"42125",42,125,2012,107440,99718,7722,7.2
"42125",42,125,2013,107008,99583,7425,6.9
"42125",42,125,2014,106172,100060,6112,5.8
"42125",42,125,2015,106615,100677,5938,5.6
"42125",42,125,2016,107289,100730,6559,6.1
"42125",42,125,2017,106484,100896,5588,5.2
"42127",42,127,1990,19370,18065,1305,6.7
"42127",42,127,1991,19567,17579,1988,10.2
"42127",42,127,1992,19352,17298,2054,10.6
"42127",42,127,1993,18854,17006,1848,9.8
"42127",42,127,1994,18739,16972,1767,9.4
"42127",42,127,1995,18930,17254,1676,8.9
"42127",42,127,1996,18903,17266,1637,8.7
"42127",42,127,1997,18953,17410,1543,8.1
"42127",42,127,1998,19129,17855,1274,6.7
"42127",42,127,1999,19863,18665,1198,6
"42127",42,127,2000,22712,21692,1020,4.5
"42127",42,127,2001,22997,21863,1134,4.9
"42127",42,127,2002,23874,22645,1229,5.1
"42127",42,127,2003,23624,22421,1203,5.1
"42127",42,127,2004,24027,22787,1240,5.2
"42127",42,127,2005,24798,23603,1195,4.8
"42127",42,127,2006,25287,24237,1050,4.2
"42127",42,127,2007,25655,24580,1075,4.2
"42127",42,127,2008,25742,24400,1342,5.2
"42127",42,127,2009,25640,23736,1904,7.4
"42127",42,127,2010,23616,21699,1917,8.1
"42127",42,127,2011,23279,21391,1888,8.1
"42127",42,127,2012,23121,21260,1861,8
"42127",42,127,2013,22717,20931,1786,7.9
"42127",42,127,2014,22345,20913,1432,6.4
"42127",42,127,2015,22268,20972,1296,5.8
"42127",42,127,2016,22527,21235,1292,5.7
"42127",42,127,2017,22528,21384,1144,5.1
"42129",42,129,1990,171870,161771,10099,5.9
"42129",42,129,1991,174461,162185,12276,7
"42129",42,129,1992,178202,164553,13649,7.7
"42129",42,129,1993,180263,166157,14106,7.8
"42129",42,129,1994,180061,167016,13045,7.2
"42129",42,129,1995,180705,168675,12030,6.7
"42129",42,129,1996,182546,171966,10580,5.8
"42129",42,129,1997,184650,174452,10198,5.5
"42129",42,129,1998,185227,175591,9636,5.2
"42129",42,129,1999,185454,176520,8934,4.8
"42129",42,129,2000,182252,173853,8399,4.6
"42129",42,129,2001,185060,175553,9507,5.1
"42129",42,129,2002,185039,174201,10838,5.9
"42129",42,129,2003,184460,173430,11030,6
"42129",42,129,2004,184930,173955,10975,5.9
"42129",42,129,2005,184182,174423,9759,5.3
"42129",42,129,2006,185706,176512,9194,5
"42129",42,129,2007,185838,177330,8508,4.6
"42129",42,129,2008,189007,179023,9984,5.3
"42129",42,129,2009,188741,174028,14713,7.8
"42129",42,129,2010,185272,170021,15251,8.2
"42129",42,129,2011,185894,171892,14002,7.5
"42129",42,129,2012,187624,173802,13822,7.4
"42129",42,129,2013,186375,173348,13027,7
"42129",42,129,2014,183230,172700,10530,5.7
"42129",42,129,2015,182925,173042,9883,5.4
"42129",42,129,2016,182859,172157,10702,5.9
"42129",42,129,2017,181839,172417,9422,5.2
"42131",42,131,1990,13842,12904,938,6.8
"42131",42,131,1991,14027,12821,1206,8.6
"42131",42,131,1992,14681,13158,1523,10.4
"42131",42,131,1993,14826,13422,1404,9.5
"42131",42,131,1994,14865,13642,1223,8.2
"42131",42,131,1995,14887,13740,1147,7.7
"42131",42,131,1996,15350,14131,1219,7.9
"42131",42,131,1997,15588,14306,1282,8.2
"42131",42,131,1998,15461,14354,1107,7.2
"42131",42,131,1999,15304,14450,854,5.6
"42131",42,131,2000,13857,13197,660,4.8
"42131",42,131,2001,13990,13260,730,5.2
"42131",42,131,2002,13928,13087,841,6
"42131",42,131,2003,14030,13189,841,6
"42131",42,131,2004,14199,13331,868,6.1
"42131",42,131,2005,14264,13527,737,5.2
"42131",42,131,2006,14353,13616,737,5.1
"42131",42,131,2007,14413,13654,759,5.3
"42131",42,131,2008,14548,13671,877,6
"42131",42,131,2009,14447,13220,1227,8.5
"42131",42,131,2010,14334,13077,1257,8.8
"42131",42,131,2011,14330,13070,1260,8.8
"42131",42,131,2012,14394,13106,1288,8.9
"42131",42,131,2013,14327,13092,1235,8.6
"42131",42,131,2014,14274,13323,951,6.7
"42131",42,131,2015,14116,13254,862,6.1
"42131",42,131,2016,14089,13215,874,6.2
"42131",42,131,2017,13958,13224,734,5.3
"42133",42,133,1990,187523,178777,8746,4.7
"42133",42,133,1991,187754,177326,10428,5.6
"42133",42,133,1992,190170,178142,12028,6.3
"42133",42,133,1993,189766,179651,10115,5.3
"42133",42,133,1994,189854,181301,8553,4.5
"42133",42,133,1995,193390,185348,8042,4.2
"42133",42,133,1996,195458,186735,8723,4.5
"42133",42,133,1997,196386,188414,7972,4.1
"42133",42,133,1998,195662,188448,7214,3.7
"42133",42,133,1999,198199,191159,7040,3.6
"42133",42,133,2000,209665,202777,6888,3.3
"42133",42,133,2001,211311,202209,9102,4.3
"42133",42,133,2002,211241,200966,10275,4.9
"42133",42,133,2003,210480,200227,10253,4.9
"42133",42,133,2004,214965,205322,9643,4.5
"42133",42,133,2005,218916,209684,9232,4.2
"42133",42,133,2006,222435,213549,8886,4
"42133",42,133,2007,225424,216856,8568,3.8
"42133",42,133,2008,229230,218459,10771,4.7
"42133",42,133,2009,226705,208284,18421,8.1
"42133",42,133,2010,230398,211054,19344,8.4
"42133",42,133,2011,230661,213368,17293,7.5
"42133",42,133,2012,233204,215912,17292,7.4
"42133",42,133,2013,232147,216521,15626,6.7
"42133",42,133,2014,230710,218272,12438,5.4
"42133",42,133,2015,232736,221649,11087,4.8
"42133",42,133,2016,234956,224099,10857,4.6
"42133",42,133,2017,234356,224108,10248,4.4
"44001",44,1,1990,26458,24675,1783,6.7
"44001",44,1,1991,26060,23867,2193,8.4
"44001",44,1,1992,26653,24217,2436,9.1
"44001",44,1,1993,26407,24366,2041,7.7
"44001",44,1,1994,25857,24239,1618,6.3
"44001",44,1,1995,25782,24450,1332,5.2
"44001",44,1,1996,26106,24957,1149,4.4
"44001",44,1,1997,26624,25509,1115,4.2
"44001",44,1,1998,26967,26021,946,3.5
"44001",44,1,1999,27061,26215,846,3.1
"44001",44,1,2000,26850,25881,969,3.6
"44001",44,1,2001,26711,25718,993,3.7
"44001",44,1,2002,27363,26199,1164,4.3
"44001",44,1,2003,27636,26372,1264,4.6
"44001",44,1,2004,27903,26671,1232,4.4
"44001",44,1,2005,28254,27040,1214,4.3
"44001",44,1,2006,28585,27360,1225,4.3
"44001",44,1,2007,27647,26403,1244,4.5
"44001",44,1,2008,27450,25585,1865,6.8
"44001",44,1,2009,27080,24354,2726,10.1
"44001",44,1,2010,26954,24336,2618,9.7
"44001",44,1,2011,26288,23763,2525,9.6
"44001",44,1,2012,26195,23843,2352,9
"44001",44,1,2013,26265,24187,2078,7.9
"44001",44,1,2014,26163,24405,1758,6.7
"44001",44,1,2015,26163,24779,1384,5.3
"44001",44,1,2016,26145,24931,1214,4.6
"44001",44,1,2017,26179,25176,1003,3.8
"44003",44,3,1990,88714,83508,5206,5.9
"44003",44,3,1991,88230,80749,7481,8.5
"44003",44,3,1992,90105,82158,7947,8.8
"44003",44,3,1993,89671,82992,6679,7.4
"44003",44,3,1994,88676,82615,6061,6.8
"44003",44,3,1995,88447,82855,5592,6.3
"44003",44,3,1996,89169,84344,4825,5.4
"44003",44,3,1997,90851,86265,4586,5
"44003",44,3,1998,91555,87559,3996,4.4
"44003",44,3,1999,92398,88768,3630,3.9
"44003",44,3,2000,92859,89267,3592,3.9
"44003",44,3,2001,92814,88937,3877,4.2
"44003",44,3,2002,93567,89213,4354,4.7
"44003",44,3,2003,95429,90678,4751,5
"44003",44,3,2004,95039,90377,4662,4.9
"44003",44,3,2005,96472,91837,4635,4.8
"44003",44,3,2006,97525,92982,4543,4.7
"44003",44,3,2007,97802,92912,4890,5
"44003",44,3,2008,97344,90157,7187,7.4
"44003",44,3,2009,96816,86700,10116,10.4
"44003",44,3,2010,94255,83788,10467,11.1
"44003",44,3,2011,92724,82866,9858,10.6
"44003",44,3,2012,92208,83037,9171,9.9
"44003",44,3,2013,91863,83830,8033,8.7
"44003",44,3,2014,91468,84910,6558,7.2
"44003",44,3,2015,91018,85996,5022,5.5
"44003",44,3,2016,90765,86459,4306,4.7
"44003",44,3,2017,91029,87306,3723,4.1
"44005",44,5,1990,43716,41152,2564,5.9
"44005",44,5,1991,42281,38787,3494,8.3
"44005",44,5,1992,42714,39089,3625,8.5
"44005",44,5,1993,41638,38245,3393,8.1
"44005",44,5,1994,40202,37341,2861,7.1
"44005",44,5,1995,39430,37049,2381,6
"44005",44,5,1996,40573,38425,2148,5.3
"44005",44,5,1997,42310,40196,2114,5
"44005",44,5,1998,41887,40004,1883,4.5
"44005",44,5,1999,43136,41547,1589,3.7
"44005",44,5,2000,44990,43336,1654,3.7
"44005",44,5,2001,44428,42709,1719,3.9
"44005",44,5,2002,44629,42682,1947,4.4
"44005",44,5,2003,45061,42946,2115,4.7
"44005",44,5,2004,44468,42421,2047,4.6
"44005",44,5,2005,44632,42577,2055,4.6
"44005",44,5,2006,44686,42666,2020,4.5
"44005",44,5,2007,45374,43313,2061,4.5
"44005",44,5,2008,44011,41018,2993,6.8
"44005",44,5,2009,43436,39197,4239,9.8
"44005",44,5,2010,45051,40560,4491,10
"44005",44,5,2011,44446,39978,4468,10.1
"44005",44,5,2012,44225,40116,4109,9.3
"44005",44,5,2013,44333,40567,3766,8.5
"44005",44,5,2014,44084,41050,3034,6.9
"44005",44,5,2015,44082,41696,2386,5.4
"44005",44,5,2016,44255,42167,2088,4.7
"44005",44,5,2017,44318,42580,1738,3.9
"44007",44,7,1990,307415,286340,21075,6.9
"44007",44,7,1991,302593,275080,27513,9.1
"44007",44,7,1992,306450,277743,28707,9.4
"44007",44,7,1993,303046,278356,24690,8.1
"44007",44,7,1994,297656,275866,21790,7.3
"44007",44,7,1995,295210,275133,20077,6.8
"44007",44,7,1996,296435,278960,17475,5.9
"44007",44,7,1997,301806,284915,16891,5.6
"44007",44,7,1998,304408,288970,15438,5.1
"44007",44,7,1999,306002,291948,14054,4.6
"44007",44,7,2000,309746,296002,13744,4.4
"44007",44,7,2001,310556,294798,15758,5.1
"44007",44,7,2002,314031,296897,17134,5.5
"44007",44,7,2003,320539,301684,18855,5.9
"44007",44,7,2004,319368,301529,17839,5.6
"44007",44,7,2005,323279,305663,17616,5.4
"44007",44,7,2006,327711,310272,17439,5.3
"44007",44,7,2007,328144,309733,18411,5.6
"44007",44,7,2008,327491,300024,27467,8.4
"44007",44,7,2009,326783,288048,38735,11.9
"44007",44,7,2010,328893,290181,38712,11.8
"44007",44,7,2011,326138,288259,37879,11.6
"44007",44,7,2012,325779,290130,35649,10.9
"44007",44,7,2013,324603,292942,31661,9.8
"44007",44,7,2014,324598,298159,26439,8.1
"44007",44,7,2015,323888,303336,20552,6.3
"44007",44,7,2016,323360,305442,17918,5.5
"44007",44,7,2017,323988,308436,15552,4.8
"44009",44,9,1990,59060,56328,2732,4.6
"44009",44,9,1991,58853,55167,3686,6.3
"44009",44,9,1992,60735,56697,4038,6.6
"44009",44,9,1993,61482,57814,3668,6
"44009",44,9,1994,61637,58507,3130,5.1
"44009",44,9,1995,62549,59592,2957,4.7
"44009",44,9,1996,63812,61322,2490,3.9
"44009",44,9,1997,66285,63819,2466,3.7
"44009",44,9,1998,67794,65510,2284,3.4
"44009",44,9,1999,69499,67283,2216,3.2
"44009",44,9,2000,69117,66828,2289,3.3
"44009",44,9,2001,69358,66884,2474,3.6
"44009",44,9,2002,70664,67840,2824,4
"44009",44,9,2003,71818,68887,2931,4.1
"44009",44,9,2004,71912,68896,3016,4.2
"44009",44,9,2005,73099,70079,3020,4.1
"44009",44,9,2006,74096,71077,3019,4.1
"44009",44,9,2007,74206,71040,3166,4.3
"44009",44,9,2008,74032,69157,4875,6.6
"44009",44,9,2009,73170,66656,6514,8.9
"44009",44,9,2010,71551,64351,7200,10.1
"44009",44,9,2011,70460,63381,7079,10
"44009",44,9,2012,70080,63307,6773,9.7
"44009",44,9,2013,69865,63846,6019,8.6
"44009",44,9,2014,69599,64599,5000,7.2
"44009",44,9,2015,69336,65448,3888,5.6
"44009",44,9,2016,69029,65745,3284,4.8
"44009",44,9,2017,69144,66369,2775,4
"45001",45,1,1990,11951,11161,790,6.6
"45001",45,1,1991,11783,10829,954,8.1
"45001",45,1,1992,11969,11063,906,7.6
"45001",45,1,1993,12408,11265,1143,9.2
"45001",45,1,1994,12486,11441,1045,8.4
"45001",45,1,1995,12612,11799,813,6.4
"45001",45,1,1996,12513,11691,822,6.6
"45001",45,1,1997,12888,12040,848,6.6
"45001",45,1,1998,12697,12082,615,4.8
"45001",45,1,1999,12418,11715,703,5.7
"45001",45,1,2000,12602,12119,483,3.8
"45001",45,1,2001,12302,11491,811,6.6
"45001",45,1,2002,11796,10889,907,7.7
"45001",45,1,2003,11813,10736,1077,9.1
"45001",45,1,2004,11934,10955,979,8.2
"45001",45,1,2005,12067,11137,930,7.7
"45001",45,1,2006,12032,10972,1060,8.8
"45001",45,1,2007,11511,10580,931,8.1
"45001",45,1,2008,11335,10419,916,8.1
"45001",45,1,2009,11260,9665,1595,14.2
"45001",45,1,2010,10925,9439,1486,13.6
"45001",45,1,2011,10780,9437,1343,12.5
"45001",45,1,2012,10684,9549,1135,10.6
"45001",45,1,2013,10543,9540,1003,9.5
"45001",45,1,2014,10576,9760,816,7.7
"45001",45,1,2015,10349,9637,712,6.9
"45001",45,1,2016,10287,9725,562,5.5
"45001",45,1,2017,10103,9640,463,4.6
"45003",45,3,1990,61218,58391,2827,4.6
"45003",45,3,1991,62030,58522,3508,5.7
"45003",45,3,1992,62353,58237,4116,6.6
"45003",45,3,1993,64701,59693,5008,7.7
"45003",45,3,1994,63838,59779,4059,6.4
"45003",45,3,1995,64456,59711,4745,7.4
"45003",45,3,1996,63640,59303,4337,6.8
"45003",45,3,1997,63262,59440,3822,6
"45003",45,3,1998,62997,60139,2858,4.5
"45003",45,3,1999,64348,61349,2999,4.7
"45003",45,3,2000,69965,67225,2740,3.9
"45003",45,3,2001,68414,65004,3410,5
"45003",45,3,2002,69172,65765,3407,4.9
"45003",45,3,2003,71273,67455,3818,5.4
"45003",45,3,2004,73551,69374,4177,5.7
"45003",45,3,2005,74270,69907,4363,5.9
"45003",45,3,2006,75160,70350,4810,6.4
"45003",45,3,2007,74572,70571,4001,5.4
"45003",45,3,2008,74897,70514,4383,5.9
"45003",45,3,2009,76639,69581,7058,9.2
"45003",45,3,2010,72368,65639,6729,9.3
"45003",45,3,2011,73303,66504,6799,9.3
"45003",45,3,2012,72956,66682,6274,8.6
"45003",45,3,2013,72660,67173,5487,7.6
"45003",45,3,2014,72970,68227,4743,6.5
"45003",45,3,2015,73925,69577,4348,5.9
"45003",45,3,2016,74152,70461,3691,5
"45003",45,3,2017,74442,71386,3056,4.1
"45005",45,5,1990,4397,4083,314,7.1
"45005",45,5,1991,4795,4286,509,10.6
"45005",45,5,1992,4874,4303,571,11.7
"45005",45,5,1993,4760,4171,589,12.4
"45005",45,5,1994,4682,4143,539,11.5
"45005",45,5,1995,4810,4374,436,9.1
"45005",45,5,1996,4627,4225,402,8.7
"45005",45,5,1997,4917,4584,333,6.8
"45005",45,5,1998,4980,4678,302,6.1
"45005",45,5,1999,4896,4533,363,7.4
"45005",45,5,2000,3749,3550,199,5.3
"45005",45,5,2001,3630,3408,222,6.1
"45005",45,5,2002,3494,3248,246,7
"45005",45,5,2003,3413,3114,299,8.8
"45005",45,5,2004,3280,2962,318,9.7
"45005",45,5,2005,3290,2941,349,10.6
"45005",45,5,2006,3869,3477,392,10.1
"45005",45,5,2007,3546,3180,366,10.3
"45005",45,5,2008,3335,2784,551,16.5
"45005",45,5,2009,3398,2697,701,20.6
"45005",45,5,2010,3318,2685,633,19.1
"45005",45,5,2011,3279,2677,602,18.4
"45005",45,5,2012,3133,2603,530,16.9
"45005",45,5,2013,3092,2658,434,14
"45005",45,5,2014,2868,2519,349,12.2
"45005",45,5,2015,2748,2438,310,11.3
"45005",45,5,2016,2662,2435,227,8.5
"45005",45,5,2017,2741,2553,188,6.9
"45007",45,7,1990,76366,72322,4044,5.3
"45007",45,7,1991,76009,71379,4630,6.1
"45007",45,7,1992,76690,72209,4481,5.8
"45007",45,7,1993,79037,74649,4388,5.6
"45007",45,7,1994,80952,76533,4419,5.5
"45007",45,7,1995,81308,77976,3332,4.1
"45007",45,7,1996,82774,78803,3971,4.8
"45007",45,7,1997,83459,80310,3149,3.8
"45007",45,7,1998,84797,82309,2488,2.9
"45007",45,7,1999,85476,82919,2557,3
"45007",45,7,2000,84560,81859,2701,3.2
"45007",45,7,2001,83150,78693,4457,5.4
"45007",45,7,2002,81853,76794,5059,6.2
"45007",45,7,2003,81882,75857,6025,7.4
"45007",45,7,2004,83362,77394,5968,7.2
"45007",45,7,2005,83943,77761,6182,7.4
"45007",45,7,2006,84455,78709,5746,6.8
"45007",45,7,2007,84980,80072,4908,5.8
"45007",45,7,2008,85313,79547,5766,6.8
"45007",45,7,2009,85177,74955,10222,12
"45007",45,7,2010,85234,75380,9854,11.6
"45007",45,7,2011,85900,77037,8863,10.3
"45007",45,7,2012,85577,77998,7579,8.9
"45007",45,7,2013,85793,79702,6091,7.1
"45007",45,7,2014,86688,81519,5169,6
"45007",45,7,2015,88475,83700,4775,5.4
"45007",45,7,2016,88932,84867,4065,4.6
"45007",45,7,2017,89559,86045,3514,3.9
"45009",45,9,1990,7371,6696,675,9.2
"45009",45,9,1991,7659,6813,846,11
"45009",45,9,1992,7625,6849,776,10.2
"45009",45,9,1993,7854,6894,960,12.2
"45009",45,9,1994,7619,6735,884,11.6
"45009",45,9,1995,7594,6847,747,9.8
"45009",45,9,1996,7773,7027,746,9.6
"45009",45,9,1997,7590,6959,631,8.3
"45009",45,9,1998,7626,7140,486,6.4
"45009",45,9,1999,7854,7208,646,8.2
"45009",45,9,2000,6564,6220,344,5.2
"45009",45,9,2001,6399,5976,423,6.6
"45009",45,9,2002,6322,5898,424,6.7
"45009",45,9,2003,6546,6031,515,7.9
"45009",45,9,2004,6424,5955,469,7.3
"45009",45,9,2005,6563,5997,566,8.6
"45009",45,9,2006,6490,5850,640,9.9
"45009",45,9,2007,6232,5664,568,9.1
"45009",45,9,2008,6326,5614,712,11.3
"45009",45,9,2009,6435,5428,1007,15.6
"45009",45,9,2010,6509,5460,1049,16.1
"45009",45,9,2011,6316,5290,1026,16.2
"45009",45,9,2012,5800,4877,923,15.9
"45009",45,9,2013,5580,4827,753,13.5
"45009",45,9,2014,5563,4920,643,11.6
"45009",45,9,2015,5460,4888,572,10.5
"45009",45,9,2016,5317,4838,479,9
"45009",45,9,2017,5230,4842,388,7.4
"45011",45,11,1990,9842,8908,934,9.5
"45011",45,11,1991,10043,8658,1385,13.8
"45011",45,11,1992,10310,9002,1308,12.7
"45011",45,11,1993,10772,9382,1390,12.9
"45011",45,11,1994,11052,9818,1234,11.2
"45011",45,11,1995,11076,9866,1210,10.9
"45011",45,11,1996,11233,10055,1178,10.5
"45011",45,11,1997,11157,10270,887,8
"45011",45,11,1998,11584,10831,753,6.5
"45011",45,11,1999,11608,10757,851,7.3
"45011",45,11,2000,10341,9810,531,5.1
"45011",45,11,2001,9970,9275,695,7
"45011",45,11,2002,9659,8904,755,7.8
"45011",45,11,2003,9604,8676,928,9.7
"45011",45,11,2004,9434,8539,895,9.5
"45011",45,11,2005,9387,8540,847,9
"45011",45,11,2006,9252,8327,925,10
"45011",45,11,2007,8818,7996,822,9.3
"45011",45,11,2008,8815,7854,961,10.9
"45011",45,11,2009,8997,7456,1541,17.1
"45011",45,11,2010,9489,7913,1576,16.6
"45011",45,11,2011,9203,7802,1401,15.2
"45011",45,11,2012,8959,7716,1243,13.9
"45011",45,11,2013,8716,7660,1056,12.1
"45011",45,11,2014,8646,7809,837,9.7
"45011",45,11,2015,8377,7625,752,9
"45011",45,11,2016,8073,7480,593,7.3
"45011",45,11,2017,8082,7594,488,6
"45013",45,13,1990,36525,35198,1327,3.6
"45013",45,13,1991,36764,35270,1494,4.1
"45013",45,13,1992,38031,36272,1759,4.6
"45013",45,13,1993,40120,38129,1991,5
"45013",45,13,1994,41539,39787,1752,4.2
"45013",45,13,1995,43704,42359,1345,3.1
"45013",45,13,1996,46015,44554,1461,3.2
"45013",45,13,1997,47863,46686,1177,2.5
"45013",45,13,1998,49742,48698,1044,2.1
"45013",45,13,1999,51925,50781,1144,2.2
"45013",45,13,2000,51639,49972,1667,3.2
"45013",45,13,2001,51281,49295,1986,3.9
"45013",45,13,2002,53591,51399,2192,4.1
"45013",45,13,2003,56173,53413,2760,4.9
"45013",45,13,2004,59027,56096,2931,5
"45013",45,13,2005,61574,58579,2995,4.9
"45013",45,13,2006,62868,59859,3009,4.8
"45013",45,13,2007,63906,61117,2789,4.4
"45013",45,13,2008,63741,60361,3380,5.3
"45013",45,13,2009,62884,57398,5486,8.7
"45013",45,13,2010,65336,59684,5652,8.7
"45013",45,13,2011,65469,59777,5692,8.7
"45013",45,13,2012,65919,60939,4980,7.6
"45013",45,13,2013,67239,62946,4293,6.4
"45013",45,13,2014,69435,65493,3942,5.7
"45013",45,13,2015,71661,67748,3913,5.5
"45013",45,13,2016,72535,69081,3454,4.8
"45013",45,13,2017,74104,71113,2991,4
"45015",45,15,1990,56106,54488,1618,2.9
"45015",45,15,1991,57383,55044,2339,4.1
"45015",45,15,1992,58927,55616,3311,5.6
"45015",45,15,1993,60371,56548,3823,6.3
"45015",45,15,1994,61643,58053,3590,5.8
"45015",45,15,1995,60866,58357,2509,4.1
"45015",45,15,1996,59997,57266,2731,4.6
"45015",45,15,1997,59526,57043,2483,4.2
"45015",45,15,1998,62140,60397,1743,2.8
"45015",45,15,1999,65485,63183,2302,3.5
"45015",45,15,2000,66480,64257,2223,3.3
"45015",45,15,2001,64707,61862,2845,4.4
"45015",45,15,2002,65449,62601,2848,4.4
"45015",45,15,2003,67909,64115,3794,5.6
"45015",45,15,2004,69977,66095,3882,5.5
"45015",45,15,2005,71630,67822,3808,5.3
"45015",45,15,2006,73123,69063,4060,5.6
"45015",45,15,2007,77641,73923,3718,4.8
"45015",45,15,2008,79848,74956,4892,6.1
"45015",45,15,2009,80462,72210,8252,10.3
"45015",45,15,2010,82740,74452,8288,10
"45015",45,15,2011,85778,77572,8206,9.6
"45015",45,15,2012,88403,80977,7426,8.4
"45015",45,15,2013,88891,82678,6213,7
"45015",45,15,2014,90878,85422,5456,6
"45015",45,15,2015,93501,88358,5143,5.5
"45015",45,15,2016,97028,92606,4422,4.6
"45015",45,15,2017,98452,94691,3761,3.8
"45017",45,17,1990,6131,5744,387,6.3
"45017",45,17,1991,6124,5690,434,7.1
"45017",45,17,1992,6215,5770,445,7.2
"45017",45,17,1993,6225,5851,374,6
"45017",45,17,1994,6367,5967,400,6.3
"45017",45,17,1995,6484,6037,447,6.9
"45017",45,17,1996,6718,6098,620,9.2
"45017",45,17,1997,6774,6363,411,6.1
"45017",45,17,1998,6811,6479,332,4.9
"45017",45,17,1999,6964,6478,486,7
"45017",45,17,2000,7171,6893,278,3.9
"45017",45,17,2001,7048,6630,418,5.9
"45017",45,17,2002,6949,6515,434,6.2
"45017",45,17,2003,7055,6561,494,7
"45017",45,17,2004,7058,6589,469,6.6
"45017",45,17,2005,7091,6572,519,7.3
"45017",45,17,2006,7080,6574,506,7.1
"45017",45,17,2007,6896,6465,431,6.3
"45017",45,17,2008,6763,6246,517,7.6
"45017",45,17,2009,6727,5903,824,12.2
"45017",45,17,2010,7044,6178,866,12.3
"45017",45,17,2011,7092,6215,877,12.4
"45017",45,17,2012,6951,6173,778,11.2
"45017",45,17,2013,6930,6266,664,9.6
"45017",45,17,2014,6885,6333,552,8
"45017",45,17,2015,6893,6402,491,7.1
"45017",45,17,2016,6903,6478,425,6.2
"45017",45,17,2017,6848,6493,355,5.2
"45019",45,19,1990,141963,137791,4172,2.9
"45019",45,19,1991,145054,138891,6163,4.2
"45019",45,19,1992,146754,137856,8898,6.1
"45019",45,19,1993,145555,136061,9494,6.5
"45019",45,19,1994,141976,132910,9066,6.4
"45019",45,19,1995,142189,134360,7829,5.5
"45019",45,19,1996,143765,135479,8286,5.8
"45019",45,19,1997,153837,147515,6322,4.1
"45019",45,19,1998,158530,153897,4633,2.9
"45019",45,19,1999,162444,157299,5145,3.2
"45019",45,19,2000,154636,149448,5188,3.4
"45019",45,19,2001,149901,143672,6229,4.2
"45019",45,19,2002,153406,146447,6959,4.5
"45019",45,19,2003,159204,150548,8656,5.4
"45019",45,19,2004,164605,155700,8905,5.4
"45019",45,19,2005,167313,158229,9084,5.4
"45019",45,19,2006,169758,161234,8524,5
"45019",45,19,2007,173525,165971,7554,4.4
"45019",45,19,2008,174276,165025,9251,5.3
"45019",45,19,2009,173571,158380,15191,8.8
"45019",45,19,2010,178847,163111,15736,8.8
"45019",45,19,2011,183009,167780,15229,8.3
"45019",45,19,2012,186506,173166,13340,7.2
"45019",45,19,2013,187570,176533,11037,5.9
"45019",45,19,2014,192333,182413,9920,5.2
"45019",45,19,2015,198201,188603,9598,4.8
"45019",45,19,2016,201825,193610,8215,4.1
"45019",45,19,2017,204937,197802,7135,3.5
"45021",45,21,1990,23011,21717,1294,5.6
"45021",45,21,1991,23030,21577,1453,6.3
"45021",45,21,1992,23270,21799,1471,6.3
"45021",45,21,1993,23781,22367,1414,5.9
"45021",45,21,1994,24068,22923,1145,4.8
"45021",45,21,1995,24494,23366,1128,4.6
"45021",45,21,1996,24989,23643,1346,5.4
"45021",45,21,1997,25068,24077,991,4
"45021",45,21,1998,25670,24700,970,3.8
"45021",45,21,1999,26095,24990,1105,4.2
"45021",45,21,2000,25816,24699,1117,4.3
"45021",45,21,2001,25459,23675,1784,7
"45021",45,21,2002,24253,22294,1959,8.1
"45021",45,21,2003,24451,22276,2175,8.9
"45021",45,21,2004,25095,22870,2225,8.9
"45021",45,21,2005,24899,22938,1961,7.9
"45021",45,21,2006,25102,23177,1925,7.7
"45021",45,21,2007,25257,23543,1714,6.8
"45021",45,21,2008,25546,23231,2315,9.1
"45021",45,21,2009,25594,21538,4056,15.8
"45021",45,21,2010,23683,19956,3727,15.7
"45021",45,21,2011,23644,20162,3482,14.7
"45021",45,21,2012,23751,20705,3046,12.8
"45021",45,21,2013,23727,21241,2486,10.5
"45021",45,21,2014,23662,21699,1963,8.3
"45021",45,21,2015,23460,21793,1667,7.1
"45021",45,21,2016,23536,22138,1398,5.9
"45021",45,21,2017,24094,22909,1185,4.9
"45023",45,23,1990,16080,14462,1618,10.1
"45023",45,23,1991,15959,13895,2064,12.9
"45023",45,23,1992,16104,14190,1914,11.9
"45023",45,23,1993,15923,13817,2106,13.2
"45023",45,23,1994,15702,13992,1710,10.9
"45023",45,23,1995,15481,14020,1461,9.4
"45023",45,23,1996,15920,14286,1634,10.3
"45023",45,23,1997,15533,14097,1436,9.2
"45023",45,23,1998,15773,14385,1388,8.8
"45023",45,23,1999,16113,14716,1397,8.7
"45023",45,23,2000,16496,15629,867,5.3
"45023",45,23,2001,16253,15002,1251,7.7
"45023",45,23,2002,15654,14123,1531,9.8
"45023",45,23,2003,15752,13982,1770,11.2
"45023",45,23,2004,15635,14093,1542,9.9
"45023",45,23,2005,15896,14437,1459,9.2
"45023",45,23,2006,16159,14511,1648,10.2
"45023",45,23,2007,15475,13788,1687,10.9
"45023",45,23,2008,15314,13505,1809,11.8
"45023",45,23,2009,15632,12534,3098,19.8
"45023",45,23,2010,14689,11860,2829,19.3
"45023",45,23,2011,14411,11914,2497,17.3
"45023",45,23,2012,14035,11961,2074,14.8
"45023",45,23,2013,13675,12005,1670,12.2
"45023",45,23,2014,13433,12134,1299,9.7
"45023",45,23,2015,13455,12329,1126,8.4
"45023",45,23,2016,13394,12434,960,7.2
"45023",45,23,2017,13592,12776,816,6
"45025",45,25,1990,19063,18048,1015,5.3
"45025",45,25,1991,19048,17837,1211,6.4
"45025",45,25,1992,19756,18503,1253,6.3
"45025",45,25,1993,20257,18634,1623,8
"45025",45,25,1994,20744,19142,1602,7.7
"45025",45,25,1995,20792,19256,1536,7.4
"45025",45,25,1996,21385,19717,1668,7.8
"45025",45,25,1997,20454,18941,1513,7.4
"45025",45,25,1998,20056,18498,1558,7.8
"45025",45,25,1999,20489,19057,1432,7
"45025",45,25,2000,19468,18542,926,4.8
"45025",45,25,2001,18873,17461,1412,7.5
"45025",45,25,2002,18431,17020,1411,7.7
"45025",45,25,2003,18814,16902,1912,10.2
"45025",45,25,2004,18250,16423,1827,10
"45025",45,25,2005,18083,16380,1703,9.4
"45025",45,25,2006,18642,16872,1770,9.5
"45025",45,25,2007,18468,17037,1431,7.7
"45025",45,25,2008,18591,16926,1665,9
"45025",45,25,2009,19022,15880,3142,16.5
"45025",45,25,2010,21289,18229,3060,14.4
"45025",45,25,2011,21164,18443,2721,12.9
"45025",45,25,2012,21047,18655,2392,11.4
"45025",45,25,2013,20991,19066,1925,9.2
"45025",45,25,2014,21219,19765,1454,6.9
"45025",45,25,2015,21440,20146,1294,6
"45025",45,25,2016,21640,20565,1075,5
"45025",45,25,2017,21621,20680,941,4.4
"45027",45,27,1990,11949,11072,877,7.3
"45027",45,27,1991,11719,10429,1290,11
"45027",45,27,1992,11858,10420,1438,12.1
"45027",45,27,1993,12456,10717,1739,14
"45027",45,27,1994,11548,10122,1426,12.3
"45027",45,27,1995,11699,10673,1026,8.8
"45027",45,27,1996,12016,10937,1079,9
"45027",45,27,1997,12405,11349,1056,8.5
"45027",45,27,1998,12428,11623,805,6.5
"45027",45,27,1999,13136,12182,954,7.3
"45027",45,27,2000,13189,12457,732,5.6
"45027",45,27,2001,12678,11718,960,7.6
"45027",45,27,2002,12600,11647,953,7.6
"45027",45,27,2003,12821,11683,1138,8.9
"45027",45,27,2004,12639,11509,1130,8.9
"45027",45,27,2005,12742,11508,1234,9.7
"45027",45,27,2006,12929,11738,1191,9.2
"45027",45,27,2007,12641,11580,1061,8.4
"45027",45,27,2008,12511,11290,1221,9.8
"45027",45,27,2009,12756,10840,1916,15
"45027",45,27,2010,13881,11937,1944,14
"45027",45,27,2011,13640,11661,1979,14.5
"45027",45,27,2012,13282,11578,1704,12.8
"45027",45,27,2013,12981,11643,1338,10.3
"45027",45,27,2014,12987,11900,1087,8.4
"45027",45,27,2015,13065,12062,1003,7.7
"45027",45,27,2016,12721,11877,844,6.6
"45027",45,27,2017,12425,11683,742,6
"45029",45,29,1990,15293,14455,838,5.5
"45029",45,29,1991,15410,13845,1565,10.2
"45029",45,29,1992,15754,14025,1729,11
"45029",45,29,1993,15902,14031,1871,11.8
"45029",45,29,1994,15710,14175,1535,9.8
"45029",45,29,1995,15661,14620,1041,6.6
"45029",45,29,1996,15711,14657,1054,6.7
"45029",45,29,1997,15665,14883,782,5
"45029",45,29,1998,15455,14768,687,4.4
"45029",45,29,1999,15442,14618,824,5.3
"45029",45,29,2000,16110,15479,631,3.9
"45029",45,29,2001,15742,14946,796,5.1
"45029",45,29,2002,15881,14943,938,5.9
"45029",45,29,2003,16196,14990,1206,7.4
"45029",45,29,2004,16305,15120,1185,7.3
"45029",45,29,2005,16396,15224,1172,7.1
"45029",45,29,2006,16889,15792,1097,6.5
"45029",45,29,2007,16458,15456,1002,6.1
"45029",45,29,2008,16649,15278,1371,8.2
"45029",45,29,2009,17187,14944,2243,13.1
"45029",45,29,2010,16827,14513,2314,13.8
"45029",45,29,2011,16662,14309,2353,14.1
"45029",45,29,2012,16455,14465,1990,12.1
"45029",45,29,2013,16338,14716,1622,9.9
"45029",45,29,2014,16647,15376,1271,7.6
"45029",45,29,2015,16719,15555,1164,7
"45029",45,29,2016,16761,15826,935,5.6
"45029",45,29,2017,16844,16036,808,4.8
"45031",45,31,1990,30042,28429,1613,5.4
"45031",45,31,1991,30535,28234,2301,7.5
"45031",45,31,1992,31803,28762,3041,9.6
"45031",45,31,1993,32772,28764,4008,12.2
"45031",45,31,1994,31657,28278,3379,10.7
"45031",45,31,1995,31489,28725,2764,8.8
"45031",45,31,1996,32259,29342,2917,9
"45031",45,31,1997,31323,29036,2287,7.3
"45031",45,31,1998,31190,29217,1973,6.3
"45031",45,31,1999,31354,29108,2246,7.2
"45031",45,31,2000,31843,30248,1595,5
"45031",45,31,2001,30807,28860,1947,6.3
"45031",45,31,2002,30773,28675,2098,6.8
"45031",45,31,2003,31347,28720,2627,8.4
"45031",45,31,2004,30727,28190,2537,8.3
"45031",45,31,2005,30588,27930,2658,8.7
"45031",45,31,2006,31020,28639,2381,7.7
"45031",45,31,2007,30770,28762,2008,6.5
"45031",45,31,2008,31143,28493,2650,8.5
"45031",45,31,2009,31068,27033,4035,13
"45031",45,31,2010,30590,26555,4035,13.2
"45031",45,31,2011,30450,26517,3933,12.9
"45031",45,31,2012,30412,27048,3364,11.1
"45031",45,31,2013,30085,27276,2809,9.3
"45031",45,31,2014,29750,27376,2374,8
"45031",45,31,2015,30066,27851,2215,7.4
"45031",45,31,2016,29915,28060,1855,6.2
"45031",45,31,2017,29830,28247,1583,5.3
"45033",45,33,1990,13042,12084,958,7.3
"45033",45,33,1991,13099,11650,1449,11.1
"45033",45,33,1992,12955,11576,1379,10.6
"45033",45,33,1993,13749,12064,1685,12.3
"45033",45,33,1994,13991,12552,1439,10.3
"45033",45,33,1995,14010,12531,1479,10.6
"45033",45,33,1996,14383,12723,1660,11.5
"45033",45,33,1997,14413,13220,1193,8.3
"45033",45,33,1998,14664,13649,1015,6.9
"45033",45,33,1999,14445,13083,1362,9.4
"45033",45,33,2000,13804,12841,963,7
"45033",45,33,2001,12964,11767,1197,9.2
"45033",45,33,2002,12912,11898,1014,7.9
"45033",45,33,2003,13268,11989,1279,9.6
"45033",45,33,2004,12924,11664,1260,9.7
"45033",45,33,2005,13545,12268,1277,9.4
"45033",45,33,2006,13398,12154,1244,9.3
"45033",45,33,2007,12978,11797,1181,9.1
"45033",45,33,2008,12972,11634,1338,10.3
"45033",45,33,2009,13778,11669,2109,15.3
"45033",45,33,2010,14014,11783,2231,15.9
"45033",45,33,2011,13654,11495,2159,15.8
"45033",45,33,2012,13203,11338,1865,14.1
"45033",45,33,2013,12757,11248,1509,11.8
"45033",45,33,2014,12600,11387,1213,9.6
"45033",45,33,2015,12674,11583,1091,8.6
"45033",45,33,2016,12688,11833,855,6.7
"45033",45,33,2017,12574,11857,717,5.7
"45035",45,35,1990,38958,37842,1116,2.9
"45035",45,35,1991,40046,38423,1623,4.1
"45035",45,35,1992,40684,38572,2112,5.2
"45035",45,35,1993,41711,39545,2166,5.2
"45035",45,35,1994,42692,40335,2357,5.5
"45035",45,35,1995,41820,39511,2309,5.5
"45035",45,35,1996,43234,41120,2114,4.9
"45035",45,35,1997,41140,39505,1635,4
"45035",45,35,1998,42845,41514,1331,3.1
"45035",45,35,1999,44663,43205,1458,3.3
"45035",45,35,2000,47746,46256,1490,3.1
"45035",45,35,2001,46987,45051,1936,4.1
"45035",45,35,2002,48526,46477,2049,4.2
"45035",45,35,2003,51237,48553,2684,5.2
"45035",45,35,2004,53399,50685,2714,5.1
"45035",45,35,2005,56737,53739,2998,5.3
"45035",45,35,2006,60523,57459,3064,5.1
"45035",45,35,2007,62138,59419,2719,4.4
"45035",45,35,2008,63518,59928,3590,5.7
"45035",45,35,2009,64044,57801,6243,9.7
"45035",45,35,2010,65563,59321,6242,9.5
"45035",45,35,2011,67006,60998,6008,9
"45035",45,35,2012,68192,62864,5328,7.8
"45035",45,35,2013,68615,64078,4537,6.6
"45035",45,35,2014,70278,66179,4099,5.8
"45035",45,35,2015,72712,68732,3980,5.5
"45035",45,35,2016,73197,69852,3345,4.6
"45035",45,35,2017,74263,71413,2850,3.8
"45037",45,37,1990,9140,8758,382,4.2
"45037",45,37,1991,9015,8555,460,5.1
"45037",45,37,1992,8950,8383,567,6.3
"45037",45,37,1993,9175,8542,633,6.9
"45037",45,37,1994,9112,8642,470,5.2
"45037",45,37,1995,9187,8555,632,6.9
"45037",45,37,1996,9365,8696,669,7.1
"45037",45,37,1997,9157,8734,423,4.6
"45037",45,37,1998,9320,8910,410,4.4
"45037",45,37,1999,9493,8989,504,5.3
"45037",45,37,2000,10481,10090,391,3.7
"45037",45,37,2001,10187,9696,491,4.8
"45037",45,37,2002,10262,9763,499,4.9
"45037",45,37,2003,10601,10058,543,5.1
"45037",45,37,2004,10924,10285,639,5.8
"45037",45,37,2005,11168,10366,802,7.2
"45037",45,37,2006,11067,10213,854,7.7
"45037",45,37,2007,10975,10281,694,6.3
"45037",45,37,2008,10934,10199,735,6.7
"45037",45,37,2009,11151,10019,1132,10.2
"45037",45,37,2010,10986,9893,1093,9.9
"45037",45,37,2011,10913,9829,1084,9.9
"45037",45,37,2012,10643,9638,1005,9.4
"45037",45,37,2013,10518,9671,847,8.1
"45037",45,37,2014,10555,9846,709,6.7
"45037",45,37,2015,10668,9991,677,6.3
"45037",45,37,2016,10551,9955,596,5.6
"45037",45,37,2017,10557,10075,482,4.6
"45039",45,39,1990,10980,9893,1087,9.9
"45039",45,39,1991,10720,9440,1280,11.9
"45039",45,39,1992,10859,9748,1111,10.2
"45039",45,39,1993,11069,9873,1196,10.8
"45039",45,39,1994,11213,10078,1135,10.1
"45039",45,39,1995,11018,10113,905,8.2
"45039",45,39,1996,10636,9668,968,9.1
"45039",45,39,1997,10846,10007,839,7.7
"45039",45,39,1998,10947,10058,889,8.1
"45039",45,39,1999,10928,9945,983,9
"45039",45,39,2000,11185,10614,571,5.1
"45039",45,39,2001,11169,10227,942,8.4
"45039",45,39,2002,11120,10192,928,8.3
"45039",45,39,2003,11408,10173,1235,10.8
"45039",45,39,2004,11300,10398,902,8
"45039",45,39,2005,11316,10432,884,7.8
"45039",45,39,2006,11410,10384,1026,9
"45039",45,39,2007,11118,10174,944,8.5
"45039",45,39,2008,11195,10004,1191,10.6
"45039",45,39,2009,10818,9393,1425,13.2
"45039",45,39,2010,10672,9113,1559,14.6
"45039",45,39,2011,10547,9016,1531,14.5
"45039",45,39,2012,10392,9039,1353,13
"45039",45,39,2013,10096,9011,1085,10.7
"45039",45,39,2014,10031,9161,870,8.7
"45039",45,39,2015,10022,9216,806,8
"45039",45,39,2016,9999,9280,719,7.2
"45039",45,39,2017,10045,9305,740,7.4
"45041",45,41,1990,56387,53792,2595,4.6
"45041",45,41,1991,57669,54236,3433,6
"45041",45,41,1992,59200,54850,4350,7.3
"45041",45,41,1993,61452,56161,5291,8.6
"45041",45,41,1994,61884,57111,4773,7.7
"45041",45,41,1995,61326,57329,3997,6.5
"45041",45,41,1996,63359,58273,5086,8
"45041",45,41,1997,63642,60046,3596,5.7
"45041",45,41,1998,63164,60330,2834,4.5
"45041",45,41,1999,63905,60571,3334,5.2
"45041",45,41,2000,60971,58398,2573,4.2
"45041",45,41,2001,59133,55865,3268,5.5
"45041",45,41,2002,59452,55634,3818,6.4
"45041",45,41,2003,61236,56353,4883,8
"45041",45,41,2004,61160,56018,5142,8.4
"45041",45,41,2005,61798,56307,5491,8.9
"45041",45,41,2006,62165,57651,4514,7.3
"45041",45,41,2007,62583,58784,3799,6.1
"45041",45,41,2008,62863,58463,4400,7
"45041",45,41,2009,63640,56550,7090,11.1
"45041",45,41,2010,64173,56905,7268,11.3
"45041",45,41,2011,64430,57197,7233,11.2
"45041",45,41,2012,64973,58697,6276,9.7
"45041",45,41,2013,64910,59546,5364,8.3
"45041",45,41,2014,64856,60181,4675,7.2
"45041",45,41,2015,65502,61238,4264,6.5
"45041",45,41,2016,65394,61965,3429,5.2
"45041",45,41,2017,65368,62379,2989,4.6
"45043",45,43,1990,22487,20652,1835,8.2
"45043",45,43,1991,21896,19857,2039,9.3
"45043",45,43,1992,22187,19900,2287,10.3
"45043",45,43,1993,23526,20480,3046,12.9
"45043",45,43,1994,23852,21261,2591,10.9
"45043",45,43,1995,24208,21953,2255,9.3
"45043",45,43,1996,25347,22295,3052,12
"45043",45,43,1997,25571,23084,2487,9.7
"45043",45,43,1998,25128,23155,1973,7.9
"45043",45,43,1999,25093,23007,2086,8.3
"45043",45,43,2000,26159,24706,1453,5.6
"45043",45,43,2001,26109,24172,1937,7.4
"45043",45,43,2002,26137,24025,2112,8.1
"45043",45,43,2003,27115,24370,2745,10.1
"45043",45,43,2004,27911,25248,2663,9.5
"45043",45,43,2005,28755,26283,2472,8.6
"45043",45,43,2006,29367,27277,2090,7.1
"45043",45,43,2007,29139,27340,1799,6.2
"45043",45,43,2008,30367,28113,2254,7.4
"45043",45,43,2009,30222,26618,3604,11.9
"45043",45,43,2010,26045,22271,3774,14.5
"45043",45,43,2011,25531,22063,3468,13.6
"45043",45,43,2012,24672,21718,2954,12
"45043",45,43,2013,24370,21897,2473,10.1
"45043",45,43,2014,24837,22712,2125,8.6
"45043",45,43,2015,25233,23114,2119,8.4
"45043",45,43,2016,24970,23281,1689,6.8
"45043",45,43,2017,25289,23893,1396,5.5
"45045",45,45,1990,173281,166785,6496,3.7
"45045",45,45,1991,173601,165006,8595,5
"45045",45,45,1992,175962,166367,9595,5.5
"45045",45,45,1993,180073,170818,9255,5.1
"45045",45,45,1994,182688,175485,7203,3.9
"45045",45,45,1995,183669,178960,4709,2.6
"45045",45,45,1996,187142,181260,5882,3.1
"45045",45,45,1997,189087,184565,4522,2.4
"45045",45,45,1998,193104,189233,3871,2
"45045",45,45,1999,195407,190830,4577,2.3
"45045",45,45,2000,205617,200014,5603,2.7
"45045",45,45,2001,202199,194579,7620,3.8
"45045",45,45,2002,199133,189682,9451,4.7
"45045",45,45,2003,201296,189885,11411,5.7
"45045",45,45,2004,206423,194272,12151,5.9
"45045",45,45,2005,209830,198291,11539,5.5
"45045",45,45,2006,215684,204101,11583,5.4
"45045",45,45,2007,220826,210480,10346,4.7
"45045",45,45,2008,223956,211534,12422,5.5
"45045",45,45,2009,223171,201358,21813,9.8
"45045",45,45,2010,220209,199005,21204,9.6
"45045",45,45,2011,224175,204795,19380,8.6
"45045",45,45,2012,226950,210086,16864,7.4
"45045",45,45,2013,230748,216668,14080,6.1
"45045",45,45,2014,235564,223004,12560,5.3
"45045",45,45,2015,242978,230986,11992,4.9
"45045",45,45,2016,245590,235237,10353,4.2
"45045",45,45,2017,247585,238524,9061,3.7
"45047",45,47,1990,30623,28909,1714,5.6
"45047",45,47,1991,30285,28186,2099,6.9
"45047",45,47,1992,31064,28924,2140,6.9
"45047",45,47,1993,31950,29695,2255,7.1
"45047",45,47,1994,32441,30285,2156,6.6
"45047",45,47,1995,33166,31407,1759,5.3
"45047",45,47,1996,33883,31587,2296,6.8
"45047",45,47,1997,34081,32368,1713,5
"45047",45,47,1998,34172,32424,1748,5.1
"45047",45,47,1999,33655,31452,2203,6.5
"45047",45,47,2000,32955,31505,1450,4.4
"45047",45,47,2001,32589,30355,2234,6.9
"45047",45,47,2002,31573,28807,2766,8.8
"45047",45,47,2003,31962,28902,3060,9.6
"45047",45,47,2004,32323,29495,2828,8.7
"45047",45,47,2005,32531,29586,2945,9.1
"45047",45,47,2006,31665,29145,2520,8
"45047",45,47,2007,30936,28799,2137,6.9
"45047",45,47,2008,30615,28281,2334,7.6
"45047",45,47,2009,30991,27121,3870,12.5
"45047",45,47,2010,31869,28091,3778,11.9
"45047",45,47,2011,32039,28403,3636,11.3
"45047",45,47,2012,32049,28798,3251,10.1
"45047",45,47,2013,31544,28826,2718,8.6
"45047",45,47,2014,31672,29488,2184,6.9
"45047",45,47,2015,31263,29290,1973,6.3
"45047",45,47,2016,31356,29741,1615,5.2
"45047",45,47,2017,30880,29482,1398,4.5
"45049",45,49,1990,7710,7304,406,5.3
"45049",45,49,1991,7609,6977,632,8.3
"45049",45,49,1992,7823,7104,719,9.2
"45049",45,49,1993,8177,7356,821,10
"45049",45,49,1994,8322,7515,807,9.7
"45049",45,49,1995,8271,7678,593,7.2
"45049",45,49,1996,8541,7932,609,7.1
"45049",45,49,1997,8467,7975,492,5.8
"45049",45,49,1998,8660,8217,443,5.1
"45049",45,49,1999,8767,8277,490,5.6
"45049",45,49,2000,8412,8039,373,4.4
"45049",45,49,2001,8088,7586,502,6.2
"45049",45,49,2002,8125,7537,588,7.2
"45049",45,49,2003,8056,7284,772,9.6
"45049",45,49,2004,7722,6998,724,9.4
"45049",45,49,2005,7772,7127,645,8.3
"45049",45,49,2006,7971,7399,572,7.2
"45049",45,49,2007,7855,7330,525,6.7
"45049",45,49,2008,7721,7028,693,9
"45049",45,49,2009,7955,6779,1176,14.8
"45049",45,49,2010,8785,7659,1126,12.8
"45049",45,49,2011,8634,7516,1118,12.9
"45049",45,49,2012,8421,7480,941,11.2
"45049",45,49,2013,8346,7571,775,9.3
"45049",45,49,2014,8315,7673,642,7.7
"45049",45,49,2015,8348,7648,700,8.4
"45049",45,49,2016,8232,7752,480,5.8
"45049",45,49,2017,8210,7843,367,4.5
"45051",45,51,1990,74481,69828,4653,6.2
"45051",45,51,1991,77011,71436,5575,7.2
"45051",45,51,1992,80930,74380,6550,8.1
"45051",45,51,1993,83127,75561,7566,9.1
"45051",45,51,1994,85996,79875,6121,7.1
"45051",45,51,1995,90939,86279,4660,5.1
"45051",45,51,1996,95234,90174,5060,5.3
"45051",45,51,1997,98126,93553,4573,4.7
"45051",45,51,1998,101210,97404,3806,3.8
"45051",45,51,1999,105223,101307,3916,3.7
"45051",45,51,2000,106718,102770,3948,3.7
"45051",45,51,2001,103215,98119,5096,4.9
"45051",45,51,2002,105925,100570,5355,5.1
"45051",45,51,2003,112092,105510,6582,5.9
"45051",45,51,2004,116350,109446,6904,5.9
"45051",45,51,2005,121360,114386,6974,5.7
"45051",45,51,2006,128200,121128,7072,5.5
"45051",45,51,2007,130268,123740,6528,5
"45051",45,51,2008,130715,121473,9242,7.1
"45051",45,51,2009,130286,115067,15219,11.7
"45051",45,51,2010,130946,114859,16087,12.3
"45051",45,51,2011,132344,116578,15766,11.9
"45051",45,51,2012,132681,118938,13743,10.4
"45051",45,51,2013,132824,121377,11447,8.6
"45051",45,51,2014,134210,124297,9913,7.4
"45051",45,51,2015,137323,127572,9751,7.1
"45051",45,51,2016,140219,132062,8157,5.8
"45051",45,51,2017,143389,136283,7106,5
"45053",45,53,1990,6609,6359,250,3.8
"45053",45,53,1991,6607,6308,299,4.5
"45053",45,53,1992,6682,6339,343,5.1
"45053",45,53,1993,6981,6498,483,6.9
"45053",45,53,1994,7086,6713,373,5.3
"45053",45,53,1995,7362,7016,346,4.7
"45053",45,53,1996,7624,7240,384,5
"45053",45,53,1997,7840,7541,299,3.8
"45053",45,53,1998,7933,7667,266,3.4
"45053",45,53,1999,8153,7872,281,3.4
"45053",45,53,2000,9294,8952,342,3.7
"45053",45,53,2001,9044,8649,395,4.4
"45053",45,53,2002,9322,8859,463,5
"45053",45,53,2003,9642,9058,584,6.1
"45053",45,53,2004,9942,9397,545,5.5
"45053",45,53,2005,10107,9586,521,5.2
"45053",45,53,2006,10185,9690,495,4.9
"45053",45,53,2007,10062,9602,460,4.6
"45053",45,53,2008,10055,9447,608,6
"45053",45,53,2009,10095,9054,1041,10.3
"45053",45,53,2010,10896,9823,1073,9.8
"45053",45,53,2011,10993,9904,1089,9.9
"45053",45,53,2012,10962,10033,929,8.5
"45053",45,53,2013,11177,10405,772,6.9
"45053",45,53,2014,11431,10780,651,5.7
"45053",45,53,2015,11821,11216,605,5.1
"45053",45,53,2016,12002,11481,521,4.3
"45053",45,53,2017,12228,11783,445,3.6
"45055",45,55,1990,22689,21314,1375,6.1
"45055",45,55,1991,23077,21190,1887,8.2
"45055",45,55,1992,23661,21470,2191,9.3
"45055",45,55,1993,23799,21206,2593,10.9
"45055",45,55,1994,23046,20992,2054,8.9
"45055",45,55,1995,22900,21454,1446,6.3
"45055",45,55,1996,23641,22153,1488,6.3
"45055",45,55,1997,23697,22420,1277,5.4
"45055",45,55,1998,23125,22025,1100,4.8
"45055",45,55,1999,23292,22138,1154,5
"45055",45,55,2000,27399,26344,1055,3.9
"45055",45,55,2001,26912,25521,1391,5.2
"45055",45,55,2002,26958,25356,1602,5.9
"45055",45,55,2003,27580,25775,1805,6.5
"45055",45,55,2004,28116,26372,1744,6.2
"45055",45,55,2005,28995,27097,1898,6.5
"45055",45,55,2006,29598,27723,1875,6.3
"45055",45,55,2007,29633,28045,1588,5.4
"45055",45,55,2008,29752,27802,1950,6.6
"45055",45,55,2009,29874,26716,3158,10.6
"45055",45,55,2010,28136,24898,3238,11.5
"45055",45,55,2011,28181,25074,3107,11
"45055",45,55,2012,28126,25448,2678,9.5
"45055",45,55,2013,27933,25752,2181,7.8
"45055",45,55,2014,28434,26601,1833,6.4
"45055",45,55,2015,28945,27217,1728,6
"45055",45,55,2016,29255,27734,1521,5.2
"45055",45,55,2017,29130,27810,1320,4.5
"45057",45,57,1990,28375,26803,1572,5.5
"45057",45,57,1991,28938,26558,2380,8.2
"45057",45,57,1992,29056,26357,2699,9.3
"45057",45,57,1993,29965,27211,2754,9.2
"45057",45,57,1994,30169,27727,2442,8.1
"45057",45,57,1995,29087,27373,1714,5.9
"45057",45,57,1996,28633,26863,1770,6.2
"45057",45,57,1997,29035,27487,1548,5.3
"45057",45,57,1998,28957,27603,1354,4.7
"45057",45,57,1999,29702,28506,1196,4
"45057",45,57,2000,30430,29281,1149,3.8
"45057",45,57,2001,29992,28352,1640,5.5
"45057",45,57,2002,29531,27634,1897,6.4
"45057",45,57,2003,29516,26809,2707,9.2
"45057",45,57,2004,29691,27058,2633,8.9
"45057",45,57,2005,29727,27241,2486,8.4
"45057",45,57,2006,30538,27787,2751,9
"45057",45,57,2007,29787,26932,2855,9.6
"45057",45,57,2008,29582,26181,3401,11.5
"45057",45,57,2009,30340,25070,5270,17.4
"45057",45,57,2010,33952,28955,4997,14.7
"45057",45,57,2011,34152,29600,4552,13.3
"45057",45,57,2012,34350,30478,3872,11.3
"45057",45,57,2013,34303,31119,3184,9.3
"45057",45,57,2014,35278,32732,2546,7.2
"45057",45,57,2015,36712,34404,2308,6.3
"45057",45,57,2016,38353,36320,2033,5.3
"45057",45,57,2017,39127,37308,1819,4.6
"45059",45,59,1990,29349,27790,1559,5.3
"45059",45,59,1991,29238,27537,1701,5.8
"45059",45,59,1992,29916,28102,1814,6.1
"45059",45,59,1993,30826,28902,1924,6.2
"45059",45,59,1994,30566,29011,1555,5.1
"45059",45,59,1995,31184,29964,1220,3.9
"45059",45,59,1996,31613,29696,1917,6.1
"45059",45,59,1997,29903,28728,1175,3.9
"45059",45,59,1998,28945,28035,910,3.1
"45059",45,59,1999,28026,26988,1038,3.7
"45059",45,59,2000,34270,33109,1161,3.4
"45059",45,59,2001,34157,31937,2220,6.5
"45059",45,59,2002,33249,30764,2485,7.5
"45059",45,59,2003,33089,30532,2557,7.7
"45059",45,59,2004,33106,30748,2358,7.1
"45059",45,59,2005,33202,30981,2221,6.7
"45059",45,59,2006,33495,31178,2317,6.9
"45059",45,59,2007,33357,30968,2389,7.2
"45059",45,59,2008,32897,30464,2433,7.4
"45059",45,59,2009,32050,28291,3759,11.7
"45059",45,59,2010,30190,26481,3709,12.3
"45059",45,59,2011,30350,26823,3527,11.6
"45059",45,59,2012,30028,26938,3090,10.3
"45059",45,59,2013,29889,27330,2559,8.6
"45059",45,59,2014,29890,27773,2117,7.1
"45059",45,59,2015,30282,28304,1978,6.5
"45059",45,59,2016,30041,28485,1556,5.2
"45059",45,59,2017,30194,28869,1325,4.4
"45061",45,61,1990,7927,7463,464,5.9
"45061",45,61,1991,7985,7392,593,7.4
"45061",45,61,1992,8250,7469,781,9.5
"45061",45,61,1993,8563,7553,1010,11.8
"45061",45,61,1994,8390,7399,991,11.8
"45061",45,61,1995,8128,7432,696,8.6
"45061",45,61,1996,8188,7415,773,9.4
"45061",45,61,1997,8099,7309,790,9.8
"45061",45,61,1998,8130,7439,691,8.5
"45061",45,61,1999,8369,7709,660,7.9
"45061",45,61,2000,8371,7883,488,5.8
"45061",45,61,2001,8147,7569,578,7.1
"45061",45,61,2002,8078,7488,590,7.3
"45061",45,61,2003,8311,7593,718,8.6
"45061",45,61,2004,8231,7513,718,8.7
"45061",45,61,2005,8303,7517,786,9.5
"45061",45,61,2006,8372,7571,801,9.6
"45061",45,61,2007,8137,7476,661,8.1
"45061",45,61,2008,8125,7368,757,9.3
"45061",45,61,2009,8495,7283,1212,14.3
"45061",45,61,2010,6953,5826,1127,16.2
"45061",45,61,2011,6880,5765,1115,16.2
"45061",45,61,2012,6728,5782,946,14.1
"45061",45,61,2013,6562,5838,724,11
"45061",45,61,2014,6452,5867,585,9.1
"45061",45,61,2015,6459,5915,544,8.4
"45061",45,61,2016,6441,5987,454,7
"45061",45,61,2017,6414,6027,387,6
"45063",45,63,1990,96743,93331,3412,3.5
"45063",45,63,1991,97559,93604,3955,4.1
"45063",45,63,1992,99495,95040,4455,4.5
"45063",45,63,1993,101177,96481,4696,4.6
"45063",45,63,1994,107182,103420,3762,3.5
"45063",45,63,1995,109623,106254,3369,3.1
"45063",45,63,1996,111041,107444,3597,3.2
"45063",45,63,1997,114151,111559,2592,2.3
"45063",45,63,1998,118518,116448,2070,1.7
"45063",45,63,1999,122509,120156,2353,1.9
"45063",45,63,2000,119575,116254,3321,2.8
"45063",45,63,2001,117194,113005,4189,3.6
"45063",45,63,2002,117552,113019,4533,3.9
"45063",45,63,2003,120921,115244,5677,4.7
"45063",45,63,2004,124332,118235,6097,4.9
"45063",45,63,2005,127602,121370,6232,4.9
"45063",45,63,2006,130643,124541,6102,4.7
"45063",45,63,2007,131525,126132,5393,4.1
"45063",45,63,2008,132615,126144,6471,4.9
"45063",45,63,2009,132981,122305,10676,8
"45063",45,63,2010,132937,122033,10904,8.2
"45063",45,63,2011,134344,123621,10723,8
"45063",45,63,2012,136586,127020,9566,7
"45063",45,63,2013,137482,129529,7953,5.8
"45063",45,63,2014,141521,134357,7164,5.1
"45063",45,63,2015,145391,138363,7028,4.8
"45063",45,63,2016,148123,142117,6006,4.1
"45063",45,63,2017,147870,142516,5354,3.6
"45065",45,65,1990,3708,3363,345,9.3
"45065",45,65,1991,3689,3253,436,11.8
"45065",45,65,1992,3707,3352,355,9.6
"45065",45,65,1993,3849,3476,373,9.7
"45065",45,65,1994,3885,3526,359,9.2
"45065",45,65,1995,4048,3667,381,9.4
"45065",45,65,1996,4092,3693,399,9.8
"45065",45,65,1997,4167,3814,353,8.5
"45065",45,65,1998,4151,3799,352,8.5
"45065",45,65,1999,4188,3706,482,11.5
"45065",45,65,2000,3786,3540,246,6.5
"45065",45,65,2001,3686,3329,357,9.7
"45065",45,65,2002,3617,3229,388,10.7
"45065",45,65,2003,3647,3178,469,12.9
"45065",45,65,2004,3472,3087,385,11.1
"45065",45,65,2005,3550,3155,395,11.1
"45065",45,65,2006,3593,3198,395,11
"45065",45,65,2007,3496,3148,348,10
"45065",45,65,2008,3444,3073,371,10.8
"45065",45,65,2009,3423,2872,551,16.1
"45065",45,65,2010,3624,3115,509,14
"45065",45,65,2011,3632,3137,495,13.6
"45065",45,65,2012,3571,3150,421,11.8
"45065",45,65,2013,3505,3161,344,9.8
"45065",45,65,2014,3488,3214,274,7.9
"45065",45,65,2015,3441,3197,244,7.1
"45065",45,65,2016,3393,3205,188,5.5
"45065",45,65,2017,3385,3230,155,4.6
"45067",45,67,1990,15883,14443,1440,9.1
"45067",45,67,1991,16698,14587,2111,12.6
"45067",45,67,1992,16689,14576,2113,12.7
"45067",45,67,1993,17158,14854,2304,13.4
"45067",45,67,1994,17148,14891,2257,13.2
"45067",45,67,1995,16497,14704,1793,10.9
"45067",45,67,1996,16638,14450,2188,13.2
"45067",45,67,1997,16148,14592,1556,9.6
"45067",45,67,1998,16255,14752,1503,9.2
"45067",45,67,1999,16867,14759,2108,12.5
"45067",45,67,2000,15681,14173,1508,9.6
"45067",45,67,2001,14559,12765,1794,12.3
"45067",45,67,2002,13939,12438,1501,10.8
"45067",45,67,2003,14340,12446,1894,13.2
"45067",45,67,2004,14192,12272,1920,13.5
"45067",45,67,2005,13783,11905,1878,13.6
"45067",45,67,2006,13391,11781,1610,12
"45067",45,67,2007,12854,11372,1482,11.5
"45067",45,67,2008,12763,11015,1748,13.7
"45067",45,67,2009,12916,10286,2630,20.4
"45067",45,67,2010,14407,11774,2633,18.3
"45067",45,67,2011,14164,11654,2510,17.7
"45067",45,67,2012,13509,11361,2148,15.9
"45067",45,67,2013,13048,11342,1706,13.1
"45067",45,67,2014,12860,11504,1356,10.5
"45067",45,67,2015,12863,11581,1282,10
"45067",45,67,2016,12683,11581,1102,8.7
"45067",45,67,2017,12541,11611,930,7.4
"45069",45,69,1990,13414,12138,1276,9.5
"45069",45,69,1991,12853,11437,1416,11
"45069",45,69,1992,12588,11295,1293,10.3
"45069",45,69,1993,12642,10967,1675,13.2
"45069",45,69,1994,11961,10278,1683,14.1
"45069",45,69,1995,11805,10377,1428,12.1
"45069",45,69,1996,12089,10238,1851,15.3
"45069",45,69,1997,11932,10445,1487,12.5
"45069",45,69,1998,11823,10388,1435,12.1
"45069",45,69,1999,11874,10453,1421,12
"45069",45,69,2000,12414,11547,867,7
"45069",45,69,2001,12331,11152,1179,9.6
"45069",45,69,2002,12076,10893,1183,9.8
"45069",45,69,2003,12685,11002,1683,13.3
"45069",45,69,2004,12454,10838,1616,13
"45069",45,69,2005,12547,11122,1425,11.4
"45069",45,69,2006,12647,11233,1414,11.2
"45069",45,69,2007,11832,10426,1406,11.9
"45069",45,69,2008,11659,10200,1459,12.5
"45069",45,69,2009,12036,9739,2297,19.1
"45069",45,69,2010,10871,8567,2304,21.2
"45069",45,69,2011,10748,8632,2116,19.7
"45069",45,69,2012,10799,8900,1899,17.6
"45069",45,69,2013,10509,9061,1448,13.8
"45069",45,69,2014,9972,8915,1057,10.6
"45069",45,69,2015,9647,8678,969,10
"45069",45,69,2016,9314,8534,780,8.4
"45069",45,69,2017,9257,8650,607,6.6
"45071",45,71,1990,16554,15634,920,5.6
"45071",45,71,1991,16867,15995,872,5.2
"45071",45,71,1992,17427,16060,1367,7.8
"45071",45,71,1993,17584,16291,1293,7.4
"45071",45,71,1994,17686,16665,1021,5.8
"45071",45,71,1995,18128,17082,1046,5.8
"45071",45,71,1996,18648,17514,1134,6.1
"45071",45,71,1997,18671,17816,855,4.6
"45071",45,71,1998,18022,17085,937,5.2
"45071",45,71,1999,18245,17402,843,4.6
"45071",45,71,2000,17481,16722,759,4.3
"45071",45,71,2001,17163,16090,1073,6.3
"45071",45,71,2002,16989,15768,1221,7.2
"45071",45,71,2003,17796,16435,1361,7.6
"45071",45,71,2004,17463,16179,1284,7.4
"45071",45,71,2005,17669,16438,1231,7
"45071",45,71,2006,17950,16793,1157,6.4
"45071",45,71,2007,18019,17008,1011,5.6
"45071",45,71,2008,18582,17289,1293,7
"45071",45,71,2009,18446,16351,2095,11.4
"45071",45,71,2010,18575,16571,2004,10.8
"45071",45,71,2011,18577,16653,1924,10.4
"45071",45,71,2012,18232,16622,1610,8.8
"45071",45,71,2013,17934,16632,1302,7.3
"45071",45,71,2014,18558,17496,1062,5.7
"45071",45,71,2015,18899,17897,1002,5.3
"45071",45,71,2016,19198,18348,850,4.4
"45071",45,71,2017,18491,17720,771,4.2
"45073",45,73,1990,29253,27782,1471,5
"45073",45,73,1991,29064,26770,2294,7.9
"45073",45,73,1992,29136,26691,2445,8.4
"45073",45,73,1993,28607,26123,2484,8.7
"45073",45,73,1994,28067,26121,1946,6.9
"45073",45,73,1995,28340,27012,1328,4.7
"45073",45,73,1996,28732,26936,1796,6.3
"45073",45,73,1997,28726,27464,1262,4.4
"45073",45,73,1998,28482,27479,1003,3.5
"45073",45,73,1999,29067,27936,1131,3.9
"45073",45,73,2000,32691,31509,1182,3.6
"45073",45,73,2001,32129,30380,1749,5.4
"45073",45,73,2002,31581,29506,2075,6.6
"45073",45,73,2003,31987,29515,2472,7.7
"45073",45,73,2004,31718,29357,2361,7.4
"45073",45,73,2005,31781,29035,2746,8.6
"45073",45,73,2006,30834,28085,2749,8.9
"45073",45,73,2007,30225,28149,2076,6.9
"45073",45,73,2008,30608,28369,2239,7.3
"45073",45,73,2009,31227,27082,4145,13.3
"45073",45,73,2010,33314,29522,3792,11.4
"45073",45,73,2011,33272,29935,3337,10
"45073",45,73,2012,33388,30452,2936,8.8
"45073",45,73,2013,33189,30647,2542,7.7
"45073",45,73,2014,34185,32027,2158,6.3
"45073",45,73,2015,34490,32493,1997,5.8
"45073",45,73,2016,34232,32474,1758,5.1
"45073",45,73,2017,34315,32817,1498,4.4
"45075",45,75,1990,39148,36186,2962,7.6
"45075",45,75,1991,39500,35891,3609,9.1
"45075",45,75,1992,40069,36246,3823,9.5
"45075",45,75,1993,40818,36637,4181,10.2
"45075",45,75,1994,41046,37170,3876,9.4
"45075",45,75,1995,41040,37129,3911,9.5
"45075",45,75,1996,41372,37240,4132,10
"45075",45,75,1997,41622,38265,3357,8.1
"45075",45,75,1998,41247,38256,2991,7.3
"45075",45,75,1999,42418,37735,4683,11
"45075",45,75,2000,41179,38715,2464,6
"45075",45,75,2001,39807,36379,3428,8.6
"45075",45,75,2002,39789,36375,3414,8.6
"45075",45,75,2003,40255,36140,4115,10.2
"45075",45,75,2004,39734,35985,3749,9.4
"45075",45,75,2005,40563,36659,3904,9.6
"45075",45,75,2006,40028,36342,3686,9.2
"45075",45,75,2007,40302,37031,3271,8.1
"45075",45,75,2008,41087,36936,4151,10.1
"45075",45,75,2009,41540,35196,6344,15.3
"45075",45,75,2010,40102,33722,6380,15.9
"45075",45,75,2011,40241,33877,6364,15.8
"45075",45,75,2012,39379,33761,5618,14.3
"45075",45,75,2013,38527,33764,4763,12.4
"45075",45,75,2014,37853,33561,4292,11.3
"45075",45,75,2015,36944,32931,4013,10.9
"45075",45,75,2016,35621,32472,3149,8.8
"45075",45,75,2017,35174,32669,2505,7.1
"45077",45,77,1990,49319,47026,2293,4.6
"45077",45,77,1991,50122,47385,2737,5.5
"45077",45,77,1992,50952,48251,2701,5.3
"45077",45,77,1993,52352,49530,2822,5.4
"45077",45,77,1994,53243,50774,2469,4.6
"45077",45,77,1995,54023,51863,2160,4
"45077",45,77,1996,54954,52171,2783,5.1
"45077",45,77,1997,54949,53206,1743,3.2
"45077",45,77,1998,56475,54935,1540,2.7
"45077",45,77,1999,57030,55188,1842,3.2
"45077",45,77,2000,58200,56380,1820,3.1
"45077",45,77,2001,57216,54343,2873,5
"45077",45,77,2002,55530,52296,3234,5.8
"45077",45,77,2003,55948,52054,3894,7
"45077",45,77,2004,56736,52894,3842,6.8
"45077",45,77,2005,57238,53508,3730,6.5
"45077",45,77,2006,57789,54196,3593,6.2
"45077",45,77,2007,58130,55185,2945,5.1
"45077",45,77,2008,58155,54637,3518,6
"45077",45,77,2009,56986,51007,5979,10.5
"45077",45,77,2010,54434,48509,5925,10.9
"45077",45,77,2011,54730,49326,5404,9.9
"45077",45,77,2012,54754,49844,4910,9
"45077",45,77,2013,54650,50614,4036,7.4
"45077",45,77,2014,54861,51398,3463,6.3
"45077",45,77,2015,56069,52837,3232,5.8
"45077",45,77,2016,56376,53582,2794,5
"45077",45,77,2017,56658,54320,2338,4.1
"45079",45,79,1990,147585,142226,5359,3.6
"45079",45,79,1991,147988,141317,6671,4.5
"45079",45,79,1992,148979,141170,7809,5.2
"45079",45,79,1993,149934,141091,8843,5.9
"45079",45,79,1994,148602,142077,6525,4.4
"45079",45,79,1995,149196,143861,5335,3.6
"45079",45,79,1996,154902,149042,5860,3.8
"45079",45,79,1997,156132,151380,4752,3
"45079",45,79,1998,158738,155191,3547,2.2
"45079",45,79,1999,162645,158353,4292,2.6
"45079",45,79,2000,163432,157932,5500,3.4
"45079",45,79,2001,159120,152465,6655,4.2
"45079",45,79,2002,159948,152549,7399,4.6
"45079",45,79,2003,164046,154509,9537,5.8
"45079",45,79,2004,167717,157612,10105,6
"45079",45,79,2005,171046,160878,10168,5.9
"45079",45,79,2006,175827,165594,10233,5.8
"45079",45,79,2007,179489,170088,9401,5.2
"45079",45,79,2008,180447,169429,11018,6.1
"45079",45,79,2009,179853,163237,16616,9.2
"45079",45,79,2010,184934,167558,17376,9.4
"45079",45,79,2011,186481,169282,17199,9.2
"45079",45,79,2012,189352,173861,15491,8.2
"45079",45,79,2013,190577,177504,13073,6.9
"45079",45,79,2014,193973,182384,11589,6
"45079",45,79,2015,198717,187477,11240,5.7
"45079",45,79,2016,200496,190862,9634,4.8
"45079",45,79,2017,199987,191462,8525,4.3
"45081",45,81,1990,8126,7640,486,6
"45081",45,81,1991,8289,7874,415,5
"45081",45,81,1992,8485,7969,516,6.1
"45081",45,81,1993,8662,8054,608,7
"45081",45,81,1994,8443,7987,456,5.4
"45081",45,81,1995,8359,7945,414,5
"45081",45,81,1996,8582,8045,537,6.3
"45081",45,81,1997,9012,8646,366,4.1
"45081",45,81,1998,8945,8563,382,4.3
"45081",45,81,1999,9094,8640,454,5
"45081",45,81,2000,9488,9132,356,3.8
"45081",45,81,2001,9225,8743,482,5.2
"45081",45,81,2002,9128,8609,519,5.7
"45081",45,81,2003,9176,8584,592,6.5
"45081",45,81,2004,9243,8556,687,7.4
"45081",45,81,2005,9270,8655,615,6.6
"45081",45,81,2006,9361,8776,585,6.2
"45081",45,81,2007,9116,8632,484,5.3
"45081",45,81,2008,8929,8395,534,6
"45081",45,81,2009,8964,8113,851,9.5
"45081",45,81,2010,8684,7813,871,10
"45081",45,81,2011,8672,7826,846,9.8
"45081",45,81,2012,8595,7866,729,8.5
"45081",45,81,2013,8569,7976,593,6.9
"45081",45,81,2014,8657,8164,493,5.7
"45081",45,81,2015,8830,8368,462,5.2
"45081",45,81,2016,8898,8496,402,4.5
"45081",45,81,2017,8854,8507,347,3.9
"45083",45,83,1990,119768,114510,5258,4.4
"45083",45,83,1991,120205,113845,6360,5.3
"45083",45,83,1992,121089,114938,6151,5.1
"45083",45,83,1993,123989,117666,6323,5.1
"45083",45,83,1994,126214,120659,5555,4.4
"45083",45,83,1995,127679,122809,4870,3.8
"45083",45,83,1996,130015,123986,6029,4.6
"45083",45,83,1997,130704,125680,5024,3.8
"45083",45,83,1998,132614,128223,4391,3.3
"45083",45,83,1999,134321,128777,5544,4.1
"45083",45,83,2000,131126,126306,4820,3.7
"45083",45,83,2001,128219,121292,6927,5.4
"45083",45,83,2002,127656,119279,8377,6.6
"45083",45,83,2003,129838,120185,9653,7.4
"45083",45,83,2004,131447,121489,9958,7.6
"45083",45,83,2005,131691,121861,9830,7.5
"45083",45,83,2006,133837,124936,8901,6.7
"45083",45,83,2007,134253,126674,7579,5.6
"45083",45,83,2008,135710,126430,9280,6.8
"45083",45,83,2009,135629,119499,16130,11.9
"45083",45,83,2010,131818,116205,15613,11.8
"45083",45,83,2011,133260,118717,14543,10.9
"45083",45,83,2012,134781,122074,12707,9.4
"45083",45,83,2013,135553,125081,10472,7.7
"45083",45,83,2014,136899,128207,8692,6.3
"45083",45,83,2015,139880,131900,7980,5.7
"45083",45,83,2016,142435,135735,6700,4.7
"45083",45,83,2017,146296,140420,5876,4
"45085",45,85,1990,40818,38648,2170,5.3
"45085",45,85,1991,41715,37908,3807,9.1
"45085",45,85,1992,42597,39119,3478,8.2
"45085",45,85,1993,44786,40891,3895,8.7
"45085",45,85,1994,44815,41293,3522,7.9
"45085",45,85,1995,45138,42422,2716,6
"45085",45,85,1996,45832,42974,2858,6.2
"45085",45,85,1997,46110,43561,2549,5.5
"45085",45,85,1998,46913,44745,2168,4.6
"45085",45,85,1999,47561,45073,2488,5.2
"45085",45,85,2000,45279,43291,1988,4.4
"45085",45,85,2001,43466,40614,2852,6.6
"45085",45,85,2002,42808,39779,3029,7.1
"45085",45,85,2003,44868,41406,3462,7.7
"45085",45,85,2004,45697,42123,3574,7.8
"45085",45,85,2005,46446,42505,3941,8.5
"45085",45,85,2006,45815,42252,3563,7.8
"45085",45,85,2007,44599,41465,3134,7
"45085",45,85,2008,43755,40137,3618,8.3
"45085",45,85,2009,44819,39309,5510,12.3
"45085",45,85,2010,44419,38887,5532,12.5
"45085",45,85,2011,44814,39405,5409,12.1
"45085",45,85,2012,44730,39963,4767,10.7
"45085",45,85,2013,44194,40331,3863,8.7
"45085",45,85,2014,44406,41161,3245,7.3
"45085",45,85,2015,44379,41356,3023,6.8
"45085",45,85,2016,44284,41695,2589,5.8
"45085",45,85,2017,44112,41794,2318,5.3
"45087",45,87,1990,15274,14108,1166,7.6
"45087",45,87,1991,15295,13878,1417,9.3
"45087",45,87,1992,15905,14541,1364,8.6
"45087",45,87,1993,16112,14643,1469,9.1
"45087",45,87,1994,16121,14794,1327,8.2
"45087",45,87,1995,15666,14228,1438,9.2
"45087",45,87,1996,15350,14033,1317,8.6
"45087",45,87,1997,15181,14190,991,6.5
"45087",45,87,1998,15185,14196,989,6.5
"45087",45,87,1999,15384,14308,1076,7
"45087",45,87,2000,14297,13542,755,5.3
"45087",45,87,2001,14035,12780,1255,8.9
"45087",45,87,2002,13569,12174,1395,10.3
"45087",45,87,2003,13345,11811,1534,11.5
"45087",45,87,2004,13016,11439,1577,12.1
"45087",45,87,2005,12671,11302,1369,10.8
"45087",45,87,2006,12286,10947,1339,10.9
"45087",45,87,2007,11657,10611,1046,9
"45087",45,87,2008,11696,10432,1264,10.8
"45087",45,87,2009,12077,9763,2314,19.2
"45087",45,87,2010,12392,10202,2190,17.7
"45087",45,87,2011,12232,10271,1961,16
"45087",45,87,2012,11963,10332,1631,13.6
"45087",45,87,2013,11730,10406,1324,11.3
"45087",45,87,2014,11503,10513,990,8.6
"45087",45,87,2015,11556,10645,911,7.9
"45087",45,87,2016,11471,10762,709,6.2
"45087",45,87,2017,11759,11129,630,5.4
"45089",45,89,1990,16716,15133,1583,9.5
"45089",45,89,1991,15836,14256,1580,10
"45089",45,89,1992,16449,14819,1630,9.9
"45089",45,89,1993,17437,14853,2584,14.8
"45089",45,89,1994,17195,14798,2397,13.9
"45089",45,89,1995,16422,14011,2411,14.7
"45089",45,89,1996,16199,13228,2971,18.3
"45089",45,89,1997,14974,12582,2392,16
"45089",45,89,1998,14521,12888,1633,11.2
"45089",45,89,1999,14978,13141,1837,12.3
"45089",45,89,2000,15312,14120,1192,7.8
"45089",45,89,2001,14994,13458,1536,10.2
"45089",45,89,2002,14823,13256,1567,10.6
"45089",45,89,2003,15621,13574,2047,13.1
"45089",45,89,2004,15145,13323,1822,12
"45089",45,89,2005,15579,13844,1735,11.1
"45089",45,89,2006,15671,14119,1552,9.9
"45089",45,89,2007,15258,13885,1373,9
"45089",45,89,2008,15437,13835,1602,10.4
"45089",45,89,2009,15856,13552,2304,14.5
"45089",45,89,2010,13351,11048,2303,17.2
"45089",45,89,2011,13427,11185,2242,16.7
"45089",45,89,2012,12435,10471,1964,15.8
"45089",45,89,2013,12675,11090,1585,12.5
"45089",45,89,2014,12649,11386,1263,10
"45089",45,89,2015,12819,11638,1181,9.2
"45089",45,89,2016,12478,11518,960,7.7
"45089",45,89,2017,12389,11603,786,6.3
"45091",45,91,1990,71898,69294,2604,3.6
"45091",45,91,1991,72959,69038,3921,5.4
"45091",45,91,1992,75225,70412,4813,6.4
"45091",45,91,1993,77541,72629,4912,6.3
"45091",45,91,1994,78521,75072,3449,4.4
"45091",45,91,1995,80278,77306,2972,3.7
"45091",45,91,1996,82856,78613,4243,5.1
"45091",45,91,1997,84332,80813,3519,4.2
"45091",45,91,1998,86537,83362,3175,3.7
"45091",45,91,1999,90198,86657,3541,3.9
"45091",45,91,2000,89184,86214,2970,3.3
"45091",45,91,2001,89041,84736,4305,4.8
"45091",45,91,2002,90543,84806,5737,6.3
"45091",45,91,2003,92849,85786,7063,7.6
"45091",45,91,2004,94122,87290,6832,7.3
"45091",45,91,2005,96285,89887,6398,6.6
"45091",45,91,2006,100969,94544,6425,6.4
"45091",45,91,2007,104653,99009,5644,5.4
"45091",45,91,2008,107682,100129,7553,7
"45091",45,91,2009,112281,97133,15148,13.5
"45091",45,91,2010,115647,101643,14004,12.1
"45091",45,91,2011,117004,104225,12779,10.9
"45091",45,91,2012,118566,107576,10990,9.3
"45091",45,91,2013,119431,110241,9190,7.7
"45091",45,91,2014,122649,114932,7717,6.3
"45091",45,91,2015,126680,119748,6932,5.5
"45091",45,91,2016,130699,124694,6005,4.6
"45091",45,91,2017,133410,128109,5301,4
"46003",46,3,1990,1316,1292,24,1.8
"46003",46,3,1991,1312,1273,39,3
"46003",46,3,1992,1370,1326,44,3.2
"46003",46,3,1993,1304,1256,48,3.7
"46003",46,3,1994,1371,1317,54,3.9
"46003",46,3,1995,1435,1391,44,3.1
"46003",46,3,1996,1313,1273,40,3
"46003",46,3,1997,1300,1269,31,2.4
"46003",46,3,1998,1349,1311,38,2.8
"46003",46,3,1999,1405,1375,30,2.1
"46003",46,3,2000,1582,1547,35,2.2
"46003",46,3,2001,1563,1521,42,2.7
"46003",46,3,2002,1514,1460,54,3.6
"46003",46,3,2003,1454,1400,54,3.7
"46003",46,3,2004,1442,1387,55,3.8
"46003",46,3,2005,1375,1319,56,4.1
"46003",46,3,2006,1363,1316,47,3.4
"46003",46,3,2007,1381,1341,40,2.9
"46003",46,3,2008,1480,1434,46,3.1
"46003",46,3,2009,1529,1462,67,4.4
"46003",46,3,2010,1677,1618,59,3.5
"46003",46,3,2011,1667,1614,53,3.2
"46003",46,3,2012,1683,1633,50,3
"46003",46,3,2013,1640,1596,44,2.7
"46003",46,3,2014,1603,1561,42,2.6
"46003",46,3,2015,1568,1533,35,2.2
"46003",46,3,2016,1518,1484,34,2.2
"46003",46,3,2017,1516,1473,43,2.8
"46005",46,5,1990,9164,8773,391,4.3
"46005",46,5,1991,8803,8429,374,4.2
"46005",46,5,1992,9082,8809,273,3
"46005",46,5,1993,9056,8803,253,2.8
"46005",46,5,1994,9461,9212,249,2.6
"46005",46,5,1995,9615,9360,255,2.7
"46005",46,5,1996,9647,9375,272,2.8
"46005",46,5,1997,9542,9097,445,4.7
"46005",46,5,1998,9169,8810,359,3.9
"46005",46,5,1999,8792,8545,247,2.8
"46005",46,5,2000,9100,8878,222,2.4
"46005",46,5,2001,9286,8977,309,3.3
"46005",46,5,2002,9137,8786,351,3.8
"46005",46,5,2003,9073,8689,384,4.2
"46005",46,5,2004,8914,8565,349,3.9
"46005",46,5,2005,8889,8501,388,4.4
"46005",46,5,2006,9033,8765,268,3
"46005",46,5,2007,9448,9217,231,2.4
"46005",46,5,2008,9705,9462,243,2.5
"46005",46,5,2009,9723,9365,358,3.7
"46005",46,5,2010,9427,9033,394,4.2
"46005",46,5,2011,9484,9125,359,3.8
"46005",46,5,2012,9567,9234,333,3.5
"46005",46,5,2013,9447,9110,337,3.6
"46005",46,5,2014,9394,9101,293,3.1
"46005",46,5,2015,9452,9202,250,2.6
"46005",46,5,2016,9393,9149,244,2.6
"46005",46,5,2017,9350,9082,268,2.9
"46007",46,7,1990,1166,1103,63,5.4
"46007",46,7,1991,1167,1110,57,4.9
"46007",46,7,1992,1147,1088,59,5.1
"46007",46,7,1993,1012,962,50,4.9
"46007",46,7,1994,1075,1019,56,5.2
"46007",46,7,1995,1084,1025,59,5.4
"46007",46,7,1996,1066,1014,52,4.9
"46007",46,7,1997,1056,1009,47,4.5
"46007",46,7,1998,1013,975,38,3.8
"46007",46,7,1999,1079,1026,53,4.9
"46007",46,7,2000,1337,1290,47,3.5
"46007",46,7,2001,1386,1331,55,4
"46007",46,7,2002,1424,1365,59,4.1
"46007",46,7,2003,1436,1381,55,3.8
"46007",46,7,2004,1432,1374,58,4.1
"46007",46,7,2005,1436,1348,88,6.1
"46007",46,7,2006,1485,1415,70,4.7
"46007",46,7,2007,1389,1333,56,4
"46007",46,7,2008,1367,1312,55,4
"46007",46,7,2009,1431,1354,77,5.4
"46007",46,7,2010,1195,1109,86,7.2
"46007",46,7,2011,1178,1092,86,7.3
"46007",46,7,2012,1199,1118,81,6.8
"46007",46,7,2013,1132,1060,72,6.4
"46007",46,7,2014,1131,1069,62,5.5
"46007",46,7,2015,1129,1072,57,5
"46007",46,7,2016,1121,1077,44,3.9
"46007",46,7,2017,1121,1071,50,4.5
"46009",46,9,1990,3002,2966,36,1.2
"46009",46,9,1991,3095,3008,87,2.8
"46009",46,9,1992,3045,2967,78,2.6
"46009",46,9,1993,2990,2918,72,2.4
"46009",46,9,1994,3090,3013,77,2.5
"46009",46,9,1995,3187,3119,68,2.1
"46009",46,9,1996,3138,3061,77,2.5
"46009",46,9,1997,3127,3060,67,2.1
"46009",46,9,1998,3115,3059,56,1.8
"46009",46,9,1999,3170,3108,62,2
"46009",46,9,2000,3324,3238,86,2.6
"46009",46,9,2001,3330,3215,115,3.5
"46009",46,9,2002,3391,3278,113,3.3
"46009",46,9,2003,3424,3303,121,3.5
"46009",46,9,2004,3358,3238,120,3.6
"46009",46,9,2005,3354,3223,131,3.9
"46009",46,9,2006,3222,3089,133,4.1
"46009",46,9,2007,3091,2974,117,3.8
"46009",46,9,2008,3074,2968,106,3.4
"46009",46,9,2009,3136,2968,168,5.4
"46009",46,9,2010,3189,3055,134,4.2
"46009",46,9,2011,3115,2960,155,5
"46009",46,9,2012,3036,2917,119,3.9
"46009",46,9,2013,2994,2897,97,3.2
"46009",46,9,2014,2994,2910,84,2.8
"46009",46,9,2015,3004,2924,80,2.7
"46009",46,9,2016,2939,2859,80,2.7
"46009",46,9,2017,2918,2829,89,3.1
"46011",46,11,1990,13971,13260,711,5.1
"46011",46,11,1991,14121,13702,419,3
"46011",46,11,1992,13968,13712,256,1.8
"46011",46,11,1993,14362,14071,291,2
"46011",46,11,1994,14960,14680,280,1.9
"46011",46,11,1995,15384,15148,236,1.5
"46011",46,11,1996,15668,15423,245,1.6
"46011",46,11,1997,15847,15596,251,1.6
"46011",46,11,1998,16156,15916,240,1.5
"46011",46,11,1999,17096,16848,248,1.5
"46011",46,11,2000,17612,17257,355,2
"46011",46,11,2001,16966,16500,466,2.7
"46011",46,11,2002,17000,16527,473,2.8
"46011",46,11,2003,17533,17004,529,3
"46011",46,11,2004,18074,17536,538,3
"46011",46,11,2005,18293,17723,570,3.1
"46011",46,11,2006,18946,18489,457,2.4
"46011",46,11,2007,19704,19279,425,2.2
"46011",46,11,2008,19593,19118,475,2.4
"46011",46,11,2009,19026,18312,714,3.8
"46011",46,11,2010,17847,17013,834,4.7
"46011",46,11,2011,17871,17079,792,4.4
"46011",46,11,2012,17682,16990,692,3.9
"46011",46,11,2013,17711,17107,604,3.4
"46011",46,11,2014,18133,17560,573,3.2
"46011",46,11,2015,18531,17987,544,2.9
"46011",46,11,2016,18848,18329,519,2.8
"46011",46,11,2017,18815,18222,593,3.2
"46013",46,13,1990,19800,18713,1087,5.5
"46013",46,13,1991,19310,18710,600,3.1
"46013",46,13,1992,19304,18802,502,2.6
"46013",46,13,1993,19689,19225,464,2.4
"46013",46,13,1994,20275,19812,463,2.3
"46013",46,13,1995,20810,20389,421,2
"46013",46,13,1996,21023,20590,433,2.1
"46013",46,13,1997,20953,20503,450,2.1
"46013",46,13,1998,21185,20702,483,2.3
"46013",46,13,1999,21054,20571,483,2.3
"46013",46,13,2000,20480,20018,462,2.3
"46013",46,13,2001,20485,19862,623,3
"46013",46,13,2002,20238,19615,623,3.1
"46013",46,13,2003,20460,19801,659,3.2
"46013",46,13,2004,20703,20045,658,3.2
"46013",46,13,2005,20846,20162,684,3.3
"46013",46,13,2006,20808,20263,545,2.6
"46013",46,13,2007,21248,20758,490,2.3
"46013",46,13,2008,21229,20706,523,2.5
"46013",46,13,2009,21221,20452,769,3.6
"46013",46,13,2010,20882,20078,804,3.9
"46013",46,13,2011,20751,19951,800,3.9
"46013",46,13,2012,20860,20115,745,3.6
"46013",46,13,2013,20885,20206,679,3.3
"46013",46,13,2014,20954,20341,613,2.9
"46013",46,13,2015,20952,20393,559,2.7
"46013",46,13,2016,21046,20480,566,2.7
"46013",46,13,2017,20950,20319,631,3
"46015",46,15,1990,2793,2730,63,2.3
"46015",46,15,1991,2692,2612,80,3
"46015",46,15,1992,2751,2662,89,3.2
"46015",46,15,1993,2735,2634,101,3.7
"46015",46,15,1994,2931,2820,111,3.8
"46015",46,15,1995,2972,2846,126,4.2
"46015",46,15,1996,2968,2855,113,3.8
"46015",46,15,1997,2854,2734,120,4.2
"46015",46,15,1998,2629,2540,89,3.4
"46015",46,15,1999,2648,2552,96,3.6
"46015",46,15,2000,2718,2653,65,2.4
"46015",46,15,2001,2855,2782,73,2.6
"46015",46,15,2002,2875,2803,72,2.5
"46015",46,15,2003,2910,2831,79,2.7
"46015",46,15,2004,2888,2806,82,2.8
"46015",46,15,2005,2861,2766,95,3.3
"46015",46,15,2006,2744,2663,81,3
"46015",46,15,2007,2814,2741,73,2.6
"46015",46,15,2008,2803,2727,76,2.7
"46015",46,15,2009,2856,2756,100,3.5
"46015",46,15,2010,2733,2632,101,3.7
"46015",46,15,2011,2710,2600,110,4.1
"46015",46,15,2012,2648,2552,96,3.6
"46015",46,15,2013,2596,2507,89,3.4
"46015",46,15,2014,2559,2475,84,3.3
"46015",46,15,2015,2532,2464,68,2.7
"46015",46,15,2016,2466,2403,63,2.6
"46015",46,15,2017,2455,2381,74,3
"46017",46,17,1990,596,540,56,9.4
"46017",46,17,1991,583,530,53,9.1
"46017",46,17,1992,596,540,56,9.4
"46017",46,17,1993,733,682,51,7
"46017",46,17,1994,798,704,94,11.8
"46017",46,17,1995,815,730,85,10.4
"46017",46,17,1996,733,659,74,10.1
"46017",46,17,1997,685,600,85,12.4
"46017",46,17,1998,818,740,78,9.5
"46017",46,17,1999,845,759,86,10.2
"46017",46,17,2000,511,464,47,9.2
"46017",46,17,2001,533,487,46,8.6
"46017",46,17,2002,541,498,43,7.9
"46017",46,17,2003,551,508,43,7.8
"46017",46,17,2004,569,506,63,11.1
"46017",46,17,2005,573,485,88,15.4
"46017",46,17,2006,549,471,78,14.2
"46017",46,17,2007,489,435,54,11
"46017",46,17,2008,482,433,49,10.2
"46017",46,17,2009,510,433,77,15.1
"46017",46,17,2010,693,615,78,11.3
"46017",46,17,2011,735,659,76,10.3
"46017",46,17,2012,746,674,72,9.7
"46017",46,17,2013,737,672,65,8.8
"46017",46,17,2014,732,675,57,7.8
"46017",46,17,2015,714,664,50,7
"46017",46,17,2016,725,665,60,8.3
"46017",46,17,2017,716,662,54,7.5
"46019",46,19,1990,3633,3506,127,3.5
"46019",46,19,1991,3587,3455,132,3.7
"46019",46,19,1992,3598,3432,166,4.6
"46019",46,19,1993,3523,3352,171,4.9
"46019",46,19,1994,3643,3498,145,4
"46019",46,19,1995,3859,3713,146,3.8
"46019",46,19,1996,3766,3595,171,4.5
"46019",46,19,1997,3782,3591,191,5.1
"46019",46,19,1998,3801,3641,160,4.2
"46019",46,19,1999,3826,3676,150,3.9
"46019",46,19,2000,4782,4653,129,2.7
"46019",46,19,2001,4843,4688,155,3.2
"46019",46,19,2002,4981,4828,153,3.1
"46019",46,19,2003,5096,4922,174,3.4
"46019",46,19,2004,5151,4964,187,3.6
"46019",46,19,2005,5151,4967,184,3.6
"46019",46,19,2006,5403,5258,145,2.7
"46019",46,19,2007,5341,5198,143,2.7
"46019",46,19,2008,5483,5331,152,2.8
"46019",46,19,2009,5447,5171,276,5.1
"46019",46,19,2010,5110,4851,259,5.1
"46019",46,19,2011,5018,4772,246,4.9
"46019",46,19,2012,4974,4742,232,4.7
"46019",46,19,2013,5023,4828,195,3.9
"46019",46,19,2014,5074,4902,172,3.4
"46019",46,19,2015,5083,4910,173,3.4
"46019",46,19,2016,5037,4862,175,3.5
"46019",46,19,2017,5019,4834,185,3.7
"46021",46,21,1990,948,920,28,3
"46021",46,21,1991,929,887,42,4.5
"46021",46,21,1992,923,900,23,2.5
"46021",46,21,1993,911,882,29,3.2
"46021",46,21,1994,940,906,34,3.6
"46021",46,21,1995,958,931,27,2.8
"46021",46,21,1996,938,909,29,3.1
"46021",46,21,1997,898,867,31,3.5
"46021",46,21,1998,861,833,28,3.3
"46021",46,21,1999,895,868,27,3
"46021",46,21,2000,928,879,49,5.3
"46021",46,21,2001,880,838,42,4.8
"46021",46,21,2002,912,881,31,3.4
"46021",46,21,2003,943,898,45,4.8
"46021",46,21,2004,927,891,36,3.9
"46021",46,21,2005,891,857,34,3.8
"46021",46,21,2006,883,857,26,2.9
"46021",46,21,2007,836,810,26,3.1
"46021",46,21,2008,838,814,24,2.9
"46021",46,21,2009,856,820,36,4.2
"46021",46,21,2010,907,868,39,4.3
"46021",46,21,2011,870,836,34,3.9
"46021",46,21,2012,860,829,31,3.6
"46021",46,21,2013,840,810,30,3.6
"46021",46,21,2014,848,820,28,3.3
"46021",46,21,2015,848,823,25,2.9
"46021",46,21,2016,848,823,25,2.9
"46021",46,21,2017,827,798,29,3.5
"46023",46,23,1990,3809,3661,148,3.9
"46023",46,23,1991,3883,3726,157,4
"46023",46,23,1992,4413,4242,171,3.9
"46023",46,23,1993,4463,4299,164,3.7
"46023",46,23,1994,4650,4469,181,3.9
"46023",46,23,1995,4803,4633,170,3.5
"46023",46,23,1996,4706,4548,158,3.4
"46023",46,23,1997,4534,4383,151,3.3
"46023",46,23,1998,4598,4416,182,4
"46023",46,23,1999,4523,4379,144,3.2
"46023",46,23,2000,4013,3903,110,2.7
"46023",46,23,2001,4182,4050,132,3.2
"46023",46,23,2002,4336,4207,129,3
"46023",46,23,2003,4322,4171,151,3.5
"46023",46,23,2004,4264,4088,176,4.1
"46023",46,23,2005,4173,3988,185,4.4
"46023",46,23,2006,4116,3969,147,3.6
"46023",46,23,2007,4030,3895,135,3.3
"46023",46,23,2008,4054,3911,143,3.5
"46023",46,23,2009,4194,3987,207,4.9
"46023",46,23,2010,4144,3941,203,4.9
"46023",46,23,2011,4124,3919,205,5
"46023",46,23,2012,4056,3855,201,5
"46023",46,23,2013,3983,3810,173,4.3
"46023",46,23,2014,4006,3853,153,3.8
"46023",46,23,2015,3977,3840,137,3.4
"46023",46,23,2016,3881,3756,125,3.2
"46023",46,23,2017,3867,3724,143,3.7
"46025",46,25,1990,1968,1900,68,3.5
"46025",46,25,1991,1903,1832,71,3.7
"46025",46,25,1992,1924,1836,88,4.6
"46025",46,25,1993,1836,1752,84,4.6
"46025",46,25,1994,1913,1838,75,3.9
"46025",46,25,1995,1976,1899,77,3.9
"46025",46,25,1996,1965,1889,76,3.9
"46025",46,25,1997,1941,1866,75,3.9
"46025",46,25,1998,1956,1895,61,3.1
"46025",46,25,1999,2010,1922,88,4.4
"46025",46,25,2000,2135,2058,77,3.6
"46025",46,25,2001,2056,1954,102,5
"46025",46,25,2002,1946,1842,104,5.3
"46025",46,25,2003,1935,1833,102,5.3
"46025",46,25,2004,1919,1834,85,4.4
"46025",46,25,2005,1869,1778,91,4.9
"46025",46,25,2006,1872,1800,72,3.8
"46025",46,25,2007,1834,1768,66,3.6
"46025",46,25,2008,1815,1745,70,3.9
"46025",46,25,2009,1828,1724,104,5.7
"46025",46,25,2010,1976,1874,102,5.2
"46025",46,25,2011,1944,1851,93,4.8
"46025",46,25,2012,1921,1838,83,4.3
"46025",46,25,2013,1972,1895,77,3.9
"46025",46,25,2014,1984,1906,78,3.9
"46025",46,25,2015,1962,1890,72,3.7
"46025",46,25,2016,1916,1841,75,3.9
"46025",46,25,2017,1897,1809,88,4.6
"46027",46,27,1990,6839,6525,314,4.6
"46027",46,27,1991,6743,6559,184,2.7
"46027",46,27,1992,6678,6598,80,1.2
"46027",46,27,1993,6660,6570,90,1.4
"46027",46,27,1994,6888,6802,86,1.2
"46027",46,27,1995,6928,6853,75,1.1
"46027",46,27,1996,6878,6787,91,1.3
"46027",46,27,1997,6890,6812,78,1.1
"46027",46,27,1998,7058,6991,67,.9
"46027",46,27,1999,7911,7854,57,.7
"46027",46,27,2000,7382,7230,152,2.1
"46027",46,27,2001,6942,6746,196,2.8
"46027",46,27,2002,6998,6782,216,3.1
"46027",46,27,2003,7152,6933,219,3.1
"46027",46,27,2004,7335,7093,242,3.3
"46027",46,27,2005,7339,7086,253,3.4
"46027",46,27,2006,7473,7255,218,2.9
"46027",46,27,2007,7614,7423,191,2.5
"46027",46,27,2008,7700,7488,212,2.8
"46027",46,27,2009,7655,7348,307,4
"46027",46,27,2010,7387,7075,312,4.2
"46027",46,27,2011,7482,7179,303,4
"46027",46,27,2012,7426,7142,284,3.8
"46027",46,27,2013,7062,6802,260,3.7
"46027",46,27,2014,7070,6825,245,3.5
"46027",46,27,2015,6997,6782,215,3.1
"46027",46,27,2016,6972,6762,210,3
"46027",46,27,2017,7145,6909,236,3.3
"46029",46,29,1990,12104,11565,539,4.5
"46029",46,29,1991,12034,11558,476,4
"46029",46,29,1992,12599,12137,462,3.7
"46029",46,29,1993,13049,12544,505,3.9
"46029",46,29,1994,13615,13149,466,3.4
"46029",46,29,1995,14129,13689,440,3.1
"46029",46,29,1996,14441,13993,448,3.1
"46029",46,29,1997,14736,14266,470,3.2
"46029",46,29,1998,14977,14498,479,3.2
"46029",46,29,1999,14731,14219,512,3.5
"46029",46,29,2000,15516,15140,376,2.4
"46029",46,29,2001,15608,15066,542,3.5
"46029",46,29,2002,15438,14865,573,3.7
"46029",46,29,2003,15618,15001,617,4
"46029",46,29,2004,15769,15201,568,3.6
"46029",46,29,2005,15889,15309,580,3.7
"46029",46,29,2006,16386,15909,477,2.9
"46029",46,29,2007,16778,16334,444,2.6
"46029",46,29,2008,16624,16122,502,3
"46029",46,29,2009,16256,15249,1007,6.2
"46029",46,29,2010,15053,14272,781,5.2
"46029",46,29,2011,15337,14638,699,4.6
"46029",46,29,2012,15486,14884,602,3.9
"46029",46,29,2013,15402,14851,551,3.6
"46029",46,29,2014,15320,14811,509,3.3
"46029",46,29,2015,15292,14820,472,3.1
"46029",46,29,2016,15177,14706,471,3.1
"46029",46,29,2017,15186,14676,510,3.4
"46031",46,31,1990,1645,1312,333,20.2
"46031",46,31,1991,1519,1195,324,21.3
"46031",46,31,1992,1748,1340,408,23.3
"46031",46,31,1993,1717,1345,372,21.7
"46031",46,31,1994,1477,1346,131,8.9
"46031",46,31,1995,1537,1418,119,7.7
"46031",46,31,1996,1475,1338,137,9.3
"46031",46,31,1997,1417,1312,105,7.4
"46031",46,31,1998,1538,1443,95,6.2
"46031",46,31,1999,1626,1505,121,7.4
"46031",46,31,2000,1385,1309,76,5.5
"46031",46,31,2001,1375,1291,84,6.1
"46031",46,31,2002,1422,1344,78,5.5
"46031",46,31,2003,1458,1368,90,6.2
"46031",46,31,2004,1453,1360,93,6.4
"46031",46,31,2005,1431,1327,104,7.3
"46031",46,31,2006,1443,1357,86,6
"46031",46,31,2007,1352,1276,76,5.6
"46031",46,31,2008,1364,1294,70,5.1
"46031",46,31,2009,1415,1321,94,6.6
"46031",46,31,2010,1542,1435,107,6.9
"46031",46,31,2011,1533,1418,115,7.5
"46031",46,31,2012,1512,1391,121,8
"46031",46,31,2013,1504,1400,104,6.9
"46031",46,31,2014,1487,1400,87,5.9
"46031",46,31,2015,1488,1412,76,5.1
"46031",46,31,2016,1451,1386,65,4.5
"46031",46,31,2017,1419,1360,59,4.2
"46033",46,33,1990,3447,3356,91,2.6
"46033",46,33,1991,3545,3402,143,4
"46033",46,33,1992,3658,3534,124,3.4
"46033",46,33,1993,3513,3351,162,4.6
"46033",46,33,1994,3520,3328,192,5.5
"46033",46,33,1995,3489,3320,169,4.8
"46033",46,33,1996,3369,3164,205,6.1
"46033",46,33,1997,3317,3156,161,4.9
"46033",46,33,1998,3369,3228,141,4.2
"46033",46,33,1999,3550,3403,147,4.1
"46033",46,33,2000,4171,4050,121,2.9
"46033",46,33,2001,4308,4165,143,3.3
"46033",46,33,2002,4528,4379,149,3.3
"46033",46,33,2003,4636,4459,177,3.8
"46033",46,33,2004,4719,4531,188,4
"46033",46,33,2005,4800,4614,186,3.9
"46033",46,33,2006,4811,4666,145,3
"46033",46,33,2007,4712,4582,130,2.8
"46033",46,33,2008,4902,4764,138,2.8
"46033",46,33,2009,5017,4807,210,4.2
"46033",46,33,2010,4070,3832,238,5.8
"46033",46,33,2011,4073,3845,228,5.6
"46033",46,33,2012,4016,3801,215,5.4
"46033",46,33,2013,4012,3808,204,5.1
"46033",46,33,2014,3961,3781,180,4.5
"46033",46,33,2015,3956,3788,168,4.2
"46033",46,33,2016,3985,3825,160,4
"46033",46,33,2017,4014,3841,173,4.3
"46035",46,35,1990,8910,8667,243,2.7
"46035",46,35,1991,8798,8583,215,2.4
"46035",46,35,1992,8995,8728,267,3
"46035",46,35,1993,9225,8954,271,2.9
"46035",46,35,1994,9560,9324,236,2.5
"46035",46,35,1995,9859,9574,285,2.9
"46035",46,35,1996,10100,9770,330,3.3
"46035",46,35,1997,10282,10020,262,2.5
"46035",46,35,1998,10260,10034,226,2.2
"46035",46,35,1999,10322,10095,227,2.2
"46035",46,35,2000,10322,10092,230,2.2
"46035",46,35,2001,10760,10490,270,2.5
"46035",46,35,2002,10775,10484,291,2.7
"46035",46,35,2003,10872,10549,323,3
"46035",46,35,2004,10921,10587,334,3.1
"46035",46,35,2005,11036,10677,359,3.3
"46035",46,35,2006,10864,10539,325,3
"46035",46,35,2007,11285,11009,276,2.4
"46035",46,35,2008,11293,10998,295,2.6
"46035",46,35,2009,11229,10685,544,4.8
"46035",46,35,2010,10922,10438,484,4.4
"46035",46,35,2011,11047,10611,436,3.9
"46035",46,35,2012,11204,10830,374,3.3
"46035",46,35,2013,11196,10847,349,3.1
"46035",46,35,2014,11257,10938,319,2.8
"46035",46,35,2015,11305,11018,287,2.5
"46035",46,35,2016,11215,10945,270,2.4
"46035",46,35,2017,11108,10785,323,2.9
"46037",46,37,1990,3031,2875,156,5.1
"46037",46,37,1991,3006,2849,157,5.2
"46037",46,37,1992,3070,2936,134,4.4
"46037",46,37,1993,3000,2875,125,4.2
"46037",46,37,1994,3098,2958,140,4.5
"46037",46,37,1995,3093,2940,153,4.9
"46037",46,37,1996,3070,2936,134,4.4
"46037",46,37,1997,3081,2936,145,4.7
"46037",46,37,1998,3041,2863,178,5.9
"46037",46,37,1999,3035,2829,206,6.8
"46037",46,37,2000,3041,2918,123,4
"46037",46,37,2001,3051,2893,158,5.2
"46037",46,37,2002,3071,2911,160,5.2
"46037",46,37,2003,3111,2923,188,6
"46037",46,37,2004,3060,2865,195,6.4
"46037",46,37,2005,3015,2833,182,6
"46037",46,37,2006,2936,2788,148,5
"46037",46,37,2007,2874,2737,137,4.8
"46037",46,37,2008,2914,2787,127,4.4
"46037",46,37,2009,2920,2717,203,7
"46037",46,37,2010,3073,2868,205,6.7
"46037",46,37,2011,3045,2846,199,6.5
"46037",46,37,2012,2948,2778,170,5.8
"46037",46,37,2013,2912,2759,153,5.3
"46037",46,37,2014,2869,2716,153,5.3
"46037",46,37,2015,2855,2712,143,5
"46037",46,37,2016,2853,2731,122,4.3
"46037",46,37,2017,2835,2719,116,4.1
"46039",46,39,1990,2156,2068,88,4.1
"46039",46,39,1991,2110,2037,73,3.5
"46039",46,39,1992,2225,2133,92,4.1
"46039",46,39,1993,2196,2102,94,4.3
"46039",46,39,1994,2313,2229,84,3.6
"46039",46,39,1995,2357,2281,76,3.2
"46039",46,39,1996,2337,2255,82,3.5
"46039",46,39,1997,2356,2282,74,3.1
"46039",46,39,1998,2419,2342,77,3.2
"46039",46,39,1999,2519,2425,94,3.7
"46039",46,39,2000,2513,2435,78,3.1
"46039",46,39,2001,2530,2429,101,4
"46039",46,39,2002,2560,2461,99,3.9
"46039",46,39,2003,2623,2515,108,4.1
"46039",46,39,2004,2646,2527,119,4.5
"46039",46,39,2005,2664,2550,114,4.3
"46039",46,39,2006,2711,2615,96,3.5
"46039",46,39,2007,2677,2584,93,3.5
"46039",46,39,2008,2774,2668,106,3.8
"46039",46,39,2009,2728,2565,163,6
"46039",46,39,2010,2478,2311,167,6.7
"46039",46,39,2011,2513,2360,153,6.1
"46039",46,39,2012,2479,2332,147,5.9
"46039",46,39,2013,2374,2241,133,5.6
"46039",46,39,2014,2328,2202,126,5.4
"46039",46,39,2015,2306,2191,115,5
"46039",46,39,2016,2236,2126,110,4.9
"46039",46,39,2017,2194,2088,106,4.8
"46041",46,41,1990,2064,1825,239,11.6
"46041",46,41,1991,2087,1813,274,13.1
"46041",46,41,1992,2106,1846,260,12.3
"46041",46,41,1993,2100,1846,254,12.1
"46041",46,41,1994,2208,1920,288,13
"46041",46,41,1995,2270,1965,305,13.4
"46041",46,41,1996,2272,1972,300,13.2
"46041",46,41,1997,2263,2004,259,11.4
"46041",46,41,1998,2448,2095,353,14.4
"46041",46,41,1999,2437,2131,306,12.6
"46041",46,41,2000,2266,2063,203,9
"46041",46,41,2001,2445,2217,228,9.3
"46041",46,41,2002,2559,2357,202,7.9
"46041",46,41,2003,2692,2465,227,8.4
"46041",46,41,2004,2736,2498,238,8.7
"46041",46,41,2005,2668,2404,264,9.9
"46041",46,41,2006,2716,2463,253,9.3
"46041",46,41,2007,2515,2274,241,9.6
"46041",46,41,2008,2512,2281,231,9.2
"46041",46,41,2009,2670,2376,294,11
"46041",46,41,2010,2356,2006,350,14.9
"46041",46,41,2011,2410,2019,391,16.2
"46041",46,41,2012,2414,2027,387,16
"46041",46,41,2013,2413,2039,374,15.5
"46041",46,41,2014,2365,2021,344,14.5
"46041",46,41,2015,2289,2025,264,11.5
"46041",46,41,2016,2248,2045,203,9
"46041",46,41,2017,2234,2006,228,10.2
"46043",46,43,1990,1563,1520,43,2.8
"46043",46,43,1991,1550,1510,40,2.6
"46043",46,43,1992,1536,1499,37,2.4
"46043",46,43,1993,1460,1416,44,3
"46043",46,43,1994,1558,1514,44,2.8
"46043",46,43,1995,1588,1533,55,3.5
"46043",46,43,1996,1614,1574,40,2.5
"46043",46,43,1997,1603,1566,37,2.3
"46043",46,43,1998,1648,1602,46,2.8
"46043",46,43,1999,1654,1618,36,2.2
"46043",46,43,2000,1736,1699,37,2.1
"46043",46,43,2001,1707,1663,44,2.6
"46043",46,43,2002,1765,1718,47,2.7
"46043",46,43,2003,1816,1767,49,2.7
"46043",46,43,2004,1824,1768,56,3.1
"46043",46,43,2005,1784,1725,59,3.3
"46043",46,43,2006,1709,1663,46,2.7
"46043",46,43,2007,1675,1633,42,2.5
"46043",46,43,2008,1706,1660,46,2.7
"46043",46,43,2009,1775,1701,74,4.2
"46043",46,43,2010,1761,1683,78,4.4
"46043",46,43,2011,1751,1680,71,4.1
"46043",46,43,2012,1693,1636,57,3.4
"46043",46,43,2013,1699,1645,54,3.2
"46043",46,43,2014,1720,1670,50,2.9
"46043",46,43,2015,1670,1629,41,2.5
"46043",46,43,2016,1668,1626,42,2.5
"46043",46,43,2017,1621,1573,48,3
"46045",46,45,1990,2124,2045,79,3.7
"46045",46,45,1991,2051,2007,44,2.1
"46045",46,45,1992,2071,2030,41,2
"46045",46,45,1993,2093,2058,35,1.7
"46045",46,45,1994,2155,2116,39,1.8
"46045",46,45,1995,2258,2222,36,1.6
"46045",46,45,1996,2284,2246,38,1.7
"46045",46,45,1997,2214,2175,39,1.8
"46045",46,45,1998,2240,2205,35,1.6
"46045",46,45,1999,2230,2188,42,1.9
"46045",46,45,2000,2139,2090,49,2.3
"46045",46,45,2001,2130,2069,61,2.9
"46045",46,45,2002,2101,2032,69,3.3
"46045",46,45,2003,2095,2026,69,3.3
"46045",46,45,2004,2079,2005,74,3.6
"46045",46,45,2005,2095,2026,69,3.3
"46045",46,45,2006,2073,2015,58,2.8
"46045",46,45,2007,2062,2010,52,2.5
"46045",46,45,2008,2072,2015,57,2.8
"46045",46,45,2009,2009,1939,70,3.5
"46045",46,45,2010,2383,2309,74,3.1
"46045",46,45,2011,2352,2274,78,3.3
"46045",46,45,2012,2305,2236,69,3
"46045",46,45,2013,2276,2212,64,2.8
"46045",46,45,2014,2227,2170,57,2.6
"46045",46,45,2015,2215,2160,55,2.5
"46045",46,45,2016,2158,2108,50,2.3
"46045",46,45,2017,2133,2073,60,2.8
"46047",46,47,1990,3280,3131,149,4.5
"46047",46,47,1991,3156,3003,153,4.8
"46047",46,47,1992,3339,3213,126,3.8
"46047",46,47,1993,3310,3187,123,3.7
"46047",46,47,1994,3539,3412,127,3.6
"46047",46,47,1995,3572,3479,93,2.6
"46047",46,47,1996,3614,3476,138,3.8
"46047",46,47,1997,3512,3383,129,3.7
"46047",46,47,1998,3445,3341,104,3
"46047",46,47,1999,3383,3257,126,3.7
"46047",46,47,2000,3537,3406,131,3.7
"46047",46,47,2001,3615,3473,142,3.9
"46047",46,47,2002,3703,3561,142,3.8
"46047",46,47,2003,3804,3626,178,4.7
"46047",46,47,2004,3842,3676,166,4.3
"46047",46,47,2005,3878,3720,158,4.1
"46047",46,47,2006,3794,3661,133,3.5
"46047",46,47,2007,3753,3632,121,3.2
"46047",46,47,2008,3758,3630,128,3.4
"46047",46,47,2009,3811,3582,229,6
"46047",46,47,2010,3262,3059,203,6.2
"46047",46,47,2011,3186,2995,191,6
"46047",46,47,2012,3121,2943,178,5.7
"46047",46,47,2013,3029,2877,152,5
"46047",46,47,2014,3001,2860,141,4.7
"46047",46,47,2015,2968,2836,132,4.4
"46047",46,47,2016,3017,2884,133,4.4
"46047",46,47,2017,2982,2858,124,4.2
"46049",46,49,1990,1248,1225,23,1.8
"46049",46,49,1991,1232,1206,26,2.1
"46049",46,49,1992,1227,1205,22,1.8
"46049",46,49,1993,1200,1171,29,2.4
"46049",46,49,1994,1218,1191,27,2.2
"46049",46,49,1995,1246,1214,32,2.6
"46049",46,49,1996,1234,1200,34,2.8
"46049",46,49,1997,1161,1137,24,2.1
"46049",46,49,1998,1172,1145,27,2.3
"46049",46,49,1999,1216,1189,27,2.2
"46049",46,49,2000,1285,1254,31,2.4
"46049",46,49,2001,1202,1168,34,2.8
"46049",46,49,2002,1180,1147,33,2.8
"46049",46,49,2003,1211,1172,39,3.2
"46049",46,49,2004,1182,1143,39,3.3
"46049",46,49,2005,1175,1131,44,3.7
"46049",46,49,2006,1144,1109,35,3.1
"46049",46,49,2007,1119,1084,35,3.1
"46049",46,49,2008,1145,1111,34,3
"46049",46,49,2009,1150,1110,40,3.5
"46049",46,49,2010,1174,1128,46,3.9
"46049",46,49,2011,1170,1121,49,4.2
"46049",46,49,2012,1144,1098,46,4
"46049",46,49,2013,1158,1120,38,3.3
"46049",46,49,2014,1139,1103,36,3.2
"46049",46,49,2015,1117,1088,29,2.6
"46049",46,49,2016,1112,1082,30,2.7
"46049",46,49,2017,1105,1070,35,3.2
"46051",46,51,1990,4141,3961,180,4.3
"46051",46,51,1991,4169,3971,198,4.7
"46051",46,51,1992,4206,3953,253,6
"46051",46,51,1993,4038,3835,203,5
"46051",46,51,1994,4150,3927,223,5.4
"46051",46,51,1995,4184,3988,196,4.7
"46051",46,51,1996,4282,4110,172,4
"46051",46,51,1997,4377,4215,162,3.7
"46051",46,51,1998,4347,4167,180,4.1
"46051",46,51,1999,4271,4112,159,3.7
"46051",46,51,2000,4148,4022,126,3
"46051",46,51,2001,4170,4014,156,3.7
"46051",46,51,2002,4247,4095,152,3.6
"46051",46,51,2003,4339,4161,178,4.1
"46051",46,51,2004,4196,4007,189,4.5
"46051",46,51,2005,4133,3946,187,4.5
"46051",46,51,2006,4233,4085,148,3.5
"46051",46,51,2007,4227,4085,142,3.4
"46051",46,51,2008,4260,4105,155,3.6
"46051",46,51,2009,4203,4004,199,4.7
"46051",46,51,2010,4797,4573,224,4.7
"46051",46,51,2011,4615,4393,222,4.8
"46051",46,51,2012,4516,4317,199,4.4
"46051",46,51,2013,4630,4436,194,4.2
"46051",46,51,2014,4682,4514,168,3.6
"46051",46,51,2015,4696,4557,139,3
"46051",46,51,2016,4449,4305,144,3.2
"46051",46,51,2017,4477,4317,160,3.6
"46053",46,53,1990,2446,2377,69,2.8
"46053",46,53,1991,2417,2361,56,2.3
"46053",46,53,1992,2458,2381,77,3.1
"46053",46,53,1993,2513,2420,93,3.7
"46053",46,53,1994,2618,2513,105,4
"46053",46,53,1995,2665,2567,98,3.7
"46053",46,53,1996,2629,2538,91,3.5
"46053",46,53,1997,2547,2475,72,2.8
"46053",46,53,1998,2542,2460,82,3.2
"46053",46,53,1999,2616,2509,107,4.1
"46053",46,53,2000,2432,2360,72,3
"46053",46,53,2001,2417,2333,84,3.5
"46053",46,53,2002,2503,2418,85,3.4
"46053",46,53,2003,2588,2505,83,3.2
"46053",46,53,2004,2523,2435,88,3.5
"46053",46,53,2005,2486,2391,95,3.8
"46053",46,53,2006,2368,2286,82,3.5
"46053",46,53,2007,2374,2298,76,3.2
"46053",46,53,2008,2368,2287,81,3.4
"46053",46,53,2009,2350,2253,97,4.1
"46053",46,53,2010,2181,2086,95,4.4
"46053",46,53,2011,2158,2059,99,4.6
"46053",46,53,2012,2130,2037,93,4.4
"46053",46,53,2013,2093,2011,82,3.9
"46053",46,53,2014,2069,1998,71,3.4
"46053",46,53,2015,2053,1988,65,3.2
"46053",46,53,2016,2071,2009,62,3
"46053",46,53,2017,2025,1953,72,3.6
"46055",46,55,1990,1182,1150,32,2.7
"46055",46,55,1991,1154,1114,40,3.5
"46055",46,55,1992,1154,1111,43,3.7
"46055",46,55,1993,1162,1111,51,4.4
"46055",46,55,1994,1194,1144,50,4.2
"46055",46,55,1995,1215,1173,42,3.5
"46055",46,55,1996,1180,1138,42,3.6
"46055",46,55,1997,1153,1111,42,3.6
"46055",46,55,1998,1100,1063,37,3.4
"46055",46,55,1999,1130,1095,35,3.1
"46055",46,55,2000,1264,1242,22,1.7
"46055",46,55,2001,1231,1204,27,2.2
"46055",46,55,2002,1259,1231,28,2.2
"46055",46,55,2003,1269,1238,31,2.4
"46055",46,55,2004,1242,1209,33,2.7
"46055",46,55,2005,1196,1156,40,3.3
"46055",46,55,2006,1169,1138,31,2.7
"46055",46,55,2007,1166,1137,29,2.5
"46055",46,55,2008,1160,1130,30,2.6
"46055",46,55,2009,1168,1125,43,3.7
"46055",46,55,2010,1123,1085,38,3.4
"46055",46,55,2011,1109,1068,41,3.7
"46055",46,55,2012,1097,1062,35,3.2
"46055",46,55,2013,1077,1046,31,2.9
"46055",46,55,2014,1085,1056,29,2.7
"46055",46,55,2015,1095,1070,25,2.3
"46055",46,55,2016,1103,1076,27,2.4
"46055",46,55,2017,1086,1055,31,2.9
"46057",46,57,1990,2171,2086,85,3.9
"46057",46,57,1991,2160,2077,83,3.8
"46057",46,57,1992,2260,2166,94,4.2
"46057",46,57,1993,2310,2215,95,4.1
"46057",46,57,1994,2410,2325,85,3.5
"46057",46,57,1995,2509,2431,78,3.1
"46057",46,57,1996,2547,2461,86,3.4
"46057",46,57,1997,2577,2487,90,3.5
"46057",46,57,1998,2580,2512,68,2.6
"46057",46,57,1999,2595,2514,81,3.1
"46057",46,57,2000,2787,2717,70,2.5
"46057",46,57,2001,2805,2708,97,3.5
"46057",46,57,2002,2792,2696,96,3.4
"46057",46,57,2003,2818,2708,110,3.9
"46057",46,57,2004,2868,2756,112,3.9
"46057",46,57,2005,2931,2813,118,4
"46057",46,57,2006,2934,2841,93,3.2
"46057",46,57,2007,3003,2919,84,2.8
"46057",46,57,2008,3004,2904,100,3.3
"46057",46,57,2009,2970,2809,161,5.4
"46057",46,57,2010,3133,2976,157,5
"46057",46,57,2011,3094,2956,138,4.5
"46057",46,57,2012,3125,3002,123,3.9
"46057",46,57,2013,3106,2999,107,3.4
"46057",46,57,2014,3120,3012,108,3.5
"46057",46,57,2015,3128,3023,105,3.4
"46057",46,57,2016,3168,3061,107,3.4
"46057",46,57,2017,3163,3047,116,3.7
"46059",46,59,1990,2005,1967,38,1.9
"46059",46,59,1991,2031,1969,62,3.1
"46059",46,59,1992,2072,2008,64,3.1
"46059",46,59,1993,2123,2067,56,2.6
"46059",46,59,1994,2198,2142,56,2.5
"46059",46,59,1995,2218,2156,62,2.8
"46059",46,59,1996,2129,2076,53,2.5
"46059",46,59,1997,2047,1989,58,2.8
"46059",46,59,1998,2064,2012,52,2.5
"46059",46,59,1999,2075,2033,42,2
"46059",46,59,2000,2043,2002,41,2
"46059",46,59,2001,1969,1918,51,2.6
"46059",46,59,2002,1960,1903,57,2.9
"46059",46,59,2003,1963,1903,60,3.1
"46059",46,59,2004,1941,1880,61,3.1
"46059",46,59,2005,1916,1855,61,3.2
"46059",46,59,2006,1892,1839,53,2.8
"46059",46,59,2007,1873,1822,51,2.7
"46059",46,59,2008,1891,1841,50,2.6
"46059",46,59,2009,1929,1869,60,3.1
"46059",46,59,2010,1903,1841,62,3.3
"46059",46,59,2011,1861,1799,62,3.3
"46059",46,59,2012,1832,1776,56,3.1
"46059",46,59,2013,1821,1771,50,2.7
"46059",46,59,2014,1823,1776,47,2.6
"46059",46,59,2015,1870,1827,43,2.3
"46059",46,59,2016,1827,1788,39,2.1
"46059",46,59,2017,1823,1777,46,2.5
"46061",46,61,1990,1536,1495,41,2.7
"46061",46,61,1991,1506,1473,33,2.2
"46061",46,61,1992,1513,1478,35,2.3
"46061",46,61,1993,1535,1489,46,3
"46061",46,61,1994,1570,1533,37,2.4
"46061",46,61,1995,1648,1603,45,2.7
"46061",46,61,1996,1585,1539,46,2.9
"46061",46,61,1997,1629,1588,41,2.5
"46061",46,61,1998,1733,1695,38,2.2
"46061",46,61,1999,1768,1728,40,2.3
"46061",46,61,2000,1589,1556,33,2.1
"46061",46,61,2001,1736,1691,45,2.6
"46061",46,61,2002,1774,1728,46,2.6
"46061",46,61,2003,1842,1783,59,3.2
"46061",46,61,2004,1962,1899,63,3.2
"46061",46,61,2005,2019,1950,69,3.4
"46061",46,61,2006,1927,1870,57,3
"46061",46,61,2007,1977,1918,59,3
"46061",46,61,2008,1980,1919,61,3.1
"46061",46,61,2009,1921,1835,86,4.5
"46061",46,61,2010,1768,1675,93,5.3
"46061",46,61,2011,1799,1712,87,4.8
"46061",46,61,2012,1809,1725,84,4.6
"46061",46,61,2013,1799,1724,75,4.2
"46061",46,61,2014,1804,1741,63,3.5
"46061",46,61,2015,1795,1735,60,3.3
"46061",46,61,2016,1765,1705,60,3.4
"46061",46,61,2017,1742,1671,71,4.1
"46063",46,63,1990,863,841,22,2.5
"46063",46,63,1991,797,775,22,2.8
"46063",46,63,1992,856,817,39,4.6
"46063",46,63,1993,776,744,32,4.1
"46063",46,63,1994,835,800,35,4.2
"46063",46,63,1995,845,814,31,3.7
"46063",46,63,1996,835,802,33,4
"46063",46,63,1997,787,765,22,2.8
"46063",46,63,1998,760,737,23,3
"46063",46,63,1999,773,744,29,3.8
"46063",46,63,2000,764,744,20,2.6
"46063",46,63,2001,763,743,20,2.6
"46063",46,63,2002,795,775,20,2.5
"46063",46,63,2003,820,796,24,2.9
"46063",46,63,2004,812,786,26,3.2
"46063",46,63,2005,810,782,28,3.5
"46063",46,63,2006,763,741,22,2.9
"46063",46,63,2007,748,729,19,2.5
"46063",46,63,2008,785,764,21,2.7
"46063",46,63,2009,797,772,25,3.1
"46063",46,63,2010,796,768,28,3.5
"46063",46,63,2011,820,787,33,4
"46063",46,63,2012,807,777,30,3.7
"46063",46,63,2013,771,749,22,2.9
"46063",46,63,2014,772,754,18,2.3
"46063",46,63,2015,778,759,19,2.4
"46063",46,63,2016,759,737,22,2.9
"46063",46,63,2017,731,707,24,3.3
"46065",46,65,1990,8375,8156,219,2.6
"46065",46,65,1991,8480,8243,237,2.8
"46065",46,65,1992,8996,8760,236,2.6
"46065",46,65,1993,9482,9224,258,2.7
"46065",46,65,1994,9821,9563,258,2.6
"46065",46,65,1995,9663,9400,263,2.7
"46065",46,65,1996,9584,9321,263,2.7
"46065",46,65,1997,9614,9374,240,2.5
"46065",46,65,1998,9758,9545,213,2.2
"46065",46,65,1999,10114,9907,207,2
"46065",46,65,2000,9637,9450,187,1.9
"46065",46,65,2001,9792,9565,227,2.3
"46065",46,65,2002,9833,9607,226,2.3
"46065",46,65,2003,9782,9519,263,2.7
"46065",46,65,2004,9864,9577,287,2.9
"46065",46,65,2005,10169,9854,315,3.1
"46065",46,65,2006,10471,10212,259,2.5
"46065",46,65,2007,10230,9992,238,2.3
"46065",46,65,2008,10322,10077,245,2.4
"46065",46,65,2009,10395,10059,336,3.2
"46065",46,65,2010,10050,9701,349,3.5
"46065",46,65,2011,9961,9598,363,3.6
"46065",46,65,2012,9916,9588,328,3.3
"46065",46,65,2013,9871,9584,287,2.9
"46065",46,65,2014,9940,9681,259,2.6
"46065",46,65,2015,9876,9638,238,2.4
"46065",46,65,2016,10043,9804,239,2.4
"46065",46,65,2017,10040,9760,280,2.8
"46067",46,67,1990,3847,3762,85,2.2
"46067",46,67,1991,3965,3872,93,2.3
"46067",46,67,1992,3928,3823,105,2.7
"46067",46,67,1993,3746,3657,89,2.4
"46067",46,67,1994,3860,3743,117,3
"46067",46,67,1995,3954,3833,121,3.1
"46067",46,67,1996,3920,3798,122,3.1
"46067",46,67,1997,3813,3718,95,2.5
"46067",46,67,1998,3856,3773,83,2.2
"46067",46,67,1999,3884,3787,97,2.5
"46067",46,67,2000,3973,3872,101,2.5
"46067",46,67,2001,3875,3751,124,3.2
"46067",46,67,2002,3892,3757,135,3.5
"46067",46,67,2003,3921,3775,146,3.7
"46067",46,67,2004,3873,3728,145,3.7
"46067",46,67,2005,3825,3671,154,4
"46067",46,67,2006,3671,3541,130,3.5
"46067",46,67,2007,3783,3669,114,3
"46067",46,67,2008,3757,3642,115,3.1
"46067",46,67,2009,3808,3649,159,4.2
"46067",46,67,2010,3804,3652,152,4
"46067",46,67,2011,3779,3634,145,3.8
"46067",46,67,2012,3712,3583,129,3.5
"46067",46,67,2013,3654,3535,119,3.3
"46067",46,67,2014,3649,3543,106,2.9
"46067",46,67,2015,3666,3575,91,2.5
"46067",46,67,2016,3642,3549,93,2.6
"46067",46,67,2017,3602,3489,113,3.1
"46069",46,69,1990,811,781,30,3.7
"46069",46,69,1991,794,775,19,2.4
"46069",46,69,1992,813,795,18,2.2
"46069",46,69,1993,763,740,23,3
"46069",46,69,1994,854,829,25,2.9
"46069",46,69,1995,899,862,37,4.1
"46069",46,69,1996,876,847,29,3.3
"46069",46,69,1997,872,843,29,3.3
"46069",46,69,1998,918,891,27,2.9
"46069",46,69,1999,917,895,22,2.4
"46069",46,69,2000,853,832,21,2.5
"46069",46,69,2001,856,833,23,2.7
"46069",46,69,2002,807,784,23,2.9
"46069",46,69,2003,854,827,27,3.2
"46069",46,69,2004,833,803,30,3.6
"46069",46,69,2005,776,743,33,4.3
"46069",46,69,2006,771,744,27,3.5
"46069",46,69,2007,734,710,24,3.3
"46069",46,69,2008,738,717,21,2.8
"46069",46,69,2009,760,730,30,3.9
"46069",46,69,2010,795,765,30,3.8
"46069",46,69,2011,784,755,29,3.7
"46069",46,69,2012,765,738,27,3.5
"46069",46,69,2013,716,692,24,3.4
"46069",46,69,2014,710,690,20,2.8
"46069",46,69,2015,705,685,20,2.8
"46069",46,69,2016,697,678,19,2.7
"46069",46,69,2017,691,669,22,3.2
"46071",46,71,1990,1175,1106,69,5.9
"46071",46,71,1991,1190,1142,48,4
"46071",46,71,1992,1179,1130,49,4.2
"46071",46,71,1993,1038,974,64,6.2
"46071",46,71,1994,1070,1002,68,6.4
"46071",46,71,1995,1112,1046,66,5.9
"46071",46,71,1996,1107,1047,60,5.4
"46071",46,71,1997,1107,1048,59,5.3
"46071",46,71,1998,1113,1056,57,5.1
"46071",46,71,1999,1136,1069,67,5.9
"46071",46,71,2000,1155,1107,48,4.2
"46071",46,71,2001,1184,1129,55,4.6
"46071",46,71,2002,1219,1161,58,4.8
"46071",46,71,2003,1276,1206,70,5.5
"46071",46,71,2004,1277,1201,76,6
"46071",46,71,2005,1292,1210,82,6.3
"46071",46,71,2006,1287,1215,72,5.6
"46071",46,71,2007,1207,1143,64,5.3
"46071",46,71,2008,1226,1155,71,5.8
"46071",46,71,2009,1271,1183,88,6.9
"46071",46,71,2010,1393,1298,95,6.8
"46071",46,71,2011,1383,1279,104,7.5
"46071",46,71,2012,1340,1246,94,7
"46071",46,71,2013,1307,1226,81,6.2
"46071",46,71,2014,1332,1260,72,5.4
"46071",46,71,2015,1324,1267,57,4.3
"46071",46,71,2016,1302,1247,55,4.2
"46071",46,71,2017,1321,1244,77,5.8
"46073",46,73,1990,1093,1056,37,3.4
"46073",46,73,1991,1055,1027,28,2.7
"46073",46,73,1992,1050,1026,24,2.3
"46073",46,73,1993,1071,1033,38,3.5
"46073",46,73,1994,1103,1063,40,3.6
"46073",46,73,1995,1138,1100,38,3.3
"46073",46,73,1996,1139,1098,41,3.6
"46073",46,73,1997,1144,1102,42,3.7
"46073",46,73,1998,1151,1120,31,2.7
"46073",46,73,1999,1324,1294,30,2.3
"46073",46,73,2000,1235,1206,29,2.3
"46073",46,73,2001,1279,1241,38,3
"46073",46,73,2002,1233,1195,38,3.1
"46073",46,73,2003,1284,1245,39,3
"46073",46,73,2004,1384,1340,44,3.2
"46073",46,73,2005,1322,1276,46,3.5
"46073",46,73,2006,1343,1305,38,2.8
"46073",46,73,2007,1379,1346,33,2.4
"46073",46,73,2008,1435,1401,34,2.4
"46073",46,73,2009,1392,1349,43,3.1
"46073",46,73,2010,1198,1154,44,3.7
"46073",46,73,2011,1230,1186,44,3.6
"46073",46,73,2012,1216,1178,38,3.1
"46073",46,73,2013,1192,1155,37,3.1
"46073",46,73,2014,1196,1166,30,2.5
"46073",46,73,2015,1123,1098,25,2.2
"46073",46,73,2016,1068,1042,26,2.4
"46073",46,73,2017,1118,1091,27,2.4
"46075",46,75,1990,746,708,38,5.1
"46075",46,75,1991,754,721,33,4.4
"46075",46,75,1992,741,710,31,4.2
"46075",46,75,1993,767,736,31,4
"46075",46,75,1994,808,778,30,3.7
"46075",46,75,1995,824,796,28,3.4
"46075",46,75,1996,793,767,26,3.3
"46075",46,75,1997,791,762,29,3.7
"46075",46,75,1998,789,766,23,2.9
"46075",46,75,1999,833,811,22,2.6
"46075",46,75,2000,761,745,16,2.1
"46075",46,75,2001,730,715,15,2.1
"46075",46,75,2002,767,753,14,1.8
"46075",46,75,2003,812,797,15,1.8
"46075",46,75,2004,771,752,19,2.5
"46075",46,75,2005,730,709,21,2.9
"46075",46,75,2006,738,720,18,2.4
"46075",46,75,2007,702,687,15,2.1
"46075",46,75,2008,692,675,17,2.5
"46075",46,75,2009,724,701,23,3.2
"46075",46,75,2010,677,657,20,3
"46075",46,75,2011,671,649,22,3.3
"46075",46,75,2012,626,602,24,3.8
"46075",46,75,2013,618,596,22,3.6
"46075",46,75,2014,605,583,22,3.6
"46075",46,75,2015,583,566,17,2.9
"46075",46,75,2016,568,555,13,2.3
"46075",46,75,2017,562,545,17,3
"46077",46,77,1990,2683,2615,68,2.5
"46077",46,77,1991,2702,2635,67,2.5
"46077",46,77,1992,2700,2578,122,4.5
"46077",46,77,1993,2584,2487,97,3.8
"46077",46,77,1994,2569,2482,87,3.4
"46077",46,77,1995,2630,2534,96,3.7
"46077",46,77,1996,2675,2574,101,3.8
"46077",46,77,1997,2635,2541,94,3.6
"46077",46,77,1998,2696,2592,104,3.9
"46077",46,77,1999,2627,2511,116,4.4
"46077",46,77,2000,3038,2962,76,2.5
"46077",46,77,2001,3051,2955,96,3.1
"46077",46,77,2002,3133,3032,101,3.2
"46077",46,77,2003,3136,3021,115,3.7
"46077",46,77,2004,3136,3011,125,4
"46077",46,77,2005,3094,2973,121,3.9
"46077",46,77,2006,2963,2865,98,3.3
"46077",46,77,2007,2952,2868,84,2.8
"46077",46,77,2008,3011,2913,98,3.3
"46077",46,77,2009,2975,2816,159,5.3
"46077",46,77,2010,2868,2713,155,5.4
"46077",46,77,2011,2874,2747,127,4.4
"46077",46,77,2012,2971,2865,106,3.6
"46077",46,77,2013,2873,2780,93,3.2
"46077",46,77,2014,2877,2791,86,3
"46077",46,77,2015,2748,2667,81,2.9
"46077",46,77,2016,2734,2662,72,2.6
"46077",46,77,2017,2729,2642,87,3.2
"46079",46,79,1990,5502,5243,259,4.7
"46079",46,79,1991,5523,5340,183,3.3
"46079",46,79,1992,5535,5375,160,2.9
"46079",46,79,1993,5584,5385,199,3.6
"46079",46,79,1994,5795,5602,193,3.3
"46079",46,79,1995,5996,5847,149,2.5
"46079",46,79,1996,6069,5881,188,3.1
"46079",46,79,1997,6068,5931,137,2.3
"46079",46,79,1998,6230,6078,152,2.4
"46079",46,79,1999,6202,6050,152,2.5
"46079",46,79,2000,6549,6392,157,2.4
"46079",46,79,2001,6668,6474,194,2.9
"46079",46,79,2002,6751,6537,214,3.2
"46079",46,79,2003,6641,6392,249,3.7
"46079",46,79,2004,6648,6403,245,3.7
"46079",46,79,2005,6690,6437,253,3.8
"46079",46,79,2006,6728,6521,207,3.1
"46079",46,79,2007,6889,6690,199,2.9
"46079",46,79,2008,6815,6600,215,3.2
"46079",46,79,2009,6738,6308,430,6.4
"46079",46,79,2010,6158,5810,348,5.7
"46079",46,79,2011,6186,5879,307,5
"46079",46,79,2012,6263,5997,266,4.2
"46079",46,79,2013,6293,6050,243,3.9
"46079",46,79,2014,6310,6081,229,3.6
"46079",46,79,2015,6498,6262,236,3.6
"46079",46,79,2016,6444,6224,220,3.4
"46079",46,79,2017,6472,6219,253,3.9
"46081",46,81,1990,11435,10932,503,4.4
"46081",46,81,1991,12048,11660,388,3.2
"46081",46,81,1992,11924,11563,361,3
"46081",46,81,1993,11998,11623,375,3.1
"46081",46,81,1994,12016,11610,406,3.4
"46081",46,81,1995,12033,11626,407,3.4
"46081",46,81,1996,12063,11600,463,3.8
"46081",46,81,1997,11852,11447,405,3.4
"46081",46,81,1998,11346,10883,463,4.1
"46081",46,81,1999,10551,10167,384,3.6
"46081",46,81,2000,11538,11219,319,2.8
"46081",46,81,2001,11529,11159,370,3.2
"46081",46,81,2002,12334,11988,346,2.8
"46081",46,81,2003,12508,12094,414,3.3
"46081",46,81,2004,12588,12145,443,3.5
"46081",46,81,2005,12864,12406,458,3.6
"46081",46,81,2006,12952,12582,370,2.9
"46081",46,81,2007,13460,13119,341,2.5
"46081",46,81,2008,13543,13155,388,2.9
"46081",46,81,2009,13589,12997,592,4.4
"46081",46,81,2010,13155,12534,621,4.7
"46081",46,81,2011,12806,12188,618,4.8
"46081",46,81,2012,12642,12075,567,4.5
"46081",46,81,2013,12642,12144,498,3.9
"46081",46,81,2014,12612,12171,441,3.5
"46081",46,81,2015,12712,12296,416,3.3
"46081",46,81,2016,13036,12605,431,3.3
"46081",46,81,2017,12997,12565,432,3.3
"46083",46,83,1990,8378,8171,207,2.5
"46083",46,83,1991,8464,8285,179,2.1
"46083",46,83,1992,8359,8169,190,2.3
"46083",46,83,1993,9122,8940,182,2
"46083",46,83,1994,9517,9330,187,2
"46083",46,83,1995,10017,9853,164,1.6
"46083",46,83,1996,10418,10230,188,1.8
"46083",46,83,1997,11272,11105,167,1.5
"46083",46,83,1998,12242,12081,161,1.3
"46083",46,83,1999,13038,12847,191,1.5
"46083",46,83,2000,14508,14265,243,1.7
"46083",46,83,2001,15382,15049,333,2.2
"46083",46,83,2002,16319,15955,364,2.2
"46083",46,83,2003,17104,16670,434,2.5
"46083",46,83,2004,18364,17845,519,2.8
"46083",46,83,2005,19303,18733,570,3
"46083",46,83,2006,20344,19846,498,2.4
"46083",46,83,2007,21201,20723,478,2.3
"46083",46,83,2008,22120,21570,550,2.5
"46083",46,83,2009,22293,21327,966,4.3
"46083",46,83,2010,26317,25287,1030,3.9
"46083",46,83,2011,26932,25963,969,3.6
"46083",46,83,2012,27813,26913,900,3.2
"46083",46,83,2013,28507,27734,773,2.7
"46083",46,83,2014,29488,28771,717,2.4
"46083",46,83,2015,30397,29712,685,2.3
"46083",46,83,2016,31375,30695,680,2.2
"46083",46,83,2017,31959,31164,795,2.5
"46085",46,85,1990,1844,1767,77,4.2
"46085",46,85,1991,1887,1782,105,5.6
"46085",46,85,1992,2031,1956,75,3.7
"46085",46,85,1993,2251,2147,104,4.6
"46085",46,85,1994,2381,2271,110,4.6
"46085",46,85,1995,2429,2324,105,4.3
"46085",46,85,1996,2430,2327,103,4.2
"46085",46,85,1997,2415,2293,122,5.1
"46085",46,85,1998,2454,2343,111,4.5
"46085",46,85,1999,2481,2368,113,4.6
"46085",46,85,2000,1929,1852,77,4
"46085",46,85,2001,1950,1865,85,4.4
"46085",46,85,2002,2003,1917,86,4.3
"46085",46,85,2003,2021,1937,84,4.2
"46085",46,85,2004,2041,1942,99,4.9
"46085",46,85,2005,2009,1903,106,5.3
"46085",46,85,2006,2025,1936,89,4.4
"46085",46,85,2007,1971,1886,85,4.3
"46085",46,85,2008,1987,1897,90,4.5
"46085",46,85,2009,2020,1898,122,6
"46085",46,85,2010,1947,1821,126,6.5
"46085",46,85,2011,1905,1783,122,6.4
"46085",46,85,2012,1880,1768,112,6
"46085",46,85,2013,1854,1765,89,4.8
"46085",46,85,2014,1800,1723,77,4.3
"46085",46,85,2015,1790,1706,84,4.7
"46085",46,85,2016,1770,1688,82,4.6
"46085",46,85,2017,1746,1659,87,5
"46087",46,87,1990,2684,2604,80,3
"46087",46,87,1991,2697,2613,84,3.1
"46087",46,87,1992,2738,2638,100,3.7
"46087",46,87,1993,2535,2459,76,3
"46087",46,87,1994,2580,2505,75,2.9
"46087",46,87,1995,2575,2511,64,2.5
"46087",46,87,1996,2524,2462,62,2.5
"46087",46,87,1997,2475,2403,72,2.9
"46087",46,87,1998,2470,2400,70,2.8
"46087",46,87,1999,2513,2454,59,2.3
"46087",46,87,2000,2985,2921,64,2.1
"46087",46,87,2001,2984,2893,91,3
"46087",46,87,2002,2978,2882,96,3.2
"46087",46,87,2003,2962,2864,98,3.3
"46087",46,87,2004,2968,2867,101,3.4
"46087",46,87,2005,2962,2860,102,3.4
"46087",46,87,2006,2922,2832,90,3.1
"46087",46,87,2007,2789,2713,76,2.7
"46087",46,87,2008,2744,2647,97,3.5
"46087",46,87,2009,2642,2499,143,5.4
"46087",46,87,2010,3241,3081,160,4.9
"46087",46,87,2011,3178,3037,141,4.4
"46087",46,87,2012,3169,3049,120,3.8
"46087",46,87,2013,3162,3060,102,3.2
"46087",46,87,2014,3150,3065,85,2.7
"46087",46,87,2015,3126,3051,75,2.4
"46087",46,87,2016,3127,3049,78,2.5
"46087",46,87,2017,3151,3063,88,2.8
"46089",46,89,1990,1470,1423,47,3.2
"46089",46,89,1991,1446,1412,34,2.4
"46089",46,89,1992,1479,1449,30,2
"46089",46,89,1993,1396,1368,28,2
"46089",46,89,1994,1452,1421,31,2.1
"46089",46,89,1995,1443,1397,46,3.2
"46089",46,89,1996,1369,1311,58,4.2
"46089",46,89,1997,1278,1247,31,2.4
"46089",46,89,1998,1258,1232,26,2.1
"46089",46,89,1999,1303,1272,31,2.4
"46089",46,89,2000,1329,1292,37,2.8
"46089",46,89,2001,1285,1241,44,3.4
"46089",46,89,2002,1300,1259,41,3.2
"46089",46,89,2003,1276,1213,63,4.9
"46089",46,89,2004,1256,1198,58,4.6
"46089",46,89,2005,1225,1172,53,4.3
"46089",46,89,2006,1198,1148,50,4.2
"46089",46,89,2007,1130,1083,47,4.2
"46089",46,89,2008,1117,1070,47,4.2
"46089",46,89,2009,1164,1102,62,5.3
"46089",46,89,2010,1207,1148,59,4.9
"46089",46,89,2011,1162,1110,52,4.5
"46089",46,89,2012,1144,1091,53,4.6
"46089",46,89,2013,1131,1088,43,3.8
"46089",46,89,2014,1125,1081,44,3.9
"46089",46,89,2015,1111,1074,37,3.3
"46089",46,89,2016,1086,1049,37,3.4
"46089",46,89,2017,1044,1007,37,3.5
"46091",46,91,1990,2177,2080,97,4.5
"46091",46,91,1991,2158,2094,64,3
"46091",46,91,1992,2171,2101,70,3.2
"46091",46,91,1993,2240,2174,66,2.9
"46091",46,91,1994,2380,2297,83,3.5
"46091",46,91,1995,2370,2293,77,3.2
"46091",46,91,1996,2298,2218,80,3.5
"46091",46,91,1997,2249,2181,68,3
"46091",46,91,1998,2269,2178,91,4
"46091",46,91,1999,2310,2177,133,5.8
"46091",46,91,2000,2226,2146,80,3.6
"46091",46,91,2001,2093,1981,112,5.4
"46091",46,91,2002,2031,1912,119,5.9
"46091",46,91,2003,2117,2008,109,5.1
"46091",46,91,2004,2111,2004,107,5.1
"46091",46,91,2005,2120,2018,102,4.8
"46091",46,91,2006,2153,2062,91,4.2
"46091",46,91,2007,2070,1983,87,4.2
"46091",46,91,2008,2109,2017,92,4.4
"46091",46,91,2009,2107,1967,140,6.6
"46091",46,91,2010,2467,2334,133,5.4
"46091",46,91,2011,2496,2356,140,5.6
"46091",46,91,2012,2499,2379,120,4.8
"46091",46,91,2013,2535,2423,112,4.4
"46091",46,91,2014,2520,2416,104,4.1
"46091",46,91,2015,2498,2402,96,3.8
"46091",46,91,2016,2455,2360,95,3.9
"46091",46,91,2017,2386,2276,110,4.6
"46093",46,93,1990,9555,9214,341,3.6
"46093",46,93,1991,10352,9938,414,4
"46093",46,93,1992,10255,9863,392,3.8
"46093",46,93,1993,11533,11099,434,3.8
"46093",46,93,1994,11758,11324,434,3.7
"46093",46,93,1995,12114,11708,406,3.4
"46093",46,93,1996,12250,11812,438,3.6
"46093",46,93,1997,12235,11861,374,3.1
"46093",46,93,1998,12426,12063,363,2.9
"46093",46,93,1999,13644,13277,367,2.7
"46093",46,93,2000,12264,11978,286,2.3
"46093",46,93,2001,12361,12007,354,2.9
"46093",46,93,2002,12538,12179,359,2.9
"46093",46,93,2003,12626,12203,423,3.4
"46093",46,93,2004,12751,12290,461,3.6
"46093",46,93,2005,12738,12259,479,3.8
"46093",46,93,2006,12630,12227,403,3.2
"46093",46,93,2007,12470,12118,352,2.8
"46093",46,93,2008,12383,11996,387,3.1
"46093",46,93,2009,12074,11470,604,5
"46093",46,93,2010,13148,12457,691,5.3
"46093",46,93,2011,13076,12441,635,4.9
"46093",46,93,2012,13173,12595,578,4.4
"46093",46,93,2013,13518,13004,514,3.8
"46093",46,93,2014,13261,12815,446,3.4
"46093",46,93,2015,13312,12890,422,3.2
"46093",46,93,2016,13649,13218,431,3.2
"46093",46,93,2017,13898,13418,480,3.5
"46095",46,95,1990,793,743,50,6.3
"46095",46,95,1991,758,715,43,5.7
"46095",46,95,1992,800,753,47,5.9
"46095",46,95,1993,787,733,54,6.9
"46095",46,95,1994,801,734,67,8.4
"46095",46,95,1995,782,739,43,5.5
"46095",46,95,1996,780,724,56,7.2
"46095",46,95,1997,727,671,56,7.7
"46095",46,95,1998,698,650,48,6.9
"46095",46,95,1999,756,706,50,6.6
"46095",46,95,2000,857,825,32,3.7
"46095",46,95,2001,931,893,38,4.1
"46095",46,95,2002,921,880,41,4.5
"46095",46,95,2003,952,903,49,5.1
"46095",46,95,2004,925,869,56,6.1
"46095",46,95,2005,909,856,53,5.8
"46095",46,95,2006,953,910,43,4.5
"46095",46,95,2007,887,848,39,4.4
"46095",46,95,2008,881,842,39,4.4
"46095",46,95,2009,875,813,62,7.1
"46095",46,95,2010,872,817,55,6.3
"46095",46,95,2011,862,807,55,6.4
"46095",46,95,2012,856,789,67,7.8
"46095",46,95,2013,831,768,63,7.6
"46095",46,95,2014,824,774,50,6.1
"46095",46,95,2015,796,755,41,5.2
"46095",46,95,2016,768,736,32,4.2
"46095",46,95,2017,758,720,38,5
"46097",46,97,1990,1563,1522,41,2.6
"46097",46,97,1991,1509,1475,34,2.3
"46097",46,97,1992,1427,1360,67,4.7
"46097",46,97,1993,1365,1294,71,5.2
"46097",46,97,1994,1416,1342,74,5.2
"46097",46,97,1995,1447,1377,70,4.8
"46097",46,97,1996,1381,1262,119,8.6
"46097",46,97,1997,1265,1222,43,3.4
"46097",46,97,1998,1269,1226,43,3.4
"46097",46,97,1999,1414,1365,49,3.5
"46097",46,97,2000,1498,1459,39,2.6
"46097",46,97,2001,1276,1216,60,4.7
"46097",46,97,2002,1204,1144,60,5
"46097",46,97,2003,1208,1150,58,4.8
"46097",46,97,2004,1222,1166,56,4.6
"46097",46,97,2005,1213,1154,59,4.9
"46097",46,97,2006,1177,1132,45,3.8
"46097",46,97,2007,1200,1158,42,3.5
"46097",46,97,2008,1253,1210,43,3.4
"46097",46,97,2009,1278,1210,68,5.3
"46097",46,97,2010,1371,1302,69,5
"46097",46,97,2011,1294,1236,58,4.5
"46097",46,97,2012,1260,1214,46,3.7
"46097",46,97,2013,1231,1186,45,3.7
"46097",46,97,2014,1237,1197,40,3.2
"46097",46,97,2015,1209,1180,29,2.4
"46097",46,97,2016,1198,1166,32,2.7
"46097",46,97,2017,1197,1161,36,3
"46099",46,99,1990,70679,68767,1912,2.7
"46099",46,99,1991,72562,70776,1786,2.5
"46099",46,99,1992,71605,69863,1742,2.4
"46099",46,99,1993,76664,74873,1791,2.3
"46099",46,99,1994,78988,77122,1866,2.4
"46099",46,99,1995,81370,79620,1750,2.2
"46099",46,99,1996,83815,82043,1772,2.1
"46099",46,99,1997,86381,84720,1661,1.9
"46099",46,99,1998,88169,86662,1507,1.7
"46099",46,99,1999,90018,88504,1514,1.7
"46099",46,99,2000,88976,87261,1715,1.9
"46099",46,99,2001,89737,87520,2217,2.5
"46099",46,99,2002,90941,88471,2470,2.7
"46099",46,99,2003,91822,88953,2869,3.1
"46099",46,99,2004,92929,89663,3266,3.5
"46099",46,99,2005,93785,90545,3240,3.5
"46099",46,99,2006,95307,92676,2631,2.8
"46099",46,99,2007,99419,96929,2490,2.5
"46099",46,99,2008,100944,98082,2862,2.8
"46099",46,99,2009,100524,95455,5069,5
"46099",46,99,2010,99177,94240,4937,5
"46099",46,99,2011,99359,94899,4460,4.5
"46099",46,99,2012,100905,96904,4001,4
"46099",46,99,2013,102442,99051,3391,3.3
"46099",46,99,2014,104333,101185,3148,3
"46099",46,99,2015,106109,103238,2871,2.7
"46099",46,99,2016,107494,104721,2773,2.6
"46099",46,99,2017,109516,106400,3116,2.8
"46101",46,101,1990,3251,3105,146,4.5
"46101",46,101,1991,3500,3316,184,5.3
"46101",46,101,1992,3396,3202,194,5.7
"46101",46,101,1993,3306,3097,209,6.3
"46101",46,101,1994,3587,3375,212,5.9
"46101",46,101,1995,3692,3490,202,5.5
"46101",46,101,1996,3607,3433,174,4.8
"46101",46,101,1997,3518,3346,172,4.9
"46101",46,101,1998,3744,3566,178,4.8
"46101",46,101,1999,3680,3492,188,5.1
"46101",46,101,2000,3721,3585,136,3.7
"46101",46,101,2001,3826,3656,170,4.4
"46101",46,101,2002,3844,3671,173,4.5
"46101",46,101,2003,3872,3674,198,5.1
"46101",46,101,2004,3851,3650,201,5.2
"46101",46,101,2005,3905,3713,192,4.9
"46101",46,101,2006,4084,3921,163,4
"46101",46,101,2007,4060,3909,151,3.7
"46101",46,101,2008,4063,3889,174,4.3
"46101",46,101,2009,3955,3690,265,6.7
"46101",46,101,2010,4154,3863,291,7
"46101",46,101,2011,4124,3860,264,6.4
"46101",46,101,2012,4004,3785,219,5.5
"46101",46,101,2013,3986,3803,183,4.6
"46101",46,101,2014,3962,3799,163,4.1
"46101",46,101,2015,3936,3802,134,3.4
"46101",46,101,2016,3942,3797,145,3.7
"46101",46,101,2017,3983,3834,149,3.7
"46102",46,102,1990,2229,1916,313,14
"46102",46,102,1991,2273,1909,364,16
"46102",46,102,1992,2549,2171,378,14.8
"46102",46,102,1993,2864,2428,436,15.2
"46102",46,102,1994,3015,2543,472,15.7
"46102",46,102,1995,3138,2698,440,14
"46102",46,102,1996,3233,2750,483,14.9
"46102",46,102,1997,3259,2880,379,11.6
"46102",46,102,1998,3239,2837,402,12.4
"46102",46,102,1999,3270,2858,412,12.6
"46102",46,102,2000,2845,2603,242,8.5
"46102",46,102,2001,3666,3376,290,7.9
"46102",46,102,2002,3779,3504,275,7.3
"46102",46,102,2003,3922,3554,368,9.4
"46102",46,102,2004,3902,3543,359,9.2
"46102",46,102,2005,3963,3530,433,10.9
"46102",46,102,2006,4036,3705,331,8.2
"46102",46,102,2007,3798,3501,297,7.8
"46102",46,102,2008,3788,3469,319,8.4
"46102",46,102,2009,3995,3560,435,10.9
"46102",46,102,2010,3715,3234,481,12.9
"46102",46,102,2011,3726,3198,528,14.2
"46102",46,102,2012,3756,3221,535,14.2
"46102",46,102,2013,3664,3168,496,13.5
"46102",46,102,2014,3612,3131,481,13.3
"46102",46,102,2015,3580,3169,411,11.5
"46102",46,102,2016,3606,3217,389,10.8
"46102",46,102,2017,3586,3163,423,11.8
"46103",46,103,1990,39753,38461,1292,3.3
"46103",46,103,1991,40603,39117,1486,3.7
"46103",46,103,1992,41851,40471,1380,3.3
"46103",46,103,1993,42773,41248,1525,3.6
"46103",46,103,1994,44007,42521,1486,3.4
"46103",46,103,1995,44804,43411,1393,3.1
"46103",46,103,1996,45524,44040,1484,3.3
"46103",46,103,1997,46060,44701,1359,3
"46103",46,103,1998,47280,46091,1189,2.5
"46103",46,103,1999,47408,46277,1131,2.4
"46103",46,103,2000,48845,47743,1102,2.3
"46103",46,103,2001,49928,48474,1454,2.9
"46103",46,103,2002,50650,49139,1511,3
"46103",46,103,2003,51313,49644,1669,3.3
"46103",46,103,2004,52187,50372,1815,3.5
"46103",46,103,2005,52584,50686,1898,3.6
"46103",46,103,2006,52940,51377,1563,3
"46103",46,103,2007,54352,52890,1462,2.7
"46103",46,103,2008,55229,53608,1621,2.9
"46103",46,103,2009,55334,52622,2712,4.9
"46103",46,103,2010,52838,50081,2757,5.2
"46103",46,103,2011,52983,50421,2562,4.8
"46103",46,103,2012,53290,50948,2342,4.4
"46103",46,103,2013,53179,51108,2071,3.9
"46103",46,103,2014,53893,52048,1845,3.4
"46103",46,103,2015,54261,52547,1714,3.2
"46103",46,103,2016,54602,52912,1690,3.1
"46103",46,103,2017,55730,53838,1892,3.4
"46105",46,105,1990,2157,2103,54,2.5
"46105",46,105,1991,2078,2028,50,2.4
"46105",46,105,1992,2056,2005,51,2.5
"46105",46,105,1993,1996,1944,52,2.6
"46105",46,105,1994,2047,2001,46,2.2
"46105",46,105,1995,2036,1988,48,2.4
"46105",46,105,1996,2026,1962,64,3.2
"46105",46,105,1997,1935,1882,53,2.7
"46105",46,105,1998,1931,1875,56,2.9
"46105",46,105,1999,2016,1955,61,3
"46105",46,105,2000,1787,1743,44,2.5
"46105",46,105,2001,1781,1730,51,2.9
"46105",46,105,2002,1813,1758,55,3
"46105",46,105,2003,1797,1739,58,3.2
"46105",46,105,2004,1774,1706,68,3.8
"46105",46,105,2005,1735,1665,70,4
"46105",46,105,2006,1735,1683,52,3
"46105",46,105,2007,1646,1598,48,2.9
"46105",46,105,2008,1620,1570,50,3.1
"46105",46,105,2009,1635,1567,68,4.2
"46105",46,105,2010,1612,1545,67,4.2
"46105",46,105,2011,1569,1501,68,4.3
"46105",46,105,2012,1533,1472,61,4
"46105",46,105,2013,1531,1474,57,3.7
"46105",46,105,2014,1547,1495,52,3.4
"46105",46,105,2015,1573,1523,50,3.2
"46105",46,105,2016,1574,1529,45,2.9
"46105",46,105,2017,1618,1570,48,3
"46107",46,107,1990,1518,1477,41,2.7
"46107",46,107,1991,1482,1440,42,2.8
"46107",46,107,1992,1566,1501,65,4.2
"46107",46,107,1993,1473,1424,49,3.3
"46107",46,107,1994,1541,1476,65,4.2
"46107",46,107,1995,1535,1477,58,3.8
"46107",46,107,1996,1525,1471,54,3.5
"46107",46,107,1997,1462,1411,51,3.5
"46107",46,107,1998,1469,1422,47,3.2
"46107",46,107,1999,1467,1415,52,3.5
"46107",46,107,2000,1457,1418,39,2.7
"46107",46,107,2001,1426,1377,49,3.4
"46107",46,107,2002,1423,1377,46,3.2
"46107",46,107,2003,1422,1377,45,3.2
"46107",46,107,2004,1386,1335,51,3.7
"46107",46,107,2005,1366,1315,51,3.7
"46107",46,107,2006,1342,1301,41,3.1
"46107",46,107,2007,1306,1268,38,2.9
"46107",46,107,2008,1307,1267,40,3.1
"46107",46,107,2009,1313,1264,49,3.7
"46107",46,107,2010,1276,1214,62,4.9
"46107",46,107,2011,1237,1171,66,5.3
"46107",46,107,2012,1210,1161,49,4
"46107",46,107,2013,1199,1153,46,3.8
"46107",46,107,2014,1197,1157,40,3.3
"46107",46,107,2015,1180,1142,38,3.2
"46107",46,107,2016,1154,1123,31,2.7
"46107",46,107,2017,1139,1100,39,3.4
"46109",46,109,1990,4572,4303,269,5.9
"46109",46,109,1991,4542,4281,261,5.7
"46109",46,109,1992,4829,4566,263,5.4
"46109",46,109,1993,4697,4453,244,5.2
"46109",46,109,1994,4805,4549,256,5.3
"46109",46,109,1995,4865,4631,234,4.8
"46109",46,109,1996,4911,4663,248,5
"46109",46,109,1997,4768,4518,250,5.2
"46109",46,109,1998,4809,4543,266,5.5
"46109",46,109,1999,4845,4592,253,5.2
"46109",46,109,2000,4617,4442,175,3.8
"46109",46,109,2001,4524,4310,214,4.7
"46109",46,109,2002,4516,4296,220,4.9
"46109",46,109,2003,4625,4375,250,5.4
"46109",46,109,2004,4723,4473,250,5.3
"46109",46,109,2005,4806,4561,245,5.1
"46109",46,109,2006,4896,4685,211,4.3
"46109",46,109,2007,4878,4682,196,4
"46109",46,109,2008,4861,4658,203,4.2
"46109",46,109,2009,4801,4513,288,6
"46109",46,109,2010,5050,4757,293,5.8
"46109",46,109,2011,5030,4692,338,6.7
"46109",46,109,2012,4922,4640,282,5.7
"46109",46,109,2013,4823,4572,251,5.2
"46109",46,109,2014,4846,4612,234,4.8
"46109",46,109,2015,4856,4645,211,4.3
"46109",46,109,2016,4832,4631,201,4.2
"46109",46,109,2017,4812,4579,233,4.8
"46111",46,111,1990,1253,1231,22,1.8
"46111",46,111,1991,1249,1208,41,3.3
"46111",46,111,1992,1282,1248,34,2.7
"46111",46,111,1993,1362,1316,46,3.4
"46111",46,111,1994,1407,1361,46,3.3
"46111",46,111,1995,1459,1407,52,3.6
"46111",46,111,1996,1463,1398,65,4.4
"46111",46,111,1997,1458,1405,53,3.6
"46111",46,111,1998,1484,1438,46,3.1
"46111",46,111,1999,1510,1469,41,2.7
"46111",46,111,2000,1482,1447,35,2.4
"46111",46,111,2001,1497,1452,45,3
"46111",46,111,2002,1549,1507,42,2.7
"46111",46,111,2003,1565,1520,45,2.9
"46111",46,111,2004,1565,1512,53,3.4
"46111",46,111,2005,1594,1539,55,3.5
"46111",46,111,2006,1510,1466,44,2.9
"46111",46,111,2007,1471,1435,36,2.4
"46111",46,111,2008,1422,1384,38,2.7
"46111",46,111,2009,1412,1356,56,4
"46111",46,111,2010,1345,1289,56,4.2
"46111",46,111,2011,1332,1276,56,4.2
"46111",46,111,2012,1295,1250,45,3.5
"46111",46,111,2013,1288,1249,39,3
"46111",46,111,2014,1240,1209,31,2.5
"46111",46,111,2015,1224,1193,31,2.5
"46111",46,111,2016,1207,1171,36,3
"46111",46,111,2017,1164,1123,41,3.5
"46115",46,115,1990,3587,3493,94,2.6
"46115",46,115,1991,3510,3402,108,3.1
"46115",46,115,1992,3444,3340,104,3
"46115",46,115,1993,3391,3294,97,2.9
"46115",46,115,1994,3607,3497,110,3
"46115",46,115,1995,3617,3505,112,3.1
"46115",46,115,1996,3541,3447,94,2.7
"46115",46,115,1997,3511,3413,98,2.8
"46115",46,115,1998,3522,3397,125,3.5
"46115",46,115,1999,3592,3474,118,3.3
"46115",46,115,2000,3534,3428,106,3
"46115",46,115,2001,3351,3232,119,3.6
"46115",46,115,2002,3367,3249,118,3.5
"46115",46,115,2003,3405,3289,116,3.4
"46115",46,115,2004,3480,3352,128,3.7
"46115",46,115,2005,3494,3356,138,3.9
"46115",46,115,2006,3556,3444,112,3.1
"46115",46,115,2007,3393,3286,107,3.2
"46115",46,115,2008,3353,3242,111,3.3
"46115",46,115,2009,3472,3327,145,4.2
"46115",46,115,2010,3591,3456,135,3.8
"46115",46,115,2011,3486,3341,145,4.2
"46115",46,115,2012,3397,3258,139,4.1
"46115",46,115,2013,3327,3208,119,3.6
"46115",46,115,2014,3381,3262,119,3.5
"46115",46,115,2015,3310,3208,102,3.1
"46115",46,115,2016,3279,3177,102,3.1
"46115",46,115,2017,3227,3115,112,3.5
"46117",46,117,1990,1416,1354,62,4.4
"46117",46,117,1991,1419,1368,51,3.6
"46117",46,117,1992,1483,1429,54,3.6
"46117",46,117,1993,1584,1531,53,3.3
"46117",46,117,1994,1706,1646,60,3.5
"46117",46,117,1995,1784,1724,60,3.4
"46117",46,117,1996,1824,1763,61,3.3
"46117",46,117,1997,1842,1788,54,2.9
"46117",46,117,1998,1869,1822,47,2.5
"46117",46,117,1999,1900,1859,41,2.2
"46117",46,117,2000,1852,1818,34,1.8
"46117",46,117,2001,1879,1834,45,2.4
"46117",46,117,2002,1851,1808,43,2.3
"46117",46,117,2003,1851,1799,52,2.8
"46117",46,117,2004,1904,1851,53,2.8
"46117",46,117,2005,1937,1885,52,2.7
"46117",46,117,2006,1982,1936,46,2.3
"46117",46,117,2007,1927,1883,44,2.3
"46117",46,117,2008,1904,1857,47,2.5
"46117",46,117,2009,1950,1888,62,3.2
"46117",46,117,2010,1955,1881,74,3.8
"46117",46,117,2011,1915,1839,76,4
"46117",46,117,2012,1858,1802,56,3
"46117",46,117,2013,1851,1800,51,2.8
"46117",46,117,2014,1854,1806,48,2.6
"46117",46,117,2015,1831,1787,44,2.4
"46117",46,117,2016,1866,1821,45,2.4
"46117",46,117,2017,1863,1801,62,3.3
"46119",46,119,1990,889,868,21,2.4
"46119",46,119,1991,888,863,25,2.8
"46119",46,119,1992,901,871,30,3.3
"46119",46,119,1993,910,887,23,2.5
"46119",46,119,1994,934,904,30,3.2
"46119",46,119,1995,964,931,33,3.4
"46119",46,119,1996,931,893,38,4.1
"46119",46,119,1997,892,866,26,2.9
"46119",46,119,1998,871,845,26,3
"46119",46,119,1999,879,855,24,2.7
"46119",46,119,2000,913,893,20,2.2
"46119",46,119,2001,905,883,22,2.4
"46119",46,119,2002,977,957,20,2
"46119",46,119,2003,1021,999,22,2.2
"46119",46,119,2004,1022,997,25,2.4
"46119",46,119,2005,1018,988,30,2.9
"46119",46,119,2006,1018,994,24,2.4
"46119",46,119,2007,992,970,22,2.2
"46119",46,119,2008,1001,979,22,2.2
"46119",46,119,2009,1001,971,30,3
"46119",46,119,2010,886,854,32,3.6
"46119",46,119,2011,873,840,33,3.8
"46119",46,119,2012,880,853,27,3.1
"46119",46,119,2013,880,854,26,3
"46119",46,119,2014,882,857,25,2.8
"46119",46,119,2015,868,846,22,2.5
"46119",46,119,2016,858,838,20,2.3
"46119",46,119,2017,845,818,27,3.2
"46121",46,121,1990,2412,2161,251,10.4
"46121",46,121,1991,2382,2150,232,9.7
"46121",46,121,1992,2498,2284,214,8.6
"46121",46,121,1993,2464,2246,218,8.8
"46121",46,121,1994,2593,2315,278,10.7
"46121",46,121,1995,2720,2499,221,8.1
"46121",46,121,1996,2747,2507,240,8.7
"46121",46,121,1997,2761,2529,232,8.4
"46121",46,121,1998,2851,2632,219,7.7
"46121",46,121,1999,2953,2745,208,7
"46121",46,121,2000,2968,2837,131,4.4
"46121",46,121,2001,3332,3161,171,5.1
"46121",46,121,2002,3324,3141,183,5.5
"46121",46,121,2003,3420,3229,191,5.6
"46121",46,121,2004,3438,3231,207,6
"46121",46,121,2005,3477,3270,207,6
"46121",46,121,2006,3624,3426,198,5.5
"46121",46,121,2007,3428,3231,197,5.7
"46121",46,121,2008,3438,3219,219,6.4
"46121",46,121,2009,3561,3306,255,7.2
"46121",46,121,2010,3385,3126,259,7.7
"46121",46,121,2011,3369,3081,288,8.5
"46121",46,121,2012,3230,2917,313,9.7
"46121",46,121,2013,3175,2864,311,9.8
"46121",46,121,2014,3102,2832,270,8.7
"46121",46,121,2015,3044,2819,225,7.4
"46121",46,121,2016,3054,2856,198,6.5
"46121",46,121,2017,3168,2958,210,6.6
"46123",46,123,1990,3275,3180,95,2.9
"46123",46,123,1991,3294,3194,100,3
"46123",46,123,1992,3315,3217,98,3
"46123",46,123,1993,3316,3206,110,3.3
"46123",46,123,1994,3497,3384,113,3.2
"46123",46,123,1995,3651,3527,124,3.4
"46123",46,123,1996,3617,3506,111,3.1
"46123",46,123,1997,3512,3408,104,3
"46123",46,123,1998,3581,3483,98,2.7
"46123",46,123,1999,3571,3468,103,2.9
"46123",46,123,2000,3304,3217,87,2.6
"46123",46,123,2001,3219,3121,98,3
"46123",46,123,2002,3190,3065,125,3.9
"46123",46,123,2003,3268,3157,111,3.4
"46123",46,123,2004,3130,3019,111,3.5
"46123",46,123,2005,3104,2993,111,3.6
"46123",46,123,2006,3046,2947,99,3.3
"46123",46,123,2007,3007,2920,87,2.9
"46123",46,123,2008,2976,2887,89,3
"46123",46,123,2009,2965,2861,104,3.5
"46123",46,123,2010,3284,3165,119,3.6
"46123",46,123,2011,3245,3123,122,3.8
"46123",46,123,2012,3145,3028,117,3.7
"46123",46,123,2013,3087,2980,107,3.5
"46123",46,123,2014,3120,3020,100,3.2
"46123",46,123,2015,3075,2993,82,2.7
"46123",46,123,2016,3058,2989,69,2.3
"46123",46,123,2017,3016,2929,87,2.9
"46125",46,125,1990,4228,4129,99,2.3
"46125",46,125,1991,4021,3915,106,2.6
"46125",46,125,1992,3686,3576,110,3
"46125",46,125,1993,3780,3649,131,3.5
"46125",46,125,1994,4034,3898,136,3.4
"46125",46,125,1995,4217,4078,139,3.3
"46125",46,125,1996,4127,4004,123,3
"46125",46,125,1997,4117,4013,104,2.5
"46125",46,125,1998,4132,4035,97,2.3
"46125",46,125,1999,4238,4152,86,2
"46125",46,125,2000,4783,4678,105,2.2
"46125",46,125,2001,4720,4587,133,2.8
"46125",46,125,2002,4636,4505,131,2.8
"46125",46,125,2003,4622,4470,152,3.3
"46125",46,125,2004,4606,4430,176,3.8
"46125",46,125,2005,4514,4345,169,3.7
"46125",46,125,2006,4509,4370,139,3.1
"46125",46,125,2007,4305,4178,127,3
"46125",46,125,2008,4271,4130,141,3.3
"46125",46,125,2009,4085,3874,211,5.2
"46125",46,125,2010,4850,4629,221,4.6
"46125",46,125,2011,4812,4614,198,4.1
"46125",46,125,2012,4730,4565,165,3.5
"46125",46,125,2013,4707,4564,143,3
"46125",46,125,2014,4657,4521,136,2.9
"46125",46,125,2015,4627,4503,124,2.7
"46125",46,125,2016,4668,4537,131,2.8
"46125",46,125,2017,4706,4554,152,3.2
"46127",46,127,1990,3340,3088,252,7.5
"46127",46,127,1991,3476,3234,242,7
"46127",46,127,1992,6165,5904,261,4.2
"46127",46,127,1993,6248,5972,276,4.4
"46127",46,127,1994,6441,6190,251,3.9
"46127",46,127,1995,6782,6536,246,3.6
"46127",46,127,1996,7166,6889,277,3.9
"46127",46,127,1997,7159,6921,238,3.3
"46127",46,127,1998,7122,6900,222,3.1
"46127",46,127,1999,7267,7074,193,2.7
"46127",46,127,2000,7299,7122,177,2.4
"46127",46,127,2001,7435,7205,230,3.1
"46127",46,127,2002,7415,7131,284,3.8
"46127",46,127,2003,7475,7151,324,4.3
"46127",46,127,2004,7505,7154,351,4.7
"46127",46,127,2005,7546,7241,305,4
"46127",46,127,2006,7732,7479,253,3.3
"46127",46,127,2007,8207,7961,246,3
"46127",46,127,2008,8420,8130,290,3.4
"46127",46,127,2009,8544,8032,512,6
"46127",46,127,2010,7743,7295,448,5.8
"46127",46,127,2011,7644,7246,398,5.2
"46127",46,127,2012,7803,7432,371,4.8
"46127",46,127,2013,7860,7533,327,4.2
"46127",46,127,2014,7994,7697,297,3.7
"46127",46,127,2015,8014,7742,272,3.4
"46127",46,127,2016,8033,7781,252,3.1
"46127",46,127,2017,7926,7634,292,3.7
"46129",46,129,1990,3014,2917,97,3.2
"46129",46,129,1991,2936,2847,89,3
"46129",46,129,1992,2960,2873,87,2.9
"46129",46,129,1993,2915,2817,98,3.4
"46129",46,129,1994,3075,2958,117,3.8
"46129",46,129,1995,3132,3001,131,4.2
"46129",46,129,1996,3096,2979,117,3.8
"46129",46,129,1997,3053,2947,106,3.5
"46129",46,129,1998,3097,2990,107,3.5
"46129",46,129,1999,3150,3051,99,3.1
"46129",46,129,2000,2887,2791,96,3.3
"46129",46,129,2001,2858,2754,104,3.6
"46129",46,129,2002,2756,2650,106,3.8
"46129",46,129,2003,2749,2612,137,5
"46129",46,129,2004,2757,2609,148,5.4
"46129",46,129,2005,2718,2580,138,5.1
"46129",46,129,2006,2732,2621,111,4.1
"46129",46,129,2007,2714,2608,106,3.9
"46129",46,129,2008,2681,2565,116,4.3
"46129",46,129,2009,2720,2581,139,5.1
"46129",46,129,2010,2393,2229,164,6.9
"46129",46,129,2011,2360,2194,166,7
"46129",46,129,2012,2325,2182,143,6.2
"46129",46,129,2013,2350,2222,128,5.4
"46129",46,129,2014,2359,2232,127,5.4
"46129",46,129,2015,2264,2141,123,5.4
"46129",46,129,2016,2237,2122,115,5.1
"46129",46,129,2017,2237,2122,115,5.1
"46135",46,135,1990,9829,9632,197,2
"46135",46,135,1991,9814,9559,255,2.6
"46135",46,135,1992,10381,10181,200,1.9
"46135",46,135,1993,10179,9970,209,2.1
"46135",46,135,1994,10737,10548,189,1.8
"46135",46,135,1995,10946,10728,218,2
"46135",46,135,1996,10881,10632,249,2.3
"46135",46,135,1997,10990,10736,254,2.3
"46135",46,135,1998,11261,11006,255,2.3
"46135",46,135,1999,11415,11173,242,2.1
"46135",46,135,2000,11458,11207,251,2.2
"46135",46,135,2001,11511,11144,367,3.2
"46135",46,135,2002,11636,11278,358,3.1
"46135",46,135,2003,11654,11252,402,3.4
"46135",46,135,2004,11804,11395,409,3.5
"46135",46,135,2005,11941,11518,423,3.5
"46135",46,135,2006,11932,11577,355,3
"46135",46,135,2007,12299,11984,315,2.6
"46135",46,135,2008,12225,11882,343,2.8
"46135",46,135,2009,12022,11350,672,5.6
"46135",46,135,2010,11427,10868,559,4.9
"46135",46,135,2011,11411,10902,509,4.5
"46135",46,135,2012,11568,11142,426,3.7
"46135",46,135,2013,11480,11096,384,3.3
"46135",46,135,2014,11345,11002,343,3
"46135",46,135,2015,11577,11275,302,2.6
"46135",46,135,2016,11560,11262,298,2.6
"46135",46,135,2017,11541,11200,341,3
"46137",46,137,1990,726,666,60,8.3
"46137",46,137,1991,749,691,58,7.7
"46137",46,137,1992,782,734,48,6.1
"46137",46,137,1993,697,645,52,7.5
"46137",46,137,1994,714,659,55,7.7
"46137",46,137,1995,722,672,50,6.9
"46137",46,137,1996,707,661,46,6.5
"46137",46,137,1997,700,632,68,9.7
"46137",46,137,1998,688,607,81,11.8
"46137",46,137,1999,703,607,96,13.7
"46137",46,137,2000,754,697,57,7.6
"46137",46,137,2001,826,760,66,8
"46137",46,137,2002,874,819,55,6.3
"46137",46,137,2003,892,834,58,6.5
"46137",46,137,2004,941,874,67,7.1
"46137",46,137,2005,908,835,73,8
"46137",46,137,2006,942,887,55,5.8
"46137",46,137,2007,865,814,51,5.9
"46137",46,137,2008,846,796,50,5.9
"46137",46,137,2009,890,827,63,7.1
"46137",46,137,2010,1054,993,61,5.8
"46137",46,137,2011,1059,991,68,6.4
"46137",46,137,2012,1055,982,73,6.9
"46137",46,137,2013,1028,964,64,6.2
"46137",46,137,2014,1002,943,59,5.9
"46137",46,137,2015,982,932,50,5.1
"46137",46,137,2016,974,930,44,4.5
"46137",46,137,2017,960,910,50,5.2
"47001",47,1,1990,32830,31232,1598,4.9
"47001",47,1,1991,33190,31501,1689,5.1
"47001",47,1,1992,34646,32759,1887,5.4
"47001",47,1,1993,35437,33690,1747,4.9
"47001",47,1,1994,35895,34464,1431,4
"47001",47,1,1995,36352,34927,1425,3.9
"47001",47,1,1996,36394,34626,1768,4.9
"47001",47,1,1997,36410,34429,1981,5.4
"47001",47,1,1998,35719,34383,1336,3.7
"47001",47,1,1999,35966,34678,1288,3.6
"47001",47,1,2000,33715,32337,1378,4.1
"47001",47,1,2001,34416,32837,1579,4.6
"47001",47,1,2002,35157,33519,1638,4.7
"47001",47,1,2003,34964,33130,1834,5.2
"47001",47,1,2004,34442,32776,1666,4.8
"47001",47,1,2005,34488,32712,1776,5.1
"47001",47,1,2006,36060,34352,1708,4.7
"47001",47,1,2007,35887,34369,1518,4.2
"47001",47,1,2008,35784,33699,2085,5.8
"47001",47,1,2009,36055,32487,3568,9.9
"47001",47,1,2010,34926,31675,3251,9.3
"47001",47,1,2011,35172,32094,3078,8.8
"47001",47,1,2012,34512,31781,2731,7.9
"47001",47,1,2013,33670,31001,2669,7.9
"47001",47,1,2014,32927,30687,2240,6.8
"47001",47,1,2015,33228,31292,1936,5.8
"47001",47,1,2016,33675,32038,1637,4.9
"47001",47,1,2017,34175,32842,1333,3.9
"47003",47,3,1990,15349,14475,874,5.7
"47003",47,3,1991,15236,13911,1325,8.7
"47003",47,3,1992,15687,14524,1163,7.4
"47003",47,3,1993,16131,15165,966,6
"47003",47,3,1994,16796,15872,924,5.5
"47003",47,3,1995,17236,16169,1067,6.2
"47003",47,3,1996,17802,16739,1063,6
"47003",47,3,1997,17769,16702,1067,6
"47003",47,3,1998,18069,17092,977,5.4
"47003",47,3,1999,18088,17184,904,5
"47003",47,3,2000,19555,18677,878,4.5
"47003",47,3,2001,19860,18854,1006,5.1
"47003",47,3,2002,20238,19147,1091,5.4
"47003",47,3,2003,21003,19576,1427,6.8
"47003",47,3,2004,20881,19769,1112,5.3
"47003",47,3,2005,21415,20256,1159,5.4
"47003",47,3,2006,22353,21180,1173,5.2
"47003",47,3,2007,22991,21887,1104,4.8
"47003",47,3,2008,22479,20953,1526,6.8
"47003",47,3,2009,22424,19683,2741,12.2
"47003",47,3,2010,21082,18436,2646,12.6
"47003",47,3,2011,20906,18553,2353,11.3
"47003",47,3,2012,20297,18313,1984,9.8
"47003",47,3,2013,20010,18167,1843,9.2
"47003",47,3,2014,19391,17940,1451,7.5
"47003",47,3,2015,19375,18127,1248,6.4
"47003",47,3,2016,19825,18842,983,5
"47003",47,3,2017,20539,19735,804,3.9
"47005",47,5,1990,6706,6191,515,7.7
"47005",47,5,1991,7122,6438,684,9.6
"47005",47,5,1992,7079,6491,588,8.3
"47005",47,5,1993,7109,6519,590,8.3
"47005",47,5,1994,7246,6705,541,7.5
"47005",47,5,1995,7949,7397,552,6.9
"47005",47,5,1996,8137,7247,890,10.9
"47005",47,5,1997,8017,7355,662,8.3
"47005",47,5,1998,7530,6942,588,7.8
"47005",47,5,1999,7621,7005,616,8.1
"47005",47,5,2000,7303,6771,532,7.3
"47005",47,5,2001,7100,6597,503,7.1
"47005",47,5,2002,7072,6558,514,7.3
"47005",47,5,2003,7020,6347,673,9.6
"47005",47,5,2004,6795,6230,565,8.3
"47005",47,5,2005,6732,6175,557,8.3
"47005",47,5,2006,7007,6506,501,7.1
"47005",47,5,2007,7003,6576,427,6.1
"47005",47,5,2008,7056,6439,617,8.7
"47005",47,5,2009,7057,6075,982,13.9
"47005",47,5,2010,7200,6314,886,12.3
"47005",47,5,2011,7132,6319,813,11.4
"47005",47,5,2012,6963,6280,683,9.8
"47005",47,5,2013,6881,6207,674,9.8
"47005",47,5,2014,6690,6104,586,8.8
"47005",47,5,2015,6753,6235,518,7.7
"47005",47,5,2016,6739,6260,479,7.1
"47005",47,5,2017,6769,6405,364,5.4
"47007",47,7,1990,3846,3605,241,6.3
"47007",47,7,1991,3667,3272,395,10.8
"47007",47,7,1992,3447,3153,294,8.5
"47007",47,7,1993,3465,3207,258,7.4
"47007",47,7,1994,3636,3432,204,5.6
"47007",47,7,1995,3853,3662,191,5
"47007",47,7,1996,4048,3828,220,5.4
"47007",47,7,1997,4052,3831,221,5.5
"47007",47,7,1998,4111,3941,170,4.1
"47007",47,7,1999,3970,3833,137,3.5
"47007",47,7,2000,5093,4891,202,4
"47007",47,7,2001,4961,4723,238,4.8
"47007",47,7,2002,5159,4864,295,5.7
"47007",47,7,2003,5040,4663,377,7.5
"47007",47,7,2004,4743,4391,352,7.4
"47007",47,7,2005,4605,4243,362,7.9
"47007",47,7,2006,4908,4589,319,6.5
"47007",47,7,2007,4943,4657,286,5.8
"47007",47,7,2008,4921,4507,414,8.4
"47007",47,7,2009,4933,4241,692,14
"47007",47,7,2010,4470,3879,591,13.2
"47007",47,7,2011,4496,3989,507,11.3
"47007",47,7,2012,4309,3862,447,10.4
"47007",47,7,2013,4336,3882,454,10.5
"47007",47,7,2014,4267,3884,383,9
"47007",47,7,2015,4243,3906,337,7.9
"47007",47,7,2016,4322,4022,300,6.9
"47007",47,7,2017,4317,4064,253,5.9
"47009",47,9,1990,41692,39500,2192,5.3
"47009",47,9,1991,42919,40299,2620,6.1
"47009",47,9,1992,44836,42187,2649,5.9
"47009",47,9,1993,46907,44196,2711,5.8
"47009",47,9,1994,48302,45917,2385,4.9
"47009",47,9,1995,50209,47578,2631,5.2
"47009",47,9,1996,50266,48027,2239,4.5
"47009",47,9,1997,50542,48379,2163,4.3
"47009",47,9,1998,50894,49210,1684,3.3
"47009",47,9,1999,52243,50325,1918,3.7
"47009",47,9,2000,53818,51944,1874,3.5
"47009",47,9,2001,55827,53510,2317,4.2
"47009",47,9,2002,57735,55291,2444,4.2
"47009",47,9,2003,57948,55325,2623,4.5
"47009",47,9,2004,58069,55627,2442,4.2
"47009",47,9,2005,59009,56242,2767,4.7
"47009",47,9,2006,62168,59474,2694,4.3
"47009",47,9,2007,62908,60431,2477,3.9
"47009",47,9,2008,63417,59507,3910,6.2
"47009",47,9,2009,63735,57439,6296,9.9
"47009",47,9,2010,61408,55826,5582,9.1
"47009",47,9,2011,61745,56702,5043,8.2
"47009",47,9,2012,60433,56162,4271,7.1
"47009",47,9,2013,59248,55124,4124,7
"47009",47,9,2014,58590,55083,3507,6
"47009",47,9,2015,59428,56355,3073,5.2
"47009",47,9,2016,60843,58190,2653,4.4
"47009",47,9,2017,61819,59667,2152,3.5
"47011",47,11,1990,38748,36757,1991,5.1
"47011",47,11,1991,38697,35826,2871,7.4
"47011",47,11,1992,38245,35634,2611,6.8
"47011",47,11,1993,39128,36567,2561,6.5
"47011",47,11,1994,40812,38835,1977,4.8
"47011",47,11,1995,41883,39776,2107,5
"47011",47,11,1996,42602,40446,2156,5.1
"47011",47,11,1997,43341,41024,2317,5.3
"47011",47,11,1998,43785,42072,1713,3.9
"47011",47,11,1999,43712,42179,1533,3.5
"47011",47,11,2000,45225,43645,1580,3.5
"47011",47,11,2001,44935,43111,1824,4.1
"47011",47,11,2002,45475,43273,2202,4.8
"47011",47,11,2003,45614,43254,2360,5.2
"47011",47,11,2004,45787,43514,2273,5
"47011",47,11,2005,46242,43813,2429,5.3
"47011",47,11,2006,48448,46019,2429,5
"47011",47,11,2007,48328,46164,2164,4.5
"47011",47,11,2008,47543,44501,3042,6.4
"47011",47,11,2009,47675,43149,4526,9.5
"47011",47,11,2010,46448,42086,4362,9.4
"47011",47,11,2011,47447,43224,4223,8.9
"47011",47,11,2012,48773,45184,3589,7.4
"47011",47,11,2013,49460,45942,3518,7.1
"47011",47,11,2014,48961,45994,2967,6.1
"47011",47,11,2015,49352,46775,2577,5.2
"47011",47,11,2016,50128,47901,2227,4.4
"47011",47,11,2017,50172,48336,1836,3.7
"47013",47,13,1990,13742,12320,1422,10.3
"47013",47,13,1991,13795,11457,2338,16.9
"47013",47,13,1992,15171,13031,2140,14.1
"47013",47,13,1993,14348,12741,1607,11.2
"47013",47,13,1994,16148,14843,1305,8.1
"47013",47,13,1995,16592,15229,1363,8.2
"47013",47,13,1996,17395,15908,1487,8.5
"47013",47,13,1997,17239,15950,1289,7.5
"47013",47,13,1998,16993,15871,1122,6.6
"47013",47,13,1999,17251,15940,1311,7.6
"47013",47,13,2000,16015,15063,952,5.9
"47013",47,13,2001,16222,15227,995,6.1
"47013",47,13,2002,16516,15440,1076,6.5
"47013",47,13,2003,16635,15478,1157,7
"47013",47,13,2004,16757,15766,991,5.9
"47013",47,13,2005,16672,15680,992,6
"47013",47,13,2006,17017,15977,1040,6.1
"47013",47,13,2007,17046,16138,908,5.3
"47013",47,13,2008,16982,15663,1319,7.8
"47013",47,13,2009,16980,14742,2238,13.2
"47013",47,13,2010,16131,14115,2016,12.5
"47013",47,13,2011,16122,14233,1889,11.7
"47013",47,13,2012,15736,13996,1740,11.1
"47013",47,13,2013,15240,13551,1689,11.1
"47013",47,13,2014,14669,13300,1369,9.3
"47013",47,13,2015,14604,13448,1156,7.9
"47013",47,13,2016,14734,13717,1017,6.9
"47013",47,13,2017,14825,14066,759,5.1
"47015",47,15,1990,5419,5092,327,6
"47015",47,15,1991,5571,5221,350,6.3
"47015",47,15,1992,5452,5143,309,5.7
"47015",47,15,1993,5216,4879,337,6.5
"47015",47,15,1994,5073,4774,299,5.9
"47015",47,15,1995,5113,4835,278,5.4
"47015",47,15,1996,5023,4706,317,6.3
"47015",47,15,1997,4905,4554,351,7.2
"47015",47,15,1998,4950,4635,315,6.4
"47015",47,15,1999,5087,4866,221,4.3
"47015",47,15,2000,6346,6125,221,3.5
"47015",47,15,2001,6380,6125,255,4
"47015",47,15,2002,6387,6094,293,4.6
"47015",47,15,2003,6387,6066,321,5
"47015",47,15,2004,6309,6018,291,4.6
"47015",47,15,2005,6377,6042,335,5.3
"47015",47,15,2006,6622,6287,335,5.1
"47015",47,15,2007,6445,6133,312,4.8
"47015",47,15,2008,6592,6106,486,7.4
"47015",47,15,2009,6593,5802,791,12
"47015",47,15,2010,6082,5405,677,11.1
"47015",47,15,2011,6093,5465,628,10.3
"47015",47,15,2012,6029,5517,512,8.5
"47015",47,15,2013,5901,5435,466,7.9
"47015",47,15,2014,5765,5399,366,6.3
"47015",47,15,2015,5847,5509,338,5.8
"47015",47,15,2016,6022,5743,279,4.6
"47015",47,15,2017,6235,6014,221,3.5
"47017",47,17,1990,12865,11906,959,7.5
"47017",47,17,1991,12923,11848,1075,8.3
"47017",47,17,1992,13520,12495,1025,7.6
"47017",47,17,1993,13564,12703,861,6.3
"47017",47,17,1994,14309,13538,771,5.4
"47017",47,17,1995,14443,13528,915,6.3
"47017",47,17,1996,14254,12849,1405,9.9
"47017",47,17,1997,13746,12576,1170,8.5
"47017",47,17,1998,13250,12095,1155,8.7
"47017",47,17,1999,12767,11586,1181,9.3
"47017",47,17,2000,14186,13093,1093,7.7
"47017",47,17,2001,13891,12882,1009,7.3
"47017",47,17,2002,14025,12758,1267,9
"47017",47,17,2003,13941,12645,1296,9.3
"47017",47,17,2004,13671,12565,1106,8.1
"47017",47,17,2005,13549,12519,1030,7.6
"47017",47,17,2006,14083,13191,892,6.3
"47017",47,17,2007,13841,12969,872,6.3
"47017",47,17,2008,13776,12516,1260,9.1
"47017",47,17,2009,13754,11555,2199,16
"47017",47,17,2010,13837,11813,2024,14.6
"47017",47,17,2011,13684,12026,1658,12.1
"47017",47,17,2012,13384,11920,1464,10.9
"47017",47,17,2013,13104,11547,1557,11.9
"47017",47,17,2014,12447,11197,1250,10
"47017",47,17,2015,12164,11157,1007,8.3
"47017",47,17,2016,12022,11216,806,6.7
"47017",47,17,2017,12000,11381,619,5.2
"47019",47,19,1990,24018,22791,1227,5.1
"47019",47,19,1991,24406,22785,1621,6.6
"47019",47,19,1992,24875,23194,1681,6.8
"47019",47,19,1993,25201,23571,1630,6.5
"47019",47,19,1994,25871,24296,1575,6.1
"47019",47,19,1995,26203,24744,1459,5.6
"47019",47,19,1996,26389,24925,1464,5.5
"47019",47,19,1997,26755,24839,1916,7.2
"47019",47,19,1998,25977,24608,1369,5.3
"47019",47,19,1999,25989,24702,1287,5
"47019",47,19,2000,27559,26261,1298,4.7
"47019",47,19,2001,27653,26305,1348,4.9
"47019",47,19,2002,28096,26287,1809,6.4
"47019",47,19,2003,28813,26987,1826,6.3
"47019",47,19,2004,28722,27041,1681,5.9
"47019",47,19,2005,28740,27086,1654,5.8
"47019",47,19,2006,29617,28125,1492,5
"47019",47,19,2007,29725,28282,1443,4.9
"47019",47,19,2008,29716,27750,1966,6.6
"47019",47,19,2009,29418,26384,3034,10.3
"47019",47,19,2010,26226,23359,2867,10.9
"47019",47,19,2011,26279,23643,2636,10
"47019",47,19,2012,25500,23225,2275,8.9
"47019",47,19,2013,24769,22488,2281,9.2
"47019",47,19,2014,23722,21893,1829,7.7
"47019",47,19,2015,23492,21978,1514,6.4
"47019",47,19,2016,23672,22337,1335,5.6
"47019",47,19,2017,23911,22825,1086,4.5
"47021",47,21,1990,14046,13552,494,3.5
"47021",47,21,1991,14263,13545,718,5
"47021",47,21,1992,14618,13897,721,4.9
"47021",47,21,1993,15408,14872,536,3.5
"47021",47,21,1994,16492,16050,442,2.7
"47021",47,21,1995,17238,16807,431,2.5
"47021",47,21,1996,17891,17451,440,2.5
"47021",47,21,1997,18629,18128,501,2.7
"47021",47,21,1998,19360,18931,429,2.2
"47021",47,21,1999,20025,19590,435,2.2
"47021",47,21,2000,19473,18944,529,2.7
"47021",47,21,2001,19624,18975,649,3.3
"47021",47,21,2002,19866,19082,784,3.9
"47021",47,21,2003,19801,18960,841,4.2
"47021",47,21,2004,19924,19030,894,4.5
"47021",47,21,2005,20229,19344,885,4.4
"47021",47,21,2006,21032,20177,855,4.1
"47021",47,21,2007,20541,19754,787,3.8
"47021",47,21,2008,20388,19276,1112,5.5
"47021",47,21,2009,20388,18463,1925,9.4
"47021",47,21,2010,20210,18400,1810,9
"47021",47,21,2011,20332,18608,1724,8.5
"47021",47,21,2012,20176,18721,1455,7.2
"47021",47,21,2013,19932,18615,1317,6.6
"47021",47,21,2014,19726,18643,1083,5.5
"47021",47,21,2015,19834,18874,960,4.8
"47021",47,21,2016,20262,19458,804,4
"47021",47,21,2017,21003,20367,636,3
"47023",47,23,1990,5805,5456,349,6
"47023",47,23,1991,5838,5462,376,6.4
"47023",47,23,1992,5790,5461,329,5.7
"47023",47,23,1993,6499,6218,281,4.3
"47023",47,23,1994,7227,6867,360,5
"47023",47,23,1995,7452,7067,385,5.2
"47023",47,23,1996,7773,7335,438,5.6
"47023",47,23,1997,8059,7629,430,5.3
"47023",47,23,1998,8305,7962,343,4.1
"47023",47,23,1999,8488,8162,326,3.8
"47023",47,23,2000,7603,7298,305,4
"47023",47,23,2001,7506,7169,337,4.5
"47023",47,23,2002,7650,7172,478,6.2
"47023",47,23,2003,7422,6976,446,6
"47023",47,23,2004,7436,7017,419,5.6
"47023",47,23,2005,7533,7082,451,6
"47023",47,23,2006,7805,7382,423,5.4
"47023",47,23,2007,7918,7502,416,5.3
"47023",47,23,2008,7947,7394,553,7
"47023",47,23,2009,7861,6974,887,11.3
"47023",47,23,2010,8363,7529,834,10
"47023",47,23,2011,8531,7756,775,9.1
"47023",47,23,2012,8376,7720,656,7.8
"47023",47,23,2013,8264,7592,672,8.1
"47023",47,23,2014,8109,7559,550,6.8
"47023",47,23,2015,8211,7730,481,5.9
"47023",47,23,2016,8447,8027,420,5
"47023",47,23,2017,8526,8188,338,4
"47025",47,25,1990,10790,10006,784,7.3
"47025",47,25,1991,10342,9397,945,9.1
"47025",47,25,1992,11641,10897,744,6.4
"47025",47,25,1993,11732,11023,709,6
"47025",47,25,1994,13015,12381,634,4.9
"47025",47,25,1995,13041,12389,652,5
"47025",47,25,1996,13076,12410,666,5.1
"47025",47,25,1997,12703,12013,690,5.4
"47025",47,25,1998,12637,12047,590,4.7
"47025",47,25,1999,13421,12854,567,4.2
"47025",47,25,2000,12563,11947,616,4.9
"47025",47,25,2001,12473,11809,664,5.3
"47025",47,25,2002,12862,12150,712,5.5
"47025",47,25,2003,12888,12142,746,5.8
"47025",47,25,2004,12600,11913,687,5.5
"47025",47,25,2005,12912,12190,722,5.6
"47025",47,25,2006,13489,12757,732,5.4
"47025",47,25,2007,13246,12536,710,5.4
"47025",47,25,2008,13332,12331,1001,7.5
"47025",47,25,2009,13178,11588,1590,12.1
"47025",47,25,2010,13619,12149,1470,10.8
"47025",47,25,2011,13685,12173,1512,11
"47025",47,25,2012,13333,12019,1314,9.9
"47025",47,25,2013,13005,11608,1397,10.7
"47025",47,25,2014,12621,11531,1090,8.6
"47025",47,25,2015,12585,11677,908,7.2
"47025",47,25,2016,12731,11943,788,6.2
"47025",47,25,2017,12734,12132,602,4.7
"47027",47,27,1990,3389,3198,191,5.6
"47027",47,27,1991,3467,3231,236,6.8
"47027",47,27,1992,3561,3294,267,7.5
"47027",47,27,1993,3525,3263,262,7.4
"47027",47,27,1994,3865,3629,236,6.1
"47027",47,27,1995,3885,3603,282,7.3
"47027",47,27,1996,3795,3267,528,13.9
"47027",47,27,1997,3317,2414,903,27.2
"47027",47,27,1998,2727,2358,369,13.5
"47027",47,27,1999,2751,2429,322,11.7
"47027",47,27,2000,3688,3452,236,6.4
"47027",47,27,2001,3564,3320,244,6.8
"47027",47,27,2002,3796,3525,271,7.1
"47027",47,27,2003,3877,3535,342,8.8
"47027",47,27,2004,3605,3279,326,9
"47027",47,27,2005,3550,3140,410,11.5
"47027",47,27,2006,3655,3255,400,10.9
"47027",47,27,2007,3528,3248,280,7.9
"47027",47,27,2008,3482,3112,370,10.6
"47027",47,27,2009,3339,2849,490,14.7
"47027",47,27,2010,3312,2912,400,12.1
"47027",47,27,2011,3416,3054,362,10.6
"47027",47,27,2012,3321,2989,332,10
"47027",47,27,2013,3095,2762,333,10.8
"47027",47,27,2014,2983,2712,271,9.1
"47027",47,27,2015,2994,2729,265,8.9
"47027",47,27,2016,3042,2843,199,6.5
"47027",47,27,2017,3084,2928,156,5.1
"47029",47,29,1990,14016,12545,1471,10.5
"47029",47,29,1991,14207,12309,1898,13.4
"47029",47,29,1992,14860,12892,1968,13.2
"47029",47,29,1993,14926,13074,1852,12.4
"47029",47,29,1994,16847,14958,1889,11.2
"47029",47,29,1995,16980,15056,1924,11.3
"47029",47,29,1996,17032,15236,1796,10.5
"47029",47,29,1997,16757,15084,1673,10
"47029",47,29,1998,16641,15340,1301,7.8
"47029",47,29,1999,16843,15706,1137,6.8
"47029",47,29,2000,15531,14551,980,6.3
"47029",47,29,2001,15477,14324,1153,7.4
"47029",47,29,2002,15683,14504,1179,7.5
"47029",47,29,2003,15727,14383,1344,8.5
"47029",47,29,2004,15383,14162,1221,7.9
"47029",47,29,2005,15749,14533,1216,7.7
"47029",47,29,2006,16387,15193,1194,7.3
"47029",47,29,2007,16605,15563,1042,6.3
"47029",47,29,2008,16501,15052,1449,8.8
"47029",47,29,2009,16642,14316,2326,14
"47029",47,29,2010,15881,13717,2164,13.6
"47029",47,29,2011,15778,13699,2079,13.2
"47029",47,29,2012,15470,13697,1773,11.5
"47029",47,29,2013,14976,13342,1634,10.9
"47029",47,29,2014,14468,13162,1306,9
"47029",47,29,2015,14382,13266,1116,7.8
"47029",47,29,2016,14451,13540,911,6.3
"47029",47,29,2017,14619,13857,762,5.2
"47031",47,31,1990,18751,17759,992,5.3
"47031",47,31,1991,19166,17786,1380,7.2
"47031",47,31,1992,19510,18324,1186,6.1
"47031",47,31,1993,20256,19053,1203,5.9
"47031",47,31,1994,22089,20927,1162,5.3
"47031",47,31,1995,22558,21376,1182,5.2
"47031",47,31,1996,22564,21224,1340,5.9
"47031",47,31,1997,23117,21736,1381,6
"47031",47,31,1998,23131,21987,1144,4.9
"47031",47,31,1999,22966,21992,974,4.2
"47031",47,31,2000,23466,22547,919,3.9
"47031",47,31,2001,24126,23066,1060,4.4
"47031",47,31,2002,25140,23914,1226,4.9
"47031",47,31,2003,25657,24378,1279,5
"47031",47,31,2004,25167,23977,1190,4.7
"47031",47,31,2005,25210,23816,1394,5.5
"47031",47,31,2006,25939,24518,1421,5.5
"47031",47,31,2007,26001,24821,1180,4.5
"47031",47,31,2008,25724,24102,1622,6.3
"47031",47,31,2009,25541,22792,2749,10.8
"47031",47,31,2010,24263,21647,2616,10.8
"47031",47,31,2011,24717,22264,2453,9.9
"47031",47,31,2012,24650,22623,2027,8.2
"47031",47,31,2013,24434,22525,1909,7.8
"47031",47,31,2014,24334,22783,1551,6.4
"47031",47,31,2015,24249,22909,1340,5.5
"47031",47,31,2016,24453,23305,1148,4.7
"47031",47,31,2017,25035,24122,913,3.6
"47033",47,33,1990,6478,6141,337,5.2
"47033",47,33,1991,6724,6293,431,6.4
"47033",47,33,1992,7066,6613,453,6.4
"47033",47,33,1993,6903,6354,549,8
"47033",47,33,1994,7506,7069,437,5.8
"47033",47,33,1995,7631,7129,502,6.6
"47033",47,33,1996,7486,6967,519,6.9
"47033",47,33,1997,7269,6720,549,7.6
"47033",47,33,1998,7269,6799,470,6.5
"47033",47,33,1999,7451,7053,398,5.3
"47033",47,33,2000,6809,6494,315,4.6
"47033",47,33,2001,6721,6346,375,5.6
"47033",47,33,2002,7041,6542,499,7.1
"47033",47,33,2003,7017,6386,631,9
"47033",47,33,2004,6591,6081,510,7.7
"47033",47,33,2005,6390,5890,500,7.8
"47033",47,33,2006,6560,6109,451,6.9
"47033",47,33,2007,6596,6191,405,6.1
"47033",47,33,2008,6463,5887,576,8.9
"47033",47,33,2009,6523,5666,857,13.1
"47033",47,33,2010,7278,6434,844,11.6
"47033",47,33,2011,7327,6555,772,10.5
"47033",47,33,2012,7215,6554,661,9.2
"47033",47,33,2013,7009,6369,640,9.1
"47033",47,33,2014,6854,6329,525,7.7
"47033",47,33,2015,6811,6372,439,6.4
"47033",47,33,2016,6887,6527,360,5.2
"47033",47,33,2017,6959,6671,288,4.1
"47035",47,35,1990,15248,14165,1083,7.1
"47035",47,35,1991,15874,14406,1468,9.2
"47035",47,35,1992,16492,14997,1495,9.1
"47035",47,35,1993,16476,15041,1435,8.7
"47035",47,35,1994,18636,17313,1323,7.1
"47035",47,35,1995,18636,17306,1330,7.1
"47035",47,35,1996,19622,18345,1277,6.5
"47035",47,35,1997,20087,18723,1364,6.8
"47035",47,35,1998,20990,19770,1220,5.8
"47035",47,35,1999,21412,20400,1012,4.7
"47035",47,35,2000,20324,19333,991,4.9
"47035",47,35,2001,20836,19506,1330,6.4
"47035",47,35,2002,22381,21015,1366,6.1
"47035",47,35,2003,22696,21197,1499,6.6
"47035",47,35,2004,21739,20371,1368,6.3
"47035",47,35,2005,22228,20748,1480,6.7
"47035",47,35,2006,23393,21944,1449,6.2
"47035",47,35,2007,23213,21939,1274,5.5
"47035",47,35,2008,23188,21369,1819,7.8
"47035",47,35,2009,23041,20420,2621,11.4
"47035",47,35,2010,23083,20605,2478,10.7
"47035",47,35,2011,23832,21413,2419,10.2
"47035",47,35,2012,23834,21689,2145,9
"47035",47,35,2013,23433,21253,2180,9.3
"47035",47,35,2014,22983,21158,1825,7.9
"47035",47,35,2015,22892,21274,1618,7.1
"47035",47,35,2016,23563,22170,1393,5.9
"47035",47,35,2017,23574,22490,1084,4.6
"47037",47,37,1990,275139,265106,10033,3.6
"47037",47,37,1991,272808,259701,13107,4.8
"47037",47,37,1992,275249,261922,13327,4.8
"47037",47,37,1993,283381,272110,11271,4
"47037",47,37,1994,293196,284284,8912,3
"47037",47,37,1995,300906,291069,9837,3.3
"47037",47,37,1996,302957,293277,9680,3.2
"47037",47,37,1997,304932,294799,10133,3.3
"47037",47,37,1998,307550,299404,8146,2.6
"47037",47,37,1999,309337,300542,8795,2.8
"47037",47,37,2000,308521,298970,9551,3.1
"47037",47,37,2001,307002,296183,10819,3.5
"47037",47,37,2002,305801,292721,13080,4.3
"47037",47,37,2003,303542,289575,13967,4.6
"47037",47,37,2004,299979,286553,13426,4.5
"47037",47,37,2005,301917,288260,13657,4.5
"47037",47,37,2006,312437,299241,13196,4.2
"47037",47,37,2007,325361,312929,12432,3.8
"47037",47,37,2008,323870,306349,17521,5.4
"47037",47,37,2009,323043,294328,28715,8.9
"47037",47,37,2010,342404,314469,27935,8.2
"47037",47,37,2011,350092,323712,26380,7.5
"47037",47,37,2012,353385,331459,21926,6.2
"47037",47,37,2013,354139,333157,20982,5.9
"47037",47,37,2014,354598,336799,17799,5
"47037",47,37,2015,363536,347645,15891,4.4
"47037",47,37,2016,373946,360525,13421,3.6
"47037",47,37,2017,388112,377454,10658,2.7
"47039",47,39,1990,4817,4421,396,8.2
"47039",47,39,1991,4799,4201,598,12.5
"47039",47,39,1992,4812,4288,524,10.9
"47039",47,39,1993,4993,4618,375,7.5
"47039",47,39,1994,5748,5405,343,6
"47039",47,39,1995,5932,5452,480,8.1
"47039",47,39,1996,5942,5310,632,10.6
"47039",47,39,1997,6065,5548,517,8.5
"47039",47,39,1998,5737,5236,501,8.7
"47039",47,39,1999,5572,5177,395,7.1
"47039",47,39,2000,5660,5362,298,5.3
"47039",47,39,2001,5520,5137,383,6.9
"47039",47,39,2002,5552,5107,445,8
"47039",47,39,2003,5540,5083,457,8.2
"47039",47,39,2004,5428,5037,391,7.2
"47039",47,39,2005,5395,4974,421,7.8
"47039",47,39,2006,5580,5217,363,6.5
"47039",47,39,2007,5790,5467,323,5.6
"47039",47,39,2008,5674,5194,480,8.5
"47039",47,39,2009,5705,4942,763,13.4
"47039",47,39,2010,5299,4603,696,13.1
"47039",47,39,2011,5331,4711,620,11.6
"47039",47,39,2012,5214,4676,538,10.3
"47039",47,39,2013,5083,4542,541,10.6
"47039",47,39,2014,4772,4318,454,9.5
"47039",47,39,2015,4704,4334,370,7.9
"47039",47,39,2016,4660,4340,320,6.9
"47039",47,39,2017,4656,4414,242,5.2
"47041",47,41,1990,7310,6894,416,5.7
"47041",47,41,1991,7592,7038,554,7.3
"47041",47,41,1992,7604,7036,568,7.5
"47041",47,41,1993,7660,7105,555,7.2
"47041",47,41,1994,8326,7831,495,5.9
"47041",47,41,1995,8563,7933,630,7.4
"47041",47,41,1996,8681,8037,644,7.4
"47041",47,41,1997,8923,8340,583,6.5
"47041",47,41,1998,8275,7734,541,6.5
"47041",47,41,1999,8182,7687,495,6
"47041",47,41,2000,8572,8175,397,4.6
"47041",47,41,2001,8491,8046,445,5.2
"47041",47,41,2002,9208,8747,461,5
"47041",47,41,2003,9632,9150,482,5
"47041",47,41,2004,9635,9154,481,5
"47041",47,41,2005,9698,9135,563,5.8
"47041",47,41,2006,10350,9790,560,5.4
"47041",47,41,2007,10422,9959,463,4.4
"47041",47,41,2008,10170,9491,679,6.7
"47041",47,41,2009,10004,8912,1092,10.9
"47041",47,41,2010,8159,7206,953,11.7
"47041",47,41,2011,8223,7311,912,11.1
"47041",47,41,2012,8043,7272,771,9.6
"47041",47,41,2013,7703,6923,780,10.1
"47041",47,41,2014,7417,6811,606,8.2
"47041",47,41,2015,7354,6849,505,6.9
"47041",47,41,2016,7548,7129,419,5.6
"47041",47,41,2017,7732,7370,362,4.7
"47043",47,43,1990,17139,16155,984,5.7
"47043",47,43,1991,17221,16040,1181,6.9
"47043",47,43,1992,17417,16312,1105,6.3
"47043",47,43,1993,18016,17116,900,5
"47043",47,43,1994,18696,17999,697,3.7
"47043",47,43,1995,19507,18689,818,4.2
"47043",47,43,1996,20264,19359,905,4.5
"47043",47,43,1997,20904,19926,978,4.7
"47043",47,43,1998,21713,20972,741,3.4
"47043",47,43,1999,22245,21547,698,3.1
"47043",47,43,2000,22074,21296,778,3.5
"47043",47,43,2001,22233,21269,964,4.3
"47043",47,43,2002,22436,21354,1082,4.8
"47043",47,43,2003,22543,21411,1132,5
"47043",47,43,2004,22445,21293,1152,5.1
"47043",47,43,2005,22668,21544,1124,5
"47043",47,43,2006,23660,22566,1094,4.6
"47043",47,43,2007,23382,22410,972,4.2
"47043",47,43,2008,23577,21947,1630,6.9
"47043",47,43,2009,23523,20919,2604,11.1
"47043",47,43,2010,23958,21512,2446,10.2
"47043",47,43,2011,24323,22002,2321,9.5
"47043",47,43,2012,24197,22185,2012,8.3
"47043",47,43,2013,23788,21958,1830,7.7
"47043",47,43,2014,23467,21998,1469,6.3
"47043",47,43,2015,24053,22746,1307,5.4
"47043",47,43,2016,24787,23710,1077,4.3
"47043",47,43,2017,25674,24827,847,3.3
"47045",47,45,1990,16709,15821,888,5.3
"47045",47,45,1991,16653,15280,1373,8.2
"47045",47,45,1992,16775,15350,1425,8.5
"47045",47,45,1993,16709,15456,1253,7.5
"47045",47,45,1994,19305,18333,972,5
"47045",47,45,1995,18968,18002,966,5.1
"47045",47,45,1996,19453,18072,1381,7.1
"47045",47,45,1997,19046,17937,1109,5.8
"47045",47,45,1998,18494,17685,809,4.4
"47045",47,45,1999,18771,17887,884,4.7
"47045",47,45,2000,17958,17049,909,5.1
"47045",47,45,2001,17602,16459,1143,6.5
"47045",47,45,2002,17474,16268,1206,6.9
"47045",47,45,2003,17483,16275,1208,6.9
"47045",47,45,2004,17611,16569,1042,5.9
"47045",47,45,2005,17228,16172,1056,6.1
"47045",47,45,2006,17807,16782,1025,5.8
"47045",47,45,2007,17554,16685,869,5
"47045",47,45,2008,17602,16275,1327,7.5
"47045",47,45,2009,17589,15136,2453,13.9
"47045",47,45,2010,17828,15676,2152,12.1
"47045",47,45,2011,17698,15500,2198,12.4
"47045",47,45,2012,17486,15564,1922,11
"47045",47,45,2013,17060,15277,1783,10.5
"47045",47,45,2014,16514,15156,1358,8.2
"47045",47,45,2015,16635,15443,1192,7.2
"47045",47,45,2016,16366,15354,1012,6.2
"47045",47,45,2017,16132,15352,780,4.8
"47047",47,47,1990,11407,10631,776,6.8
"47047",47,47,1991,11244,10488,756,6.7
"47047",47,47,1992,11415,10453,962,8.4
"47047",47,47,1993,11438,10607,831,7.3
"47047",47,47,1994,11673,11082,591,5.1
"47047",47,47,1995,12249,11616,633,5.2
"47047",47,47,1996,12962,12343,619,4.8
"47047",47,47,1997,13760,12979,781,5.7
"47047",47,47,1998,14188,13616,572,4
"47047",47,47,1999,14718,14186,532,3.6
"47047",47,47,2000,13946,13329,617,4.4
"47047",47,47,2001,14575,13797,778,5.3
"47047",47,47,2002,14979,14074,905,6
"47047",47,47,2003,15317,14378,939,6.1
"47047",47,47,2004,15457,14492,965,6.2
"47047",47,47,2005,15955,14874,1081,6.8
"47047",47,47,2006,17274,16198,1076,6.2
"47047",47,47,2007,18005,16913,1092,6.1
"47047",47,47,2008,18173,16823,1350,7.4
"47047",47,47,2009,18209,16194,2015,11.1
"47047",47,47,2010,18830,16959,1871,9.9
"47047",47,47,2011,18773,16987,1786,9.5
"47047",47,47,2012,18417,16858,1559,8.5
"47047",47,47,2013,18128,16562,1566,8.6
"47047",47,47,2014,17738,16460,1278,7.2
"47047",47,47,2015,17840,16738,1102,6.2
"47047",47,47,2016,18284,17365,919,5
"47047",47,47,2017,18522,17785,737,4
"47049",47,49,1990,6288,5696,592,9.4
"47049",47,49,1991,6648,6009,639,9.6
"47049",47,49,1992,6971,6248,723,10.4
"47049",47,49,1993,7157,6424,733,10.2
"47049",47,49,1994,7502,6695,807,10.8
"47049",47,49,1995,7438,6642,796,10.7
"47049",47,49,1996,7384,6719,665,9
"47049",47,49,1997,7214,6512,702,9.7
"47049",47,49,1998,6809,6181,628,9.2
"47049",47,49,1999,6704,5997,707,10.5
"47049",47,49,2000,6841,6341,500,7.3
"47049",47,49,2001,6738,6159,579,8.6
"47049",47,49,2002,7047,6519,528,7.5
"47049",47,49,2003,7149,6582,567,7.9
"47049",47,49,2004,7182,6712,470,6.5
"47049",47,49,2005,7029,6532,497,7.1
"47049",47,49,2006,7689,7181,508,6.6
"47049",47,49,2007,7842,7348,494,6.3
"47049",47,49,2008,8049,7293,756,9.4
"47049",47,49,2009,7977,6908,1069,13.4
"47049",47,49,2010,7407,6489,918,12.4
"47049",47,49,2011,7504,6648,856,11.4
"47049",47,49,2012,7474,6746,728,9.7
"47049",47,49,2013,7410,6686,724,9.8
"47049",47,49,2014,7007,6413,594,8.5
"47049",47,49,2015,6990,6481,509,7.3
"47049",47,49,2016,7107,6670,437,6.1
"47049",47,49,2017,7132,6812,320,4.5
"47051",47,51,1990,15891,15073,818,5.1
"47051",47,51,1991,16014,15009,1005,6.3
"47051",47,51,1992,16338,15331,1007,6.2
"47051",47,51,1993,16793,15839,954,5.7
"47051",47,51,1994,18356,17397,959,5.2
"47051",47,51,1995,18577,17523,1054,5.7
"47051",47,51,1996,18609,17229,1380,7.4
"47051",47,51,1997,18561,17582,979,5.3
"47051",47,51,1998,18684,17819,865,4.6
"47051",47,51,1999,18536,17718,818,4.4
"47051",47,51,2000,18679,17965,714,3.8
"47051",47,51,2001,19185,18402,783,4.1
"47051",47,51,2002,19987,19035,952,4.8
"47051",47,51,2003,20400,19353,1047,5.1
"47051",47,51,2004,20044,19002,1042,5.2
"47051",47,51,2005,19828,18729,1099,5.5
"47051",47,51,2006,20309,19146,1163,5.7
"47051",47,51,2007,20283,19286,997,4.9
"47051",47,51,2008,19891,18567,1324,6.7
"47051",47,51,2009,19633,17490,2143,10.9
"47051",47,51,2010,19306,17357,1949,10.1
"47051",47,51,2011,19291,17486,1805,9.4
"47051",47,51,2012,19475,17961,1514,7.8
"47051",47,51,2013,19598,18177,1421,7.3
"47051",47,51,2014,19552,18354,1198,6.1
"47051",47,51,2015,19560,18546,1014,5.2
"47051",47,51,2016,19841,18880,961,4.8
"47051",47,51,2017,19907,19154,753,3.8
"47053",47,53,1990,21812,20113,1699,7.8
"47053",47,53,1991,21917,19966,1951,8.9
"47053",47,53,1992,21961,20166,1795,8.2
"47053",47,53,1993,22242,20646,1596,7.2
"47053",47,53,1994,23061,21829,1232,5.3
"47053",47,53,1995,23570,22140,1430,6.1
"47053",47,53,1996,23235,21035,2200,9.5
"47053",47,53,1997,22406,20727,1679,7.5
"47053",47,53,1998,22000,20667,1333,6.1
"47053",47,53,1999,21591,20236,1355,6.3
"47053",47,53,2000,23160,21946,1214,5.2
"47053",47,53,2001,22616,20900,1716,7.6
"47053",47,53,2002,22311,20592,1719,7.7
"47053",47,53,2003,22065,20157,1908,8.6
"47053",47,53,2004,21354,19638,1716,8
"47053",47,53,2005,20641,18886,1755,8.5
"47053",47,53,2006,21262,19623,1639,7.7
"47053",47,53,2007,21111,19654,1457,6.9
"47053",47,53,2008,21198,19190,2008,9.5
"47053",47,53,2009,21584,18415,3169,14.7
"47053",47,53,2010,23743,20890,2853,12
"47053",47,53,2011,23852,21129,2723,11.4
"47053",47,53,2012,22887,20532,2355,10.3
"47053",47,53,2013,22064,19629,2435,11
"47053",47,53,2014,21124,19241,1883,8.9
"47053",47,53,2015,20994,19447,1547,7.4
"47053",47,53,2016,21238,19997,1241,5.8
"47053",47,53,2017,21386,20410,976,4.6
"47055",47,55,1990,12474,11796,678,5.4
"47055",47,55,1991,13005,12041,964,7.4
"47055",47,55,1992,13097,12153,944,7.2
"47055",47,55,1993,13630,12964,666,4.9
"47055",47,55,1994,15012,14353,659,4.4
"47055",47,55,1995,16172,15393,779,4.8
"47055",47,55,1996,16187,15112,1075,6.6
"47055",47,55,1997,15674,14761,913,5.8
"47055",47,55,1998,15762,15111,651,4.1
"47055",47,55,1999,16526,15888,638,3.9
"47055",47,55,2000,14857,14221,636,4.3
"47055",47,55,2001,14827,13924,903,6.1
"47055",47,55,2002,14694,13598,1096,7.5
"47055",47,55,2003,14124,12832,1292,9.1
"47055",47,55,2004,13340,12379,961,7.2
"47055",47,55,2005,13273,12302,971,7.3
"47055",47,55,2006,13567,12597,970,7.1
"47055",47,55,2007,13464,12626,838,6.2
"47055",47,55,2008,13460,12381,1079,8
"47055",47,55,2009,13425,11420,2005,14.9
"47055",47,55,2010,14243,12525,1718,12.1
"47055",47,55,2011,14313,12886,1427,10
"47055",47,55,2012,14038,12856,1182,8.4
"47055",47,55,2013,14056,12906,1150,8.2
"47055",47,55,2014,14163,13299,864,6.1
"47055",47,55,2015,14528,13804,724,5
"47055",47,55,2016,15275,14662,613,4
"47055",47,55,2017,15600,15068,532,3.4
"47057",47,57,1990,7994,7462,532,6.7
"47057",47,57,1991,8215,7442,773,9.4
"47057",47,57,1992,8515,7864,651,7.6
"47057",47,57,1993,8655,7988,667,7.7
"47057",47,57,1994,9550,8948,602,6.3
"47057",47,57,1995,9762,9112,650,6.7
"47057",47,57,1996,9990,9397,593,5.9
"47057",47,57,1997,10030,9385,645,6.4
"47057",47,57,1998,10134,9624,510,5
"47057",47,57,1999,10391,9957,434,4.2
"47057",47,57,2000,9662,9232,430,4.5
"47057",47,57,2001,9756,9193,563,5.8
"47057",47,57,2002,10082,9331,751,7.4
"47057",47,57,2003,9945,9225,720,7.2
"47057",47,57,2004,9885,9296,589,6
"47057",47,57,2005,10042,9442,600,6
"47057",47,57,2006,10363,9749,614,5.9
"47057",47,57,2007,10219,9682,537,5.3
"47057",47,57,2008,10243,9428,815,8
"47057",47,57,2009,10120,8699,1421,14
"47057",47,57,2010,10040,8760,1280,12.7
"47057",47,57,2011,10004,8837,1167,11.7
"47057",47,57,2012,9686,8690,996,10.3
"47057",47,57,2013,9409,8468,941,10
"47057",47,57,2014,9175,8425,750,8.2
"47057",47,57,2015,9129,8523,606,6.6
"47057",47,57,2016,9286,8784,502,5.4
"47057",47,57,2017,9409,9014,395,4.2
"47059",47,59,1990,28718,26230,2488,8.7
"47059",47,59,1991,27366,24010,3356,12.3
"47059",47,59,1992,28221,24846,3375,12
"47059",47,59,1993,28170,25403,2767,9.8
"47059",47,59,1994,32748,30028,2720,8.3
"47059",47,59,1995,33642,30697,2945,8.8
"47059",47,59,1996,34625,31452,3173,9.2
"47059",47,59,1997,35352,32113,3239,9.2
"47059",47,59,1998,35177,32905,2272,6.5
"47059",47,59,1999,36348,34330,2018,5.6
"47059",47,59,2000,31531,29722,1809,5.7
"47059",47,59,2001,30879,28592,2287,7.4
"47059",47,59,2002,31448,29380,2068,6.6
"47059",47,59,2003,32236,29814,2422,7.5
"47059",47,59,2004,32050,29610,2440,7.6
"47059",47,59,2005,31971,29235,2736,8.6
"47059",47,59,2006,32963,30359,2604,7.9
"47059",47,59,2007,31718,29533,2185,6.9
"47059",47,59,2008,30265,27444,2821,9.3
"47059",47,59,2009,29907,25169,4738,15.8
"47059",47,59,2010,30986,27011,3975,12.8
"47059",47,59,2011,30708,27208,3500,11.4
"47059",47,59,2012,30080,27025,3055,10.2
"47059",47,59,2013,30354,27422,2932,9.7
"47059",47,59,2014,30031,27609,2422,8.1
"47059",47,59,2015,30559,28588,1971,6.4
"47059",47,59,2016,30875,29195,1680,5.4
"47059",47,59,2017,30828,29445,1383,4.5
"47061",47,61,1990,5374,4909,465,8.7
"47061",47,61,1991,5423,4771,652,12
"47061",47,61,1992,4976,4319,657,13.2
"47061",47,61,1993,4691,4142,549,11.7
"47061",47,61,1994,5573,5096,477,8.6
"47061",47,61,1995,5844,5318,526,9
"47061",47,61,1996,5894,5393,501,8.5
"47061",47,61,1997,5921,5406,515,8.7
"47061",47,61,1998,5625,5256,369,6.6
"47061",47,61,1999,5562,5240,322,5.8
"47061",47,61,2000,5648,5373,275,4.9
"47061",47,61,2001,5545,5234,311,5.6
"47061",47,61,2002,5766,5389,377,6.5
"47061",47,61,2003,5834,5472,362,6.2
"47061",47,61,2004,5728,5380,348,6.1
"47061",47,61,2005,5756,5323,433,7.5
"47061",47,61,2006,5941,5465,476,8
"47061",47,61,2007,5994,5639,355,5.9
"47061",47,61,2008,5947,5450,497,8.4
"47061",47,61,2009,6016,5167,849,14.1
"47061",47,61,2010,5635,4923,712,12.6
"47061",47,61,2011,5534,4847,687,12.4
"47061",47,61,2012,5532,4976,556,10.1
"47061",47,61,2013,5319,4783,536,10.1
"47061",47,61,2014,5076,4602,474,9.3
"47061",47,61,2015,4862,4486,376,7.7
"47061",47,61,2016,4789,4480,309,6.5
"47061",47,61,2017,4851,4609,242,5
"47063",47,63,1990,25865,24230,1635,6.3
"47063",47,63,1991,26308,23765,2543,9.7
"47063",47,63,1992,27248,25107,2141,7.9
"47063",47,63,1993,27403,25441,1962,7.2
"47063",47,63,1994,30507,28314,2193,7.2
"47063",47,63,1995,30605,28485,2120,6.9
"47063",47,63,1996,30579,28905,1674,5.5
"47063",47,63,1997,30218,28496,1722,5.7
"47063",47,63,1998,30227,28851,1376,4.6
"47063",47,63,1999,30670,29363,1307,4.3
"47063",47,63,2000,29462,28306,1156,3.9
"47063",47,63,2001,29913,28170,1743,5.8
"47063",47,63,2002,29800,28060,1740,5.8
"47063",47,63,2003,29291,27495,1796,6.1
"47063",47,63,2004,29088,27509,1579,5.4
"47063",47,63,2005,29400,27686,1714,5.8
"47063",47,63,2006,30674,28904,1770,5.8
"47063",47,63,2007,30399,28963,1436,4.7
"47063",47,63,2008,30293,28141,2152,7.1
"47063",47,63,2009,29971,26169,3802,12.7
"47063",47,63,2010,28403,25120,3283,11.6
"47063",47,63,2011,28311,25244,3067,10.8
"47063",47,63,2012,27603,25007,2596,9.4
"47063",47,63,2013,26957,24498,2459,9.1
"47063",47,63,2014,26219,24286,1933,7.4
"47063",47,63,2015,26420,24782,1638,6.2
"47063",47,63,2016,26852,25483,1369,5.1
"47063",47,63,2017,27312,26215,1097,4
"47065",47,65,1990,140751,135065,5686,4
"47065",47,65,1991,142013,133499,8514,6
"47065",47,65,1992,141829,133904,7925,5.6
"47065",47,65,1993,145679,138793,6886,4.7
"47065",47,65,1994,149147,142960,6187,4.1
"47065",47,65,1995,150125,143329,6796,4.5
"47065",47,65,1996,151317,144830,6487,4.3
"47065",47,65,1997,149704,142458,7246,4.8
"47065",47,65,1998,148639,143015,5624,3.8
"47065",47,65,1999,152627,147700,4927,3.2
"47065",47,65,2000,159100,153944,5156,3.2
"47065",47,65,2001,158891,153238,5653,3.6
"47065",47,65,2002,160193,153346,6847,4.3
"47065",47,65,2003,158186,151034,7152,4.5
"47065",47,65,2004,155737,148769,6968,4.5
"47065",47,65,2005,156630,149223,7407,4.7
"47065",47,65,2006,163857,156599,7258,4.4
"47065",47,65,2007,168789,162123,6666,3.9
"47065",47,65,2008,167906,158356,9550,5.7
"47065",47,65,2009,164214,149419,14795,9
"47065",47,65,2010,169043,154963,14080,8.3
"47065",47,65,2011,171726,158391,13335,7.8
"47065",47,65,2012,171034,159238,11796,6.9
"47065",47,65,2013,168353,156177,12176,7.2
"47065",47,65,2014,163932,153784,10148,6.2
"47065",47,65,2015,167045,158180,8865,5.3
"47065",47,65,2016,171922,164027,7895,4.6
"47065",47,65,2017,176554,170150,6404,3.6
"47067",47,67,1990,2217,2079,138,6.2
"47067",47,67,1991,2245,2066,179,8
"47067",47,67,1992,2345,2159,186,7.9
"47067",47,67,1993,2247,2023,224,10
"47067",47,67,1994,2452,2264,188,7.7
"47067",47,67,1995,2691,2520,171,6.4
"47067",47,67,1996,2691,2537,154,5.7
"47067",47,67,1997,2673,2504,169,6.3
"47067",47,67,1998,2810,2640,170,6
"47067",47,67,1999,2799,2622,177,6.3
"47067",47,67,2000,2645,2512,133,5
"47067",47,67,2001,2554,2376,178,7
"47067",47,67,2002,2617,2415,202,7.7
"47067",47,67,2003,2654,2471,183,6.9
"47067",47,67,2004,2415,2181,234,9.7
"47067",47,67,2005,2398,2181,217,9
"47067",47,67,2006,2503,2329,174,7
"47067",47,67,2007,2466,2327,139,5.6
"47067",47,67,2008,2561,2349,212,8.3
"47067",47,67,2009,2664,2270,394,14.8
"47067",47,67,2010,2575,2168,407,15.8
"47067",47,67,2011,2429,2092,337,13.9
"47067",47,67,2012,2257,1991,266,11.8
"47067",47,67,2013,2146,1892,254,11.8
"47067",47,67,2014,2059,1857,202,9.8
"47067",47,67,2015,2060,1861,199,9.7
"47067",47,67,2016,2033,1872,161,7.9
"47067",47,67,2017,2051,1932,119,5.8
"47069",47,69,1990,9530,8905,625,6.6
"47069",47,69,1991,9590,8788,802,8.4
"47069",47,69,1992,9437,8618,819,8.7
"47069",47,69,1993,9427,8420,1007,10.7
"47069",47,69,1994,9238,8229,1009,10.9
"47069",47,69,1995,9165,8313,852,9.3
"47069",47,69,1996,9253,8440,813,8.8
"47069",47,69,1997,9404,8342,1062,11.3
"47069",47,69,1998,9693,8518,1175,12.1
"47069",47,69,1999,9585,8703,882,9.2
"47069",47,69,2000,11001,10446,555,5
"47069",47,69,2001,11004,10240,764,6.9
"47069",47,69,2002,11324,10483,841,7.4
"47069",47,69,2003,11392,10482,910,8
"47069",47,69,2004,11128,10232,896,8.1
"47069",47,69,2005,11035,10089,946,8.6
"47069",47,69,2006,11502,10673,829,7.2
"47069",47,69,2007,11647,10887,760,6.5
"47069",47,69,2008,11581,10585,996,8.6
"47069",47,69,2009,11329,9893,1436,12.7
"47069",47,69,2010,10349,8981,1368,13.2
"47069",47,69,2011,10176,8946,1230,12.1
"47069",47,69,2012,9999,8909,1090,10.9
"47069",47,69,2013,9780,8692,1088,11.1
"47069",47,69,2014,9531,8646,885,9.3
"47069",47,69,2015,9274,8578,696,7.5
"47069",47,69,2016,9196,8631,565,6.1
"47069",47,69,2017,9263,8785,478,5.2
"47071",47,71,1990,10619,9826,793,7.5
"47071",47,71,1991,10875,9830,1045,9.6
"47071",47,71,1992,10727,9554,1173,10.9
"47071",47,71,1993,10971,9647,1324,12.1
"47071",47,71,1994,11813,10795,1018,8.6
"47071",47,71,1995,12428,11444,984,7.9
"47071",47,71,1996,12574,11438,1136,9
"47071",47,71,1997,12797,11641,1156,9
"47071",47,71,1998,12640,11719,921,7.3
"47071",47,71,1999,12435,11582,853,6.9
"47071",47,71,2000,11606,10995,611,5.3
"47071",47,71,2001,11470,10756,714,6.2
"47071",47,71,2002,11699,10830,869,7.4
"47071",47,71,2003,11699,10620,1079,9.2
"47071",47,71,2004,11287,10446,841,7.5
"47071",47,71,2005,11177,10360,817,7.3
"47071",47,71,2006,11823,11090,733,6.2
"47071",47,71,2007,12014,11360,654,5.4
"47071",47,71,2008,11892,10985,907,7.6
"47071",47,71,2009,11866,10383,1483,12.5
"47071",47,71,2010,11429,10053,1376,12
"47071",47,71,2011,11456,10167,1289,11.3
"47071",47,71,2012,11148,10027,1121,10.1
"47071",47,71,2013,10975,9839,1136,10.4
"47071",47,71,2014,10419,9485,934,9
"47071",47,71,2015,10246,9510,736,7.2
"47071",47,71,2016,10205,9597,608,6
"47071",47,71,2017,10422,9931,491,4.7
"47073",47,73,1990,20574,19558,1016,4.9
"47073",47,73,1991,21021,19758,1263,6
"47073",47,73,1992,21616,20310,1306,6
"47073",47,73,1993,22048,20782,1266,5.7
"47073",47,73,1994,22771,21516,1255,5.5
"47073",47,73,1995,23502,22225,1277,5.4
"47073",47,73,1996,23673,22548,1125,4.8
"47073",47,73,1997,23978,22648,1330,5.5
"47073",47,73,1998,23835,22680,1155,4.8
"47073",47,73,1999,24295,23044,1251,5.1
"47073",47,73,2000,24443,23433,1010,4.1
"47073",47,73,2001,25102,23809,1293,5.2
"47073",47,73,2002,25454,24017,1437,5.6
"47073",47,73,2003,25807,24094,1713,6.6
"47073",47,73,2004,25060,23549,1511,6
"47073",47,73,2005,25347,23775,1572,6.2
"47073",47,73,2006,26623,25091,1532,5.8
"47073",47,73,2007,26405,25196,1209,4.6
"47073",47,73,2008,26981,25172,1809,6.7
"47073",47,73,2009,27491,24386,3105,11.3
"47073",47,73,2010,25559,22782,2777,10.9
"47073",47,73,2011,25738,23191,2547,9.9
"47073",47,73,2012,25096,22883,2213,8.8
"47073",47,73,2013,24671,22501,2170,8.8
"47073",47,73,2014,23756,22014,1742,7.3
"47073",47,73,2015,23494,21994,1500,6.4
"47073",47,73,2016,23708,22434,1274,5.4
"47073",47,73,2017,23838,22838,1000,4.2
"47075",47,75,1990,8268,7511,757,9.2
"47075",47,75,1991,8212,7291,921,11.2
"47075",47,75,1992,8727,7635,1092,12.5
"47075",47,75,1993,8469,7401,1068,12.6
"47075",47,75,1994,8972,8062,910,10.1
"47075",47,75,1995,9033,7978,1055,11.7
"47075",47,75,1996,8916,7870,1046,11.7
"47075",47,75,1997,8675,7605,1070,12.3
"47075",47,75,1998,8679,7786,893,10.3
"47075",47,75,1999,8520,7766,754,8.8
"47075",47,75,2000,9250,8741,509,5.5
"47075",47,75,2001,9360,8689,671,7.2
"47075",47,75,2002,9660,8885,775,8
"47075",47,75,2003,9652,8753,899,9.3
"47075",47,75,2004,9305,8519,786,8.4
"47075",47,75,2005,9116,8358,758,8.3
"47075",47,75,2006,9788,9044,744,7.6
"47075",47,75,2007,9911,9221,690,7
"47075",47,75,2008,9490,8493,997,10.5
"47075",47,75,2009,9297,7816,1481,15.9
"47075",47,75,2010,8960,7561,1399,15.6
"47075",47,75,2011,8503,7327,1176,13.8
"47075",47,75,2012,8229,7279,950,11.5
"47075",47,75,2013,8098,7142,956,11.8
"47075",47,75,2014,7721,6963,758,9.8
"47075",47,75,2015,7616,6979,637,8.4
"47075",47,75,2016,7677,7180,497,6.5
"47075",47,75,2017,7865,7458,407,5.2
"47077",47,77,1990,11109,10212,897,8.1
"47077",47,77,1991,11048,9926,1122,10.2
"47077",47,77,1992,11353,10415,938,8.3
"47077",47,77,1993,11951,11150,801,6.7
"47077",47,77,1994,13135,12389,746,5.7
"47077",47,77,1995,13482,12460,1022,7.6
"47077",47,77,1996,13910,12517,1393,10
"47077",47,77,1997,14209,12979,1230,8.7
"47077",47,77,1998,14376,13254,1122,7.8
"47077",47,77,1999,14648,13775,873,6
"47077",47,77,2000,12798,12174,624,4.9
"47077",47,77,2001,12552,11707,845,6.7
"47077",47,77,2002,12764,11748,1016,8
"47077",47,77,2003,13089,12041,1048,8
"47077",47,77,2004,13182,12289,893,6.8
"47077",47,77,2005,12615,11678,937,7.4
"47077",47,77,2006,12448,11611,837,6.7
"47077",47,77,2007,12167,11382,785,6.5
"47077",47,77,2008,12093,10856,1237,10.2
"47077",47,77,2009,12055,9875,2180,18.1
"47077",47,77,2010,12999,11146,1853,14.3
"47077",47,77,2011,13586,12071,1515,11.2
"47077",47,77,2012,13206,11930,1276,9.7
"47077",47,77,2013,12664,11334,1330,10.5
"47077",47,77,2014,12151,11103,1048,8.6
"47077",47,77,2015,12254,11277,977,8
"47077",47,77,2016,11987,11169,818,6.8
"47077",47,77,2017,11904,11293,611,5.1
"47079",47,79,1990,12462,11640,822,6.6
"47079",47,79,1991,12168,11267,901,7.4
"47079",47,79,1992,13246,12264,982,7.4
"47079",47,79,1993,13676,12755,921,6.7
"47079",47,79,1994,14650,13865,785,5.4
"47079",47,79,1995,14860,14021,839,5.6
"47079",47,79,1996,15120,14157,963,6.4
"47079",47,79,1997,14880,13804,1076,7.2
"47079",47,79,1998,14857,13813,1044,7
"47079",47,79,1999,14685,13734,951,6.5
"47079",47,79,2000,14728,14019,709,4.8
"47079",47,79,2001,14673,13794,879,6
"47079",47,79,2002,14786,13818,968,6.5
"47079",47,79,2003,14563,13343,1220,8.4
"47079",47,79,2004,14192,13064,1128,7.9
"47079",47,79,2005,14027,12974,1053,7.5
"47079",47,79,2006,14345,13320,1025,7.1
"47079",47,79,2007,14172,13294,878,6.2
"47079",47,79,2008,13924,12710,1214,8.7
"47079",47,79,2009,13672,11845,1827,13.4
"47079",47,79,2010,14467,12820,1647,11.4
"47079",47,79,2011,14448,12884,1564,10.8
"47079",47,79,2012,14296,12950,1346,9.4
"47079",47,79,2013,14296,12942,1354,9.5
"47079",47,79,2014,13857,12741,1116,8.1
"47079",47,79,2015,13854,12948,906,6.5
"47079",47,79,2016,13923,13106,817,5.9
"47079",47,79,2017,14035,13400,635,4.5
"47081",47,81,1990,7747,7153,594,7.7
"47081",47,81,1991,7970,7243,727,9.1
"47081",47,81,1992,8003,7348,655,8.2
"47081",47,81,1993,8061,7412,649,8.1
"47081",47,81,1994,8455,8039,416,4.9
"47081",47,81,1995,8711,8320,391,4.5
"47081",47,81,1996,8853,8244,609,6.9
"47081",47,81,1997,8520,8032,488,5.7
"47081",47,81,1998,8214,7627,587,7.1
"47081",47,81,1999,7993,7532,461,5.8
"47081",47,81,2000,9767,9374,393,4
"47081",47,81,2001,9878,9383,495,5
"47081",47,81,2002,10108,9512,596,5.9
"47081",47,81,2003,10027,9427,600,6
"47081",47,81,2004,10054,9444,610,6.1
"47081",47,81,2005,10122,9495,627,6.2
"47081",47,81,2006,10368,9805,563,5.4
"47081",47,81,2007,10107,9560,547,5.4
"47081",47,81,2008,10142,9289,853,8.4
"47081",47,81,2009,10090,8778,1312,13
"47081",47,81,2010,10980,9757,1223,11.1
"47081",47,81,2011,10894,9777,1117,10.3
"47081",47,81,2012,10652,9707,945,8.9
"47081",47,81,2013,10482,9613,869,8.3
"47081",47,81,2014,10280,9604,676,6.6
"47081",47,81,2015,10300,9715,585,5.7
"47081",47,81,2016,10436,9955,481,4.6
"47081",47,81,2017,10789,10422,367,3.4
"47083",47,83,1990,3025,2717,308,10.2
"47083",47,83,1991,3156,2809,347,11
"47083",47,83,1992,3244,2801,443,13.7
"47083",47,83,1993,3190,2799,391,12.3
"47083",47,83,1994,2904,2577,327,11.3
"47083",47,83,1995,2993,2522,471,15.7
"47083",47,83,1996,3124,2686,438,14
"47083",47,83,1997,3056,2553,503,16.5
"47083",47,83,1998,2815,2494,321,11.4
"47083",47,83,1999,2763,2508,255,9.2
"47083",47,83,2000,3666,3454,212,5.8
"47083",47,83,2001,3625,3371,254,7
"47083",47,83,2002,3741,3469,272,7.3
"47083",47,83,2003,3729,3445,284,7.6
"47083",47,83,2004,3745,3458,287,7.7
"47083",47,83,2005,3763,3444,319,8.5
"47083",47,83,2006,3927,3637,290,7.4
"47083",47,83,2007,3916,3704,212,5.4
"47083",47,83,2008,3864,3551,313,8.1
"47083",47,83,2009,3922,3447,475,12.1
"47083",47,83,2010,3535,3112,423,12
"47083",47,83,2011,3568,3170,398,11.2
"47083",47,83,2012,3519,3126,393,11.2
"47083",47,83,2013,3363,2995,368,10.9
"47083",47,83,2014,3282,2958,324,9.9
"47083",47,83,2015,3192,2917,275,8.6
"47083",47,83,2016,3198,2958,240,7.5
"47083",47,83,2017,3205,3021,184,5.7
"47085",47,85,1990,7298,6478,820,11.2
"47085",47,85,1991,6849,6042,807,11.8
"47085",47,85,1992,6609,5725,884,13.4
"47085",47,85,1993,7113,6259,854,12
"47085",47,85,1994,8314,7636,678,8.2
"47085",47,85,1995,8352,7551,801,9.6
"47085",47,85,1996,8497,7517,980,11.5
"47085",47,85,1997,8072,7211,861,10.7
"47085",47,85,1998,8112,7525,587,7.2
"47085",47,85,1999,8092,7541,551,6.8
"47085",47,85,2000,8864,8428,436,4.9
"47085",47,85,2001,8759,8205,554,6.3
"47085",47,85,2002,8922,8339,583,6.5
"47085",47,85,2003,8917,8319,598,6.7
"47085",47,85,2004,8772,8151,621,7.1
"47085",47,85,2005,8824,8146,678,7.7
"47085",47,85,2006,9106,8529,577,6.3
"47085",47,85,2007,9183,8676,507,5.5
"47085",47,85,2008,9023,8260,763,8.5
"47085",47,85,2009,9033,7880,1153,12.8
"47085",47,85,2010,8882,7890,992,11.2
"47085",47,85,2011,8849,7923,926,10.5
"47085",47,85,2012,8660,7837,823,9.5
"47085",47,85,2013,8644,7882,762,8.8
"47085",47,85,2014,8346,7694,652,7.8
"47085",47,85,2015,8454,7883,571,6.8
"47085",47,85,2016,8644,8124,520,6
"47085",47,85,2017,8840,8462,378,4.3
"47087",47,87,1990,4229,3908,321,7.6
"47087",47,87,1991,4077,3729,348,8.5
"47087",47,87,1992,4104,3766,338,8.2
"47087",47,87,1993,4182,3790,392,9.4
"47087",47,87,1994,4363,4066,297,6.8
"47087",47,87,1995,4464,4174,290,6.5
"47087",47,87,1996,4514,4298,216,4.8
"47087",47,87,1997,4588,4221,367,8
"47087",47,87,1998,4693,4285,408,8.7
"47087",47,87,1999,4697,4297,400,8.5
"47087",47,87,2000,5051,4739,312,6.2
"47087",47,87,2001,5022,4734,288,5.7
"47087",47,87,2002,5146,4794,352,6.8
"47087",47,87,2003,5237,4818,419,8
"47087",47,87,2004,5171,4823,348,6.7
"47087",47,87,2005,5158,4714,444,8.6
"47087",47,87,2006,5092,4744,348,6.8
"47087",47,87,2007,4991,4651,340,6.8
"47087",47,87,2008,4980,4551,429,8.6
"47087",47,87,2009,5008,4321,687,13.7
"47087",47,87,2010,4788,4184,604,12.6
"47087",47,87,2011,4749,4194,555,11.7
"47087",47,87,2012,4588,4108,480,10.5
"47087",47,87,2013,4570,4098,472,10.3
"47087",47,87,2014,4449,4059,390,8.8
"47087",47,87,2015,4457,4107,350,7.9
"47087",47,87,2016,4492,4179,313,7
"47087",47,87,2017,4586,4342,244,5.3
"47089",47,89,1990,16529,15308,1221,7.4
"47089",47,89,1991,16937,15322,1615,9.5
"47089",47,89,1992,17935,16333,1602,8.9
"47089",47,89,1993,18718,17037,1681,9
"47089",47,89,1994,20696,19293,1403,6.8
"47089",47,89,1995,21694,20156,1538,7.1
"47089",47,89,1996,22386,21102,1284,5.7
"47089",47,89,1997,23115,21603,1512,6.5
"47089",47,89,1998,23674,22511,1163,4.9
"47089",47,89,1999,24600,23591,1009,4.1
"47089",47,89,2000,22368,21424,944,4.2
"47089",47,89,2001,22529,21351,1178,5.2
"47089",47,89,2002,23213,21752,1461,6.3
"47089",47,89,2003,23107,21677,1430,6.2
"47089",47,89,2004,23192,21778,1414,6.1
"47089",47,89,2005,23507,22115,1392,5.9
"47089",47,89,2006,24518,23118,1400,5.7
"47089",47,89,2007,24508,23258,1250,5.1
"47089",47,89,2008,24619,22869,1750,7.1
"47089",47,89,2009,24299,21228,3071,12.6
"47089",47,89,2010,24414,21612,2802,11.5
"47089",47,89,2011,24314,21765,2549,10.5
"47089",47,89,2012,24000,21752,2248,9.4
"47089",47,89,2013,23296,21183,2113,9.1
"47089",47,89,2014,22932,21235,1697,7.4
"47089",47,89,2015,23255,21769,1486,6.4
"47089",47,89,2016,23616,22372,1244,5.3
"47089",47,89,2017,23978,23015,963,4
"47091",47,91,1990,5986,5608,378,6.3
"47091",47,91,1991,6664,6168,496,7.4
"47091",47,91,1992,7119,6509,610,8.6
"47091",47,91,1993,7184,6699,485,6.8
"47091",47,91,1994,8283,7665,618,7.5
"47091",47,91,1995,8521,7346,1175,13.8
"47091",47,91,1996,7980,6975,1005,12.6
"47091",47,91,1997,7411,6711,700,9.4
"47091",47,91,1998,7336,6785,551,7.5
"47091",47,91,1999,7424,6722,702,9.5
"47091",47,91,2000,6900,6446,454,6.6
"47091",47,91,2001,6772,6249,523,7.7
"47091",47,91,2002,7023,6434,589,8.4
"47091",47,91,2003,6986,6381,605,8.7
"47091",47,91,2004,6868,6337,531,7.7
"47091",47,91,2005,6943,6373,570,8.2
"47091",47,91,2006,7338,6855,483,6.6
"47091",47,91,2007,7415,7000,415,5.6
"47091",47,91,2008,7278,6648,630,8.7
"47091",47,91,2009,7460,6502,958,12.8
"47091",47,91,2010,7446,6491,955,12.8
"47091",47,91,2011,7529,6660,869,11.5
"47091",47,91,2012,7353,6658,695,9.5
"47091",47,91,2013,7329,6668,661,9
"47091",47,91,2014,7103,6616,487,6.9
"47091",47,91,2015,7296,6886,410,5.6
"47091",47,91,2016,7541,7180,361,4.8
"47091",47,91,2017,7625,7325,300,3.9
"47093",47,93,1990,173391,166177,7214,4.2
"47093",47,93,1991,175849,167932,7917,4.5
"47093",47,93,1992,182982,174615,8367,4.6
"47093",47,93,1993,188713,181282,7431,3.9
"47093",47,93,1994,193303,186766,6537,3.4
"47093",47,93,1995,197924,191203,6721,3.4
"47093",47,93,1996,197245,190479,6766,3.4
"47093",47,93,1997,197457,190486,6971,3.5
"47093",47,93,1998,202940,196471,6469,3.2
"47093",47,93,1999,203690,198555,5135,2.5
"47093",47,93,2000,200467,194379,6088,3
"47093",47,93,2001,205825,199138,6687,3.2
"47093",47,93,2002,212552,204944,7608,3.6
"47093",47,93,2003,212988,204625,8363,3.9
"47093",47,93,2004,212136,203884,8252,3.9
"47093",47,93,2005,213735,204747,8988,4.2
"47093",47,93,2006,224145,215313,8832,3.9
"47093",47,93,2007,229804,221965,7839,3.4
"47093",47,93,2008,230189,218720,11469,5
"47093",47,93,2009,230341,211705,18636,8.1
"47093",47,93,2010,229800,212757,17043,7.4
"47093",47,93,2011,233360,217245,16115,6.9
"47093",47,93,2012,230959,216796,14163,6.1
"47093",47,93,2013,227126,212736,14390,6.3
"47093",47,93,2014,224743,212518,12225,5.4
"47093",47,93,2015,228031,217386,10645,4.7
"47093",47,93,2016,233712,224410,9302,4
"47093",47,93,2017,237543,230043,7500,3.2
"47095",47,95,1990,2601,2437,164,6.3
"47095",47,95,1991,2563,2359,204,8
"47095",47,95,1992,2696,2508,188,7
"47095",47,95,1993,2850,2691,159,5.6
"47095",47,95,1994,2996,2783,213,7.1
"47095",47,95,1995,2845,2679,166,5.8
"47095",47,95,1996,2851,2593,258,9
"47095",47,95,1997,2707,2472,235,8.7
"47095",47,95,1998,2550,2300,250,9.8
"47095",47,95,1999,2589,2429,160,6.2
"47095",47,95,2000,2541,2385,156,6.1
"47095",47,95,2001,2577,2410,167,6.5
"47095",47,95,2002,2761,2575,186,6.7
"47095",47,95,2003,2770,2572,198,7.1
"47095",47,95,2004,2593,2420,173,6.7
"47095",47,95,2005,2568,2357,211,8.2
"47095",47,95,2006,2705,2518,187,6.9
"47095",47,95,2007,2721,2562,159,5.8
"47095",47,95,2008,2674,2469,205,7.7
"47095",47,95,2009,2662,2368,294,11
"47095",47,95,2010,2175,1934,241,11.1
"47095",47,95,2011,2198,1933,265,12.1
"47095",47,95,2012,2208,1978,230,10.4
"47095",47,95,2013,2179,1959,220,10.1
"47095",47,95,2014,2093,1900,193,9.2
"47095",47,95,2015,1968,1800,168,8.5
"47095",47,95,2016,1916,1767,149,7.8
"47095",47,95,2017,1859,1754,105,5.6
"47097",47,97,1990,9907,9127,780,7.9
"47097",47,97,1991,9391,8393,998,10.6
"47097",47,97,1992,9394,8473,921,9.8
"47097",47,97,1993,9280,7892,1388,15
"47097",47,97,1994,9585,8625,960,10
"47097",47,97,1995,9648,8802,846,8.8
"47097",47,97,1996,10023,9195,828,8.3
"47097",47,97,1997,10058,9187,871,8.7
"47097",47,97,1998,10078,9229,849,8.4
"47097",47,97,1999,10177,9335,842,8.3
"47097",47,97,2000,11177,10612,565,5.1
"47097",47,97,2001,11013,10158,855,7.8
"47097",47,97,2002,10705,9829,876,8.2
"47097",47,97,2003,10476,9356,1120,10.7
"47097",47,97,2004,9890,8920,970,9.8
"47097",47,97,2005,9598,8760,838,8.7
"47097",47,97,2006,10074,9266,808,8
"47097",47,97,2007,10478,9788,690,6.6
"47097",47,97,2008,10354,9069,1285,12.4
"47097",47,97,2009,10416,8458,1958,18.8
"47097",47,97,2010,10782,9251,1531,14.2
"47097",47,97,2011,10648,9325,1323,12.4
"47097",47,97,2012,10525,9377,1148,10.9
"47097",47,97,2013,10224,9028,1196,11.7
"47097",47,97,2014,9777,8819,958,9.8
"47097",47,97,2015,9580,8733,847,8.8
"47097",47,97,2016,9435,8708,727,7.7
"47097",47,97,2017,9455,8896,559,5.9
"47099",47,99,1990,17036,15576,1460,8.6
"47099",47,99,1991,18187,16514,1673,9.2
"47099",47,99,1992,19623,18086,1537,7.8
"47099",47,99,1993,20012,18731,1281,6.4
"47099",47,99,1994,21929,20507,1422,6.5
"47099",47,99,1995,21831,19506,2325,10.6
"47099",47,99,1996,22216,19520,2696,12.1
"47099",47,99,1997,21917,19461,2456,11.2
"47099",47,99,1998,21917,19915,2002,9.1
"47099",47,99,1999,21041,18751,2290,10.9
"47099",47,99,2000,18922,17192,1730,9.1
"47099",47,99,2001,18624,16921,1703,9.1
"47099",47,99,2002,18763,17153,1610,8.6
"47099",47,99,2003,18828,17082,1746,9.3
"47099",47,99,2004,17896,16352,1544,8.6
"47099",47,99,2005,17272,15537,1735,10
"47099",47,99,2006,17168,15234,1934,11.3
"47099",47,99,2007,16755,15399,1356,8.1
"47099",47,99,2008,16624,14997,1627,9.8
"47099",47,99,2009,16870,14269,2601,15.4
"47099",47,99,2010,19340,16962,2378,12.3
"47099",47,99,2011,19253,17245,2008,10.4
"47099",47,99,2012,18710,16927,1783,9.5
"47099",47,99,2013,18101,16314,1787,9.9
"47099",47,99,2014,17556,16130,1426,8.1
"47099",47,99,2015,17691,16525,1166,6.6
"47099",47,99,2016,17794,16772,1022,5.7
"47099",47,99,2017,17769,16994,775,4.4
"47101",47,101,1990,4232,3889,343,8.1
"47101",47,101,1991,4317,3934,383,8.9
"47101",47,101,1992,4557,4218,339,7.4
"47101",47,101,1993,4624,4218,406,8.8
"47101",47,101,1994,4883,4529,354,7.2
"47101",47,101,1995,5188,4699,489,9.4
"47101",47,101,1996,5147,4348,799,15.5
"47101",47,101,1997,4692,3894,798,17
"47101",47,101,1998,4381,3887,494,11.3
"47101",47,101,1999,4227,3829,398,9.4
"47101",47,101,2000,5254,4971,283,5.4
"47101",47,101,2001,5283,4936,347,6.6
"47101",47,101,2002,5405,5025,380,7
"47101",47,101,2003,5407,4969,438,8.1
"47101",47,101,2004,5192,4833,359,6.9
"47101",47,101,2005,5113,4629,484,9.5
"47101",47,101,2006,5311,4929,382,7.2
"47101",47,101,2007,5441,5045,396,7.3
"47101",47,101,2008,5462,4914,548,10
"47101",47,101,2009,5577,4700,877,15.7
"47101",47,101,2010,5407,4595,812,15
"47101",47,101,2011,5255,4576,679,12.9
"47101",47,101,2012,5046,4501,545,10.8
"47101",47,101,2013,4990,4460,530,10.6
"47101",47,101,2014,4832,4399,433,9
"47101",47,101,2015,4796,4446,350,7.3
"47101",47,101,2016,4888,4598,290,5.9
"47101",47,101,2017,4945,4721,224,4.5
"47103",47,103,1990,14089,13446,643,4.6
"47103",47,103,1991,14127,12785,1342,9.5
"47103",47,103,1992,14358,13500,858,6
"47103",47,103,1993,14236,13277,959,6.7
"47103",47,103,1994,15061,14294,767,5.1
"47103",47,103,1995,15469,14563,906,5.9
"47103",47,103,1996,15304,13625,1679,11
"47103",47,103,1997,14738,13455,1283,8.7
"47103",47,103,1998,14372,13552,820,5.7
"47103",47,103,1999,14452,13865,587,4.1
"47103",47,103,2000,15736,15185,551,3.5
"47103",47,103,2001,15874,15190,684,4.3
"47103",47,103,2002,16316,15588,728,4.5
"47103",47,103,2003,16116,15265,851,5.3
"47103",47,103,2004,15855,15036,819,5.2
"47103",47,103,2005,16401,15621,780,4.8
"47103",47,103,2006,17290,16564,726,4.2
"47103",47,103,2007,17528,16905,623,3.6
"47103",47,103,2008,17214,16366,848,4.9
"47103",47,103,2009,17095,15867,1228,7.2
"47103",47,103,2010,15705,14581,1124,7.2
"47103",47,103,2011,15771,14722,1049,6.7
"47103",47,103,2012,15595,14645,950,6.1
"47103",47,103,2013,15549,14577,972,6.3
"47103",47,103,2014,15266,14450,816,5.3
"47103",47,103,2015,15117,14390,727,4.8
"47103",47,103,2016,15967,15315,652,4.1
"47103",47,103,2017,16316,15781,535,3.3
"47105",47,105,1990,15937,15019,918,5.8
"47105",47,105,1991,16512,15348,1164,7
"47105",47,105,1992,17148,16171,977,5.7
"47105",47,105,1993,17716,16885,831,4.7
"47105",47,105,1994,18535,17807,728,3.9
"47105",47,105,1995,19233,18463,770,4
"47105",47,105,1996,19658,18892,766,3.9
"47105",47,105,1997,20167,19284,883,4.4
"47105",47,105,1998,20484,19818,666,3.3
"47105",47,105,1999,21020,20401,619,2.9
"47105",47,105,2000,19422,18744,678,3.5
"47105",47,105,2001,20179,19345,834,4.1
"47105",47,105,2002,21095,20085,1010,4.8
"47105",47,105,2003,21212,20190,1022,4.8
"47105",47,105,2004,21200,20255,945,4.5
"47105",47,105,2005,21651,20642,1009,4.7
"47105",47,105,2006,22932,21918,1014,4.4
"47105",47,105,2007,23300,22395,905,3.9
"47105",47,105,2008,23563,22230,1333,5.7
"47105",47,105,2009,23654,21363,2291,9.7
"47105",47,105,2010,22352,20280,2072,9.3
"47105",47,105,2011,22586,20633,1953,8.6
"47105",47,105,2012,22335,20646,1689,7.6
"47105",47,105,2013,22077,20358,1719,7.8
"47105",47,105,2014,21691,20245,1446,6.7
"47105",47,105,2015,21899,20674,1225,5.6
"47105",47,105,2016,22283,21246,1037,4.7
"47105",47,105,2017,22622,21799,823,3.6
"47107",47,107,1990,20603,18830,1773,8.6
"47107",47,107,1991,20378,18296,2082,10.2
"47107",47,107,1992,20182,18286,1896,9.4
"47107",47,107,1993,20234,18656,1578,7.8
"47107",47,107,1994,21174,19820,1354,6.4
"47107",47,107,1995,22364,20313,2051,9.2
"47107",47,107,1996,22680,20661,2019,8.9
"47107",47,107,1997,22604,20840,1764,7.8
"47107",47,107,1998,22208,20809,1399,6.3
"47107",47,107,1999,22017,20756,1261,5.7
"47107",47,107,2000,23485,22444,1041,4.4
"47107",47,107,2001,23354,21785,1569,6.7
"47107",47,107,2002,23791,22013,1778,7.5
"47107",47,107,2003,24079,22291,1788,7.4
"47107",47,107,2004,23521,21992,1529,6.5
"47107",47,107,2005,23768,22321,1447,6.1
"47107",47,107,2006,25008,23585,1423,5.7
"47107",47,107,2007,24906,23530,1376,5.5
"47107",47,107,2008,24033,21934,2099,8.7
"47107",47,107,2009,23549,20252,3297,14
"47107",47,107,2010,22839,19978,2861,12.5
"47107",47,107,2011,23065,20491,2574,11.2
"47107",47,107,2012,23623,21462,2161,9.1
"47107",47,107,2013,22842,20775,2067,9
"47107",47,107,2014,22280,20604,1676,7.5
"47107",47,107,2015,22610,21181,1429,6.3
"47107",47,107,2016,22763,21530,1233,5.4
"47107",47,107,2017,22821,21829,992,4.3
"47109",47,109,1990,10306,9533,773,7.5
"47109",47,109,1991,10649,9682,967,9.1
"47109",47,109,1992,11147,10198,949,8.5
"47109",47,109,1993,11195,10252,943,8.4
"47109",47,109,1994,11466,10358,1108,9.7
"47109",47,109,1995,11702,10520,1182,10.1
"47109",47,109,1996,11948,10960,988,8.3
"47109",47,109,1997,11953,11008,945,7.9
"47109",47,109,1998,12194,11429,765,6.3
"47109",47,109,1999,11861,11275,586,4.9
"47109",47,109,2000,11705,11196,509,4.3
"47109",47,109,2001,11978,11288,690,5.8
"47109",47,109,2002,12291,11509,782,6.4
"47109",47,109,2003,12266,11422,844,6.9
"47109",47,109,2004,12134,11410,724,6
"47109",47,109,2005,12196,11464,732,6
"47109",47,109,2006,12434,11671,763,6.1
"47109",47,109,2007,12420,11676,744,6
"47109",47,109,2008,11522,10477,1045,9.1
"47109",47,109,2009,11077,9526,1551,14
"47109",47,109,2010,10497,9149,1348,12.8
"47109",47,109,2011,10403,9226,1177,11.3
"47109",47,109,2012,9768,8766,1002,10.3
"47109",47,109,2013,9327,8233,1094,11.7
"47109",47,109,2014,8905,7961,944,10.6
"47109",47,109,2015,8744,8002,742,8.5
"47109",47,109,2016,8766,8152,614,7
"47109",47,109,2017,8591,8109,482,5.6
"47111",47,111,1990,7943,7420,523,6.6
"47111",47,111,1991,8556,7800,756,8.8
"47111",47,111,1992,8626,8095,531,6.2
"47111",47,111,1993,8825,8384,441,5
"47111",47,111,1994,9695,8933,762,7.9
"47111",47,111,1995,9413,8593,820,8.7
"47111",47,111,1996,9321,8400,921,9.9
"47111",47,111,1997,8585,7706,879,10.2
"47111",47,111,1998,8187,7693,494,6
"47111",47,111,1999,8407,8053,354,4.2
"47111",47,111,2000,10165,9792,373,3.7
"47111",47,111,2001,10468,9885,583,5.6
"47111",47,111,2002,10364,9794,570,5.5
"47111",47,111,2003,10491,9759,732,7
"47111",47,111,2004,10323,9765,558,5.4
"47111",47,111,2005,10453,9856,597,5.7
"47111",47,111,2006,11008,10254,754,6.8
"47111",47,111,2007,10569,9938,631,6
"47111",47,111,2008,10638,9752,886,8.3
"47111",47,111,2009,10629,9322,1307,12.3
"47111",47,111,2010,10245,9095,1150,11.2
"47111",47,111,2011,10338,9277,1061,10.3
"47111",47,111,2012,10139,9299,840,8.3
"47111",47,111,2013,10056,9232,824,8.2
"47111",47,111,2014,9915,9268,647,6.5
"47111",47,111,2015,9945,9418,527,5.3
"47111",47,111,2016,10238,9793,445,4.3
"47111",47,111,2017,10625,10262,363,3.4
"47113",47,113,1990,38139,36113,2026,5.3
"47113",47,113,1991,39540,37222,2318,5.9
"47113",47,113,1992,40021,37563,2458,6.1
"47113",47,113,1993,40632,38393,2239,5.5
"47113",47,113,1994,45827,43934,1893,4.1
"47113",47,113,1995,46953,44690,2263,4.8
"47113",47,113,1996,47397,45248,2149,4.5
"47113",47,113,1997,48757,46599,2158,4.4
"47113",47,113,1998,50176,48438,1738,3.5
"47113",47,113,1999,51269,49578,1691,3.3
"47113",47,113,2000,46566,44878,1688,3.6
"47113",47,113,2001,46010,43732,2278,5
"47113",47,113,2002,46411,43710,2701,5.8
"47113",47,113,2003,46484,43715,2769,6
"47113",47,113,2004,45970,43443,2527,5.5
"47113",47,113,2005,46399,43811,2588,5.6
"47113",47,113,2006,48455,45843,2612,5.4
"47113",47,113,2007,49023,46606,2417,4.9
"47113",47,113,2008,48674,45396,3278,6.7
"47113",47,113,2009,48374,43230,5144,10.6
"47113",47,113,2010,48201,43363,4838,10
"47113",47,113,2011,49066,44498,4568,9.3
"47113",47,113,2012,48531,44585,3946,8.1
"47113",47,113,2013,47496,43660,3836,8.1
"47113",47,113,2014,46282,43148,3134,6.8
"47113",47,113,2015,46453,43722,2731,5.9
"47113",47,113,2016,47801,45484,2317,4.8
"47113",47,113,2017,48256,46362,1894,3.9
"47115",47,115,1990,11327,10655,672,5.9
"47115",47,115,1991,11596,10575,1021,8.8
"47115",47,115,1992,11644,10623,1021,8.8
"47115",47,115,1993,12043,11133,910,7.6
"47115",47,115,1994,12306,11596,710,5.8
"47115",47,115,1995,12482,11652,830,6.6
"47115",47,115,1996,12574,11786,788,6.3
"47115",47,115,1997,12533,11674,859,6.9
"47115",47,115,1998,12447,11735,712,5.7
"47115",47,115,1999,12826,12215,611,4.8
"47115",47,115,2000,13012,12438,574,4.4
"47115",47,115,2001,13042,12371,671,5.1
"47115",47,115,2002,13162,12343,819,6.2
"47115",47,115,2003,12914,12168,746,5.8
"47115",47,115,2004,12709,11918,791,6.2
"47115",47,115,2005,12720,11935,785,6.2
"47115",47,115,2006,13289,12529,760,5.7
"47115",47,115,2007,13154,12378,776,5.9
"47115",47,115,2008,13039,12040,999,7.7
"47115",47,115,2009,12707,11144,1563,12.3
"47115",47,115,2010,12542,11145,1397,11.1
"47115",47,115,2011,12513,11205,1308,10.5
"47115",47,115,2012,12282,11163,1119,9.1
"47115",47,115,2013,11995,10900,1095,9.1
"47115",47,115,2014,11580,10667,913,7.9
"47115",47,115,2015,11693,10905,788,6.7
"47115",47,115,2016,11919,11173,746,6.3
"47115",47,115,2017,12176,11591,585,4.8
"47117",47,117,1990,11327,10725,602,5.3
"47117",47,117,1991,10827,9900,927,8.6
"47117",47,117,1992,11619,10921,698,6
"47117",47,117,1993,11867,11299,568,4.8
"47117",47,117,1994,12650,12110,540,4.3
"47117",47,117,1995,12436,11688,748,6
"47117",47,117,1996,12662,12099,563,4.4
"47117",47,117,1997,12726,12124,602,4.7
"47117",47,117,1998,12531,11956,575,4.6
"47117",47,117,1999,12431,11982,449,3.6
"47117",47,117,2000,13924,13435,489,3.5
"47117",47,117,2001,13850,13135,715,5.2
"47117",47,117,2002,14138,13396,742,5.2
"47117",47,117,2003,13312,11998,1314,9.9
"47117",47,117,2004,12661,11779,882,7
"47117",47,117,2005,12381,11581,800,6.5
"47117",47,117,2006,12828,12016,812,6.3
"47117",47,117,2007,13070,12087,983,7.5
"47117",47,117,2008,12591,11428,1163,9.2
"47117",47,117,2009,12507,10332,2175,17.4
"47117",47,117,2010,14400,12382,2018,14
"47117",47,117,2011,14431,12781,1650,11.4
"47117",47,117,2012,14300,12959,1341,9.4
"47117",47,117,2013,14317,13148,1169,8.2
"47117",47,117,2014,14384,13484,900,6.3
"47117",47,117,2015,14741,13917,824,5.6
"47117",47,117,2016,15076,14382,694,4.6
"47117",47,117,2017,15535,15018,517,3.3
"47119",47,119,1990,28594,26673,1921,6.7
"47119",47,119,1991,30800,27793,3007,9.8
"47119",47,119,1992,31061,28438,2623,8.4
"47119",47,119,1993,32967,31121,1846,5.6
"47119",47,119,1994,35773,34122,1651,4.6
"47119",47,119,1995,36533,34409,2124,5.8
"47119",47,119,1996,36898,35074,1824,4.9
"47119",47,119,1997,37078,35147,1931,5.2
"47119",47,119,1998,37116,35740,1376,3.7
"47119",47,119,1999,37961,36644,1317,3.5
"47119",47,119,2000,36688,35408,1280,3.5
"47119",47,119,2001,36622,35124,1498,4.1
"47119",47,119,2002,37218,35452,1766,4.7
"47119",47,119,2003,36888,34633,2255,6.1
"47119",47,119,2004,35790,33866,1924,5.4
"47119",47,119,2005,35653,33509,2144,6
"47119",47,119,2006,36975,34952,2023,5.5
"47119",47,119,2007,36916,34037,2879,7.8
"47119",47,119,2008,37574,34526,3048,8.1
"47119",47,119,2009,37374,32225,5149,13.8
"47119",47,119,2010,41469,36374,5095,12.3
"47119",47,119,2011,41313,37081,4232,10.2
"47119",47,119,2012,40673,37487,3186,7.8
"47119",47,119,2013,40771,37872,2899,7.1
"47119",47,119,2014,40925,38496,2429,5.9
"47119",47,119,2015,42288,40121,2167,5.1
"47119",47,119,2016,44098,42319,1779,4
"47119",47,119,2017,45784,44312,1472,3.2
"47121",47,121,1990,3861,3463,398,10.3
"47121",47,121,1991,3902,3398,504,12.9
"47121",47,121,1992,3925,3396,529,13.5
"47121",47,121,1993,3968,3521,447,11.3
"47121",47,121,1994,4260,3864,396,9.3
"47121",47,121,1995,4434,3971,463,10.4
"47121",47,121,1996,4559,4071,488,10.7
"47121",47,121,1997,4693,4233,460,9.8
"47121",47,121,1998,4718,4329,389,8.2
"47121",47,121,1999,4738,4372,366,7.7
"47121",47,121,2000,4858,4611,247,5.1
"47121",47,121,2001,4820,4504,316,6.6
"47121",47,121,2002,4904,4519,385,7.9
"47121",47,121,2003,4846,4461,385,7.9
"47121",47,121,2004,4780,4434,346,7.2
"47121",47,121,2005,4750,4404,346,7.3
"47121",47,121,2006,4929,4593,336,6.8
"47121",47,121,2007,4929,4622,307,6.2
"47121",47,121,2008,4968,4527,441,8.9
"47121",47,121,2009,5135,4386,749,14.6
"47121",47,121,2010,4971,4320,651,13.1
"47121",47,121,2011,4984,4388,596,12
"47121",47,121,2012,5063,4541,522,10.3
"47121",47,121,2013,5030,4514,516,10.3
"47121",47,121,2014,4848,4428,420,8.7
"47121",47,121,2015,4848,4479,369,7.6
"47121",47,121,2016,4898,4564,334,6.8
"47121",47,121,2017,5007,4747,260,5.2
"47123",47,123,1990,14518,12986,1532,10.6
"47123",47,123,1991,13979,12009,1970,14.1
"47123",47,123,1992,13827,12286,1541,11.1
"47123",47,123,1993,15167,13687,1480,9.8
"47123",47,123,1994,17228,15756,1472,8.5
"47123",47,123,1995,18081,16472,1609,8.9
"47123",47,123,1996,18073,15993,2080,11.5
"47123",47,123,1997,17811,16212,1599,9
"47123",47,123,1998,18004,16889,1115,6.2
"47123",47,123,1999,19128,18139,989,5.2
"47123",47,123,2000,17346,16428,918,5.3
"47123",47,123,2001,17386,16158,1228,7.1
"47123",47,123,2002,17575,16190,1385,7.9
"47123",47,123,2003,17826,16430,1396,7.8
"47123",47,123,2004,17933,16787,1146,6.4
"47123",47,123,2005,18464,17342,1122,6.1
"47123",47,123,2006,19723,18588,1135,5.8
"47123",47,123,2007,19630,18481,1149,5.9
"47123",47,123,2008,18960,17079,1881,9.9
"47123",47,123,2009,18769,15481,3288,17.5
"47123",47,123,2010,19493,17014,2479,12.7
"47123",47,123,2011,19588,17345,2243,11.5
"47123",47,123,2012,19478,17540,1938,9.9
"47123",47,123,2013,19236,17351,1885,9.8
"47123",47,123,2014,18941,17502,1439,7.6
"47123",47,123,2015,19013,17821,1192,6.3
"47123",47,123,2016,19405,18384,1021,5.3
"47123",47,123,2017,19734,18950,784,4
"47125",47,125,1990,40472,38149,2323,5.7
"47125",47,125,1991,41239,38460,2779,6.7
"47125",47,125,1992,41922,39305,2617,6.2
"47125",47,125,1993,44805,42358,2447,5.5
"47125",47,125,1994,50928,48756,2172,4.3
"47125",47,125,1995,52583,50603,1980,3.8
"47125",47,125,1996,52971,50826,2145,4
"47125",47,125,1997,54265,51842,2423,4.5
"47125",47,125,1998,56495,54441,2054,3.6
"47125",47,125,1999,59412,57607,1805,3
"47125",47,125,2000,59228,57034,2194,3.7
"47125",47,125,2001,59924,57312,2612,4.4
"47125",47,125,2002,61720,58579,3141,5.1
"47125",47,125,2003,62703,59549,3154,5
"47125",47,125,2004,63669,60667,3002,4.7
"47125",47,125,2005,65160,61940,3220,4.9
"47125",47,125,2006,69568,66296,3272,4.7
"47125",47,125,2007,68883,65642,3241,4.7
"47125",47,125,2008,68013,63737,4276,6.3
"47125",47,125,2009,69330,63164,6166,8.9
"47125",47,125,2010,75637,69181,6456,8.5
"47125",47,125,2011,77267,70667,6600,8.5
"47125",47,125,2012,78041,72126,5915,7.6
"47125",47,125,2013,77325,71473,5852,7.6
"47125",47,125,2014,76843,71736,5107,6.6
"47125",47,125,2015,78457,73899,4558,5.8
"47125",47,125,2016,79969,75915,4054,5.1
"47125",47,125,2017,80988,77686,3302,4.1
"47127",47,127,1990,2507,2415,92,3.7
"47127",47,127,1991,2596,2438,158,6.1
"47127",47,127,1992,2646,2523,123,4.6
"47127",47,127,1993,2727,2622,105,3.9
"47127",47,127,1994,3028,2913,115,3.8
"47127",47,127,1995,3010,2926,84,2.8
"47127",47,127,1996,3042,2886,156,5.1
"47127",47,127,1997,3022,2913,109,3.6
"47127",47,127,1998,2976,2888,88,3
"47127",47,127,1999,2909,2846,63,2.2
"47127",47,127,2000,2906,2817,89,3.1
"47127",47,127,2001,2998,2890,108,3.6
"47127",47,127,2002,3137,3027,110,3.5
"47127",47,127,2003,3149,3030,119,3.8
"47127",47,127,2004,3121,2986,135,4.3
"47127",47,127,2005,3086,2944,142,4.6
"47127",47,127,2006,3158,3009,149,4.7
"47127",47,127,2007,3196,3064,132,4.1
"47127",47,127,2008,3165,2989,176,5.6
"47127",47,127,2009,3051,2761,290,9.5
"47127",47,127,2010,3257,3000,257,7.9
"47127",47,127,2011,3341,3111,230,6.9
"47127",47,127,2012,3395,3198,197,5.8
"47127",47,127,2013,3323,3123,200,6
"47127",47,127,2014,3273,3107,166,5.1
"47127",47,127,2015,3300,3151,149,4.5
"47127",47,127,2016,3386,3259,127,3.8
"47127",47,127,2017,3484,3376,108,3.1
"47129",47,129,1990,6818,6211,607,8.9
"47129",47,129,1991,6958,6347,611,8.8
"47129",47,129,1992,6913,6216,697,10.1
"47129",47,129,1993,6105,5505,600,9.8
"47129",47,129,1994,7319,6826,493,6.7
"47129",47,129,1995,7606,6966,640,8.4
"47129",47,129,1996,7097,6638,459,6.5
"47129",47,129,1997,6740,6198,542,8
"47129",47,129,1998,6863,6357,506,7.4
"47129",47,129,1999,6973,6468,505,7.2
"47129",47,129,2000,7984,7582,402,5
"47129",47,129,2001,7733,7265,468,6.1
"47129",47,129,2002,8237,7474,763,9.3
"47129",47,129,2003,8140,7478,662,8.1
"47129",47,129,2004,8065,7452,613,7.6
"47129",47,129,2005,8118,7509,609,7.5
"47129",47,129,2006,8412,7850,562,6.7
"47129",47,129,2007,8494,8003,491,5.8
"47129",47,129,2008,8565,7914,651,7.6
"47129",47,129,2009,8812,7813,999,11.3
"47129",47,129,2010,8403,7448,955,11.4
"47129",47,129,2011,8475,7560,915,10.8
"47129",47,129,2012,8325,7472,853,10.2
"47129",47,129,2013,8051,7229,822,10.2
"47129",47,129,2014,7749,7067,682,8.8
"47129",47,129,2015,7704,7129,575,7.5
"47129",47,129,2016,7805,7303,502,6.4
"47129",47,129,2017,7871,7489,382,4.9
"47131",47,131,1990,15087,14142,945,6.3
"47131",47,131,1991,14486,12973,1513,10.4
"47131",47,131,1992,14274,12902,1372,9.6
"47131",47,131,1993,14151,13134,1017,7.2
"47131",47,131,1994,14758,13942,816,5.5
"47131",47,131,1995,14949,14116,833,5.6
"47131",47,131,1996,15507,14140,1367,8.8
"47131",47,131,1997,15087,13931,1156,7.7
"47131",47,131,1998,15330,14508,822,5.4
"47131",47,131,1999,15675,14739,936,6
"47131",47,131,2000,16226,15541,685,4.2
"47131",47,131,2001,16558,15809,749,4.5
"47131",47,131,2002,16968,16132,836,4.9
"47131",47,131,2003,16350,15193,1157,7.1
"47131",47,131,2004,15637,14646,991,6.3
"47131",47,131,2005,15360,14434,926,6
"47131",47,131,2006,15911,15025,886,5.6
"47131",47,131,2007,15737,14866,871,5.5
"47131",47,131,2008,15602,14507,1095,7
"47131",47,131,2009,15199,13635,1564,10.3
"47131",47,131,2010,15546,14050,1496,9.6
"47131",47,131,2011,15287,13433,1854,12.1
"47131",47,131,2012,14349,12422,1927,13.4
"47131",47,131,2013,13660,12072,1588,11.6
"47131",47,131,2014,12769,11550,1219,9.5
"47131",47,131,2015,12456,11383,1073,8.6
"47131",47,131,2016,12571,11688,883,7
"47131",47,131,2017,12273,11600,673,5.5
"47133",47,133,1990,8628,7852,776,9
"47133",47,133,1991,8573,7687,886,10.3
"47133",47,133,1992,8601,7844,757,8.8
"47133",47,133,1993,8800,7923,877,10
"47133",47,133,1994,9274,8633,641,6.9
"47133",47,133,1995,9369,8660,709,7.6
"47133",47,133,1996,9677,9040,637,6.6
"47133",47,133,1997,9994,9031,963,9.6
"47133",47,133,1998,9967,9258,709,7.1
"47133",47,133,1999,9880,9323,557,5.6
"47133",47,133,2000,9581,9076,505,5.3
"47133",47,133,2001,9545,8960,585,6.1
"47133",47,133,2002,9697,9082,615,6.3
"47133",47,133,2003,9706,9091,615,6.3
"47133",47,133,2004,9808,9264,544,5.5
"47133",47,133,2005,9705,9140,565,5.8
"47133",47,133,2006,10102,9427,675,6.7
"47133",47,133,2007,10189,9454,735,7.2
"47133",47,133,2008,10114,9206,908,9
"47133",47,133,2009,10105,8752,1353,13.4
"47133",47,133,2010,10246,9151,1095,10.7
"47133",47,133,2011,10016,8992,1024,10.2
"47133",47,133,2012,9738,8870,868,8.9
"47133",47,133,2013,9492,8636,856,9
"47133",47,133,2014,9079,8363,716,7.9
"47133",47,133,2015,9075,8428,647,7.1
"47133",47,133,2016,9217,8725,492,5.3
"47133",47,133,2017,9590,9195,395,4.1
"47135",47,135,1990,3011,2796,215,7.1
"47135",47,135,1991,2973,2655,318,10.7
"47135",47,135,1992,2894,2621,273,9.4
"47135",47,135,1993,2956,2737,219,7.4
"47135",47,135,1994,3297,3141,156,4.7
"47135",47,135,1995,3414,3203,211,6.2
"47135",47,135,1996,3620,3424,196,5.4
"47135",47,135,1997,3925,3662,263,6.7
"47135",47,135,1998,3805,3537,268,7
"47135",47,135,1999,3867,3579,288,7.4
"47135",47,135,2000,3477,3299,178,5.1
"47135",47,135,2001,3360,3126,234,7
"47135",47,135,2002,3255,3022,233,7.2
"47135",47,135,2003,3215,2993,222,6.9
"47135",47,135,2004,3162,2953,209,6.6
"47135",47,135,2005,3254,3020,234,7.2
"47135",47,135,2006,3318,3096,222,6.7
"47135",47,135,2007,3157,2916,241,7.6
"47135",47,135,2008,2980,2503,477,16
"47135",47,135,2009,2831,2178,653,23.1
"47135",47,135,2010,3164,2738,426,13.5
"47135",47,135,2011,3030,2676,354,11.7
"47135",47,135,2012,3115,2811,304,9.8
"47135",47,135,2013,3114,2821,293,9.4
"47135",47,135,2014,3032,2787,245,8.1
"47135",47,135,2015,3114,2905,209,6.7
"47135",47,135,2016,3191,2989,202,6.3
"47135",47,135,2017,3242,3086,156,4.8
"47137",47,137,1990,2031,1895,136,6.7
"47137",47,137,1991,1935,1831,104,5.4
"47137",47,137,1992,2030,1876,154,7.6
"47137",47,137,1993,2017,1869,148,7.3
"47137",47,137,1994,2131,1997,134,6.3
"47137",47,137,1995,2278,2031,247,10.8
"47137",47,137,1996,2311,2086,225,9.7
"47137",47,137,1997,2218,2039,179,8.1
"47137",47,137,1998,2188,2061,127,5.8
"47137",47,137,1999,2229,2089,140,6.3
"47137",47,137,2000,2263,2149,114,5
"47137",47,137,2001,2143,1955,188,8.8
"47137",47,137,2002,2091,1893,198,9.5
"47137",47,137,2003,2026,1848,178,8.8
"47137",47,137,2004,1915,1751,164,8.6
"47137",47,137,2005,1839,1682,157,8.5
"47137",47,137,2006,1905,1745,160,8.4
"47137",47,137,2007,1937,1780,157,8.1
"47137",47,137,2008,1893,1690,203,10.7
"47137",47,137,2009,1821,1547,274,15
"47137",47,137,2010,2407,2139,268,11.1
"47137",47,137,2011,2434,2159,275,11.3
"47137",47,137,2012,2448,2218,230,9.4
"47137",47,137,2013,2318,2097,221,9.5
"47137",47,137,2014,2268,2067,201,8.9
"47137",47,137,2015,2394,2212,182,7.6
"47137",47,137,2016,2325,2173,152,6.5
"47137",47,137,2017,2454,2346,108,4.4
"47139",47,139,1990,6452,5919,533,8.3
"47139",47,139,1991,6444,5729,715,11.1
"47139",47,139,1992,6311,5676,635,10.1
"47139",47,139,1993,6277,5768,509,8.1
"47139",47,139,1994,6534,6131,403,6.2
"47139",47,139,1995,6826,6294,532,7.8
"47139",47,139,1996,6861,6369,492,7.2
"47139",47,139,1997,7008,6482,526,7.5
"47139",47,139,1998,6980,6559,421,6
"47139",47,139,1999,6936,6588,348,5
"47139",47,139,2000,7464,7135,329,4.4
"47139",47,139,2001,7396,7042,354,4.8
"47139",47,139,2002,7407,6979,428,5.8
"47139",47,139,2003,7399,6949,450,6.1
"47139",47,139,2004,7226,6821,405,5.6
"47139",47,139,2005,7220,6792,428,5.9
"47139",47,139,2006,7439,7021,418,5.6
"47139",47,139,2007,7148,6789,359,5
"47139",47,139,2008,7039,6472,567,8.1
"47139",47,139,2009,7080,6187,893,12.6
"47139",47,139,2010,7336,6514,822,11.2
"47139",47,139,2011,7427,6600,827,11.1
"47139",47,139,2012,7486,6752,734,9.8
"47139",47,139,2013,7531,6837,694,9.2
"47139",47,139,2014,7362,6782,580,7.9
"47139",47,139,2015,7312,6832,480,6.6
"47139",47,139,2016,7391,6969,422,5.7
"47139",47,139,2017,7372,7036,336,4.6
"47141",47,141,1990,26397,24529,1868,7.1
"47141",47,141,1991,26171,24003,2168,8.3
"47141",47,141,1992,26871,24997,1874,7
"47141",47,141,1993,27485,25663,1822,6.6
"47141",47,141,1994,29959,28248,1711,5.7
"47141",47,141,1995,30333,28854,1479,4.9
"47141",47,141,1996,31219,29734,1485,4.8
"47141",47,141,1997,31186,29399,1787,5.7
"47141",47,141,1998,31320,29971,1349,4.3
"47141",47,141,1999,31746,30320,1426,4.5
"47141",47,141,2000,31695,30326,1369,4.3
"47141",47,141,2001,31679,30219,1460,4.6
"47141",47,141,2002,32793,31034,1759,5.4
"47141",47,141,2003,33261,31603,1658,5
"47141",47,141,2004,33714,32195,1519,4.5
"47141",47,141,2005,33719,32029,1690,5
"47141",47,141,2006,35566,33532,2034,5.7
"47141",47,141,2007,35659,34045,1614,4.5
"47141",47,141,2008,36063,33738,2325,6.4
"47141",47,141,2009,36014,32518,3496,9.7
"47141",47,141,2010,34011,30819,3192,9.4
"47141",47,141,2011,34387,31327,3060,8.9
"47141",47,141,2012,32924,30279,2645,8
"47141",47,141,2013,32459,29859,2600,8
"47141",47,141,2014,31900,29709,2191,6.9
"47141",47,141,2015,32396,30506,1890,5.8
"47141",47,141,2016,33264,31637,1627,4.9
"47141",47,141,2017,34084,32807,1277,3.7
"47143",47,143,1990,11144,10330,814,7.3
"47143",47,143,1991,11072,9769,1303,11.8
"47143",47,143,1992,10459,9380,1079,10.3
"47143",47,143,1993,11035,9923,1112,10.1
"47143",47,143,1994,11924,10917,1007,8.4
"47143",47,143,1995,12186,11077,1109,9.1
"47143",47,143,1996,12559,11240,1319,10.5
"47143",47,143,1997,11905,10737,1168,9.8
"47143",47,143,1998,11866,10945,921,7.8
"47143",47,143,1999,12375,11668,707,5.7
"47143",47,143,2000,13284,12672,612,4.6
"47143",47,143,2001,12840,12134,706,5.5
"47143",47,143,2002,13057,12312,745,5.7
"47143",47,143,2003,13226,12437,789,6
"47143",47,143,2004,13201,12371,830,6.3
"47143",47,143,2005,13141,12253,888,6.8
"47143",47,143,2006,13399,12559,840,6.3
"47143",47,143,2007,13174,12410,764,5.8
"47143",47,143,2008,13446,12373,1073,8
"47143",47,143,2009,13468,11645,1823,13.5
"47143",47,143,2010,13562,11892,1670,12.3
"47143",47,143,2011,13854,12294,1560,11.3
"47143",47,143,2012,13503,12120,1383,10.2
"47143",47,143,2013,13350,11922,1428,10.7
"47143",47,143,2014,13208,12097,1111,8.4
"47143",47,143,2015,13069,12104,965,7.4
"47143",47,143,2016,13475,12520,955,7.1
"47143",47,143,2017,13275,12423,852,6.4
"47145",47,145,1990,21751,19930,1821,8.4
"47145",47,145,1991,20182,18523,1659,8.2
"47145",47,145,1992,20475,18722,1753,8.6
"47145",47,145,1993,28069,26457,1612,5.7
"47145",47,145,1994,30716,29354,1362,4.4
"47145",47,145,1995,29055,27385,1670,5.7
"47145",47,145,1996,28049,26544,1505,5.4
"47145",47,145,1997,27251,25306,1945,7.1
"47145",47,145,1998,26328,24975,1353,5.1
"47145",47,145,1999,25076,23942,1134,4.5
"47145",47,145,2000,24651,23614,1037,4.2
"47145",47,145,2001,24969,23820,1149,4.6
"47145",47,145,2002,25754,24372,1382,5.4
"47145",47,145,2003,25676,24277,1399,5.4
"47145",47,145,2004,24979,23556,1423,5.7
"47145",47,145,2005,25587,24096,1491,5.8
"47145",47,145,2006,26998,25542,1456,5.4
"47145",47,145,2007,27068,25877,1191,4.4
"47145",47,145,2008,27239,25636,1603,5.9
"47145",47,145,2009,27483,24975,2508,9.1
"47145",47,145,2010,24323,22089,2234,9.2
"47145",47,145,2011,24447,22232,2215,9.1
"47145",47,145,2012,23894,21834,2060,8.6
"47145",47,145,2013,23176,21080,2096,9
"47145",47,145,2014,22465,20743,1722,7.7
"47145",47,145,2015,22547,21089,1458,6.5
"47145",47,145,2016,22864,21595,1269,5.6
"47145",47,145,2017,23150,22140,1010,4.4
"47147",47,147,1990,21165,20038,1127,5.3
"47147",47,147,1991,21710,20054,1656,7.6
"47147",47,147,1992,21935,20511,1424,6.5
"47147",47,147,1993,23155,21692,1463,6.3
"47147",47,147,1994,24228,23097,1131,4.7
"47147",47,147,1995,25484,24335,1149,4.5
"47147",47,147,1996,26649,25324,1325,5
"47147",47,147,1997,27590,26315,1275,4.6
"47147",47,147,1998,28684,27679,1005,3.5
"47147",47,147,1999,29789,28829,960,3.2
"47147",47,147,2000,29505,28478,1027,3.5
"47147",47,147,2001,30035,28775,1260,4.2
"47147",47,147,2002,30635,29128,1507,4.9
"47147",47,147,2003,30872,29281,1591,5.2
"47147",47,147,2004,30819,29352,1467,4.8
"47147",47,147,2005,31473,29943,1530,4.9
"47147",47,147,2006,33306,31824,1482,4.4
"47147",47,147,2007,33095,31654,1441,4.4
"47147",47,147,2008,33484,31424,2060,6.2
"47147",47,147,2009,33982,30508,3474,10.2
"47147",47,147,2010,33768,30654,3114,9.2
"47147",47,147,2011,34127,31263,2864,8.4
"47147",47,147,2012,33744,31371,2373,7
"47147",47,147,2013,33566,31296,2270,6.8
"47147",47,147,2014,33334,31442,1892,5.7
"47147",47,147,2015,33761,32115,1646,4.9
"47147",47,147,2016,34762,33321,1441,4.1
"47147",47,147,2017,36117,34901,1216,3.4
"47149",47,149,1990,64416,61627,2789,4.3
"47149",47,149,1991,65803,62422,3381,5.1
"47149",47,149,1992,67967,64683,3284,4.8
"47149",47,149,1993,72891,69803,3088,4.2
"47149",47,149,1994,77865,75510,2355,3
"47149",47,149,1995,83136,80270,2866,3.4
"47149",47,149,1996,87197,84166,3031,3.5
"47149",47,149,1997,90861,87501,3360,3.7
"47149",47,149,1998,95347,92562,2785,2.9
"47149",47,149,1999,99024,96468,2556,2.6
"47149",47,149,2000,102345,99271,3074,3
"47149",47,149,2001,105142,101305,3837,3.6
"47149",47,149,2002,108226,103794,4432,4.1
"47149",47,149,2003,110835,105991,4844,4.4
"47149",47,149,2004,113004,108394,4610,4.1
"47149",47,149,2005,117742,112833,4909,4.2
"47149",47,149,2006,127182,122056,5126,4
"47149",47,149,2007,130630,125789,4841,3.7
"47149",47,149,2008,133528,125803,7725,5.8
"47149",47,149,2009,135885,122762,13123,9.7
"47149",47,149,2010,140219,127797,12422,8.9
"47149",47,149,2011,144110,132654,11456,7.9
"47149",47,149,2012,145170,135724,9446,6.5
"47149",47,149,2013,146980,137817,9163,6.2
"47149",47,149,2014,148975,141168,7807,5.2
"47149",47,149,2015,155332,148375,6957,4.5
"47149",47,149,2016,163654,157631,6023,3.7
"47149",47,149,2017,169956,165060,4896,2.9
"47151",47,151,1990,7145,6458,687,9.6
"47151",47,151,1991,7720,6620,1100,14.2
"47151",47,151,1992,7701,6476,1225,15.9
"47151",47,151,1993,7746,6578,1168,15.1
"47151",47,151,1994,8146,7314,832,10.2
"47151",47,151,1995,8690,7804,886,10.2
"47151",47,151,1996,8716,7844,872,10
"47151",47,151,1997,8621,7879,742,8.6
"47151",47,151,1998,8538,7958,580,6.8
"47151",47,151,1999,8977,8224,753,8.4
"47151",47,151,2000,8605,8162,443,5.1
"47151",47,151,2001,8793,8203,590,6.7
"47151",47,151,2002,8646,7730,916,10.6
"47151",47,151,2003,8509,7681,828,9.7
"47151",47,151,2004,8333,7729,604,7.2
"47151",47,151,2005,8437,7853,584,6.9
"47151",47,151,2006,8825,8232,593,6.7
"47151",47,151,2007,8771,8156,615,7
"47151",47,151,2008,8536,7551,985,11.5
"47151",47,151,2009,8519,6956,1563,18.3
"47151",47,151,2010,9253,7680,1573,17
"47151",47,151,2011,9144,7539,1605,17.6
"47151",47,151,2012,8774,7411,1363,15.5
"47151",47,151,2013,8582,7338,1244,14.5
"47151",47,151,2014,8213,7256,957,11.7
"47151",47,151,2015,8067,7316,751,9.3
"47151",47,151,2016,8023,7430,593,7.4
"47151",47,151,2017,8171,7756,415,5.1
"47153",47,153,1990,4050,3856,194,4.8
"47153",47,153,1991,4536,4202,334,7.4
"47153",47,153,1992,4450,4018,432,9.7
"47153",47,153,1993,4742,4369,373,7.9
"47153",47,153,1994,4731,4408,323,6.8
"47153",47,153,1995,4689,4410,279,6
"47153",47,153,1996,4889,4591,298,6.1
"47153",47,153,1997,4810,4481,329,6.8
"47153",47,153,1998,4845,4561,284,5.9
"47153",47,153,1999,4960,4764,196,4
"47153",47,153,2000,5317,5115,202,3.8
"47153",47,153,2001,5394,5138,256,4.7
"47153",47,153,2002,5517,5245,272,4.9
"47153",47,153,2003,5560,5270,290,5.2
"47153",47,153,2004,5607,5309,298,5.3
"47153",47,153,2005,5792,5461,331,5.7
"47153",47,153,2006,6112,5835,277,4.5
"47153",47,153,2007,6185,5886,299,4.8
"47153",47,153,2008,6269,5793,476,7.6
"47153",47,153,2009,6309,5530,779,12.3
"47153",47,153,2010,6101,5364,737,12.1
"47153",47,153,2011,6093,5471,622,10.2
"47153",47,153,2012,5960,5460,500,8.4
"47153",47,153,2013,5908,5399,509,8.6
"47153",47,153,2014,5705,5281,424,7.4
"47153",47,153,2015,5783,5409,374,6.5
"47153",47,153,2016,5922,5577,345,5.8
"47153",47,153,2017,6087,5787,300,4.9
"47155",47,155,1990,27170,24790,2380,8.8
"47155",47,155,1991,28169,25525,2644,9.4
"47155",47,155,1992,29672,26844,2828,9.5
"47155",47,155,1993,31149,28367,2782,8.9
"47155",47,155,1994,32388,29837,2551,7.9
"47155",47,155,1995,33588,30739,2849,8.5
"47155",47,155,1996,34239,31384,2855,8.3
"47155",47,155,1997,34812,31943,2869,8.2
"47155",47,155,1998,35379,32992,2387,6.7
"47155",47,155,1999,36308,33952,2356,6.5
"47155",47,155,2000,39426,37500,1926,4.9
"47155",47,155,2001,40086,37930,2156,5.4
"47155",47,155,2002,41529,39098,2431,5.9
"47155",47,155,2003,43166,40607,2559,5.9
"47155",47,155,2004,43722,41045,2677,6.1
"47155",47,155,2005,44971,42243,2728,6.1
"47155",47,155,2006,47576,44988,2588,5.4
"47155",47,155,2007,48350,45955,2395,5
"47155",47,155,2008,48468,45049,3419,7.1
"47155",47,155,2009,48753,43453,5300,10.9
"47155",47,155,2010,49081,43961,5120,10.4
"47155",47,155,2011,49713,44746,4967,10
"47155",47,155,2012,49488,45160,4328,8.7
"47155",47,155,2013,48968,44826,4142,8.5
"47155",47,155,2014,48668,45200,3468,7.1
"47155",47,155,2015,49768,46775,2993,6
"47155",47,155,2016,51213,48687,2526,4.9
"47155",47,155,2017,52301,50215,2086,4
"47157",47,157,1990,396770,378906,17864,4.5
"47157",47,157,1991,396182,374207,21975,5.5
"47157",47,157,1992,396267,373133,23134,5.8
"47157",47,157,1993,400623,378542,22081,5.5
"47157",47,157,1994,415612,395978,19634,4.7
"47157",47,157,1995,430227,409163,21064,4.9
"47157",47,157,1996,434750,415658,19092,4.4
"47157",47,157,1997,441284,421196,20088,4.6
"47157",47,157,1998,445859,428636,17223,3.9
"47157",47,157,1999,451185,434479,16706,3.7
"47157",47,157,2000,438053,421418,16635,3.8
"47157",47,157,2001,438554,419566,18988,4.3
"47157",47,157,2002,440141,417056,23085,5.2
"47157",47,157,2003,438615,412494,26121,6
"47157",47,157,2004,426615,401090,25525,6
"47157",47,157,2005,428931,402211,26720,6.2
"47157",47,157,2006,444671,419148,25523,5.7
"47157",47,157,2007,446771,424197,22574,5.1
"47157",47,157,2008,440054,409635,30419,6.9
"47157",47,157,2009,438125,393849,44276,10.1
"47157",47,157,2010,448829,405047,43782,9.8
"47157",47,157,2011,451309,408345,42964,9.5
"47157",47,157,2012,446126,407723,38403,8.6
"47157",47,157,2013,438627,399995,38632,8.8
"47157",47,157,2014,427667,395109,32558,7.6
"47157",47,157,2015,429297,401766,27531,6.4
"47157",47,157,2016,434261,411126,23135,5.3
"47157",47,157,2017,439415,420439,18976,4.3
"47159",47,159,1990,6755,6301,454,6.7
"47159",47,159,1991,6999,6467,532,7.6
"47159",47,159,1992,7782,7331,451,5.8
"47159",47,159,1993,8307,7910,397,4.8
"47159",47,159,1994,9072,8665,407,4.5
"47159",47,159,1995,9236,8792,444,4.8
"47159",47,159,1996,9265,8794,471,5.1
"47159",47,159,1997,9430,8933,497,5.3
"47159",47,159,1998,9748,9373,375,3.8
"47159",47,159,1999,9849,9479,370,3.8
"47159",47,159,2000,8879,8502,377,4.2
"47159",47,159,2001,8904,8477,427,4.8
"47159",47,159,2002,8956,8506,450,5
"47159",47,159,2003,9219,8466,753,8.2
"47159",47,159,2004,8981,8386,595,6.6
"47159",47,159,2005,9047,8501,546,6
"47159",47,159,2006,9363,8822,541,5.8
"47159",47,159,2007,9148,8659,489,5.3
"47159",47,159,2008,9260,8505,755,8.2
"47159",47,159,2009,9359,8087,1272,13.6
"47159",47,159,2010,8934,7838,1096,12.3
"47159",47,159,2011,8861,7954,907,10.2
"47159",47,159,2012,8670,7963,707,8.2
"47159",47,159,2013,8513,7848,665,7.8
"47159",47,159,2014,8306,7776,530,6.4
"47159",47,159,2015,8472,7997,475,5.6
"47159",47,159,2016,8683,8286,397,4.6
"47159",47,159,2017,8996,8678,318,3.5
"47161",47,161,1990,4422,4117,305,6.9
"47161",47,161,1991,5020,4616,404,8
"47161",47,161,1992,4092,3675,417,10.2
"47161",47,161,1993,4093,3707,386,9.4
"47161",47,161,1994,4281,3872,409,9.6
"47161",47,161,1995,3985,3372,613,15.4
"47161",47,161,1996,3820,3248,572,15
"47161",47,161,1997,3509,3018,491,14
"47161",47,161,1998,3294,2956,338,10.3
"47161",47,161,1999,3482,3204,278,8
"47161",47,161,2000,5488,5226,262,4.8
"47161",47,161,2001,5601,5302,299,5.3
"47161",47,161,2002,5824,5453,371,6.4
"47161",47,161,2003,5864,5468,396,6.8
"47161",47,161,2004,5831,5448,383,6.6
"47161",47,161,2005,5865,5432,433,7.4
"47161",47,161,2006,6313,5831,482,7.6
"47161",47,161,2007,5896,5536,360,6.1
"47161",47,161,2008,5928,5422,506,8.5
"47161",47,161,2009,5915,5210,705,11.9
"47161",47,161,2010,5669,4966,703,12.4
"47161",47,161,2011,5657,4955,702,12.4
"47161",47,161,2012,5542,4931,611,11
"47161",47,161,2013,5339,4754,585,11
"47161",47,161,2014,5203,4723,480,9.2
"47161",47,161,2015,5131,4737,394,7.7
"47161",47,161,2016,5168,4818,350,6.8
"47161",47,161,2017,5203,4926,277,5.3
"47163",47,163,1990,69039,66275,2764,4
"47163",47,163,1991,69927,66517,3410,4.9
"47163",47,163,1992,71815,68151,3664,5.1
"47163",47,163,1993,72654,69047,3607,5
"47163",47,163,1994,74522,70857,3665,4.9
"47163",47,163,1995,76249,72714,3535,4.6
"47163",47,163,1996,76518,73498,3020,3.9
"47163",47,163,1997,76290,73331,2959,3.9
"47163",47,163,1998,75330,72382,2948,3.9
"47163",47,163,1999,75670,72631,3039,4
"47163",47,163,2000,72620,69973,2647,3.6
"47163",47,163,2001,73259,70200,3059,4.2
"47163",47,163,2002,74132,70323,3809,5.1
"47163",47,163,2003,74156,69943,4213,5.7
"47163",47,163,2004,71578,67635,3943,5.5
"47163",47,163,2005,71480,67752,3728,5.2
"47163",47,163,2006,74291,70919,3372,4.5
"47163",47,163,2007,74033,71092,2941,4
"47163",47,163,2008,74632,70674,3958,5.3
"47163",47,163,2009,74989,68394,6595,8.8
"47163",47,163,2010,73637,66974,6663,9
"47163",47,163,2011,74647,68445,6202,8.3
"47163",47,163,2012,72944,67447,5497,7.5
"47163",47,163,2013,71515,66077,5438,7.6
"47163",47,163,2014,69534,64918,4616,6.6
"47163",47,163,2015,69035,65049,3986,5.8
"47163",47,163,2016,69778,66179,3599,5.2
"47163",47,163,2017,70193,67370,2823,4
"47165",47,165,1990,54501,51711,2790,5.1
"47165",47,165,1991,55114,51404,3710,6.7
"47165",47,165,1992,56062,52495,3567,6.4
"47165",47,165,1993,58439,55509,2930,5
"47165",47,165,1994,61036,58865,2171,3.6
"47165",47,165,1995,63743,61326,2417,3.8
"47165",47,165,1996,65604,63212,2392,3.6
"47165",47,165,1997,67084,64600,2484,3.7
"47165",47,165,1998,69262,66910,2352,3.4
"47165",47,165,1999,70570,68697,1873,2.7
"47165",47,165,2000,70256,68028,2228,3.2
"47165",47,165,2001,71773,68584,3189,4.4
"47165",47,165,2002,72648,69388,3260,4.5
"47165",47,165,2003,73106,69687,3419,4.7
"47165",47,165,2004,73439,70212,3227,4.4
"47165",47,165,2005,75319,71846,3473,4.6
"47165",47,165,2006,79721,76393,3328,4.2
"47165",47,165,2007,79517,76262,3255,4.1
"47165",47,165,2008,79984,75213,4771,6
"47165",47,165,2009,80600,72678,7922,9.8
"47165",47,165,2010,83250,75868,7382,8.9
"47165",47,165,2011,84927,78236,6691,7.9
"47165",47,165,2012,85031,79493,5538,6.5
"47165",47,165,2013,85370,80082,5288,6.2
"47165",47,165,2014,86070,81544,4526,5.3
"47165",47,165,2015,88443,84371,4072,4.6
"47165",47,165,2016,92346,88773,3573,3.9
"47165",47,165,2017,95769,92939,2830,3
"47167",47,167,1990,16814,15956,858,5.1
"47167",47,167,1991,17075,15877,1198,7
"47167",47,167,1992,17196,15955,1241,7.2
"47167",47,167,1993,17916,16782,1134,6.3
"47167",47,167,1994,18863,17877,986,5.2
"47167",47,167,1995,20087,19013,1074,5.3
"47167",47,167,1996,20895,19859,1036,5
"47167",47,167,1997,21743,20609,1134,5.2
"47167",47,167,1998,22533,21510,1023,4.5
"47167",47,167,1999,22905,22153,752,3.3
"47167",47,167,2000,25059,24147,912,3.6
"47167",47,167,2001,25778,24600,1178,4.6
"47167",47,167,2002,26076,24647,1429,5.5
"47167",47,167,2003,26319,24632,1687,6.4
"47167",47,167,2004,25738,24137,1601,6.2
"47167",47,167,2005,26436,24733,1703,6.4
"47167",47,167,2006,27896,26341,1555,5.6
"47167",47,167,2007,28295,26840,1455,5.1
"47167",47,167,2008,28736,26473,2263,7.9
"47167",47,167,2009,29018,25418,3600,12.4
"47167",47,167,2010,29054,25761,3293,11.3
"47167",47,167,2011,28855,25878,2977,10.3
"47167",47,167,2012,28320,25811,2509,8.9
"47167",47,167,2013,27946,25294,2652,9.5
"47167",47,167,2014,27247,24995,2252,8.3
"47167",47,167,2015,27447,25504,1943,7.1
"47167",47,167,2016,27512,25952,1560,5.7
"47167",47,167,2017,27774,26553,1221,4.4
"47169",47,169,1990,2885,2709,176,6.1
"47169",47,169,1991,2834,2520,314,11.1
"47169",47,169,1992,2718,2481,237,8.7
"47169",47,169,1993,2925,2747,178,6.1
"47169",47,169,1994,2337,2191,146,6.2
"47169",47,169,1995,2338,2128,210,9
"47169",47,169,1996,2099,1875,224,10.7
"47169",47,169,1997,2041,1849,192,9.4
"47169",47,169,1998,2050,1867,183,8.9
"47169",47,169,1999,2120,2007,113,5.3
"47169",47,169,2000,3542,3423,119,3.4
"47169",47,169,2001,3600,3403,197,5.5
"47169",47,169,2002,3571,3390,181,5.1
"47169",47,169,2003,3583,3375,208,5.8
"47169",47,169,2004,3553,3351,202,5.7
"47169",47,169,2005,3671,3428,243,6.6
"47169",47,169,2006,3831,3599,232,6.1
"47169",47,169,2007,3686,3477,209,5.7
"47169",47,169,2008,3721,3410,311,8.4
"47169",47,169,2009,3718,3268,450,12.1
"47169",47,169,2010,3742,3336,406,10.8
"47169",47,169,2011,3762,3370,392,10.4
"47169",47,169,2012,3684,3366,318,8.6
"47169",47,169,2013,3649,3339,310,8.5
"47169",47,169,2014,3653,3396,257,7
"47169",47,169,2015,3677,3460,217,5.9
"47169",47,169,2016,3846,3661,185,4.8
"47169",47,169,2017,3971,3834,137,3.5
"47171",47,171,1990,7512,6922,590,7.9
"47171",47,171,1991,7821,6903,918,11.7
"47171",47,171,1992,7930,7096,834,10.5
"47171",47,171,1993,7940,7155,785,9.9
"47171",47,171,1994,8084,7291,793,9.8
"47171",47,171,1995,8129,7517,612,7.5
"47171",47,171,1996,8192,7663,529,6.5
"47171",47,171,1997,8183,7629,554,6.8
"47171",47,171,1998,7949,7526,423,5.3
"47171",47,171,1999,8061,7602,459,5.7
"47171",47,171,2000,8261,7705,556,6.7
"47171",47,171,2001,8157,7671,486,6
"47171",47,171,2002,8265,7705,560,6.8
"47171",47,171,2003,8283,7727,556,6.7
"47171",47,171,2004,8207,7696,511,6.2
"47171",47,171,2005,8144,7638,506,6.2
"47171",47,171,2006,8456,7932,524,6.2
"47171",47,171,2007,8429,7988,441,5.2
"47171",47,171,2008,8432,7808,624,7.4
"47171",47,171,2009,8472,7489,983,11.6
"47171",47,171,2010,7919,6973,946,11.9
"47171",47,171,2011,7904,7032,872,11
"47171",47,171,2012,7710,6916,794,10.3
"47171",47,171,2013,7406,6625,781,10.5
"47171",47,171,2014,7090,6443,647,9.1
"47171",47,171,2015,7020,6461,559,8
"47171",47,171,2016,7013,6516,497,7.1
"47171",47,171,2017,7044,6667,377,5.4
"47173",47,173,1990,6300,5965,335,5.3
"47173",47,173,1991,6465,6034,431,6.7
"47173",47,173,1992,6510,6203,307,4.7
"47173",47,173,1993,6695,6421,274,4.1
"47173",47,173,1994,6984,6766,218,3.1
"47173",47,173,1995,7411,7073,338,4.6
"47173",47,173,1996,7470,7152,318,4.3
"47173",47,173,1997,7562,7305,257,3.4
"47173",47,173,1998,7801,7467,334,4.3
"47173",47,173,1999,7978,7701,277,3.5
"47173",47,173,2000,8047,7743,304,3.8
"47173",47,173,2001,8402,8049,353,4.2
"47173",47,173,2002,8695,8292,403,4.6
"47173",47,173,2003,8724,8284,440,5
"47173",47,173,2004,8643,8207,436,5
"47173",47,173,2005,8718,8231,487,5.6
"47173",47,173,2006,8947,8512,435,4.9
"47173",47,173,2007,8826,8435,391,4.4
"47173",47,173,2008,8802,8250,552,6.3
"47173",47,173,2009,8913,7946,967,10.8
"47173",47,173,2010,7763,6927,836,10.8
"47173",47,173,2011,7846,7048,798,10.2
"47173",47,173,2012,7627,6907,720,9.4
"47173",47,173,2013,7413,6698,715,9.6
"47173",47,173,2014,7192,6625,567,7.9
"47173",47,173,2015,7208,6718,490,6.8
"47173",47,173,2016,7280,6861,419,5.8
"47173",47,173,2017,7359,7038,321,4.4
"47175",47,175,1990,2248,2022,226,10.1
"47175",47,175,1991,2231,2010,221,9.9
"47175",47,175,1992,2294,2092,202,8.8
"47175",47,175,1993,2437,2249,188,7.7
"47175",47,175,1994,2544,2312,232,9.1
"47175",47,175,1995,2475,2299,176,7.1
"47175",47,175,1996,2439,2253,186,7.6
"47175",47,175,1997,2461,2225,236,9.6
"47175",47,175,1998,2421,2254,167,6.9
"47175",47,175,1999,2419,2269,150,6.2
"47175",47,175,2000,2651,2530,121,4.6
"47175",47,175,2001,2613,2451,162,6.2
"47175",47,175,2002,2552,2377,175,6.9
"47175",47,175,2003,2515,2326,189,7.5
"47175",47,175,2004,2462,2307,155,6.3
"47175",47,175,2005,2456,2245,211,8.6
"47175",47,175,2006,2526,2326,200,7.9
"47175",47,175,2007,2505,2356,149,5.9
"47175",47,175,2008,2507,2298,209,8.3
"47175",47,175,2009,2452,2087,365,14.9
"47175",47,175,2010,2342,2033,309,13.2
"47175",47,175,2011,2297,2028,269,11.7
"47175",47,175,2012,2245,1987,258,11.5
"47175",47,175,2013,2192,1939,253,11.5
"47175",47,175,2014,2098,1897,201,9.6
"47175",47,175,2015,2050,1886,164,8
"47175",47,175,2016,2037,1912,125,6.1
"47175",47,175,2017,2099,2008,91,4.3
"47177",47,177,1990,16941,15682,1259,7.4
"47177",47,177,1991,17209,15666,1543,9
"47177",47,177,1992,17807,16323,1484,8.3
"47177",47,177,1993,18599,17255,1344,7.2
"47177",47,177,1994,19091,18025,1066,5.6
"47177",47,177,1995,19413,18179,1234,6.4
"47177",47,177,1996,19267,18063,1204,6.2
"47177",47,177,1997,19431,17905,1526,7.9
"47177",47,177,1998,19647,18438,1209,6.2
"47177",47,177,1999,19655,18777,878,4.5
"47177",47,177,2000,19374,18591,783,4
"47177",47,177,2001,18798,17576,1222,6.5
"47177",47,177,2002,19613,18345,1268,6.5
"47177",47,177,2003,19738,18589,1149,5.8
"47177",47,177,2004,19129,18137,992,5.2
"47177",47,177,2005,18324,16872,1452,7.9
"47177",47,177,2006,18443,16792,1651,9
"47177",47,177,2007,17935,16793,1142,6.4
"47177",47,177,2008,17507,16023,1484,8.5
"47177",47,177,2009,17151,14688,2463,14.4
"47177",47,177,2010,17750,15815,1935,10.9
"47177",47,177,2011,17934,16102,1832,10.2
"47177",47,177,2012,17498,15964,1534,8.8
"47177",47,177,2013,17518,16022,1496,8.5
"47177",47,177,2014,17335,16162,1173,6.8
"47177",47,177,2015,17771,16775,996,5.6
"47177",47,177,2016,17673,16828,845,4.8
"47177",47,177,2017,17195,16521,674,3.9
"47179",47,179,1990,45756,43719,2037,4.5
"47179",47,179,1991,46756,44160,2596,5.6
"47179",47,179,1992,47822,45218,2604,5.4
"47179",47,179,1993,49079,46259,2820,5.7
"47179",47,179,1994,49897,47688,2209,4.4
"47179",47,179,1995,51492,49424,2068,4
"47179",47,179,1996,52367,50356,2011,3.8
"47179",47,179,1997,52779,50633,2146,4.1
"47179",47,179,1998,52175,50391,1784,3.4
"47179",47,179,1999,52805,50913,1892,3.6
"47179",47,179,2000,54816,52670,2146,3.9
"47179",47,179,2001,55303,52698,2605,4.7
"47179",47,179,2002,56485,53481,3004,5.3
"47179",47,179,2003,56810,53857,2953,5.2
"47179",47,179,2004,57105,54273,2832,5
"47179",47,179,2005,57753,54913,2840,4.9
"47179",47,179,2006,60380,57650,2730,4.5
"47179",47,179,2007,61604,59119,2485,4
"47179",47,179,2008,62201,58702,3499,5.6
"47179",47,179,2009,62614,57165,5449,8.7
"47179",47,179,2010,60672,55393,5279,8.7
"47179",47,179,2011,61291,56366,4925,8
"47179",47,179,2012,60304,56033,4271,7.1
"47179",47,179,2013,58779,54532,4247,7.2
"47179",47,179,2014,57441,53824,3617,6.3
"47179",47,179,2015,57746,54540,3206,5.6
"47179",47,179,2016,58751,55951,2800,4.8
"47179",47,179,2017,59402,57152,2250,3.8
"47181",47,181,1990,6894,6394,500,7.3
"47181",47,181,1991,6956,6307,649,9.3
"47181",47,181,1992,7426,6839,587,7.9
"47181",47,181,1993,7484,6933,551,7.4
"47181",47,181,1994,7563,6936,627,8.3
"47181",47,181,1995,7633,6756,877,11.5
"47181",47,181,1996,7803,6944,859,11
"47181",47,181,1997,7884,6872,1012,12.8
"47181",47,181,1998,7758,6698,1060,13.7
"47181",47,181,1999,7638,6731,907,11.9
"47181",47,181,2000,6679,6138,541,8.1
"47181",47,181,2001,6729,6119,610,9.1
"47181",47,181,2002,6853,6252,601,8.8
"47181",47,181,2003,6720,6052,668,9.9
"47181",47,181,2004,6549,5992,557,8.5
"47181",47,181,2005,6498,5708,790,12.2
"47181",47,181,2006,6667,5976,691,10.4
"47181",47,181,2007,6671,6180,491,7.4
"47181",47,181,2008,6641,5973,668,10.1
"47181",47,181,2009,6692,5794,898,13.4
"47181",47,181,2010,6935,6144,791,11.4
"47181",47,181,2011,6812,6080,732,10.7
"47181",47,181,2012,6662,6031,631,9.5
"47181",47,181,2013,6531,5899,632,9.7
"47181",47,181,2014,6425,5866,559,8.7
"47181",47,181,2015,6177,5720,457,7.4
"47181",47,181,2016,6089,5689,400,6.6
"47181",47,181,2017,6157,5838,319,5.2
"47183",47,183,1990,16143,15085,1058,6.6
"47183",47,183,1991,16155,15092,1063,6.6
"47183",47,183,1992,17609,16816,793,4.5
"47183",47,183,1993,18047,17510,537,3
"47183",47,183,1994,17463,16968,495,2.8
"47183",47,183,1995,17765,17099,666,3.7
"47183",47,183,1996,18174,17243,931,5.1
"47183",47,183,1997,17745,16698,1047,5.9
"47183",47,183,1998,17499,16505,994,5.7
"47183",47,183,1999,17130,16096,1034,6
"47183",47,183,2000,16760,15942,818,4.9
"47183",47,183,2001,17073,16086,987,5.8
"47183",47,183,2002,17218,16156,1062,6.2
"47183",47,183,2003,16538,15184,1354,8.2
"47183",47,183,2004,15563,14428,1135,7.3
"47183",47,183,2005,15305,14240,1065,7
"47183",47,183,2006,15801,14722,1079,6.8
"47183",47,183,2007,15734,14711,1023,6.5
"47183",47,183,2008,15657,14375,1282,8.2
"47183",47,183,2009,15947,13961,1986,12.5
"47183",47,183,2010,16934,15072,1862,11
"47183",47,183,2011,16711,14806,1905,11.4
"47183",47,183,2012,16946,15094,1852,10.9
"47183",47,183,2013,16516,14800,1716,10.4
"47183",47,183,2014,15804,14453,1351,8.5
"47183",47,183,2015,15564,14510,1054,6.8
"47183",47,183,2016,15865,14940,925,5.8
"47183",47,183,2017,15897,15125,772,4.9
"47185",47,185,1990,9772,8909,863,8.8
"47185",47,185,1991,9521,8568,953,10
"47185",47,185,1992,9936,8931,1005,10.1
"47185",47,185,1993,9911,9077,834,8.4
"47185",47,185,1994,10731,10028,703,6.6
"47185",47,185,1995,10760,10020,740,6.9
"47185",47,185,1996,11430,10615,815,7.1
"47185",47,185,1997,11254,10251,1003,8.9
"47185",47,185,1998,11440,10800,640,5.6
"47185",47,185,1999,11499,10977,522,4.5
"47185",47,185,2000,10906,10413,493,4.5
"47185",47,185,2001,10587,9971,616,5.8
"47185",47,185,2002,10655,9956,699,6.6
"47185",47,185,2003,10801,9959,842,7.8
"47185",47,185,2004,10756,10120,636,5.9
"47185",47,185,2005,10785,9736,1049,9.7
"47185",47,185,2006,10908,9920,988,9.1
"47185",47,185,2007,10612,9971,641,6
"47185",47,185,2008,10623,9734,889,8.4
"47185",47,185,2009,10682,9168,1514,14.2
"47185",47,185,2010,12333,11036,1297,10.5
"47185",47,185,2011,12485,11254,1231,9.9
"47185",47,185,2012,12213,11020,1193,9.8
"47185",47,185,2013,11865,10740,1125,9.5
"47185",47,185,2014,11382,10540,842,7.4
"47185",47,185,2015,11395,10705,690,6.1
"47185",47,185,2016,11765,11180,585,5
"47185",47,185,2017,11965,11492,473,4
"47187",47,187,1990,42860,41642,1218,2.8
"47187",47,187,1991,43853,42328,1525,3.5
"47187",47,187,1992,45742,44004,1738,3.8
"47187",47,187,1993,48756,47338,1418,2.9
"47187",47,187,1994,53003,51802,1201,2.3
"47187",47,187,1995,55883,54724,1159,2.1
"47187",47,187,1996,58679,57471,1208,2.1
"47187",47,187,1997,61599,60275,1324,2.1
"47187",47,187,1998,65960,64853,1107,1.7
"47187",47,187,1999,70195,68893,1302,1.9
"47187",47,187,2000,69784,68072,1712,2.5
"47187",47,187,2001,71564,69569,1995,2.8
"47187",47,187,2002,73732,71214,2518,3.4
"47187",47,187,2003,75612,72878,2734,3.6
"47187",47,187,2004,77382,74595,2787,3.6
"47187",47,187,2005,81057,77958,3099,3.8
"47187",47,187,2006,87280,84211,3069,3.5
"47187",47,187,2007,88210,84981,3229,3.7
"47187",47,187,2008,89065,84967,4098,4.6
"47187",47,187,2009,89683,82930,6753,7.5
"47187",47,187,2010,94495,88285,6210,6.6
"47187",47,187,2011,97414,91713,5701,5.9
"47187",47,187,2012,99015,94106,4909,5
"47187",47,187,2013,101172,95951,5221,5.2
"47187",47,187,2014,103213,98538,4675,4.5
"47187",47,187,2015,107404,103103,4301,4
"47187",47,187,2016,113583,109713,3870,3.4
"47187",47,187,2017,118004,114854,3150,2.7
"47189",47,189,1990,36052,34253,1799,5
"47189",47,189,1991,36420,34267,2153,5.9
"47189",47,189,1992,36863,34929,1934,5.2
"47189",47,189,1993,38469,36896,1573,4.1
"47189",47,189,1994,40757,39368,1389,3.4
"47189",47,189,1995,42621,40967,1654,3.9
"47189",47,189,1996,43967,42348,1619,3.7
"47189",47,189,1997,45251,43527,1724,3.8
"47189",47,189,1998,47378,45762,1616,3.4
"47189",47,189,1999,48950,47638,1312,2.7
"47189",47,189,2000,49650,48107,1543,3.1
"47189",47,189,2001,50511,48655,1856,3.7
"47189",47,189,2002,51549,49364,2185,4.2
"47189",47,189,2003,52298,49871,2427,4.6
"47189",47,189,2004,52691,50322,2369,4.5
"47189",47,189,2005,54198,51727,2471,4.6
"47189",47,189,2006,57827,55252,2575,4.5
"47189",47,189,2007,57487,55167,2320,4
"47189",47,189,2008,58531,55177,3354,5.7
"47189",47,189,2009,58741,53438,5303,9
"47189",47,189,2010,58517,53617,4900,8.4
"47189",47,189,2011,60063,55525,4538,7.6
"47189",47,189,2012,60691,56806,3885,6.4
"47189",47,189,2013,61464,57587,3877,6.3
"47189",47,189,2014,62232,58949,3283,5.3
"47189",47,189,2015,64515,61562,2953,4.6
"47189",47,189,2016,67843,65239,2604,3.8
"47189",47,189,2017,70373,68315,2058,2.9
"48001",48,1,1990,17851,16599,1252,7
"48001",48,1,1991,18294,17093,1201,6.6
"48001",48,1,1992,18588,17171,1417,7.6
"48001",48,1,1993,18630,17467,1163,6.2
"48001",48,1,1994,19750,18730,1020,5.2
"48001",48,1,1995,20568,19473,1095,5.3
"48001",48,1,1996,20153,18973,1180,5.9
"48001",48,1,1997,20159,19002,1157,5.7
"48001",48,1,1998,20949,19735,1214,5.8
"48001",48,1,1999,20467,19198,1269,6.2
"48001",48,1,2000,19623,18442,1181,6
"48001",48,1,2001,19894,18712,1182,5.9
"48001",48,1,2002,20036,18533,1503,7.5
"48001",48,1,2003,20632,18992,1640,7.9
"48001",48,1,2004,20587,19165,1422,6.9
"48001",48,1,2005,20015,18753,1262,6.3
"48001",48,1,2006,20220,19040,1180,5.8
"48001",48,1,2007,20033,19024,1009,5
"48001",48,1,2008,20214,19087,1127,5.6
"48001",48,1,2009,20852,19040,1812,8.7
"48001",48,1,2010,21711,19956,1755,8.1
"48001",48,1,2011,22194,20570,1624,7.3
"48001",48,1,2012,22391,20974,1417,6.3
"48001",48,1,2013,22042,20763,1279,5.8
"48001",48,1,2014,21793,20778,1015,4.7
"48001",48,1,2015,22826,21930,896,3.9
"48001",48,1,2016,23466,22452,1014,4.3
"48001",48,1,2017,23262,22419,843,3.6
"48003",48,3,1990,6335,6102,233,3.7
"48003",48,3,1991,6351,6067,284,4.5
"48003",48,3,1992,6342,5831,511,8.1
"48003",48,3,1993,6061,5606,455,7.5
"48003",48,3,1994,5865,5467,398,6.8
"48003",48,3,1995,5510,5220,290,5.3
"48003",48,3,1996,5516,5253,263,4.8
"48003",48,3,1997,5462,5183,279,5.1
"48003",48,3,1998,5526,5084,442,8
"48003",48,3,1999,5300,4692,608,11.5
"48003",48,3,2000,5628,5354,274,4.9
"48003",48,3,2001,5674,5435,239,4.2
"48003",48,3,2002,5864,5542,322,5.5
"48003",48,3,2003,6244,5901,343,5.5
"48003",48,3,2004,6200,5910,290,4.7
"48003",48,3,2005,6337,6082,255,4
"48003",48,3,2006,6786,6551,235,3.5
"48003",48,3,2007,6678,6465,213,3.2
"48003",48,3,2008,6871,6642,229,3.3
"48003",48,3,2009,6985,6494,491,7
"48003",48,3,2010,7120,6681,439,6.2
"48003",48,3,2011,7794,7405,389,5
"48003",48,3,2012,8544,8203,341,4
"48003",48,3,2013,9173,8823,350,3.8
"48003",48,3,2014,9529,9244,285,3
"48003",48,3,2015,9293,8970,323,3.5
"48003",48,3,2016,8674,8265,409,4.7
"48003",48,3,2017,9011,8735,276,3.1
"48005",48,5,1990,32155,30083,2072,6.4
"48005",48,5,1991,32586,30201,2385,7.3
"48005",48,5,1992,33659,31101,2558,7.6
"48005",48,5,1993,34384,31636,2748,8
"48005",48,5,1994,34199,32004,2195,6.4
"48005",48,5,1995,34320,32506,1814,5.3
"48005",48,5,1996,34914,33050,1864,5.3
"48005",48,5,1997,35910,33998,1912,5.3
"48005",48,5,1998,36275,34166,2109,5.8
"48005",48,5,1999,35789,33637,2152,6
"48005",48,5,2000,37984,36179,1805,4.8
"48005",48,5,2001,38566,36476,2090,5.4
"48005",48,5,2002,39305,36729,2576,6.6
"48005",48,5,2003,40274,37631,2643,6.6
"48005",48,5,2004,40159,37569,2590,6.4
"48005",48,5,2005,39283,37137,2146,5.5
"48005",48,5,2006,39965,38111,1854,4.6
"48005",48,5,2007,39625,37905,1720,4.3
"48005",48,5,2008,39083,37234,1849,4.7
"48005",48,5,2009,39961,36681,3280,8.2
"48005",48,5,2010,38067,34825,3242,8.5
"48005",48,5,2011,38118,35107,3011,7.9
"48005",48,5,2012,37870,35257,2613,6.9
"48005",48,5,2013,37966,35509,2457,6.5
"48005",48,5,2014,37742,35767,1975,5.2
"48005",48,5,2015,37364,35278,2086,5.6
"48005",48,5,2016,36997,34814,2183,5.9
"48005",48,5,2017,36614,34757,1857,5.1
"48007",48,7,1990,7412,7115,297,4
"48007",48,7,1991,7665,7380,285,3.7
"48007",48,7,1992,7864,7388,476,6.1
"48007",48,7,1993,8317,7828,489,5.9
"48007",48,7,1994,8736,8178,558,6.4
"48007",48,7,1995,8861,8313,548,6.2
"48007",48,7,1996,8974,8541,433,4.8
"48007",48,7,1997,9421,8812,609,6.5
"48007",48,7,1998,9650,9063,587,6.1
"48007",48,7,1999,9711,9144,567,5.8
"48007",48,7,2000,9737,9166,571,5.9
"48007",48,7,2001,9893,9261,632,6.4
"48007",48,7,2002,10242,9523,719,7
"48007",48,7,2003,10740,9946,794,7.4
"48007",48,7,2004,10995,10094,901,8.2
"48007",48,7,2005,10964,10363,601,5.5
"48007",48,7,2006,11014,10500,514,4.7
"48007",48,7,2007,10996,10554,442,4
"48007",48,7,2008,11389,10890,499,4.4
"48007",48,7,2009,11566,10776,790,6.8
"48007",48,7,2010,9686,8796,890,9.2
"48007",48,7,2011,9815,8954,861,8.8
"48007",48,7,2012,9944,9251,693,7
"48007",48,7,2013,10069,9408,661,6.6
"48007",48,7,2014,10201,9637,564,5.5
"48007",48,7,2015,10051,9543,508,5.1
"48007",48,7,2016,10220,9649,571,5.6
"48007",48,7,2017,10366,9665,701,6.8
"48009",48,9,1990,3856,3710,146,3.8
"48009",48,9,1991,3750,3603,147,3.9
"48009",48,9,1992,3761,3616,145,3.9
"48009",48,9,1993,3875,3739,136,3.5
"48009",48,9,1994,4001,3839,162,4
"48009",48,9,1995,4060,3944,116,2.9
"48009",48,9,1996,4116,3994,122,3
"48009",48,9,1997,4143,4035,108,2.6
"48009",48,9,1998,4165,4021,144,3.5
"48009",48,9,1999,4068,3937,131,3.2
"48009",48,9,2000,4871,4717,154,3.2
"48009",48,9,2001,5011,4850,161,3.2
"48009",48,9,2002,5123,4918,205,4
"48009",48,9,2003,5262,5039,223,4.2
"48009",48,9,2004,5321,5123,198,3.7
"48009",48,9,2005,5289,5105,184,3.5
"48009",48,9,2006,5449,5266,183,3.4
"48009",48,9,2007,5100,4939,161,3.2
"48009",48,9,2008,5129,4943,186,3.6
"48009",48,9,2009,5001,4705,296,5.9
"48009",48,9,2010,4601,4295,306,6.7
"48009",48,9,2011,4484,4212,272,6.1
"48009",48,9,2012,4370,4131,239,5.5
"48009",48,9,2013,4231,4010,221,5.2
"48009",48,9,2014,4242,4051,191,4.5
"48009",48,9,2015,4119,3937,182,4.4
"48009",48,9,2016,4081,3905,176,4.3
"48009",48,9,2017,4093,3953,140,3.4
"48011",48,11,1990,994,947,47,4.7
"48011",48,11,1991,1047,1012,35,3.3
"48011",48,11,1992,1073,1030,43,4
"48011",48,11,1993,1005,965,40,4
"48011",48,11,1994,953,917,36,3.8
"48011",48,11,1995,959,927,32,3.3
"48011",48,11,1996,1004,975,29,2.9
"48011",48,11,1997,935,899,36,3.9
"48011",48,11,1998,979,958,21,2.1
"48011",48,11,1999,1032,1015,17,1.6
"48011",48,11,2000,1090,1056,34,3.1
"48011",48,11,2001,1085,1049,36,3.3
"48011",48,11,2002,1083,1034,49,4.5
"48011",48,11,2003,1093,1042,51,4.7
"48011",48,11,2004,1120,1076,44,3.9
"48011",48,11,2005,1123,1079,44,3.9
"48011",48,11,2006,1103,1064,39,3.5
"48011",48,11,2007,1068,1032,36,3.4
"48011",48,11,2008,1092,1054,38,3.5
"48011",48,11,2009,1060,1012,48,4.5
"48011",48,11,2010,1012,962,50,4.9
"48011",48,11,2011,1037,987,50,4.8
"48011",48,11,2012,1027,981,46,4.5
"48011",48,11,2013,1006,966,40,4
"48011",48,11,2014,1004,972,32,3.2
"48011",48,11,2015,975,949,26,2.7
"48011",48,11,2016,932,906,26,2.8
"48011",48,11,2017,920,897,23,2.5
"48013",48,13,1990,12729,11850,879,6.9
"48013",48,13,1991,13737,12755,982,7.1
"48013",48,13,1992,14287,13090,1197,8.4
"48013",48,13,1993,14979,14049,930,6.2
"48013",48,13,1994,15234,14510,724,4.8
"48013",48,13,1995,15505,14736,769,5
"48013",48,13,1996,15463,14749,714,4.6
"48013",48,13,1997,16177,15412,765,4.7
"48013",48,13,1998,16684,15890,794,4.8
"48013",48,13,1999,17901,17155,746,4.2
"48013",48,13,2000,17239,16536,703,4.1
"48013",48,13,2001,17721,16907,814,4.6
"48013",48,13,2002,18371,17273,1098,6
"48013",48,13,2003,18663,17414,1249,6.7
"48013",48,13,2004,18811,17733,1078,5.7
"48013",48,13,2005,19011,18014,997,5.2
"48013",48,13,2006,19177,18289,888,4.6
"48013",48,13,2007,18717,17957,760,4.1
"48013",48,13,2008,18903,18021,882,4.7
"48013",48,13,2009,19420,17978,1442,7.4
"48013",48,13,2010,19631,18030,1601,8.2
"48013",48,13,2011,19891,18303,1588,8
"48013",48,13,2012,20072,18719,1353,6.7
"48013",48,13,2013,20247,18985,1262,6.2
"48013",48,13,2014,20372,19365,1007,4.9
"48013",48,13,2015,20520,19544,976,4.8
"48013",48,13,2016,20984,19864,1120,5.3
"48013",48,13,2017,21181,20295,886,4.2
"48015",48,15,1990,9193,8856,337,3.7
"48015",48,15,1991,9641,9304,337,3.5
"48015",48,15,1992,9679,9268,411,4.2
"48015",48,15,1993,10217,9808,409,4
"48015",48,15,1994,10666,10231,435,4.1
"48015",48,15,1995,11326,10912,414,3.7
"48015",48,15,1996,11468,11055,413,3.6
"48015",48,15,1997,11776,11316,460,3.9
"48015",48,15,1998,12612,12203,409,3.2
"48015",48,15,1999,13469,12951,518,3.8
"48015",48,15,2000,12019,11551,468,3.9
"48015",48,15,2001,12186,11707,479,3.9
"48015",48,15,2002,12397,11744,653,5.3
"48015",48,15,2003,12629,11849,780,6.2
"48015",48,15,2004,12668,12000,668,5.3
"48015",48,15,2005,12797,12216,581,4.5
"48015",48,15,2006,12695,12148,547,4.3
"48015",48,15,2007,12820,12342,478,3.7
"48015",48,15,2008,13014,12468,546,4.2
"48015",48,15,2009,13214,12246,968,7.3
"48015",48,15,2010,13920,12801,1119,8
"48015",48,15,2011,14153,13036,1117,7.9
"48015",48,15,2012,14093,13192,901,6.4
"48015",48,15,2013,14136,13307,829,5.9
"48015",48,15,2014,14136,13462,674,4.8
"48015",48,15,2015,14030,13386,644,4.6
"48015",48,15,2016,14004,13259,745,5.3
"48015",48,15,2017,13997,13391,606,4.3
"48017",48,17,1990,3650,3548,102,2.8
"48017",48,17,1991,3796,3615,181,4.8
"48017",48,17,1992,3807,3560,247,6.5
"48017",48,17,1993,3891,3637,254,6.5
"48017",48,17,1994,3645,3460,185,5.1
"48017",48,17,1995,3773,3545,228,6
"48017",48,17,1996,3742,3538,204,5.5
"48017",48,17,1997,3545,3308,237,6.7
"48017",48,17,1998,3536,3313,223,6.3
"48017",48,17,1999,3475,3299,176,5.1
"48017",48,17,2000,3194,3049,145,4.5
"48017",48,17,2001,3317,3161,156,4.7
"48017",48,17,2002,3362,3179,183,5.4
"48017",48,17,2003,3645,3437,208,5.7
"48017",48,17,2004,3494,3303,191,5.5
"48017",48,17,2005,3234,3059,175,5.4
"48017",48,17,2006,3157,3001,156,4.9
"48017",48,17,2007,3277,3137,140,4.3
"48017",48,17,2008,3339,3203,136,4.1
"48017",48,17,2009,3350,3162,188,5.6
"48017",48,17,2010,3258,3001,257,7.9
"48017",48,17,2011,3290,3044,246,7.5
"48017",48,17,2012,3183,2963,220,6.9
"48017",48,17,2013,3048,2830,218,7.2
"48017",48,17,2014,2958,2809,149,5
"48017",48,17,2015,2798,2678,120,4.3
"48017",48,17,2016,2714,2595,119,4.4
"48017",48,17,2017,2670,2556,114,4.3
"48019",48,19,1990,5513,5421,92,1.7
"48019",48,19,1991,6122,5991,131,2.1
"48019",48,19,1992,6375,6167,208,3.3
"48019",48,19,1993,6455,6254,201,3.1
"48019",48,19,1994,6530,6335,195,3
"48019",48,19,1995,6700,6465,235,3.5
"48019",48,19,1996,6518,6288,230,3.5
"48019",48,19,1997,6276,6034,242,3.9
"48019",48,19,1998,6719,6496,223,3.3
"48019",48,19,1999,6893,6707,186,2.7
"48019",48,19,2000,8711,8396,315,3.6
"48019",48,19,2001,8928,8572,356,4
"48019",48,19,2002,9295,8822,473,5.1
"48019",48,19,2003,9480,8967,513,5.4
"48019",48,19,2004,9541,9061,480,5
"48019",48,19,2005,9665,9230,435,4.5
"48019",48,19,2006,9742,9331,411,4.2
"48019",48,19,2007,9579,9219,360,3.8
"48019",48,19,2008,9661,9240,421,4.4
"48019",48,19,2009,9817,9176,641,6.5
"48019",48,19,2010,9176,8460,716,7.8
"48019",48,19,2011,9179,8491,688,7.5
"48019",48,19,2012,9128,8530,598,6.6
"48019",48,19,2013,9071,8525,546,6
"48019",48,19,2014,9126,8691,435,4.8
"48019",48,19,2015,9171,8807,364,4
"48019",48,19,2016,9486,9097,389,4.1
"48019",48,19,2017,9639,9293,346,3.6
"48021",48,21,1990,18515,17638,877,4.7
"48021",48,21,1991,18682,17886,796,4.3
"48021",48,21,1992,19711,18834,877,4.4
"48021",48,21,1993,20624,19896,728,3.5
"48021",48,21,1994,22044,21368,676,3.1
"48021",48,21,1995,23198,22559,639,2.8
"48021",48,21,1996,24810,23966,844,3.4
"48021",48,21,1997,26108,25036,1072,4.1
"48021",48,21,1998,26925,26097,828,3.1
"48021",48,21,1999,28232,27519,713,2.5
"48021",48,21,2000,29727,28723,1004,3.4
"48021",48,21,2001,30526,29122,1404,4.6
"48021",48,21,2002,31618,29625,1993,6.3
"48021",48,21,2003,32574,30383,2191,6.7
"48021",48,21,2004,33101,31195,1906,5.8
"48021",48,21,2005,33653,31948,1705,5.1
"48021",48,21,2006,34124,32555,1569,4.6
"48021",48,21,2007,33376,31996,1380,4.1
"48021",48,21,2008,33669,32029,1640,4.9
"48021",48,21,2009,34248,31535,2713,7.9
"48021",48,21,2010,35289,32382,2907,8.2
"48021",48,21,2011,35719,32884,2835,7.9
"48021",48,21,2012,35304,32944,2360,6.7
"48021",48,21,2013,35910,33700,2210,6.2
"48021",48,21,2014,36713,34929,1784,4.9
"48021",48,21,2015,37507,36053,1454,3.9
"48021",48,21,2016,38959,37503,1456,3.7
"48021",48,21,2017,40124,38709,1415,3.5
"48023",48,23,1990,1986,1912,74,3.7
"48023",48,23,1991,1898,1777,121,6.4
"48023",48,23,1992,1853,1781,72,3.9
"48023",48,23,1993,1848,1774,74,4
"48023",48,23,1994,1849,1763,86,4.7
"48023",48,23,1995,1894,1800,94,5
"48023",48,23,1996,1824,1726,98,5.4
"48023",48,23,1997,1789,1687,102,5.7
"48023",48,23,1998,1816,1719,97,5.3
"48023",48,23,1999,1738,1664,74,4.3
"48023",48,23,2000,1849,1764,85,4.6
"48023",48,23,2001,1854,1764,90,4.9
"48023",48,23,2002,1869,1755,114,6.1
"48023",48,23,2003,2029,1908,121,6
"48023",48,23,2004,2008,1900,108,5.4
"48023",48,23,2005,1863,1774,89,4.8
"48023",48,23,2006,1922,1843,79,4.1
"48023",48,23,2007,2024,1948,76,3.8
"48023",48,23,2008,2032,1956,76,3.7
"48023",48,23,2009,1962,1852,110,5.6
"48023",48,23,2010,1733,1611,122,7
"48023",48,23,2011,1862,1751,111,6
"48023",48,23,2012,1866,1771,95,5.1
"48023",48,23,2013,1673,1584,89,5.3
"48023",48,23,2014,1652,1582,70,4.2
"48023",48,23,2015,1625,1568,57,3.5
"48023",48,23,2016,1603,1545,58,3.6
"48023",48,23,2017,1599,1544,55,3.4
"48025",48,25,1990,9717,9032,685,7
"48025",48,25,1991,9311,8626,685,7.4
"48025",48,25,1992,9477,8439,1038,11
"48025",48,25,1993,10137,8798,1339,13.2
"48025",48,25,1994,10579,9639,940,8.9
"48025",48,25,1995,11252,10340,912,8.1
"48025",48,25,1996,11075,10311,764,6.9
"48025",48,25,1997,10917,10281,636,5.8
"48025",48,25,1998,11078,10437,641,5.8
"48025",48,25,1999,10902,10235,667,6.1
"48025",48,25,2000,11323,10663,660,5.8
"48025",48,25,2001,11351,10670,681,6
"48025",48,25,2002,11444,10625,819,7.2
"48025",48,25,2003,11826,10868,958,8.1
"48025",48,25,2004,11424,10551,873,7.6
"48025",48,25,2005,11054,10267,787,7.1
"48025",48,25,2006,11415,10697,718,6.3
"48025",48,25,2007,11178,10523,655,5.9
"48025",48,25,2008,11234,10544,690,6.1
"48025",48,25,2009,11879,10809,1070,9
"48025",48,25,2010,10522,9582,940,8.9
"48025",48,25,2011,10591,9683,908,8.6
"48025",48,25,2012,10853,10090,763,7
"48025",48,25,2013,11321,10577,744,6.6
"48025",48,25,2014,10735,10112,623,5.8
"48025",48,25,2015,10373,9732,641,6.2
"48025",48,25,2016,10292,9517,775,7.5
"48025",48,25,2017,9938,9297,641,6.4
"48027",48,27,1990,76833,71289,5544,7.2
"48027",48,27,1991,76152,71011,5141,6.8
"48027",48,27,1992,79657,74111,5546,7
"48027",48,27,1993,84402,79434,4968,5.9
"48027",48,27,1994,86623,81824,4799,5.5
"48027",48,27,1995,89884,85443,4441,4.9
"48027",48,27,1996,90880,86370,4510,5
"48027",48,27,1997,92349,87620,4729,5.1
"48027",48,27,1998,93467,89418,4049,4.3
"48027",48,27,1999,94235,91011,3224,3.4
"48027",48,27,2000,101432,97227,4205,4.1
"48027",48,27,2001,102961,97989,4972,4.8
"48027",48,27,2002,107065,100809,6256,5.8
"48027",48,27,2003,108776,102007,6769,6.2
"48027",48,27,2004,110947,105164,5783,5.2
"48027",48,27,2005,114094,108380,5714,5
"48027",48,27,2006,115516,109785,5731,5
"48027",48,27,2007,118579,113309,5270,4.4
"48027",48,27,2008,122365,116433,5932,4.8
"48027",48,27,2009,126877,118431,8446,6.7
"48027",48,27,2010,131835,121669,10166,7.7
"48027",48,27,2011,133465,122763,10702,8
"48027",48,27,2012,134133,124194,9939,7.4
"48027",48,27,2013,135335,125981,9354,6.9
"48027",48,27,2014,134896,127044,7852,5.8
"48027",48,27,2015,136155,129832,6323,4.6
"48027",48,27,2016,139247,132983,6264,4.5
"48027",48,27,2017,141233,135305,5928,4.2
"48029",48,29,1990,563648,522540,41108,7.3
"48029",48,29,1991,567358,528464,38894,6.9
"48029",48,29,1992,588301,550605,37696,6.4
"48029",48,29,1993,603735,570095,33640,5.6
"48029",48,29,1994,619650,590199,29451,4.8
"48029",48,29,1995,635490,606201,29289,4.6
"48029",48,29,1996,643113,613908,29205,4.5
"48029",48,29,1997,656644,629289,27355,4.2
"48029",48,29,1998,661519,635849,25670,3.9
"48029",48,29,1999,670474,648566,21908,3.3
"48029",48,29,2000,662639,636095,26544,4
"48029",48,29,2001,670948,640055,30893,4.6
"48029",48,29,2002,688385,648499,39886,5.8
"48029",48,29,2003,697931,654692,43239,6.2
"48029",48,29,2004,703887,663941,39946,5.7
"48029",48,29,2005,714126,677680,36446,5.1
"48029",48,29,2006,728361,694464,33897,4.7
"48029",48,29,2007,733499,703469,30030,4.1
"48029",48,29,2008,748686,713891,34795,4.6
"48029",48,29,2009,763919,712413,51506,6.7
"48029",48,29,2010,812516,753313,59203,7.3
"48029",48,29,2011,829870,770139,59731,7.2
"48029",48,29,2012,840497,787214,53283,6.3
"48029",48,29,2013,854655,804941,49714,5.8
"48029",48,29,2014,866455,825960,40495,4.7
"48029",48,29,2015,878118,844697,33421,3.8
"48029",48,29,2016,903856,870020,33836,3.7
"48029",48,29,2017,924590,892277,32313,3.5
"48031",48,31,1990,2858,2812,46,1.6
"48031",48,31,1991,2933,2847,86,2.9
"48031",48,31,1992,2985,2868,117,3.9
"48031",48,31,1993,3128,3022,106,3.4
"48031",48,31,1994,3238,3150,88,2.7
"48031",48,31,1995,3410,3327,83,2.4
"48031",48,31,1996,3554,3455,99,2.8
"48031",48,31,1997,3614,3523,91,2.5
"48031",48,31,1998,3758,3675,83,2.2
"48031",48,31,1999,3927,3843,84,2.1
"48031",48,31,2000,4476,4336,140,3.1
"48031",48,31,2001,4417,4253,164,3.7
"48031",48,31,2002,4507,4290,217,4.8
"48031",48,31,2003,4687,4459,228,4.9
"48031",48,31,2004,4811,4600,211,4.4
"48031",48,31,2005,4691,4500,191,4.1
"48031",48,31,2006,4657,4478,179,3.8
"48031",48,31,2007,4764,4609,155,3.3
"48031",48,31,2008,4872,4696,176,3.6
"48031",48,31,2009,5067,4804,263,5.2
"48031",48,31,2010,5419,5096,323,6
"48031",48,31,2011,5420,5112,308,5.7
"48031",48,31,2012,5493,5210,283,5.2
"48031",48,31,2013,5540,5280,260,4.7
"48031",48,31,2014,5679,5472,207,3.6
"48031",48,31,2015,5763,5583,180,3.1
"48031",48,31,2016,5924,5741,183,3.1
"48031",48,31,2017,6217,6048,169,2.7
"48033",48,33,1990,438,424,14,3.2
"48033",48,33,1991,395,375,20,5.1
"48033",48,33,1992,382,365,17,4.5
"48033",48,33,1993,403,391,12,3
"48033",48,33,1994,409,388,21,5.1
"48033",48,33,1995,406,395,11,2.7
"48033",48,33,1996,391,384,7,1.8
"48033",48,33,1997,393,386,7,1.8
"48033",48,33,1998,405,397,8,2
"48033",48,33,1999,393,384,9,2.3
"48033",48,33,2000,422,395,27,6.4
"48033",48,33,2001,441,427,14,3.2
"48033",48,33,2002,438,421,17,3.9
"48033",48,33,2003,527,504,23,4.4
"48033",48,33,2004,510,490,20,3.9
"48033",48,33,2005,457,440,17,3.7
"48033",48,33,2006,406,388,18,4.4
"48033",48,33,2007,372,357,15,4
"48033",48,33,2008,397,384,13,3.3
"48033",48,33,2009,424,401,23,5.4
"48033",48,33,2010,357,334,23,6.4
"48033",48,33,2011,389,368,21,5.4
"48033",48,33,2012,419,401,18,4.3
"48033",48,33,2013,417,400,17,4.1
"48033",48,33,2014,423,410,13,3.1
"48033",48,33,2015,412,400,12,2.9
"48033",48,33,2016,365,352,13,3.6
"48033",48,33,2017,318,307,11,3.5
"48035",48,35,1990,6379,5942,437,6.9
"48035",48,35,1991,5901,5405,496,8.4
"48035",48,35,1992,6057,5711,346,5.7
"48035",48,35,1993,6424,6007,417,6.5
"48035",48,35,1994,6272,5966,306,4.9
"48035",48,35,1995,6282,5966,316,5
"48035",48,35,1996,6440,6164,276,4.3
"48035",48,35,1997,6469,6167,302,4.7
"48035",48,35,1998,6592,6317,275,4.2
"48035",48,35,1999,7251,6991,260,3.6
"48035",48,35,2000,8067,7734,333,4.1
"48035",48,35,2001,8036,7638,398,5
"48035",48,35,2002,8050,7543,507,6.3
"48035",48,35,2003,8280,7727,553,6.7
"48035",48,35,2004,8416,7941,475,5.6
"48035",48,35,2005,8387,7959,428,5.1
"48035",48,35,2006,8190,7790,400,4.9
"48035",48,35,2007,8167,7821,346,4.2
"48035",48,35,2008,8265,7892,373,4.5
"48035",48,35,2009,8550,7885,665,7.8
"48035",48,35,2010,8450,7706,744,8.8
"48035",48,35,2011,8408,7709,699,8.3
"48035",48,35,2012,8191,7599,592,7.2
"48035",48,35,2013,8081,7558,523,6.5
"48035",48,35,2014,8140,7720,420,5.2
"48035",48,35,2015,8053,7692,361,4.5
"48035",48,35,2016,8174,7822,352,4.3
"48035",48,35,2017,8176,7850,326,4
"48037",48,37,1990,38098,35554,2544,6.7
"48037",48,37,1991,38147,34854,3293,8.6
"48037",48,37,1992,39496,35771,3725,9.4
"48037",48,37,1993,39761,36073,3688,9.3
"48037",48,37,1994,40032,36065,3967,9.9
"48037",48,37,1995,39781,36426,3355,8.4
"48037",48,37,1996,39961,36818,3143,7.9
"48037",48,37,1997,40169,36830,3339,8.3
"48037",48,37,1998,39338,36009,3329,8.5
"48037",48,37,1999,39144,36917,2227,5.7
"48037",48,37,2000,40492,38519,1973,4.9
"48037",48,37,2001,40535,38481,2054,5.1
"48037",48,37,2002,41530,39016,2514,6.1
"48037",48,37,2003,41888,39153,2735,6.5
"48037",48,37,2004,42014,39501,2513,6
"48037",48,37,2005,42168,39885,2283,5.4
"48037",48,37,2006,42705,40438,2267,5.3
"48037",48,37,2007,42908,40897,2011,4.7
"48037",48,37,2008,43472,41323,2149,4.9
"48037",48,37,2009,44185,41259,2926,6.6
"48037",48,37,2010,42211,38648,3563,8.4
"48037",48,37,2011,42338,38833,3505,8.3
"48037",48,37,2012,41556,38465,3091,7.4
"48037",48,37,2013,40557,37466,3091,7.6
"48037",48,37,2014,39662,37170,2492,6.3
"48037",48,37,2015,39120,37244,1876,4.8
"48037",48,37,2016,39555,37695,1860,4.7
"48037",48,37,2017,39326,37537,1789,4.5
"48039",48,39,1990,98105,93572,4533,4.6
"48039",48,39,1991,102720,97748,4972,4.8
"48039",48,39,1992,102909,95570,7339,7.1
"48039",48,39,1993,104909,96872,8037,7.7
"48039",48,39,1994,107159,99416,7743,7.2
"48039",48,39,1995,105693,97802,7891,7.5
"48039",48,39,1996,104673,97526,7147,6.8
"48039",48,39,1997,106136,98479,7657,7.2
"48039",48,39,1998,105551,99039,6512,6.2
"48039",48,39,1999,104631,97483,7148,6.8
"48039",48,39,2000,120108,114243,5865,4.9
"48039",48,39,2001,122355,116255,6100,5
"48039",48,39,2002,126398,118357,8041,6.4
"48039",48,39,2003,129263,119843,9420,7.3
"48039",48,39,2004,131263,122285,8978,6.8
"48039",48,39,2005,133540,125868,7672,5.7
"48039",48,39,2006,134697,128003,6694,5
"48039",48,39,2007,137904,131893,6011,4.4
"48039",48,39,2008,142335,135102,7233,5.1
"48039",48,39,2009,146139,134316,11823,8.1
"48039",48,39,2010,155227,142043,13184,8.5
"48039",48,39,2011,158581,145857,12724,8
"48039",48,39,2012,161209,150457,10752,6.7
"48039",48,39,2013,164345,154302,10043,6.1
"48039",48,39,2014,166712,158250,8462,5.1
"48039",48,39,2015,166911,159285,7626,4.6
"48039",48,39,2016,169559,160772,8787,5.2
"48039",48,39,2017,171954,162901,9053,5.3
"48041",48,41,1990,61595,58306,3289,5.3
"48041",48,41,1991,62309,60154,2155,3.5
"48041",48,41,1992,64214,62350,1864,2.9
"48041",48,41,1993,66694,64917,1777,2.7
"48041",48,41,1994,68664,66824,1840,2.7
"48041",48,41,1995,68910,66825,2085,3
"48041",48,41,1996,69241,67510,1731,2.5
"48041",48,41,1997,71058,69561,1497,2.1
"48041",48,41,1998,73739,72468,1271,1.7
"48041",48,41,1999,75666,74330,1336,1.8
"48041",48,41,2000,78711,75832,2879,3.7
"48041",48,41,2001,79882,76866,3016,3.8
"48041",48,41,2002,82544,78955,3589,4.3
"48041",48,41,2003,84869,80819,4050,4.8
"48041",48,41,2004,85858,82169,3689,4.3
"48041",48,41,2005,86694,83047,3647,4.2
"48041",48,41,2006,86883,83395,3488,4
"48041",48,41,2007,88105,84943,3162,3.6
"48041",48,41,2008,91699,88162,3537,3.9
"48041",48,41,2009,96652,91367,5285,5.5
"48041",48,41,2010,100017,93723,6294,6.3
"48041",48,41,2011,99772,93755,6017,6
"48041",48,41,2012,99833,94566,5267,5.3
"48041",48,41,2013,102810,97768,5042,4.9
"48041",48,41,2014,104349,100194,4155,4
"48041",48,41,2015,108516,104924,3592,3.3
"48041",48,41,2016,111095,107255,3840,3.5
"48041",48,41,2017,113424,109948,3476,3.1
"48043",48,43,1990,4252,4052,200,4.7
"48043",48,43,1991,4074,3941,133,3.3
"48043",48,43,1992,4234,4141,93,2.2
"48043",48,43,1993,4485,4378,107,2.4
"48043",48,43,1994,4707,4591,116,2.5
"48043",48,43,1995,4691,4574,117,2.5
"48043",48,43,1996,4854,4717,137,2.8
"48043",48,43,1997,4996,4859,137,2.7
"48043",48,43,1998,5183,5055,128,2.5
"48043",48,43,1999,5238,5108,130,2.5
"48043",48,43,2000,4561,4385,176,3.9
"48043",48,43,2001,4721,4531,190,4
"48043",48,43,2002,4843,4610,233,4.8
"48043",48,43,2003,5112,4869,243,4.8
"48043",48,43,2004,5410,5178,232,4.3
"48043",48,43,2005,5249,5052,197,3.8
"48043",48,43,2006,5413,5229,184,3.4
"48043",48,43,2007,5217,5046,171,3.3
"48043",48,43,2008,5101,4914,187,3.7
"48043",48,43,2009,5153,4892,261,5.1
"48043",48,43,2010,4912,4644,268,5.5
"48043",48,43,2011,4862,4592,270,5.6
"48043",48,43,2012,4563,4331,232,5.1
"48043",48,43,2013,4155,3924,231,5.6
"48043",48,43,2014,4067,3879,188,4.6
"48043",48,43,2015,3907,3753,154,3.9
"48043",48,43,2016,3955,3806,149,3.8
"48043",48,43,2017,3921,3784,137,3.5
"48045",48,45,1990,922,910,12,1.3
"48045",48,45,1991,925,902,23,2.5
"48045",48,45,1992,978,938,40,4.1
"48045",48,45,1993,981,949,32,3.3
"48045",48,45,1994,956,925,31,3.2
"48045",48,45,1995,972,932,40,4.1
"48045",48,45,1996,969,938,31,3.2
"48045",48,45,1997,921,894,27,2.9
"48045",48,45,1998,928,894,34,3.7
"48045",48,45,1999,912,878,34,3.7
"48045",48,45,2000,911,878,33,3.6
"48045",48,45,2001,867,832,35,4
"48045",48,45,2002,853,810,43,5
"48045",48,45,2003,805,755,50,6.2
"48045",48,45,2004,751,706,45,6
"48045",48,45,2005,716,677,39,5.4
"48045",48,45,2006,693,661,32,4.6
"48045",48,45,2007,712,682,30,4.2
"48045",48,45,2008,703,673,30,4.3
"48045",48,45,2009,714,678,36,5
"48045",48,45,2010,734,689,45,6.1
"48045",48,45,2011,722,678,44,6.1
"48045",48,45,2012,643,608,35,5.4
"48045",48,45,2013,628,593,35,5.6
"48045",48,45,2014,637,610,27,4.2
"48045",48,45,2015,594,571,23,3.9
"48045",48,45,2016,547,523,24,4.4
"48045",48,45,2017,556,532,24,4.3
"48047",48,47,1990,3059,2789,270,8.8
"48047",48,47,1991,2928,2631,297,10.1
"48047",48,47,1992,3055,2665,390,12.8
"48047",48,47,1993,3353,2990,363,10.8
"48047",48,47,1994,3362,2983,379,11.3
"48047",48,47,1995,3205,2763,442,13.8
"48047",48,47,1996,3089,2674,415,13.4
"48047",48,47,1997,2884,2522,362,12.6
"48047",48,47,1998,2996,2722,274,9.1
"48047",48,47,1999,3137,2828,309,9.9
"48047",48,47,2000,2889,2695,194,6.7
"48047",48,47,2001,3111,2927,184,5.9
"48047",48,47,2002,3199,2955,244,7.6
"48047",48,47,2003,3300,3031,269,8.2
"48047",48,47,2004,3248,3007,241,7.4
"48047",48,47,2005,3092,2883,209,6.8
"48047",48,47,2006,3029,2841,188,6.2
"48047",48,47,2007,3081,2917,164,5.3
"48047",48,47,2008,3268,3096,172,5.3
"48047",48,47,2009,3308,2999,309,9.3
"48047",48,47,2010,2592,2282,310,12
"48047",48,47,2011,2689,2405,284,10.6
"48047",48,47,2012,2721,2484,237,8.7
"48047",48,47,2013,2764,2516,248,9
"48047",48,47,2014,2707,2498,209,7.7
"48047",48,47,2015,2601,2343,258,9.9
"48047",48,47,2016,2435,2148,287,11.8
"48047",48,47,2017,2425,2226,199,8.2
"48049",48,49,1990,15400,14279,1121,7.3
"48049",48,49,1991,15567,14289,1278,8.2
"48049",48,49,1992,15584,14170,1414,9.1
"48049",48,49,1993,15877,14578,1299,8.2
"48049",48,49,1994,16452,15322,1130,6.9
"48049",48,49,1995,16890,15831,1059,6.3
"48049",48,49,1996,16983,15881,1102,6.5
"48049",48,49,1997,16685,15712,973,5.8
"48049",48,49,1998,16975,16159,816,4.8
"48049",48,49,1999,17160,16496,664,3.9
"48049",48,49,2000,17680,16897,783,4.4
"48049",48,49,2001,17869,17030,839,4.7
"48049",48,49,2002,18196,17129,1067,5.9
"48049",48,49,2003,18489,17415,1074,5.8
"48049",48,49,2004,18352,17348,1004,5.5
"48049",48,49,2005,18671,17793,878,4.7
"48049",48,49,2006,19020,18178,842,4.4
"48049",48,49,2007,18504,17752,752,4.1
"48049",48,49,2008,18430,17625,805,4.4
"48049",48,49,2009,19013,17717,1296,6.8
"48049",48,49,2010,16432,15084,1348,8.2
"48049",48,49,2011,16378,15067,1311,8
"48049",48,49,2012,16071,14981,1090,6.8
"48049",48,49,2013,15936,14906,1030,6.5
"48049",48,49,2014,15852,15032,820,5.2
"48049",48,49,2015,15880,15195,685,4.3
"48049",48,49,2016,16142,15441,701,4.3
"48049",48,49,2017,16183,15562,621,3.8
"48051",48,51,1990,6119,5807,312,5.1
"48051",48,51,1991,6550,6253,297,4.5
"48051",48,51,1992,6997,6619,378,5.4
"48051",48,51,1993,7202,6858,344,4.8
"48051",48,51,1994,7504,7149,355,4.7
"48051",48,51,1995,7398,7009,389,5.3
"48051",48,51,1996,7443,7141,302,4.1
"48051",48,51,1997,7278,6974,304,4.2
"48051",48,51,1998,6988,6698,290,4.1
"48051",48,51,1999,6819,6506,313,4.6
"48051",48,51,2000,7725,7419,306,4
"48051",48,51,2001,7936,7627,309,3.9
"48051",48,51,2002,8196,7766,430,5.2
"48051",48,51,2003,8466,7962,504,6
"48051",48,51,2004,8575,8125,450,5.2
"48051",48,51,2005,8615,8258,357,4.1
"48051",48,51,2006,8343,8006,337,4
"48051",48,51,2007,7732,7436,296,3.8
"48051",48,51,2008,7883,7539,344,4.4
"48051",48,51,2009,8142,7584,558,6.9
"48051",48,51,2010,7870,7251,619,7.9
"48051",48,51,2011,7764,7199,565,7.3
"48051",48,51,2012,7666,7184,482,6.3
"48051",48,51,2013,7697,7222,475,6.2
"48051",48,51,2014,7593,7232,361,4.8
"48051",48,51,2015,7751,7414,337,4.3
"48051",48,51,2016,7861,7496,365,4.6
"48051",48,51,2017,7987,7658,329,4.1
"48053",48,53,1990,9385,9043,342,3.6
"48053",48,53,1991,9539,9026,513,5.4
"48053",48,53,1992,9681,9039,642,6.6
"48053",48,53,1993,10282,9776,506,4.9
"48053",48,53,1994,10807,10340,467,4.3
"48053",48,53,1995,12135,11656,479,3.9
"48053",48,53,1996,12921,12401,520,4
"48053",48,53,1997,13277,12744,533,4
"48053",48,53,1998,13563,13078,485,3.6
"48053",48,53,1999,14035,13651,384,2.7
"48053",48,53,2000,17197,16595,602,3.5
"48053",48,53,2001,17960,17206,754,4.2
"48053",48,53,2002,19172,18148,1024,5.3
"48053",48,53,2003,20188,19065,1123,5.6
"48053",48,53,2004,20612,19607,1005,4.9
"48053",48,53,2005,20273,19380,893,4.4
"48053",48,53,2006,21298,20429,869,4.1
"48053",48,53,2007,21718,20970,748,3.4
"48053",48,53,2008,22164,21306,858,3.9
"48053",48,53,2009,22224,20870,1354,6.1
"48053",48,53,2010,20289,18915,1374,6.8
"48053",48,53,2011,20659,19265,1394,6.7
"48053",48,53,2012,20426,19209,1217,6
"48053",48,53,2013,20802,19663,1139,5.5
"48053",48,53,2014,21502,20577,925,4.3
"48053",48,53,2015,21159,20389,770,3.6
"48053",48,53,2016,21955,21196,759,3.5
"48053",48,53,2017,22153,21451,702,3.2
"48055",48,55,1990,11782,11084,698,5.9
"48055",48,55,1991,11837,11214,623,5.3
"48055",48,55,1992,12206,11660,546,4.5
"48055",48,55,1993,12715,12212,503,4
"48055",48,55,1994,13393,12904,489,3.7
"48055",48,55,1995,14353,13819,534,3.7
"48055",48,55,1996,14901,14324,577,3.9
"48055",48,55,1997,15454,14811,643,4.2
"48055",48,55,1998,15729,15122,607,3.9
"48055",48,55,1999,16247,15683,564,3.5
"48055",48,55,2000,15106,14495,611,4
"48055",48,55,2001,15271,14515,756,5
"48055",48,55,2002,15619,14567,1052,6.7
"48055",48,55,2003,15808,14649,1159,7.3
"48055",48,55,2004,16028,15007,1021,6.4
"48055",48,55,2005,15967,15117,850,5.3
"48055",48,55,2006,15882,15108,774,4.9
"48055",48,55,2007,15408,14728,680,4.4
"48055",48,55,2008,15372,14570,802,5.2
"48055",48,55,2009,15740,14428,1312,8.3
"48055",48,55,2010,16661,15225,1436,8.6
"48055",48,55,2011,16857,15437,1420,8.4
"48055",48,55,2012,16844,15636,1208,7.2
"48055",48,55,2013,17125,16001,1124,6.6
"48055",48,55,2014,17241,16345,896,5.2
"48055",48,55,2015,17410,16655,755,4.3
"48055",48,55,2016,17911,17136,775,4.3
"48055",48,55,2017,18406,17694,712,3.9
"48057",48,57,1990,8435,7902,533,6.3
"48057",48,57,1991,8960,8393,567,6.3
"48057",48,57,1992,10004,9201,803,8
"48057",48,57,1993,10246,9164,1082,10.6
"48057",48,57,1994,9933,8716,1217,12.3
"48057",48,57,1995,9548,8671,877,9.2
"48057",48,57,1996,9767,9049,718,7.4
"48057",48,57,1997,9038,8241,797,8.8
"48057",48,57,1998,9402,8765,637,6.8
"48057",48,57,1999,9644,9074,570,5.9
"48057",48,57,2000,9353,8920,433,4.6
"48057",48,57,2001,9454,8803,651,6.9
"48057",48,57,2002,9300,8588,712,7.7
"48057",48,57,2003,9239,8549,690,7.5
"48057",48,57,2004,9254,8596,658,7.1
"48057",48,57,2005,9347,8805,542,5.8
"48057",48,57,2006,9372,8919,453,4.8
"48057",48,57,2007,9245,8837,408,4.4
"48057",48,57,2008,9378,8934,444,4.7
"48057",48,57,2009,9446,8644,802,8.5
"48057",48,57,2010,10182,9285,897,8.8
"48057",48,57,2011,10602,9698,904,8.5
"48057",48,57,2012,10423,9658,765,7.3
"48057",48,57,2013,10844,10172,672,6.2
"48057",48,57,2014,11089,10561,528,4.8
"48057",48,57,2015,11319,10868,451,4
"48057",48,57,2016,10756,10156,600,5.6
"48057",48,57,2017,10424,9818,606,5.8
"48059",48,59,1990,5295,5072,223,4.2
"48059",48,59,1991,5512,5240,272,4.9
"48059",48,59,1992,5527,5235,292,5.3
"48059",48,59,1993,5807,5507,300,5.2
"48059",48,59,1994,5914,5654,260,4.4
"48059",48,59,1995,6281,6026,255,4.1
"48059",48,59,1996,6466,6203,263,4.1
"48059",48,59,1997,5911,5678,233,3.9
"48059",48,59,1998,5963,5724,239,4
"48059",48,59,1999,6145,5876,269,4.4
"48059",48,59,2000,6214,5977,237,3.8
"48059",48,59,2001,6233,5965,268,4.3
"48059",48,59,2002,6507,6182,325,5
"48059",48,59,2003,6754,6393,361,5.3
"48059",48,59,2004,6856,6540,316,4.6
"48059",48,59,2005,6993,6708,285,4.1
"48059",48,59,2006,7109,6835,274,3.9
"48059",48,59,2007,6924,6691,233,3.4
"48059",48,59,2008,7102,6847,255,3.6
"48059",48,59,2009,7092,6679,413,5.8
"48059",48,59,2010,6002,5566,436,7.3
"48059",48,59,2011,6018,5587,431,7.2
"48059",48,59,2012,5933,5572,361,6.1
"48059",48,59,2013,5917,5578,339,5.7
"48059",48,59,2014,5832,5573,259,4.4
"48059",48,59,2015,5727,5483,244,4.3
"48059",48,59,2016,5796,5549,247,4.3
"48059",48,59,2017,5843,5628,215,3.7
"48061",48,61,1990,104152,90888,13264,12.7
"48061",48,61,1991,109324,92942,16382,15
"48061",48,61,1992,113741,97092,16649,14.6
"48061",48,61,1993,117962,102097,15865,13.4
"48061",48,61,1994,122477,106727,15750,12.9
"48061",48,61,1995,122700,107089,15611,12.7
"48061",48,61,1996,124222,108455,15767,12.7
"48061",48,61,1997,126848,111137,15711,12.4
"48061",48,61,1998,127362,111144,16218,12.7
"48061",48,61,1999,127149,114536,12613,9.9
"48061",48,61,2000,127268,118477,8791,6.9
"48061",48,61,2001,130981,120785,10196,7.8
"48061",48,61,2002,138349,125902,12447,9
"48061",48,61,2003,142105,128600,13505,9.5
"48061",48,61,2004,141646,129413,12233,8.6
"48061",48,61,2005,140218,129543,10675,7.6
"48061",48,61,2006,142935,133567,9368,6.6
"48061",48,61,2007,142753,134375,8378,5.9
"48061",48,61,2008,145893,136275,9618,6.6
"48061",48,61,2009,151405,136689,14716,9.7
"48061",48,61,2010,162316,144171,18145,11.2
"48061",48,61,2011,165823,146773,19050,11.5
"48061",48,61,2012,166314,149171,17143,10.3
"48061",48,61,2013,167093,150439,16654,10
"48061",48,61,2014,166361,152513,13848,8.3
"48061",48,61,2015,162940,151358,11582,7.1
"48061",48,61,2016,165730,153845,11885,7.2
"48061",48,61,2017,166268,154837,11431,6.9
"48063",48,63,1990,4731,4367,364,7.7
"48063",48,63,1991,4829,4360,469,9.7
"48063",48,63,1992,4961,4360,601,12.1
"48063",48,63,1993,4988,4487,501,10
"48063",48,63,1994,4968,4544,424,8.5
"48063",48,63,1995,5008,4602,406,8.1
"48063",48,63,1996,5309,4888,421,7.9
"48063",48,63,1997,5463,5091,372,6.8
"48063",48,63,1998,5449,5001,448,8.2
"48063",48,63,1999,5390,5032,358,6.6
"48063",48,63,2000,5220,4952,268,5.1
"48063",48,63,2001,5288,5002,286,5.4
"48063",48,63,2002,5514,5148,366,6.6
"48063",48,63,2003,5907,5505,402,6.8
"48063",48,63,2004,5484,5159,325,5.9
"48063",48,63,2005,5374,5064,310,5.8
"48063",48,63,2006,5494,5218,276,5
"48063",48,63,2007,5549,5299,250,4.5
"48063",48,63,2008,5559,5290,269,4.8
"48063",48,63,2009,5743,5234,509,8.9
"48063",48,63,2010,5697,5181,516,9.1
"48063",48,63,2011,5679,5171,508,8.9
"48063",48,63,2012,5505,5064,441,8
"48063",48,63,2013,5516,5111,405,7.3
"48063",48,63,2014,5218,4900,318,6.1
"48063",48,63,2015,5089,4777,312,6.1
"48063",48,63,2016,5052,4707,345,6.8
"48063",48,63,2017,5040,4756,284,5.6
"48065",48,65,1990,3050,2953,97,3.2
"48065",48,65,1991,3138,3005,133,4.2
"48065",48,65,1992,3395,3218,177,5.2
"48065",48,65,1993,3592,3457,135,3.8
"48065",48,65,1994,3828,3695,133,3.5
"48065",48,65,1995,3842,3699,143,3.7
"48065",48,65,1996,3582,3426,156,4.4
"48065",48,65,1997,3340,3189,151,4.5
"48065",48,65,1998,3155,3032,123,3.9
"48065",48,65,1999,3176,3046,130,4.1
"48065",48,65,2000,3356,3248,108,3.2
"48065",48,65,2001,3294,3178,116,3.5
"48065",48,65,2002,3471,3312,159,4.6
"48065",48,65,2003,3502,3336,166,4.7
"48065",48,65,2004,3499,3355,144,4.1
"48065",48,65,2005,3489,3352,137,3.9
"48065",48,65,2006,3518,3395,123,3.5
"48065",48,65,2007,3349,3246,103,3.1
"48065",48,65,2008,3286,3177,109,3.3
"48065",48,65,2009,3261,3071,190,5.8
"48065",48,65,2010,3353,3171,182,5.4
"48065",48,65,2011,3425,3254,171,5
"48065",48,65,2012,3291,3141,150,4.6
"48065",48,65,2013,3178,3037,141,4.4
"48065",48,65,2014,3150,3045,105,3.3
"48065",48,65,2015,3066,2968,98,3.2
"48065",48,65,2016,3092,2991,101,3.3
"48065",48,65,2017,3060,2963,97,3.2
"48067",48,67,1990,13288,12280,1008,7.6
"48067",48,67,1991,14633,13081,1552,10.6
"48067",48,67,1992,14454,12622,1832,12.7
"48067",48,67,1993,14443,12900,1543,10.7
"48067",48,67,1994,14684,13174,1510,10.3
"48067",48,67,1995,15208,13782,1426,9.4
"48067",48,67,1996,15608,14249,1359,8.7
"48067",48,67,1997,15385,14216,1169,7.6
"48067",48,67,1998,15935,14558,1377,8.6
"48067",48,67,1999,15447,14289,1158,7.5
"48067",48,67,2000,13542,12754,788,5.8
"48067",48,67,2001,13448,12581,867,6.4
"48067",48,67,2002,13742,12633,1109,8.1
"48067",48,67,2003,13761,12663,1098,8
"48067",48,67,2004,13703,12749,954,7
"48067",48,67,2005,13340,12512,828,6.2
"48067",48,67,2006,13030,12269,761,5.8
"48067",48,67,2007,12972,12279,693,5.3
"48067",48,67,2008,12887,12106,781,6.1
"48067",48,67,2009,13337,11824,1513,11.3
"48067",48,67,2010,13337,11844,1493,11.2
"48067",48,67,2011,13305,11888,1417,10.7
"48067",48,67,2012,12827,11650,1177,9.2
"48067",48,67,2013,12596,11437,1159,9.2
"48067",48,67,2014,12283,11346,937,7.6
"48067",48,67,2015,12157,11333,824,6.8
"48067",48,67,2016,12247,11367,880,7.2
"48067",48,67,2017,12198,11472,726,6
"48069",48,69,1990,4061,3894,167,4.1
"48069",48,69,1991,4181,3967,214,5.1
"48069",48,69,1992,4077,3804,273,6.7
"48069",48,69,1993,4258,3957,301,7.1
"48069",48,69,1994,4187,3957,230,5.5
"48069",48,69,1995,4174,3962,212,5.1
"48069",48,69,1996,4171,3971,200,4.8
"48069",48,69,1997,4187,3984,203,4.8
"48069",48,69,1998,4148,3959,189,4.6
"48069",48,69,1999,3726,3560,166,4.5
"48069",48,69,2000,3992,3848,144,3.6
"48069",48,69,2001,3894,3737,157,4
"48069",48,69,2002,3691,3514,177,4.8
"48069",48,69,2003,3938,3736,202,5.1
"48069",48,69,2004,3683,3501,182,4.9
"48069",48,69,2005,3387,3201,186,5.5
"48069",48,69,2006,3230,3080,150,4.6
"48069",48,69,2007,3423,3297,126,3.7
"48069",48,69,2008,3600,3472,128,3.6
"48069",48,69,2009,3693,3516,177,4.8
"48069",48,69,2010,4138,3915,223,5.4
"48069",48,69,2011,4091,3886,205,5
"48069",48,69,2012,4060,3882,178,4.4
"48069",48,69,2013,3785,3607,178,4.7
"48069",48,69,2014,3796,3645,151,4
"48069",48,69,2015,3613,3491,122,3.4
"48069",48,69,2016,3489,3382,107,3.1
"48069",48,69,2017,3358,3248,110,3.3
"48071",48,71,1990,9835,9465,370,3.8
"48071",48,71,1991,9902,9443,459,4.6
"48071",48,71,1992,9999,9385,614,6.1
"48071",48,71,1993,10342,9518,824,8
"48071",48,71,1994,10520,9819,701,6.7
"48071",48,71,1995,10810,10205,605,5.6
"48071",48,71,1996,11118,10533,585,5.3
"48071",48,71,1997,11472,10870,602,5.2
"48071",48,71,1998,11791,11279,512,4.3
"48071",48,71,1999,11785,11268,517,4.4
"48071",48,71,2000,13112,12561,551,4.2
"48071",48,71,2001,13296,12703,593,4.5
"48071",48,71,2002,13484,12781,703,5.2
"48071",48,71,2003,13646,12807,839,6.1
"48071",48,71,2004,13771,12977,794,5.8
"48071",48,71,2005,13984,13123,861,6.2
"48071",48,71,2006,13788,13076,712,5.2
"48071",48,71,2007,13816,13179,637,4.6
"48071",48,71,2008,14270,13463,807,5.7
"48071",48,71,2009,15348,13953,1395,9.1
"48071",48,71,2010,16607,14999,1608,9.7
"48071",48,71,2011,16802,15242,1560,9.3
"48071",48,71,2012,17150,15771,1379,8
"48071",48,71,2013,17485,16202,1283,7.3
"48071",48,71,2014,17843,16816,1027,5.8
"48071",48,71,2015,17792,16844,948,5.3
"48071",48,71,2016,18180,17074,1106,6.1
"48071",48,71,2017,18511,17306,1205,6.5
"48073",48,73,1990,18852,17675,1177,6.2
"48073",48,73,1991,18889,17617,1272,6.7
"48073",48,73,1992,18907,17522,1385,7.3
"48073",48,73,1993,18858,17551,1307,6.9
"48073",48,73,1994,19187,18118,1069,5.6
"48073",48,73,1995,20199,19132,1067,5.3
"48073",48,73,1996,20654,19660,994,4.8
"48073",48,73,1997,20510,19578,932,4.5
"48073",48,73,1998,20865,19985,880,4.2
"48073",48,73,1999,20800,19924,876,4.2
"48073",48,73,2000,20935,19976,959,4.6
"48073",48,73,2001,20766,19723,1043,5
"48073",48,73,2002,21010,19787,1223,5.8
"48073",48,73,2003,21807,20522,1285,5.9
"48073",48,73,2004,21066,19912,1154,5.5
"48073",48,73,2005,20580,19430,1150,5.6
"48073",48,73,2006,20227,19153,1074,5.3
"48073",48,73,2007,20252,19287,965,4.8
"48073",48,73,2008,20325,19140,1185,5.8
"48073",48,73,2009,20965,19119,1846,8.8
"48073",48,73,2010,21893,19961,1932,8.8
"48073",48,73,2011,22209,20404,1805,8.1
"48073",48,73,2012,21979,20388,1591,7.2
"48073",48,73,2013,21534,20041,1493,6.9
"48073",48,73,2014,21183,19955,1228,5.8
"48073",48,73,2015,20881,19804,1077,5.2
"48073",48,73,2016,21160,20086,1074,5.1
"48073",48,73,2017,20659,19723,936,4.5
"48075",48,75,1990,2598,2470,128,4.9
"48075",48,75,1991,2701,2551,150,5.6
"48075",48,75,1992,3052,2838,214,7
"48075",48,75,1993,3085,2932,153,5
"48075",48,75,1994,3270,3149,121,3.7
"48075",48,75,1995,3357,3221,136,4.1
"48075",48,75,1996,3288,3133,155,4.7
"48075",48,75,1997,3120,2980,140,4.5
"48075",48,75,1998,3182,3048,134,4.2
"48075",48,75,1999,3018,2918,100,3.3
"48075",48,75,2000,2984,2845,139,4.7
"48075",48,75,2001,3076,2926,150,4.9
"48075",48,75,2002,3158,2973,185,5.9
"48075",48,75,2003,3298,3102,196,5.9
"48075",48,75,2004,3207,3024,183,5.7
"48075",48,75,2005,3069,2896,173,5.6
"48075",48,75,2006,3033,2865,168,5.5
"48075",48,75,2007,3010,2865,145,4.8
"48075",48,75,2008,3052,2900,152,5
"48075",48,75,2009,3298,3098,200,6.1
"48075",48,75,2010,3157,2979,178,5.6
"48075",48,75,2011,3084,2925,159,5.2
"48075",48,75,2012,2969,2838,131,4.4
"48075",48,75,2013,2936,2811,125,4.3
"48075",48,75,2014,2863,2759,104,3.6
"48075",48,75,2015,2866,2777,89,3.1
"48075",48,75,2016,2954,2866,88,3
"48075",48,75,2017,2910,2824,86,3
"48077",48,77,1990,4731,4553,178,3.8
"48077",48,77,1991,4721,4525,196,4.2
"48077",48,77,1992,4718,4488,230,4.9
"48077",48,77,1993,4737,4526,211,4.5
"48077",48,77,1994,4852,4657,195,4
"48077",48,77,1995,5281,5102,179,3.4
"48077",48,77,1996,5328,5147,181,3.4
"48077",48,77,1997,5230,5048,182,3.5
"48077",48,77,1998,5367,5196,171,3.2
"48077",48,77,1999,5568,5408,160,2.9
"48077",48,77,2000,5959,5748,211,3.5
"48077",48,77,2001,6137,5930,207,3.4
"48077",48,77,2002,6337,6042,295,4.7
"48077",48,77,2003,6415,6111,304,4.7
"48077",48,77,2004,6360,6110,250,3.9
"48077",48,77,2005,6476,6230,246,3.8
"48077",48,77,2006,6449,6206,243,3.8
"48077",48,77,2007,6212,5997,215,3.5
"48077",48,77,2008,6039,5804,235,3.9
"48077",48,77,2009,6074,5657,417,6.9
"48077",48,77,2010,5539,5124,415,7.5
"48077",48,77,2011,5516,5159,357,6.5
"48077",48,77,2012,5319,5021,298,5.6
"48077",48,77,2013,5141,4857,284,5.5
"48077",48,77,2014,5019,4790,229,4.6
"48077",48,77,2015,4908,4693,215,4.4
"48077",48,77,2016,4787,4578,209,4.4
"48077",48,77,2017,4797,4626,171,3.6
"48079",48,79,1990,1944,1864,80,4.1
"48079",48,79,1991,1987,1897,90,4.5
"48079",48,79,1992,1895,1747,148,7.8
"48079",48,79,1993,1887,1702,185,9.8
"48079",48,79,1994,1733,1591,142,8.2
"48079",48,79,1995,1645,1540,105,6.4
"48079",48,79,1996,1626,1534,92,5.7
"48079",48,79,1997,1497,1420,77,5.1
"48079",48,79,1998,1437,1358,79,5.5
"48079",48,79,1999,1329,1255,74,5.6
"48079",48,79,2000,1591,1498,93,5.8
"48079",48,79,2001,1604,1515,89,5.5
"48079",48,79,2002,1573,1464,109,6.9
"48079",48,79,2003,1734,1594,140,8.1
"48079",48,79,2004,1602,1494,108,6.7
"48079",48,79,2005,1550,1462,88,5.7
"48079",48,79,2006,1457,1370,87,6
"48079",48,79,2007,1477,1404,73,4.9
"48079",48,79,2008,1501,1430,71,4.7
"48079",48,79,2009,1506,1409,97,6.4
"48079",48,79,2010,1524,1400,124,8.1
"48079",48,79,2011,1498,1371,127,8.5
"48079",48,79,2012,1447,1338,109,7.5
"48079",48,79,2013,1403,1310,93,6.6
"48079",48,79,2014,1398,1327,71,5.1
"48079",48,79,2015,1316,1249,67,5.1
"48079",48,79,2016,1172,1113,59,5
"48079",48,79,2017,1133,1081,52,4.6
"48081",48,81,1990,1394,1372,22,1.6
"48081",48,81,1991,1361,1329,32,2.4
"48081",48,81,1992,1413,1356,57,4
"48081",48,81,1993,1412,1363,49,3.5
"48081",48,81,1994,1476,1424,52,3.5
"48081",48,81,1995,1553,1517,36,2.3
"48081",48,81,1996,1598,1562,36,2.3
"48081",48,81,1997,1543,1495,48,3.1
"48081",48,81,1998,1525,1477,48,3.1
"48081",48,81,1999,1577,1533,44,2.8
"48081",48,81,2000,1663,1593,70,4.2
"48081",48,81,2001,1626,1553,73,4.5
"48081",48,81,2002,1605,1516,89,5.5
"48081",48,81,2003,1616,1523,93,5.8
"48081",48,81,2004,1499,1410,89,5.9
"48081",48,81,2005,1372,1296,76,5.5
"48081",48,81,2006,1349,1275,74,5.5
"48081",48,81,2007,1377,1301,76,5.5
"48081",48,81,2008,1282,1183,99,7.7
"48081",48,81,2009,1322,1215,107,8.1
"48081",48,81,2010,1575,1479,96,6.1
"48081",48,81,2011,1536,1448,88,5.7
"48081",48,81,2012,1473,1398,75,5.1
"48081",48,81,2013,1459,1385,74,5.1
"48081",48,81,2014,1438,1376,62,4.3
"48081",48,81,2015,1396,1340,56,4
"48081",48,81,2016,1419,1360,59,4.2
"48081",48,81,2017,1396,1345,51,3.7
"48083",48,83,1990,3977,3631,346,8.7
"48083",48,83,1991,3663,3394,269,7.3
"48083",48,83,1992,3670,3378,292,8
"48083",48,83,1993,3792,3565,227,6
"48083",48,83,1994,3861,3625,236,6.1
"48083",48,83,1995,3973,3707,266,6.7
"48083",48,83,1996,3992,3717,275,6.9
"48083",48,83,1997,4035,3697,338,8.4
"48083",48,83,1998,3694,3350,344,9.3
"48083",48,83,1999,3325,3108,217,6.5
"48083",48,83,2000,4220,4020,200,4.7
"48083",48,83,2001,4168,3962,206,4.9
"48083",48,83,2002,4351,4064,287,6.6
"48083",48,83,2003,4376,4098,278,6.4
"48083",48,83,2004,4279,4043,236,5.5
"48083",48,83,2005,4319,4120,199,4.6
"48083",48,83,2006,4273,4091,182,4.3
"48083",48,83,2007,4367,4216,151,3.5
"48083",48,83,2008,4361,4184,177,4.1
"48083",48,83,2009,4381,4079,302,6.9
"48083",48,83,2010,3484,3168,316,9.1
"48083",48,83,2011,3400,3101,299,8.8
"48083",48,83,2012,3316,3067,249,7.5
"48083",48,83,2013,3158,2920,238,7.5
"48083",48,83,2014,3121,2931,190,6.1
"48083",48,83,2015,3048,2879,169,5.5
"48083",48,83,2016,3060,2882,178,5.8
"48083",48,83,2017,3070,2934,136,4.4
"48085",48,85,1990,161227,155069,6158,3.8
"48085",48,85,1991,166485,158397,8088,4.9
"48085",48,85,1992,173527,164507,9020,5.2
"48085",48,85,1993,182938,175291,7647,4.2
"48085",48,85,1994,196870,189416,7454,3.8
"48085",48,85,1995,209814,203027,6787,3.2
"48085",48,85,1996,224868,219091,5777,2.6
"48085",48,85,1997,245428,239803,5625,2.3
"48085",48,85,1998,261450,256132,5318,2
"48085",48,85,1999,280505,274713,5792,2.1
"48085",48,85,2000,300048,291653,8395,2.8
"48085",48,85,2001,318349,305193,13156,4.1
"48085",48,85,2002,331175,311011,20164,6.1
"48085",48,85,2003,339497,319162,20335,6
"48085",48,85,2004,351740,334267,17473,5
"48085",48,85,2005,367439,350325,17114,4.7
"48085",48,85,2006,384587,368310,16277,4.2
"48085",48,85,2007,395832,380804,15028,3.8
"48085",48,85,2008,405733,387584,18149,4.5
"48085",48,85,2009,414997,384888,30109,7.3
"48085",48,85,2010,425252,394597,30655,7.2
"48085",48,85,2011,438645,409063,29582,6.7
"48085",48,85,2012,446733,420419,26314,5.9
"48085",48,85,2013,457847,432552,25295,5.5
"48085",48,85,2014,474119,452567,21552,4.5
"48085",48,85,2015,488234,470529,17705,3.6
"48085",48,85,2016,512119,494019,18100,3.5
"48085",48,85,2017,527317,509347,17970,3.4
"48087",48,87,1990,1790,1727,63,3.5
"48087",48,87,1991,1818,1735,83,4.6
"48087",48,87,1992,1780,1695,85,4.8
"48087",48,87,1993,1801,1699,102,5.7
"48087",48,87,1994,1731,1624,107,6.2
"48087",48,87,1995,1668,1603,65,3.9
"48087",48,87,1996,1720,1655,65,3.8
"48087",48,87,1997,1686,1620,66,3.9
"48087",48,87,1998,1549,1523,26,1.7
"48087",48,87,1999,1488,1472,16,1.1
"48087",48,87,2000,1534,1477,57,3.7
"48087",48,87,2001,1641,1580,61,3.7
"48087",48,87,2002,1658,1587,71,4.3
"48087",48,87,2003,1713,1629,84,4.9
"48087",48,87,2004,1655,1572,83,5
"48087",48,87,2005,1625,1553,72,4.4
"48087",48,87,2006,1553,1486,67,4.3
"48087",48,87,2007,1534,1483,51,3.3
"48087",48,87,2008,1475,1418,57,3.9
"48087",48,87,2009,1492,1411,81,5.4
"48087",48,87,2010,1341,1266,75,5.6
"48087",48,87,2011,1307,1231,76,5.8
"48087",48,87,2012,1248,1186,62,5
"48087",48,87,2013,1217,1155,62,5.1
"48087",48,87,2014,1259,1208,51,4.1
"48087",48,87,2015,1270,1223,47,3.7
"48087",48,87,2016,1213,1171,42,3.5
"48087",48,87,2017,1159,1117,42,3.6
"48089",48,89,1990,7998,7786,212,2.7
"48089",48,89,1991,8112,7870,242,3
"48089",48,89,1992,8382,7993,389,4.6
"48089",48,89,1993,8461,8129,332,3.9
"48089",48,89,1994,8413,8069,344,4.1
"48089",48,89,1995,8207,7929,278,3.4
"48089",48,89,1996,8110,7832,278,3.4
"48089",48,89,1997,8184,7861,323,3.9
"48089",48,89,1998,8213,7903,310,3.8
"48089",48,89,1999,8338,8020,318,3.8
"48089",48,89,2000,9930,9559,371,3.7
"48089",48,89,2001,9870,9451,419,4.2
"48089",48,89,2002,10038,9532,506,5
"48089",48,89,2003,10365,9797,568,5.5
"48089",48,89,2004,10294,9770,524,5.1
"48089",48,89,2005,10314,9852,462,4.5
"48089",48,89,2006,10676,10221,455,4.3
"48089",48,89,2007,10442,10070,372,3.6
"48089",48,89,2008,10930,10504,426,3.9
"48089",48,89,2009,10742,10057,685,6.4
"48089",48,89,2010,9596,8816,780,8.1
"48089",48,89,2011,10108,9326,782,7.7
"48089",48,89,2012,10184,9536,648,6.4
"48089",48,89,2013,10102,9520,582,5.8
"48089",48,89,2014,10277,9821,456,4.4
"48089",48,89,2015,9899,9509,390,3.9
"48089",48,89,2016,9776,9316,460,4.7
"48089",48,89,2017,10080,9693,387,3.8
"48091",48,91,1990,25764,24382,1382,5.4
"48091",48,91,1991,26425,24896,1529,5.8
"48091",48,91,1992,27901,26404,1497,5.4
"48091",48,91,1993,29360,27873,1487,5.1
"48091",48,91,1994,31322,30092,1230,3.9
"48091",48,91,1995,33175,31987,1188,3.6
"48091",48,91,1996,34915,33780,1135,3.3
"48091",48,91,1997,36722,35628,1094,3
"48091",48,91,1998,37838,36819,1019,2.7
"48091",48,91,1999,39693,38701,992,2.5
"48091",48,91,2000,40428,39018,1410,3.5
"48091",48,91,2001,42014,40218,1796,4.3
"48091",48,91,2002,43962,41461,2501,5.7
"48091",48,91,2003,45240,42637,2603,5.8
"48091",48,91,2004,46893,44458,2435,5.2
"48091",48,91,2005,48830,46631,2199,4.5
"48091",48,91,2006,51236,49150,2086,4.1
"48091",48,91,2007,52364,50496,1868,3.6
"48091",48,91,2008,54681,52475,2206,4
"48091",48,91,2009,57279,53758,3521,6.1
"48091",48,91,2010,53489,49723,3766,7
"48091",48,91,2011,54641,50881,3760,6.9
"48091",48,91,2012,55918,52535,3383,6
"48091",48,91,2013,57924,54472,3452,6
"48091",48,91,2014,59850,57138,2712,4.5
"48091",48,91,2015,61841,59574,2267,3.7
"48091",48,91,2016,65377,63013,2364,3.6
"48091",48,91,2017,66826,64580,2246,3.4
"48093",48,93,1990,5974,5674,300,5
"48093",48,93,1991,5992,5708,284,4.7
"48093",48,93,1992,6301,5984,317,5
"48093",48,93,1993,6413,6110,303,4.7
"48093",48,93,1994,6583,6334,249,3.8
"48093",48,93,1995,6604,6361,243,3.7
"48093",48,93,1996,6707,6412,295,4.4
"48093",48,93,1997,6632,6356,276,4.2
"48093",48,93,1998,6859,6593,266,3.9
"48093",48,93,1999,6638,6412,226,3.4
"48093",48,93,2000,6687,6427,260,3.9
"48093",48,93,2001,6794,6519,275,4
"48093",48,93,2002,6926,6608,318,4.6
"48093",48,93,2003,7083,6716,367,5.2
"48093",48,93,2004,6799,6463,336,4.9
"48093",48,93,2005,6427,6125,302,4.7
"48093",48,93,2006,6349,6066,283,4.5
"48093",48,93,2007,6462,6219,243,3.8
"48093",48,93,2008,6528,6283,245,3.8
"48093",48,93,2009,6833,6421,412,6
"48093",48,93,2010,6025,5570,455,7.6
"48093",48,93,2011,5946,5505,441,7.4
"48093",48,93,2012,5790,5421,369,6.4
"48093",48,93,2013,5654,5323,331,5.9
"48093",48,93,2014,5537,5270,267,4.8
"48093",48,93,2015,5354,5127,227,4.2
"48093",48,93,2016,5348,5118,230,4.3
"48093",48,93,2017,5288,5093,195,3.7
"48095",48,95,1990,1449,1404,45,3.1
"48095",48,95,1991,1445,1409,36,2.5
"48095",48,95,1992,1461,1413,48,3.3
"48095",48,95,1993,1447,1402,45,3.1
"48095",48,95,1994,1453,1404,49,3.4
"48095",48,95,1995,1423,1392,31,2.2
"48095",48,95,1996,1473,1440,33,2.2
"48095",48,95,1997,1534,1493,41,2.7
"48095",48,95,1998,1500,1460,40,2.7
"48095",48,95,1999,1561,1522,39,2.5
"48095",48,95,2000,1437,1357,80,5.6
"48095",48,95,2001,1449,1375,74,5.1
"48095",48,95,2002,1393,1309,84,6
"48095",48,95,2003,1478,1383,95,6.4
"48095",48,95,2004,1395,1310,85,6.1
"48095",48,95,2005,1377,1296,81,5.9
"48095",48,95,2006,1323,1252,71,5.4
"48095",48,95,2007,1315,1250,65,4.9
"48095",48,95,2008,1327,1259,68,5.1
"48095",48,95,2009,1348,1252,96,7.1
"48095",48,95,2010,1566,1476,90,5.7
"48095",48,95,2011,1576,1503,73,4.6
"48095",48,95,2012,1512,1448,64,4.2
"48095",48,95,2013,1455,1397,58,4
"48095",48,95,2014,1414,1372,42,3
"48095",48,95,2015,1373,1328,45,3.3
"48095",48,95,2016,1329,1284,45,3.4
"48095",48,95,2017,1207,1156,51,4.2
"48097",48,97,1990,14776,14057,719,4.9
"48097",48,97,1991,15129,14233,896,5.9
"48097",48,97,1992,15480,14510,970,6.3
"48097",48,97,1993,15277,14245,1032,6.8
"48097",48,97,1994,15588,14631,957,6.1
"48097",48,97,1995,15584,14789,795,5.1
"48097",48,97,1996,15975,15338,637,4
"48097",48,97,1997,16492,15884,608,3.7
"48097",48,97,1998,16842,16282,560,3.3
"48097",48,97,1999,17119,16591,528,3.1
"48097",48,97,2000,18675,17999,676,3.6
"48097",48,97,2001,18938,18035,903,4.8
"48097",48,97,2002,18283,17220,1063,5.8
"48097",48,97,2003,19045,17966,1079,5.7
"48097",48,97,2004,19337,18382,955,4.9
"48097",48,97,2005,19868,19025,843,4.2
"48097",48,97,2006,20758,19977,781,3.8
"48097",48,97,2007,21646,20879,767,3.5
"48097",48,97,2008,22455,21680,775,3.5
"48097",48,97,2009,21821,20402,1419,6.5
"48097",48,97,2010,19539,18119,1420,7.3
"48097",48,97,2011,20367,19137,1230,6
"48097",48,97,2012,20693,19653,1040,5
"48097",48,97,2013,20486,19463,1023,5
"48097",48,97,2014,20546,19755,791,3.8
"48097",48,97,2015,19752,19024,728,3.7
"48097",48,97,2016,18882,18133,749,4
"48097",48,97,2017,18826,18155,671,3.6
"48099",48,99,1990,17942,16458,1484,8.3
"48099",48,99,1991,17086,15875,1211,7.1
"48099",48,99,1992,18310,17177,1133,6.2
"48099",48,99,1993,19276,18270,1006,5.2
"48099",48,99,1994,19616,18638,978,5
"48099",48,99,1995,20614,19613,1001,4.9
"48099",48,99,1996,21751,20741,1010,4.6
"48099",48,99,1997,22120,21056,1064,4.8
"48099",48,99,1998,21253,20311,942,4.4
"48099",48,99,1999,21479,20663,816,3.8
"48099",48,99,2000,23964,22699,1265,5.3
"48099",48,99,2001,23935,22509,1426,6
"48099",48,99,2002,24480,22791,1689,6.9
"48099",48,99,2003,24710,22903,1807,7.3
"48099",48,99,2004,24887,23302,1585,6.4
"48099",48,99,2005,25361,23789,1572,6.2
"48099",48,99,2006,24516,22935,1581,6.4
"48099",48,99,2007,23247,21887,1360,5.9
"48099",48,99,2008,23451,22001,1450,6.2
"48099",48,99,2009,24278,22285,1993,8.2
"48099",48,99,2010,25338,23441,1897,7.5
"48099",48,99,2011,25663,23687,1976,7.7
"48099",48,99,2012,25396,23528,1868,7.4
"48099",48,99,2013,25222,23411,1811,7.2
"48099",48,99,2014,24722,23250,1472,6
"48099",48,99,2015,24484,23318,1166,4.8
"48099",48,99,2016,24373,23236,1137,4.7
"48099",48,99,2017,24691,23634,1057,4.3
"48101",48,101,1990,1007,975,32,3.2
"48101",48,101,1991,939,896,43,4.6
"48101",48,101,1992,919,852,67,7.3
"48101",48,101,1993,903,831,72,8
"48101",48,101,1994,852,796,56,6.6
"48101",48,101,1995,869,814,55,6.3
"48101",48,101,1996,878,814,64,7.3
"48101",48,101,1997,843,777,66,7.8
"48101",48,101,1998,836,789,47,5.6
"48101",48,101,1999,837,794,43,5.1
"48101",48,101,2000,951,910,41,4.3
"48101",48,101,2001,961,915,46,4.8
"48101",48,101,2002,936,887,49,5.2
"48101",48,101,2003,985,924,61,6.2
"48101",48,101,2004,910,860,50,5.5
"48101",48,101,2005,822,776,46,5.6
"48101",48,101,2006,789,750,39,4.9
"48101",48,101,2007,819,786,33,4
"48101",48,101,2008,829,796,33,4
"48101",48,101,2009,799,755,44,5.5
"48101",48,101,2010,669,622,47,7
"48101",48,101,2011,667,617,50,7.5
"48101",48,101,2012,666,616,50,7.5
"48101",48,101,2013,624,582,42,6.7
"48101",48,101,2014,605,568,37,6.1
"48101",48,101,2015,545,506,39,7.2
"48101",48,101,2016,525,498,27,5.1
"48101",48,101,2017,517,495,22,4.3
"48103",48,103,1990,2225,2144,81,3.6
"48103",48,103,1991,2332,2232,100,4.3
"48103",48,103,1992,2269,2093,176,7.8
"48103",48,103,1993,2225,2069,156,7
"48103",48,103,1994,2216,2092,124,5.6
"48103",48,103,1995,2236,2140,96,4.3
"48103",48,103,1996,2329,2246,83,3.6
"48103",48,103,1997,2230,2149,81,3.6
"48103",48,103,1998,2183,2052,131,6
"48103",48,103,1999,2018,1839,179,8.9
"48103",48,103,2000,1613,1527,86,5.3
"48103",48,103,2001,1484,1411,73,4.9
"48103",48,103,2002,1573,1457,116,7.4
"48103",48,103,2003,1684,1561,123,7.3
"48103",48,103,2004,1586,1491,95,6
"48103",48,103,2005,1578,1498,80,5.1
"48103",48,103,2006,1722,1647,75,4.4
"48103",48,103,2007,1645,1579,66,4
"48103",48,103,2008,1703,1634,69,4.1
"48103",48,103,2009,1771,1617,154,8.7
"48103",48,103,2010,1819,1681,138,7.6
"48103",48,103,2011,1919,1792,127,6.6
"48103",48,103,2012,2060,1960,100,4.9
"48103",48,103,2013,2087,1994,93,4.5
"48103",48,103,2014,2006,1926,80,4
"48103",48,103,2015,1835,1730,105,5.7
"48103",48,103,2016,1703,1557,146,8.6
"48103",48,103,2017,1588,1504,84,5.3
"48105",48,105,1990,1867,1791,76,4.1
"48105",48,105,1991,1842,1740,102,5.5
"48105",48,105,1992,1945,1795,150,7.7
"48105",48,105,1993,1909,1814,95,5
"48105",48,105,1994,1956,1892,64,3.3
"48105",48,105,1995,2036,1975,61,3
"48105",48,105,1996,1999,1935,64,3.2
"48105",48,105,1997,2020,1957,63,3.1
"48105",48,105,1998,2112,2011,101,4.8
"48105",48,105,1999,2044,1877,167,8.2
"48105",48,105,2000,2045,1969,76,3.7
"48105",48,105,2001,2040,1969,71,3.5
"48105",48,105,2002,2110,2016,94,4.5
"48105",48,105,2003,2177,2089,88,4
"48105",48,105,2004,2090,2011,79,3.8
"48105",48,105,2005,2036,1961,75,3.7
"48105",48,105,2006,2027,1958,69,3.4
"48105",48,105,2007,2068,2008,60,2.9
"48105",48,105,2008,2204,2141,63,2.9
"48105",48,105,2009,2282,2087,195,8.5
"48105",48,105,2010,1721,1575,146,8.5
"48105",48,105,2011,1715,1602,113,6.6
"48105",48,105,2012,1774,1685,89,5
"48105",48,105,2013,1883,1787,96,5.1
"48105",48,105,2014,1933,1860,73,3.8
"48105",48,105,2015,1899,1785,114,6
"48105",48,105,2016,1733,1603,130,7.5
"48105",48,105,2017,1689,1620,69,4.1
"48107",48,107,1990,3234,3093,141,4.4
"48107",48,107,1991,3310,3155,155,4.7
"48107",48,107,1992,3294,3032,262,8
"48107",48,107,1993,3348,3104,244,7.3
"48107",48,107,1994,3321,3070,251,7.6
"48107",48,107,1995,3221,3007,214,6.6
"48107",48,107,1996,3170,2913,257,8.1
"48107",48,107,1997,3082,2853,229,7.4
"48107",48,107,1998,2945,2723,222,7.5
"48107",48,107,1999,2722,2544,178,6.5
"48107",48,107,2000,2982,2847,135,4.5
"48107",48,107,2001,2986,2839,147,4.9
"48107",48,107,2002,2955,2792,163,5.5
"48107",48,107,2003,2957,2765,192,6.5
"48107",48,107,2004,2914,2741,173,5.9
"48107",48,107,2005,2923,2765,158,5.4
"48107",48,107,2006,2844,2690,154,5.4
"48107",48,107,2007,2638,2514,124,4.7
"48107",48,107,2008,2601,2473,128,4.9
"48107",48,107,2009,2581,2403,178,6.9
"48107",48,107,2010,2951,2716,235,8
"48107",48,107,2011,3005,2753,252,8.4
"48107",48,107,2012,2911,2702,209,7.2
"48107",48,107,2013,2767,2603,164,5.9
"48107",48,107,2014,2698,2572,126,4.7
"48107",48,107,2015,2645,2531,114,4.3
"48107",48,107,2016,2616,2502,114,4.4
"48107",48,107,2017,2603,2495,108,4.1
"48109",48,109,1990,1615,1499,116,7.2
"48109",48,109,1991,1577,1464,113,7.2
"48109",48,109,1992,1540,1425,115,7.5
"48109",48,109,1993,1410,1312,98,7
"48109",48,109,1994,1286,1214,72,5.6
"48109",48,109,1995,1281,1207,74,5.8
"48109",48,109,1996,1349,1226,123,9.1
"48109",48,109,1997,1368,1242,126,9.2
"48109",48,109,1998,1245,1141,104,8.4
"48109",48,109,1999,1239,1139,100,8.1
"48109",48,109,2000,1493,1409,84,5.6
"48109",48,109,2001,1547,1474,73,4.7
"48109",48,109,2002,1607,1511,96,6
"48109",48,109,2003,1599,1511,88,5.5
"48109",48,109,2004,1545,1464,81,5.2
"48109",48,109,2005,1648,1583,65,3.9
"48109",48,109,2006,1636,1585,51,3.1
"48109",48,109,2007,1752,1705,47,2.7
"48109",48,109,2008,1754,1703,51,2.9
"48109",48,109,2009,1809,1737,72,4
"48109",48,109,2010,1032,959,73,7.1
"48109",48,109,2011,1018,948,70,6.9
"48109",48,109,2012,989,929,60,6.1
"48109",48,109,2013,1019,968,51,5
"48109",48,109,2014,1012,970,42,4.2
"48109",48,109,2015,1039,996,43,4.1
"48109",48,109,2016,998,957,41,4.1
"48109",48,109,2017,913,880,33,3.6
"48111",48,111,1990,2500,2444,56,2.2
"48111",48,111,1991,2664,2585,79,3
"48111",48,111,1992,2865,2763,102,3.6
"48111",48,111,1993,3093,3003,90,2.9
"48111",48,111,1994,3287,3204,83,2.5
"48111",48,111,1995,3294,3183,111,3.4
"48111",48,111,1996,3271,3170,101,3.1
"48111",48,111,1997,3400,3276,124,3.6
"48111",48,111,1998,3650,3530,120,3.3
"48111",48,111,1999,3659,3561,98,2.7
"48111",48,111,2000,3286,3177,109,3.3
"48111",48,111,2001,3309,3207,102,3.1
"48111",48,111,2002,3325,3201,124,3.7
"48111",48,111,2003,3413,3273,140,4.1
"48111",48,111,2004,3272,3148,124,3.8
"48111",48,111,2005,3079,2976,103,3.3
"48111",48,111,2006,3021,2920,101,3.3
"48111",48,111,2007,3236,3146,90,2.8
"48111",48,111,2008,3558,3452,106,3
"48111",48,111,2009,3756,3600,156,4.2
"48111",48,111,2010,3880,3673,207,5.3
"48111",48,111,2011,4054,3877,177,4.4
"48111",48,111,2012,4021,3873,148,3.7
"48111",48,111,2013,3898,3762,136,3.5
"48111",48,111,2014,3903,3789,114,2.9
"48111",48,111,2015,4004,3917,87,2.2
"48111",48,111,2016,3993,3904,89,2.2
"48111",48,111,2017,4056,3970,86,2.1
"48113",48,113,1990,1073287,1016640,56647,5.3
"48113",48,113,1991,1080986,1011500,69486,6.4
"48113",48,113,1992,1096470,1015638,80832,7.4
"48113",48,113,1993,1103260,1031106,72154,6.5
"48113",48,113,1994,1121339,1058009,63330,5.6
"48113",48,113,1995,1136869,1078665,58204,5.1
"48113",48,113,1996,1151815,1099649,52166,4.5
"48113",48,113,1997,1184205,1135155,49050,4.1
"48113",48,113,1998,1193975,1149251,44724,3.7
"48113",48,113,1999,1208890,1165810,43080,3.6
"48113",48,113,2000,1187494,1142138,45356,3.8
"48113",48,113,2001,1192682,1129816,62866,5.3
"48113",48,113,2002,1181082,1093896,87186,7.4
"48113",48,113,2003,1158506,1072829,85677,7.4
"48113",48,113,2004,1147253,1072514,74739,6.5
"48113",48,113,2005,1142456,1077868,64588,5.7
"48113",48,113,2006,1146694,1088046,58648,5.1
"48113",48,113,2007,1137194,1085427,51767,4.6
"48113",48,113,2008,1140659,1080079,60580,5.3
"48113",48,113,2009,1143197,1049081,94116,8.2
"48113",48,113,2010,1194015,1091493,102522,8.6
"48113",48,113,2011,1212288,1113577,98711,8.1
"48113",48,113,2012,1223343,1136230,87113,7.1
"48113",48,113,2013,1234933,1153569,81364,6.6
"48113",48,113,2014,1250984,1183245,67739,5.4
"48113",48,113,2015,1261721,1207803,53918,4.3
"48113",48,113,2016,1296256,1244191,52065,4
"48113",48,113,2017,1333933,1282785,51148,3.8
"48115",48,115,1990,5957,5473,484,8.1
"48115",48,115,1991,5799,5415,384,6.6
"48115",48,115,1992,5903,5481,422,7.1
"48115",48,115,1993,6098,5646,452,7.4
"48115",48,115,1994,6413,5901,512,8
"48115",48,115,1995,6342,5917,425,6.7
"48115",48,115,1996,6279,5835,444,7.1
"48115",48,115,1997,6048,5692,356,5.9
"48115",48,115,1998,5958,5586,372,6.2
"48115",48,115,1999,6102,5693,409,6.7
"48115",48,115,2000,5850,5544,306,5.2
"48115",48,115,2001,5973,5656,317,5.3
"48115",48,115,2002,5425,5041,384,7.1
"48115",48,115,2003,5622,5201,421,7.5
"48115",48,115,2004,5497,5110,387,7
"48115",48,115,2005,5170,4817,353,6.8
"48115",48,115,2006,5080,4748,332,6.5
"48115",48,115,2007,5074,4812,262,5.2
"48115",48,115,2008,5123,4853,270,5.3
"48115",48,115,2009,5357,4931,426,8
"48115",48,115,2010,5136,4741,395,7.7
"48115",48,115,2011,5223,4832,391,7.5
"48115",48,115,2012,5080,4754,326,6.4
"48115",48,115,2013,5001,4681,320,6.4
"48115",48,115,2014,4899,4661,238,4.9
"48115",48,115,2015,4769,4553,216,4.5
"48115",48,115,2016,4632,4400,232,5
"48115",48,115,2017,4656,4429,227,4.9
"48117",48,117,1990,8982,8499,483,5.4
"48117",48,117,1991,9013,8397,616,6.8
"48117",48,117,1992,9170,8378,792,8.6
"48117",48,117,1993,9294,8564,730,7.9
"48117",48,117,1994,9012,8312,700,7.8
"48117",48,117,1995,8741,8056,685,7.8
"48117",48,117,1996,8591,7938,653,7.6
"48117",48,117,1997,8286,7644,642,7.7
"48117",48,117,1998,8082,7482,600,7.4
"48117",48,117,1999,7879,7419,460,5.8
"48117",48,117,2000,8248,7854,394,4.8
"48117",48,117,2001,8230,7856,374,4.5
"48117",48,117,2002,8025,7553,472,5.9
"48117",48,117,2003,8159,7684,475,5.8
"48117",48,117,2004,8064,7643,421,5.2
"48117",48,117,2005,8330,7943,387,4.6
"48117",48,117,2006,8209,7861,348,4.2
"48117",48,117,2007,8706,8398,308,3.5
"48117",48,117,2008,8932,8597,335,3.8
"48117",48,117,2009,9138,8662,476,5.2
"48117",48,117,2010,9504,8957,547,5.8
"48117",48,117,2011,9633,9109,524,5.4
"48117",48,117,2012,9325,8887,438,4.7
"48117",48,117,2013,9157,8749,408,4.5
"48117",48,117,2014,9108,8779,329,3.6
"48117",48,117,2015,8787,8511,276,3.1
"48117",48,117,2016,8594,8326,268,3.1
"48117",48,117,2017,8339,8084,255,3.1
"48119",48,119,1990,2267,2148,119,5.2
"48119",48,119,1991,2047,1908,139,6.8
"48119",48,119,1992,2100,1955,145,6.9
"48119",48,119,1993,2208,2090,118,5.3
"48119",48,119,1994,2483,2365,118,4.8
"48119",48,119,1995,2586,2472,114,4.4
"48119",48,119,1996,2726,2616,110,4
"48119",48,119,1997,2695,2574,121,4.5
"48119",48,119,1998,2720,2619,101,3.7
"48119",48,119,1999,3394,3277,117,3.4
"48119",48,119,2000,2569,2440,129,5
"48119",48,119,2001,2510,2376,134,5.3
"48119",48,119,2002,2479,2322,157,6.3
"48119",48,119,2003,2419,2259,160,6.6
"48119",48,119,2004,2474,2302,172,7
"48119",48,119,2005,2412,2279,133,5.5
"48119",48,119,2006,2419,2294,125,5.2
"48119",48,119,2007,2301,2193,108,4.7
"48119",48,119,2008,2296,2174,122,5.3
"48119",48,119,2009,2254,2059,195,8.7
"48119",48,119,2010,2596,2391,205,7.9
"48119",48,119,2011,2632,2420,212,8.1
"48119",48,119,2012,2625,2448,177,6.7
"48119",48,119,2013,2636,2469,167,6.3
"48119",48,119,2014,2653,2493,160,6
"48119",48,119,2015,2592,2474,118,4.6
"48119",48,119,2016,2602,2503,99,3.8
"48119",48,119,2017,2609,2524,85,3.3
"48121",48,121,1990,169862,162882,6980,4.1
"48121",48,121,1991,172941,164552,8389,4.9
"48121",48,121,1992,178464,169325,9139,5.1
"48121",48,121,1993,184621,176987,7634,4.1
"48121",48,121,1994,196490,188713,7777,4
"48121",48,121,1995,204323,197273,7050,3.5
"48121",48,121,1996,213696,207674,6022,2.8
"48121",48,121,1997,226298,221209,5089,2.2
"48121",48,121,1998,237355,232548,4807,2
"48121",48,121,1999,251449,246613,4836,1.9
"48121",48,121,2000,267721,260275,7446,2.8
"48121",48,121,2001,277221,267519,9702,3.5
"48121",48,121,2002,285634,271418,14216,5
"48121",48,121,2003,292734,277387,15347,5.2
"48121",48,121,2004,300921,287278,13643,4.5
"48121",48,121,2005,314097,299695,14402,4.6
"48121",48,121,2006,326923,313184,13739,4.2
"48121",48,121,2007,337573,324605,12968,3.8
"48121",48,121,2008,344467,329325,15142,4.4
"48121",48,121,2009,350711,325707,25004,7.1
"48121",48,121,2010,369088,342972,26116,7.1
"48121",48,121,2011,379534,354648,24886,6.6
"48121",48,121,2012,388543,366353,22190,5.7
"48121",48,121,2013,400381,378959,21422,5.4
"48121",48,121,2014,414162,395799,18363,4.4
"48121",48,121,2015,428166,412960,15206,3.6
"48121",48,121,2016,451157,435696,15461,3.4
"48121",48,121,2017,464581,449263,15318,3.3
"48123",48,123,1990,7815,7400,415,5.3
"48123",48,123,1991,7718,7386,332,4.3
"48123",48,123,1992,8087,7603,484,6
"48123",48,123,1993,8064,7628,436,5.4
"48123",48,123,1994,8427,8012,415,4.9
"48123",48,123,1995,8560,8119,441,5.2
"48123",48,123,1996,8081,7713,368,4.6
"48123",48,123,1997,8119,7733,386,4.8
"48123",48,123,1998,8611,8221,390,4.5
"48123",48,123,1999,8432,8048,384,4.6
"48123",48,123,2000,8989,8606,383,4.3
"48123",48,123,2001,9251,8836,415,4.5
"48123",48,123,2002,9268,8736,532,5.7
"48123",48,123,2003,9674,9126,548,5.7
"48123",48,123,2004,9375,8861,514,5.5
"48123",48,123,2005,9338,8907,431,4.6
"48123",48,123,2006,9208,8803,405,4.4
"48123",48,123,2007,8987,8637,350,3.9
"48123",48,123,2008,9043,8673,370,4.1
"48123",48,123,2009,9177,8486,691,7.5
"48123",48,123,2010,9076,8371,705,7.8
"48123",48,123,2011,9475,8864,611,6.4
"48123",48,123,2012,9741,9275,466,4.8
"48123",48,123,2013,9704,9245,459,4.7
"48123",48,123,2014,10016,9633,383,3.8
"48123",48,123,2015,10045,9645,400,4
"48123",48,123,2016,9482,8964,518,5.5
"48123",48,123,2017,9586,9160,426,4.4
"48125",48,125,1990,1090,1041,49,4.5
"48125",48,125,1991,1051,999,52,4.9
"48125",48,125,1992,1037,974,63,6.1
"48125",48,125,1993,1024,959,65,6.3
"48125",48,125,1994,1048,974,74,7.1
"48125",48,125,1995,1102,992,110,10
"48125",48,125,1996,1024,954,70,6.8
"48125",48,125,1997,1045,995,50,4.8
"48125",48,125,1998,1007,961,46,4.6
"48125",48,125,1999,872,824,48,5.5
"48125",48,125,2000,1136,1078,58,5.1
"48125",48,125,2001,1101,1047,54,4.9
"48125",48,125,2002,1157,1094,63,5.4
"48125",48,125,2003,1190,1117,73,6.1
"48125",48,125,2004,1142,1073,69,6
"48125",48,125,2005,1076,1020,56,5.2
"48125",48,125,2006,1199,1148,51,4.3
"48125",48,125,2007,1176,1131,45,3.8
"48125",48,125,2008,994,944,50,5
"48125",48,125,2009,1027,953,74,7.2
"48125",48,125,2010,871,773,98,11.3
"48125",48,125,2011,910,771,139,15.3
"48125",48,125,2012,833,744,89,10.7
"48125",48,125,2013,770,699,71,9.2
"48125",48,125,2014,745,698,47,6.3
"48125",48,125,2015,702,670,32,4.6
"48125",48,125,2016,690,656,34,4.9
"48125",48,125,2017,682,650,32,4.7
"48127",48,127,1990,3924,3374,550,14
"48127",48,127,1991,4174,3585,589,14.1
"48127",48,127,1992,4150,3324,826,19.9
"48127",48,127,1993,3733,3027,706,18.9
"48127",48,127,1994,3794,3120,674,17.8
"48127",48,127,1995,3776,3149,627,16.6
"48127",48,127,1996,3683,3116,567,15.4
"48127",48,127,1997,3668,3057,611,16.7
"48127",48,127,1998,3692,3083,609,16.5
"48127",48,127,1999,3669,3089,580,15.8
"48127",48,127,2000,3862,3530,332,8.6
"48127",48,127,2001,3875,3577,298,7.7
"48127",48,127,2002,4028,3657,371,9.2
"48127",48,127,2003,4248,3850,398,9.4
"48127",48,127,2004,3991,3636,355,8.9
"48127",48,127,2005,3813,3500,313,8.2
"48127",48,127,2006,3827,3538,289,7.6
"48127",48,127,2007,3956,3709,247,6.2
"48127",48,127,2008,3965,3706,259,6.5
"48127",48,127,2009,4199,3779,420,10
"48127",48,127,2010,3856,3450,406,10.5
"48127",48,127,2011,4913,4533,380,7.7
"48127",48,127,2012,5764,5428,336,5.8
"48127",48,127,2013,6783,6443,340,5
"48127",48,127,2014,7660,7371,289,3.8
"48127",48,127,2015,7156,6825,331,4.6
"48127",48,127,2016,6227,5784,443,7.1
"48127",48,127,2017,6480,6150,330,5.1
"48129",48,129,1990,1685,1596,89,5.3
"48129",48,129,1991,1558,1487,71,4.6
"48129",48,129,1992,1571,1499,72,4.6
"48129",48,129,1993,1535,1479,56,3.6
"48129",48,129,1994,1608,1549,59,3.7
"48129",48,129,1995,1593,1544,49,3.1
"48129",48,129,1996,1617,1567,50,3.1
"48129",48,129,1997,1513,1463,50,3.3
"48129",48,129,1998,1481,1407,74,5
"48129",48,129,1999,1544,1489,55,3.6
"48129",48,129,2000,1869,1793,76,4.1
"48129",48,129,2001,1880,1799,81,4.3
"48129",48,129,2002,1929,1834,95,4.9
"48129",48,129,2003,1972,1863,109,5.5
"48129",48,129,2004,1932,1826,106,5.5
"48129",48,129,2005,1835,1745,90,4.9
"48129",48,129,2006,1813,1728,85,4.7
"48129",48,129,2007,1805,1727,78,4.3
"48129",48,129,2008,1879,1799,80,4.3
"48129",48,129,2009,1926,1814,112,5.8
"48129",48,129,2010,1810,1685,125,6.9
"48129",48,129,2011,1814,1697,117,6.4
"48129",48,129,2012,1710,1609,101,5.9
"48129",48,129,2013,1988,1887,101,5.1
"48129",48,129,2014,1620,1542,78,4.8
"48129",48,129,2015,1592,1526,66,4.1
"48129",48,129,2016,1554,1491,63,4.1
"48129",48,129,2017,1507,1452,55,3.6
"48131",48,131,1990,4446,3987,459,10.3
"48131",48,131,1991,4312,3841,471,10.9
"48131",48,131,1992,4490,3837,653,14.5
"48131",48,131,1993,4587,3974,613,13.4
"48131",48,131,1994,4589,3988,601,13.1
"48131",48,131,1995,4812,4154,658,13.7
"48131",48,131,1996,4732,4141,591,12.5
"48131",48,131,1997,4777,4350,427,8.9
"48131",48,131,1998,5026,4400,626,12.5
"48131",48,131,1999,5042,4280,762,15.1
"48131",48,131,2000,5014,4665,349,7
"48131",48,131,2001,5222,4889,333,6.4
"48131",48,131,2002,5073,4606,467,9.2
"48131",48,131,2003,5280,4841,439,8.3
"48131",48,131,2004,5273,4914,359,6.8
"48131",48,131,2005,5249,4926,323,6.2
"48131",48,131,2006,5234,4952,282,5.4
"48131",48,131,2007,5133,4883,250,4.9
"48131",48,131,2008,5170,4895,275,5.3
"48131",48,131,2009,5254,4680,574,10.9
"48131",48,131,2010,5038,4453,585,11.6
"48131",48,131,2011,5210,4721,489,9.4
"48131",48,131,2012,5431,5050,381,7
"48131",48,131,2013,5542,5188,354,6.4
"48131",48,131,2014,5530,5222,308,5.6
"48131",48,131,2015,5234,4811,423,8.1
"48131",48,131,2016,4875,4343,532,10.9
"48131",48,131,2017,4803,4435,368,7.7
"48133",48,133,1990,8028,7447,581,7.2
"48133",48,133,1991,7977,7384,593,7.4
"48133",48,133,1992,7855,7310,545,6.9
"48133",48,133,1993,7974,7540,434,5.4
"48133",48,133,1994,8092,7650,442,5.5
"48133",48,133,1995,8160,7730,430,5.3
"48133",48,133,1996,8589,8180,409,4.8
"48133",48,133,1997,8649,8232,417,4.8
"48133",48,133,1998,8874,8436,438,4.9
"48133",48,133,1999,9015,8586,429,4.8
"48133",48,133,2000,8594,8187,407,4.7
"48133",48,133,2001,8698,8274,424,4.9
"48133",48,133,2002,8736,8218,518,5.9
"48133",48,133,2003,8648,8091,557,6.4
"48133",48,133,2004,8554,8074,480,5.6
"48133",48,133,2005,8491,8050,441,5.2
"48133",48,133,2006,8323,7923,400,4.8
"48133",48,133,2007,8119,7771,348,4.3
"48133",48,133,2008,8444,8069,375,4.4
"48133",48,133,2009,8591,7943,648,7.5
"48133",48,133,2010,8113,7412,701,8.6
"48133",48,133,2011,8421,7775,646,7.7
"48133",48,133,2012,8267,7716,551,6.7
"48133",48,133,2013,8530,8014,516,6
"48133",48,133,2014,8362,7959,403,4.8
"48133",48,133,2015,8031,7652,379,4.7
"48133",48,133,2016,7406,7004,402,5.4
"48133",48,133,2017,7852,7513,339,4.3
"48135",48,135,1990,55931,52791,3140,5.6
"48135",48,135,1991,57900,54296,3604,6.2
"48135",48,135,1992,59985,54169,5816,9.7
"48135",48,135,1993,60082,54560,5522,9.2
"48135",48,135,1994,60624,55249,5375,8.9
"48135",48,135,1995,60078,55590,4488,7.5
"48135",48,135,1996,60327,56155,4172,6.9
"48135",48,135,1997,61731,57917,3814,6.2
"48135",48,135,1998,63536,59313,4223,6.6
"48135",48,135,1999,61122,54709,6413,10.5
"48135",48,135,2000,56621,53610,3011,5.3
"48135",48,135,2001,57617,54808,2809,4.9
"48135",48,135,2002,59540,55636,3904,6.6
"48135",48,135,2003,60621,56615,4006,6.6
"48135",48,135,2004,61296,57801,3495,5.7
"48135",48,135,2005,62285,59458,2827,4.5
"48135",48,135,2006,65211,62705,2506,3.8
"48135",48,135,2007,66597,64372,2225,3.3
"48135",48,135,2008,70608,68219,2389,3.4
"48135",48,135,2009,71470,65671,5799,8.1
"48135",48,135,2010,68186,62525,5661,8.3
"48135",48,135,2011,72809,68356,4453,6.1
"48135",48,135,2012,77060,73523,3537,4.6
"48135",48,135,2013,78750,75338,3412,4.3
"48135",48,135,2014,82387,79552,2835,3.4
"48135",48,135,2015,79709,76012,3697,4.6
"48135",48,135,2016,76073,71239,4834,6.4
"48135",48,135,2017,78116,74904,3212,4.1
"48137",48,137,1990,944,885,59,6.3
"48137",48,137,1991,955,888,67,7
"48137",48,137,1992,913,851,62,6.8
"48137",48,137,1993,953,881,72,7.6
"48137",48,137,1994,952,887,65,6.8
"48137",48,137,1995,912,871,41,4.5
"48137",48,137,1996,918,870,48,5.2
"48137",48,137,1997,861,811,50,5.8
"48137",48,137,1998,843,791,52,6.2
"48137",48,137,1999,793,745,48,6.1
"48137",48,137,2000,954,913,41,4.3
"48137",48,137,2001,1040,993,47,4.5
"48137",48,137,2002,1073,1018,55,5.1
"48137",48,137,2003,1141,1092,49,4.3
"48137",48,137,2004,1105,1060,45,4.1
"48137",48,137,2005,1027,986,41,4
"48137",48,137,2006,960,919,41,4.3
"48137",48,137,2007,1001,962,39,3.9
"48137",48,137,2008,1043,1004,39,3.7
"48137",48,137,2009,1076,1000,76,7.1
"48137",48,137,2010,1037,963,74,7.1
"48137",48,137,2011,991,926,65,6.6
"48137",48,137,2012,926,867,59,6.4
"48137",48,137,2013,904,851,53,5.9
"48137",48,137,2014,867,830,37,4.3
"48137",48,137,2015,864,824,40,4.6
"48137",48,137,2016,865,825,40,4.6
"48137",48,137,2017,904,875,29,3.2
"48139",48,139,1990,43925,41537,2388,5.4
"48139",48,139,1991,44231,41266,2965,6.7
"48139",48,139,1992,45070,41800,3270,7.3
"48139",48,139,1993,45927,42896,3031,6.6
"48139",48,139,1994,47181,44637,2544,5.4
"48139",48,139,1995,48222,45919,2303,4.8
"48139",48,139,1996,49928,47712,2216,4.4
"48139",48,139,1997,52334,50156,2178,4.2
"48139",48,139,1998,53869,51886,1983,3.7
"48139",48,139,1999,55881,54140,1741,3.1
"48139",48,139,2000,60192,58069,2123,3.5
"48139",48,139,2001,60906,58260,2646,4.3
"48139",48,139,2002,61738,58172,3566,5.8
"48139",48,139,2003,63011,59012,3999,6.3
"48139",48,139,2004,64162,60563,3599,5.6
"48139",48,139,2005,66297,62763,3534,5.3
"48139",48,139,2006,68403,64983,3420,5
"48139",48,139,2007,69138,66183,2955,4.3
"48139",48,139,2008,70202,66716,3486,5
"48139",48,139,2009,70942,65301,5641,8
"48139",48,139,2010,75674,69611,6063,8
"48139",48,139,2011,76874,70912,5962,7.8
"48139",48,139,2012,76794,71601,5193,6.8
"48139",48,139,2013,77676,72879,4797,6.2
"48139",48,139,2014,79088,75200,3888,4.9
"48139",48,139,2015,80881,77700,3181,3.9
"48139",48,139,2016,84838,81663,3175,3.7
"48139",48,139,2017,87132,84141,2991,3.4
"48141",48,141,1990,259755,229415,30340,11.7
"48141",48,141,1991,263149,231548,31601,12
"48141",48,141,1992,273016,241250,31766,11.6
"48141",48,141,1993,279293,249307,29986,10.7
"48141",48,141,1994,284612,254764,29848,10.5
"48141",48,141,1995,286718,256600,30118,10.5
"48141",48,141,1996,290418,256439,33979,11.7
"48141",48,141,1997,292486,260293,32193,11
"48141",48,141,1998,290423,260328,30095,10.4
"48141",48,141,1999,288679,261255,27424,9.5
"48141",48,141,2000,275363,256975,18388,6.7
"48141",48,141,2001,275336,255436,19900,7.2
"48141",48,141,2002,283402,260275,23127,8.2
"48141",48,141,2003,288490,263240,25250,8.8
"48141",48,141,2004,288551,266962,21589,7.5
"48141",48,141,2005,290010,269570,20440,7
"48141",48,141,2006,291023,271630,19393,6.7
"48141",48,141,2007,291099,274246,16853,5.8
"48141",48,141,2008,297690,279528,18162,6.1
"48141",48,141,2009,307566,280379,27187,8.8
"48141",48,141,2010,340841,309629,31212,9.2
"48141",48,141,2011,346748,313903,32845,9.5
"48141",48,141,2012,347513,317841,29672,8.5
"48141",48,141,2013,347223,319781,27442,7.9
"48141",48,141,2014,344510,322445,22065,6.4
"48141",48,141,2015,341302,323688,17614,5.2
"48141",48,141,2016,349153,331902,17251,4.9
"48141",48,141,2017,353387,337112,16275,4.6
"48143",48,143,1990,14137,13257,880,6.2
"48143",48,143,1991,14285,13613,672,4.7
"48143",48,143,1992,14261,13641,620,4.3
"48143",48,143,1993,15091,14398,693,4.6
"48143",48,143,1994,15712,15181,531,3.4
"48143",48,143,1995,16029,15580,449,2.8
"48143",48,143,1996,16120,15686,434,2.7
"48143",48,143,1997,16306,15887,419,2.6
"48143",48,143,1998,16462,15987,475,2.9
"48143",48,143,1999,16524,16111,413,2.5
"48143",48,143,2000,16598,16001,597,3.6
"48143",48,143,2001,16944,16298,646,3.8
"48143",48,143,2002,17124,16328,796,4.6
"48143",48,143,2003,17796,16937,859,4.8
"48143",48,143,2004,17529,16753,776,4.4
"48143",48,143,2005,17496,16774,722,4.1
"48143",48,143,2006,17741,17041,700,3.9
"48143",48,143,2007,17914,17273,641,3.6
"48143",48,143,2008,18622,17930,692,3.7
"48143",48,143,2009,19196,17985,1211,6.3
"48143",48,143,2010,20499,19179,1320,6.4
"48143",48,143,2011,20688,19438,1250,6
"48143",48,143,2012,20056,18941,1115,5.6
"48143",48,143,2013,19851,18780,1071,5.4
"48143",48,143,2014,20101,19248,853,4.2
"48143",48,143,2015,20145,19355,790,3.9
"48143",48,143,2016,20196,19377,819,4.1
"48143",48,143,2017,20586,19883,703,3.4
"48145",48,145,1990,7096,6766,330,4.7
"48145",48,145,1991,7227,6852,375,5.2
"48145",48,145,1992,7211,6843,368,5.1
"48145",48,145,1993,7387,6990,397,5.4
"48145",48,145,1994,7430,7077,353,4.8
"48145",48,145,1995,7588,7237,351,4.6
"48145",48,145,1996,7688,7420,268,3.5
"48145",48,145,1997,7535,7184,351,4.7
"48145",48,145,1998,6997,6670,327,4.7
"48145",48,145,1999,7435,7157,278,3.7
"48145",48,145,2000,7201,6815,386,5.4
"48145",48,145,2001,7232,6834,398,5.5
"48145",48,145,2002,7355,6905,450,6.1
"48145",48,145,2003,7631,7096,535,7
"48145",48,145,2004,7526,7062,464,6.2
"48145",48,145,2005,7276,6826,450,6.2
"48145",48,145,2006,7063,6626,437,6.2
"48145",48,145,2007,6796,6443,353,5.2
"48145",48,145,2008,6555,6177,378,5.8
"48145",48,145,2009,6670,6089,581,8.7
"48145",48,145,2010,7242,6626,616,8.5
"48145",48,145,2011,7185,6591,594,8.3
"48145",48,145,2012,6917,6410,507,7.3
"48145",48,145,2013,6779,6299,480,7.1
"48145",48,145,2014,6549,6190,359,5.5
"48145",48,145,2015,6449,6176,273,4.2
"48145",48,145,2016,6598,6308,290,4.4
"48145",48,145,2017,6669,6389,280,4.2
"48147",48,147,1990,11116,10330,786,7.1
"48147",48,147,1991,11193,10280,913,8.2
"48147",48,147,1992,11327,10333,994,8.8
"48147",48,147,1993,11172,10328,844,7.6
"48147",48,147,1994,11258,10470,788,7
"48147",48,147,1995,11809,10974,835,7.1
"48147",48,147,1996,12545,11828,717,5.7
"48147",48,147,1997,12682,12061,621,4.9
"48147",48,147,1998,13111,12509,602,4.6
"48147",48,147,1999,12937,12222,715,5.5
"48147",48,147,2000,13949,13282,667,4.8
"48147",48,147,2001,13881,12980,901,6.5
"48147",48,147,2002,14024,12929,1095,7.8
"48147",48,147,2003,13954,12917,1037,7.4
"48147",48,147,2004,13930,12971,959,6.9
"48147",48,147,2005,13803,12921,882,6.4
"48147",48,147,2006,13455,12652,803,6
"48147",48,147,2007,13376,12692,684,5.1
"48147",48,147,2008,13435,12661,774,5.8
"48147",48,147,2009,13628,12455,1173,8.6
"48147",48,147,2010,15341,14092,1249,8.1
"48147",48,147,2011,15277,14016,1261,8.3
"48147",48,147,2012,15068,14004,1064,7.1
"48147",48,147,2013,15283,14217,1066,7
"48147",48,147,2014,15279,14467,812,5.3
"48147",48,147,2015,15362,14733,629,4.1
"48147",48,147,2016,15739,15147,592,3.8
"48147",48,147,2017,15937,15407,530,3.3
"48149",48,149,1990,9426,9199,227,2.4
"48149",48,149,1991,10042,9809,233,2.3
"48149",48,149,1992,10285,9977,308,3
"48149",48,149,1993,10145,9850,295,2.9
"48149",48,149,1994,10450,10181,269,2.6
"48149",48,149,1995,10688,10364,324,3
"48149",48,149,1996,10663,10322,341,3.2
"48149",48,149,1997,10416,10138,278,2.7
"48149",48,149,1998,10444,10163,281,2.7
"48149",48,149,1999,10829,10499,330,3
"48149",48,149,2000,11442,11054,388,3.4
"48149",48,149,2001,11821,11399,422,3.6
"48149",48,149,2002,12085,11547,538,4.5
"48149",48,149,2003,12194,11616,578,4.7
"48149",48,149,2004,12091,11596,495,4.1
"48149",48,149,2005,11997,11529,468,3.9
"48149",48,149,2006,11981,11543,438,3.7
"48149",48,149,2007,12051,11670,381,3.2
"48149",48,149,2008,12321,11901,420,3.4
"48149",48,149,2009,12261,11590,671,5.5
"48149",48,149,2010,12029,11295,734,6.1
"48149",48,149,2011,12510,11788,722,5.8
"48149",48,149,2012,12525,11919,606,4.8
"48149",48,149,2013,12661,12098,563,4.4
"48149",48,149,2014,13075,12627,448,3.4
"48149",48,149,2015,12764,12341,423,3.3
"48149",48,149,2016,12468,12013,455,3.6
"48149",48,149,2017,12623,12224,399,3.2
"48151",48,151,1990,2195,2058,137,6.2
"48151",48,151,1991,1997,1879,118,5.9
"48151",48,151,1992,2026,1879,147,7.3
"48151",48,151,1993,2025,1893,132,6.5
"48151",48,151,1994,1951,1831,120,6.2
"48151",48,151,1995,1932,1825,107,5.5
"48151",48,151,1996,1869,1771,98,5.2
"48151",48,151,1997,1838,1767,71,3.9
"48151",48,151,1998,1768,1693,75,4.2
"48151",48,151,1999,1650,1584,66,4
"48151",48,151,2000,2158,2076,82,3.8
"48151",48,151,2001,2180,2095,85,3.9
"48151",48,151,2002,2137,2018,119,5.6
"48151",48,151,2003,2226,2102,124,5.6
"48151",48,151,2004,2114,2008,106,5
"48151",48,151,2005,2028,1942,86,4.2
"48151",48,151,2006,1953,1874,79,4
"48151",48,151,2007,1972,1895,77,3.9
"48151",48,151,2008,1981,1906,75,3.8
"48151",48,151,2009,2020,1899,121,6
"48151",48,151,2010,1925,1790,135,7
"48151",48,151,2011,1941,1812,129,6.6
"48151",48,151,2012,1908,1805,103,5.4
"48151",48,151,2013,1886,1784,102,5.4
"48151",48,151,2014,1864,1780,84,4.5
"48151",48,151,2015,1799,1730,69,3.8
"48151",48,151,2016,1756,1681,75,4.3
"48151",48,151,2017,1722,1661,61,3.5
"48153",48,153,1990,3947,3793,154,3.9
"48153",48,153,1991,3913,3685,228,5.8
"48153",48,153,1992,3774,3500,274,7.3
"48153",48,153,1993,3597,3356,241,6.7
"48153",48,153,1994,3492,3291,201,5.8
"48153",48,153,1995,3508,3282,226,6.4
"48153",48,153,1996,3536,3288,248,7
"48153",48,153,1997,3414,3163,251,7.4
"48153",48,153,1998,3422,3151,271,7.9
"48153",48,153,1999,3203,2998,205,6.4
"48153",48,153,2000,3479,3313,166,4.8
"48153",48,153,2001,3478,3285,193,5.5
"48153",48,153,2002,3476,3247,229,6.6
"48153",48,153,2003,3670,3410,260,7.1
"48153",48,153,2004,3487,3262,225,6.5
"48153",48,153,2005,3255,3069,186,5.7
"48153",48,153,2006,3127,2943,184,5.9
"48153",48,153,2007,3131,2970,161,5.1
"48153",48,153,2008,3212,3061,151,4.7
"48153",48,153,2009,3221,3011,210,6.5
"48153",48,153,2010,3372,3105,267,7.9
"48153",48,153,2011,3328,3072,256,7.7
"48153",48,153,2012,3198,2992,206,6.4
"48153",48,153,2013,3123,2847,276,8.8
"48153",48,153,2014,2964,2753,211,7.1
"48153",48,153,2015,2743,2591,152,5.5
"48153",48,153,2016,2733,2595,138,5
"48153",48,153,2017,2694,2546,148,5.5
"48155",48,155,1990,840,826,14,1.7
"48155",48,155,1991,917,904,13,1.4
"48155",48,155,1992,964,953,11,1.1
"48155",48,155,1993,1061,1040,21,2
"48155",48,155,1994,1018,992,26,2.6
"48155",48,155,1995,1031,1010,21,2
"48155",48,155,1996,1110,1055,55,5
"48155",48,155,1997,891,837,54,6.1
"48155",48,155,1998,805,773,32,4
"48155",48,155,1999,853,834,19,2.2
"48155",48,155,2000,795,765,30,3.8
"48155",48,155,2001,783,753,30,3.8
"48155",48,155,2002,769,726,43,5.6
"48155",48,155,2003,807,747,60,7.4
"48155",48,155,2004,737,692,45,6.1
"48155",48,155,2005,686,653,33,4.8
"48155",48,155,2006,665,636,29,4.4
"48155",48,155,2007,686,661,25,3.6
"48155",48,155,2008,712,683,29,4.1
"48155",48,155,2009,720,679,41,5.7
"48155",48,155,2010,662,618,44,6.6
"48155",48,155,2011,667,618,49,7.3
"48155",48,155,2012,622,586,36,5.8
"48155",48,155,2013,578,548,30,5.2
"48155",48,155,2014,579,554,25,4.3
"48155",48,155,2015,550,528,22,4
"48155",48,155,2016,539,519,20,3.7
"48155",48,155,2017,595,575,20,3.4
"48157",48,157,1990,122373,118105,4268,3.5
"48157",48,157,1991,128335,123576,4759,3.7
"48157",48,157,1992,134974,128738,6236,4.6
"48157",48,157,1993,141341,134543,6798,4.8
"48157",48,157,1994,148316,141662,6654,4.5
"48157",48,157,1995,154027,148399,5628,3.7
"48157",48,157,1996,160645,155715,4930,3.1
"48157",48,157,1997,169790,164590,5200,3.1
"48157",48,157,1998,180580,175461,5119,2.8
"48157",48,157,1999,188554,182509,6045,3.2
"48157",48,157,2000,185694,179151,6543,3.5
"48157",48,157,2001,194220,186708,7512,3.9
"48157",48,157,2002,205912,195257,10655,5.2
"48157",48,157,2003,216199,203016,13183,6.1
"48157",48,157,2004,224488,212229,12259,5.5
"48157",48,157,2005,235000,222687,12313,5.2
"48157",48,157,2006,244549,233014,11535,4.7
"48157",48,157,2007,252965,242849,10116,4
"48157",48,157,2008,265383,253772,11611,4.4
"48157",48,157,2009,276806,257050,19756,7.1
"48157",48,157,2010,298162,275453,22709,7.6
"48157",48,157,2011,308363,286479,21884,7.1
"48157",48,157,2012,319114,300119,18995,6
"48157",48,157,2013,333271,314975,18296,5.5
"48157",48,157,2014,347068,331406,15662,4.5
"48157",48,157,2015,355573,340441,15132,4.3
"48157",48,157,2016,366246,347950,18296,5
"48157",48,157,2017,369788,352659,17129,4.6
"48159",48,159,1990,3514,3304,210,6
"48159",48,159,1991,3550,3292,258,7.3
"48159",48,159,1992,3608,3283,325,9
"48159",48,159,1993,3734,3437,297,8
"48159",48,159,1994,3847,3566,281,7.3
"48159",48,159,1995,3994,3732,262,6.6
"48159",48,159,1996,4301,4033,268,6.2
"48159",48,159,1997,4442,4233,209,4.7
"48159",48,159,1998,4449,4254,195,4.4
"48159",48,159,1999,4545,4369,176,3.9
"48159",48,159,2000,4435,4249,186,4.2
"48159",48,159,2001,4624,4432,192,4.2
"48159",48,159,2002,4961,4723,238,4.8
"48159",48,159,2003,4834,4587,247,5.1
"48159",48,159,2004,5163,4929,234,4.5
"48159",48,159,2005,5137,4888,249,4.8
"48159",48,159,2006,5478,5251,227,4.1
"48159",48,159,2007,5430,5223,207,3.8
"48159",48,159,2008,5302,5080,222,4.2
"48159",48,159,2009,5466,5093,373,6.8
"48159",48,159,2010,4811,4397,414,8.6
"48159",48,159,2011,4756,4368,388,8.2
"48159",48,159,2012,4630,4288,342,7.4
"48159",48,159,2013,4690,4384,306,6.5
"48159",48,159,2014,4659,4419,240,5.2
"48159",48,159,2015,4553,4331,222,4.9
"48159",48,159,2016,4502,4281,221,4.9
"48159",48,159,2017,4533,4325,208,4.6
"48161",48,161,1990,7061,6671,390,5.5
"48161",48,161,1991,7098,6678,420,5.9
"48161",48,161,1992,7486,6985,501,6.7
"48161",48,161,1993,7514,6932,582,7.7
"48161",48,161,1994,7523,6998,525,7
"48161",48,161,1995,7350,6929,421,5.7
"48161",48,161,1996,7581,7176,405,5.3
"48161",48,161,1997,7484,7087,397,5.3
"48161",48,161,1998,7536,7119,417,5.5
"48161",48,161,1999,7469,7132,337,4.5
"48161",48,161,2000,7902,7504,398,5
"48161",48,161,2001,8822,8431,391,4.4
"48161",48,161,2002,9191,8663,528,5.7
"48161",48,161,2003,9450,8882,568,6
"48161",48,161,2004,9792,9327,465,4.7
"48161",48,161,2005,10010,9586,424,4.2
"48161",48,161,2006,10099,9703,396,3.9
"48161",48,161,2007,9890,9533,357,3.6
"48161",48,161,2008,10192,9788,404,4
"48161",48,161,2009,10139,9499,640,6.3
"48161",48,161,2010,8149,7478,671,8.2
"48161",48,161,2011,8079,7447,632,7.8
"48161",48,161,2012,8062,7519,543,6.7
"48161",48,161,2013,7859,7317,542,6.9
"48161",48,161,2014,7844,7403,441,5.6
"48161",48,161,2015,7405,7004,401,5.4
"48161",48,161,2016,6857,6399,458,6.7
"48161",48,161,2017,6738,6313,425,6.3
"48163",48,163,1990,6108,5685,423,6.9
"48163",48,163,1991,7240,6630,610,8.4
"48163",48,163,1992,7623,6523,1100,14.4
"48163",48,163,1993,6975,6149,826,11.8
"48163",48,163,1994,6808,6036,772,11.3
"48163",48,163,1995,6621,5903,718,10.8
"48163",48,163,1996,6224,5622,602,9.7
"48163",48,163,1997,6317,5776,541,8.6
"48163",48,163,1998,6392,5826,566,8.9
"48163",48,163,1999,6139,5682,457,7.4
"48163",48,163,2000,6168,5796,372,6
"48163",48,163,2001,6230,5826,404,6.5
"48163",48,163,2002,6297,5810,487,7.7
"48163",48,163,2003,6619,6103,516,7.8
"48163",48,163,2004,6489,6038,451,7
"48163",48,163,2005,6371,5986,385,6
"48163",48,163,2006,6459,6110,349,5.4
"48163",48,163,2007,6504,6189,315,4.8
"48163",48,163,2008,6861,6495,366,5.3
"48163",48,163,2009,7439,6883,556,7.5
"48163",48,163,2010,7584,7031,553,7.3
"48163",48,163,2011,7973,7455,518,6.5
"48163",48,163,2012,8673,8236,437,5
"48163",48,163,2013,9288,8854,434,4.7
"48163",48,163,2014,10343,9974,369,3.6
"48163",48,163,2015,9795,9420,375,3.8
"48163",48,163,2016,8765,8338,427,4.9
"48163",48,163,2017,9300,8942,358,3.8
"48165",48,165,1990,6462,6210,252,3.9
"48165",48,165,1991,6796,6563,233,3.4
"48165",48,165,1992,6801,6434,367,5.4
"48165",48,165,1993,6887,6531,356,5.2
"48165",48,165,1994,6964,6632,332,4.8
"48165",48,165,1995,7000,6646,354,5.1
"48165",48,165,1996,6941,6655,286,4.1
"48165",48,165,1997,6776,6499,277,4.1
"48165",48,165,1998,6830,6484,346,5.1
"48165",48,165,1999,6729,6363,366,5.4
"48165",48,165,2000,6248,5981,267,4.3
"48165",48,165,2001,6312,6028,284,4.5
"48165",48,165,2002,6425,6113,312,4.9
"48165",48,165,2003,6837,6501,336,4.9
"48165",48,165,2004,6619,6289,330,5
"48165",48,165,2005,6223,5926,297,4.8
"48165",48,165,2006,6040,5764,276,4.6
"48165",48,165,2007,6399,6163,236,3.7
"48165",48,165,2008,6794,6535,259,3.8
"48165",48,165,2009,7041,6599,442,6.3
"48165",48,165,2010,7935,7464,471,5.9
"48165",48,165,2011,8508,8076,432,5.1
"48165",48,165,2012,8785,8412,373,4.2
"48165",48,165,2013,8916,8544,372,4.2
"48165",48,165,2014,9367,9062,305,3.3
"48165",48,165,2015,9398,9094,304,3.2
"48165",48,165,2016,9166,8825,341,3.7
"48165",48,165,2017,9239,8959,280,3
"48167",48,167,1990,113422,105449,7973,7
"48167",48,167,1991,116006,107404,8602,7.4
"48167",48,167,1992,121668,110833,10835,8.9
"48167",48,167,1993,125193,114472,10721,8.6
"48167",48,167,1994,125049,114446,10603,8.5
"48167",48,167,1995,126733,117142,9591,7.6
"48167",48,167,1996,126544,116191,10353,8.2
"48167",48,167,1997,125632,115539,10093,8
"48167",48,167,1998,123800,115462,8338,6.7
"48167",48,167,1999,122493,114420,8073,6.6
"48167",48,167,2000,128041,121875,6166,4.8
"48167",48,167,2001,129811,123099,6712,5.2
"48167",48,167,2002,133025,124370,8655,6.5
"48167",48,167,2003,135219,125578,9641,7.1
"48167",48,167,2004,136302,127098,9204,6.8
"48167",48,167,2005,137734,129836,7898,5.7
"48167",48,167,2006,137491,130476,7015,5.1
"48167",48,167,2007,138036,131749,6287,4.6
"48167",48,167,2008,141815,133876,7939,5.6
"48167",48,167,2009,140480,128942,11538,8.2
"48167",48,167,2010,147321,133867,13454,9.1
"48167",48,167,2011,149857,136627,13230,8.8
"48167",48,167,2012,153148,141451,11697,7.6
"48167",48,167,2013,155754,145043,10711,6.9
"48167",48,167,2014,157629,148793,8836,5.6
"48167",48,167,2015,157808,149954,7854,5
"48167",48,167,2016,159820,151306,8514,5.3
"48167",48,167,2017,161703,153291,8412,5.2
"48169",48,169,1990,2228,2132,96,4.3
"48169",48,169,1991,2271,2178,93,4.1
"48169",48,169,1992,2527,2391,136,5.4
"48169",48,169,1993,2406,2261,145,6
"48169",48,169,1994,2238,2089,149,6.7
"48169",48,169,1995,2211,2081,130,5.9
"48169",48,169,1996,2230,2103,127,5.7
"48169",48,169,1997,2143,1988,155,7.2
"48169",48,169,1998,2033,1894,139,6.8
"48169",48,169,1999,1989,1872,117,5.9
"48169",48,169,2000,2123,2031,92,4.3
"48169",48,169,2001,2329,2242,87,3.7
"48169",48,169,2002,2215,2096,119,5.4
"48169",48,169,2003,2307,2172,135,5.9
"48169",48,169,2004,2326,2202,124,5.3
"48169",48,169,2005,2399,2292,107,4.5
"48169",48,169,2006,2548,2451,97,3.8
"48169",48,169,2007,2425,2343,82,3.4
"48169",48,169,2008,2402,2311,91,3.8
"48169",48,169,2009,2456,2329,127,5.2
"48169",48,169,2010,2143,2017,126,5.9
"48169",48,169,2011,2225,2091,134,6
"48169",48,169,2012,2196,2087,109,5
"48169",48,169,2013,2238,2137,101,4.5
"48169",48,169,2014,2244,2162,82,3.7
"48169",48,169,2015,2129,2051,78,3.7
"48169",48,169,2016,2127,2044,83,3.9
"48169",48,169,2017,2117,2047,70,3.3
"48171",48,171,1990,8042,7912,130,1.6
"48171",48,171,1991,8791,8625,166,1.9
"48171",48,171,1992,9096,8870,226,2.5
"48171",48,171,1993,9401,9197,204,2.2
"48171",48,171,1994,9660,9469,191,2
"48171",48,171,1995,9951,9780,171,1.7
"48171",48,171,1996,9963,9798,165,1.7
"48171",48,171,1997,10119,9960,159,1.6
"48171",48,171,1998,10375,10188,187,1.8
"48171",48,171,1999,10285,10058,227,2.2
"48171",48,171,2000,10537,10133,404,3.8
"48171",48,171,2001,10843,10470,373,3.4
"48171",48,171,2002,11255,10795,460,4.1
"48171",48,171,2003,11795,11286,509,4.3
"48171",48,171,2004,12189,11735,454,3.7
"48171",48,171,2005,12746,12315,431,3.4
"48171",48,171,2006,12815,12398,417,3.3
"48171",48,171,2007,12904,12548,356,2.8
"48171",48,171,2008,13186,12785,401,3
"48171",48,171,2009,13690,13081,609,4.4
"48171",48,171,2010,12199,11533,666,5.5
"48171",48,171,2011,12447,11785,662,5.3
"48171",48,171,2012,12331,11752,579,4.7
"48171",48,171,2013,12426,11879,547,4.4
"48171",48,171,2014,12521,12080,441,3.5
"48171",48,171,2015,12633,12270,363,2.9
"48171",48,171,2016,12972,12604,368,2.8
"48171",48,171,2017,13193,12853,340,2.6
"48173",48,173,1990,662,650,12,1.8
"48173",48,173,1991,690,677,13,1.9
"48173",48,173,1992,614,594,20,3.3
"48173",48,173,1993,601,584,17,2.8
"48173",48,173,1994,597,581,16,2.7
"48173",48,173,1995,633,614,19,3
"48173",48,173,1996,614,597,17,2.8
"48173",48,173,1997,642,628,14,2.2
"48173",48,173,1998,661,646,15,2.3
"48173",48,173,1999,698,680,18,2.6
"48173",48,173,2000,728,706,22,3
"48173",48,173,2001,741,719,22,3
"48173",48,173,2002,691,665,26,3.8
"48173",48,173,2003,744,713,31,4.2
"48173",48,173,2004,679,653,26,3.8
"48173",48,173,2005,637,613,24,3.8
"48173",48,173,2006,579,553,26,4.5
"48173",48,173,2007,600,579,21,3.5
"48173",48,173,2008,630,606,24,3.8
"48173",48,173,2009,652,622,30,4.6
"48173",48,173,2010,704,670,34,4.8
"48173",48,173,2011,748,716,32,4.3
"48173",48,173,2012,763,732,31,4.1
"48173",48,173,2013,744,717,27,3.6
"48173",48,173,2014,830,808,22,2.7
"48173",48,173,2015,821,798,23,2.8
"48173",48,173,2016,747,718,29,3.9
"48173",48,173,2017,689,671,18,2.6
"48175",48,175,1990,2617,2498,119,4.5
"48175",48,175,1991,2669,2537,132,4.9
"48175",48,175,1992,2747,2587,160,5.8
"48175",48,175,1993,2758,2592,166,6
"48175",48,175,1994,2804,2618,186,6.6
"48175",48,175,1995,2736,2547,189,6.9
"48175",48,175,1996,2675,2546,129,4.8
"48175",48,175,1997,2485,2371,114,4.6
"48175",48,175,1998,2751,2649,102,3.7
"48175",48,175,1999,2690,2572,118,4.4
"48175",48,175,2000,3337,3211,126,3.8
"48175",48,175,2001,3323,3184,139,4.2
"48175",48,175,2002,3340,3166,174,5.2
"48175",48,175,2003,3376,3187,189,5.6
"48175",48,175,2004,3344,3158,186,5.6
"48175",48,175,2005,3397,3234,163,4.8
"48175",48,175,2006,3439,3301,138,4
"48175",48,175,2007,3440,3311,129,3.8
"48175",48,175,2008,3466,3337,129,3.7
"48175",48,175,2009,3383,3150,233,6.9
"48175",48,175,2010,3356,3108,248,7.4
"48175",48,175,2011,3377,3158,219,6.5
"48175",48,175,2012,3480,3289,191,5.5
"48175",48,175,2013,3538,3354,184,5.2
"48175",48,175,2014,3572,3426,146,4.1
"48175",48,175,2015,3445,3292,153,4.4
"48175",48,175,2016,3312,3120,192,5.8
"48175",48,175,2017,3244,3084,160,4.9
"48177",48,177,1990,7690,7458,232,3
"48177",48,177,1991,7947,7631,316,4
"48177",48,177,1992,7855,7430,425,5.4
"48177",48,177,1993,7645,7278,367,4.8
"48177",48,177,1994,7748,7399,349,4.5
"48177",48,177,1995,7516,7202,314,4.2
"48177",48,177,1996,7592,7216,376,5
"48177",48,177,1997,7324,6977,347,4.7
"48177",48,177,1998,7402,7110,292,3.9
"48177",48,177,1999,7506,7264,242,3.2
"48177",48,177,2000,9117,8803,314,3.4
"48177",48,177,2001,9241,8905,336,3.6
"48177",48,177,2002,9520,9048,472,5
"48177",48,177,2003,10088,9583,505,5
"48177",48,177,2004,9795,9346,449,4.6
"48177",48,177,2005,9632,9233,399,4.1
"48177",48,177,2006,9727,9338,389,4
"48177",48,177,2007,9680,9314,366,3.8
"48177",48,177,2008,9741,9363,378,3.9
"48177",48,177,2009,10126,9568,558,5.5
"48177",48,177,2010,9304,8670,634,6.8
"48177",48,177,2011,9474,8891,583,6.2
"48177",48,177,2012,9457,8977,480,5.1
"48177",48,177,2013,9517,9030,487,5.1
"48177",48,177,2014,9938,9555,383,3.9
"48177",48,177,2015,9691,9336,355,3.7
"48177",48,177,2016,9553,9149,404,4.2
"48177",48,177,2017,9361,9035,326,3.5
"48179",48,179,1990,11142,10668,474,4.3
"48179",48,179,1991,11049,10488,561,5.1
"48179",48,179,1992,11023,10319,704,6.4
"48179",48,179,1993,11270,10660,610,5.4
"48179",48,179,1994,11114,10607,507,4.6
"48179",48,179,1995,10907,10389,518,4.7
"48179",48,179,1996,10932,10437,495,4.5
"48179",48,179,1997,10703,10252,451,4.2
"48179",48,179,1998,10499,9993,506,4.8
"48179",48,179,1999,9698,9015,683,7
"48179",48,179,2000,9991,9495,496,5
"48179",48,179,2001,10144,9699,445,4.4
"48179",48,179,2002,10149,9530,619,6.1
"48179",48,179,2003,10329,9707,622,6
"48179",48,179,2004,10405,9876,529,5.1
"48179",48,179,2005,10824,10367,457,4.2
"48179",48,179,2006,10871,10449,422,3.9
"48179",48,179,2007,11155,10781,374,3.4
"48179",48,179,2008,11368,10976,392,3.4
"48179",48,179,2009,11279,10364,915,8.1
"48179",48,179,2010,9282,8485,797,8.6
"48179",48,179,2011,9634,8979,655,6.8
"48179",48,179,2012,9699,9155,544,5.6
"48179",48,179,2013,9786,9282,504,5.2
"48179",48,179,2014,9787,9394,393,4
"48179",48,179,2015,9268,8748,520,5.6
"48179",48,179,2016,8470,7887,583,6.9
"48179",48,179,2017,8216,7782,434,5.3
"48181",48,181,1990,46437,43815,2622,5.6
"48181",48,181,1991,46321,42973,3348,7.2
"48181",48,181,1992,46042,42366,3676,8
"48181",48,181,1993,46304,42889,3415,7.4
"48181",48,181,1994,47607,44675,2932,6.2
"48181",48,181,1995,48090,45637,2453,5.1
"48181",48,181,1996,49379,46967,2412,4.9
"48181",48,181,1997,50344,48082,2262,4.5
"48181",48,181,1998,50436,47963,2473,4.9
"48181",48,181,1999,50674,48389,2285,4.5
"48181",48,181,2000,56405,54152,2253,4
"48181",48,181,2001,55945,52997,2948,5.3
"48181",48,181,2002,56497,52744,3753,6.6
"48181",48,181,2003,57062,53038,4024,7.1
"48181",48,181,2004,56897,53431,3466,6.1
"48181",48,181,2005,56416,53380,3036,5.4
"48181",48,181,2006,56189,53472,2717,4.8
"48181",48,181,2007,55226,52706,2520,4.6
"48181",48,181,2008,55534,52693,2841,5.1
"48181",48,181,2009,56774,52260,4514,8
"48181",48,181,2010,59489,54620,4869,8.2
"48181",48,181,2011,60176,55436,4740,7.9
"48181",48,181,2012,60023,55913,4110,6.8
"48181",48,181,2013,60525,56735,3790,6.3
"48181",48,181,2014,60353,57429,2924,4.8
"48181",48,181,2015,59944,57533,2411,4
"48181",48,181,2016,61095,58744,2351,3.8
"48181",48,181,2017,62020,59857,2163,3.5
"48183",48,183,1990,53298,49001,4297,8.1
"48183",48,183,1991,54827,49824,5003,9.1
"48183",48,183,1992,56413,50682,5731,10.2
"48183",48,183,1993,56739,51200,5539,9.8
"48183",48,183,1994,57776,52712,5064,8.8
"48183",48,183,1995,57792,53379,4413,7.6
"48183",48,183,1996,58209,53949,4260,7.3
"48183",48,183,1997,59320,55068,4252,7.2
"48183",48,183,1998,59436,55212,4224,7.1
"48183",48,183,1999,59185,54717,4468,7.5
"48183",48,183,2000,55252,52286,2966,5.4
"48183",48,183,2001,55929,52887,3042,5.4
"48183",48,183,2002,56805,52820,3985,7
"48183",48,183,2003,57976,53906,4070,7
"48183",48,183,2004,59950,56477,3473,5.8
"48183",48,183,2005,60526,57558,2968,4.9
"48183",48,183,2006,61403,58640,2763,4.5
"48183",48,183,2007,62388,60043,2345,3.8
"48183",48,183,2008,63962,61447,2515,3.9
"48183",48,183,2009,64999,60381,4618,7.1
"48183",48,183,2010,60363,55568,4795,7.9
"48183",48,183,2011,61082,56722,4360,7.1
"48183",48,183,2012,61643,57824,3819,6.2
"48183",48,183,2013,61556,57894,3662,5.9
"48183",48,183,2014,61148,58184,2964,4.8
"48183",48,183,2015,59229,56301,2928,4.9
"48183",48,183,2016,58251,54711,3540,6.1
"48183",48,183,2017,57632,54678,2954,5.1
"48185",48,185,1990,7365,6983,382,5.2
"48185",48,185,1991,8082,7711,371,4.6
"48185",48,185,1992,7941,7465,476,6
"48185",48,185,1993,8137,7715,422,5.2
"48185",48,185,1994,8503,8106,397,4.7
"48185",48,185,1995,8608,8142,466,5.4
"48185",48,185,1996,8567,8017,550,6.4
"48185",48,185,1997,8865,8416,449,5.1
"48185",48,185,1998,8895,8462,433,4.9
"48185",48,185,1999,8966,8332,634,7.1
"48185",48,185,2000,9970,9440,530,5.3
"48185",48,185,2001,9951,9403,548,5.5
"48185",48,185,2002,9971,9207,764,7.7
"48185",48,185,2003,10297,9461,836,8.1
"48185",48,185,2004,10295,9581,714,6.9
"48185",48,185,2005,10229,9606,623,6.1
"48185",48,185,2006,10454,9896,558,5.3
"48185",48,185,2007,10447,9967,480,4.6
"48185",48,185,2008,10828,10277,551,5.1
"48185",48,185,2009,11544,10555,989,8.6
"48185",48,185,2010,11320,10312,1008,8.9
"48185",48,185,2011,11618,10714,904,7.8
"48185",48,185,2012,11814,11054,760,6.4
"48185",48,185,2013,11818,11110,708,6
"48185",48,185,2014,11824,11261,563,4.8
"48185",48,185,2015,11502,10891,611,5.3
"48185",48,185,2016,11032,10304,728,6.6
"48185",48,185,2017,10842,10270,572,5.3
"48187",48,187,1990,32217,30794,1423,4.4
"48187",48,187,1991,32382,30981,1401,4.3
"48187",48,187,1992,33500,32094,1406,4.2
"48187",48,187,1993,34698,33452,1246,3.6
"48187",48,187,1994,36467,35306,1161,3.2
"48187",48,187,1995,37708,36614,1094,2.9
"48187",48,187,1996,39029,37833,1196,3.1
"48187",48,187,1997,40806,39614,1192,2.9
"48187",48,187,1998,41727,40649,1078,2.6
"48187",48,187,1999,43183,42116,1067,2.5
"48187",48,187,2000,45406,43873,1533,3.4
"48187",48,187,2001,46480,44700,1780,3.8
"48187",48,187,2002,48040,45513,2527,5.3
"48187",48,187,2003,49002,46400,2602,5.3
"48187",48,187,2004,49907,47495,2412,4.8
"48187",48,187,2005,51700,49318,2382,4.6
"48187",48,187,2006,54238,51905,2333,4.3
"48187",48,187,2007,55441,53362,2079,3.7
"48187",48,187,2008,57728,55278,2450,4.2
"48187",48,187,2009,60038,56180,3858,6.4
"48187",48,187,2010,64924,60560,4364,6.7
"48187",48,187,2011,66766,62439,4327,6.5
"48187",48,187,2012,68312,64435,3877,5.7
"48187",48,187,2013,70098,66253,3845,5.5
"48187",48,187,2014,71582,68488,3094,4.3
"48187",48,187,2015,72882,70313,2569,3.5
"48187",48,187,2016,75830,73109,2721,3.6
"48187",48,187,2017,77510,74946,2564,3.3
"48189",48,189,1990,16832,16000,832,4.9
"48189",48,189,1991,17179,16267,912,5.3
"48189",48,189,1992,17255,16154,1101,6.4
"48189",48,189,1993,17039,16075,964,5.7
"48189",48,189,1994,17576,16710,866,4.9
"48189",48,189,1995,17821,16721,1100,6.2
"48189",48,189,1996,17705,16554,1151,6.5
"48189",48,189,1997,17328,16201,1127,6.5
"48189",48,189,1998,17359,16303,1056,6.1
"48189",48,189,1999,16956,16108,848,5
"48189",48,189,2000,16959,16204,755,4.5
"48189",48,189,2001,17137,16346,791,4.6
"48189",48,189,2002,16914,15960,954,5.6
"48189",48,189,2003,17699,16618,1081,6.1
"48189",48,189,2004,17302,16283,1019,5.9
"48189",48,189,2005,16756,15865,891,5.3
"48189",48,189,2006,16548,15692,856,5.2
"48189",48,189,2007,16208,15458,750,4.6
"48189",48,189,2008,16753,16009,744,4.4
"48189",48,189,2009,17323,16278,1045,6
"48189",48,189,2010,16180,14982,1198,7.4
"48189",48,189,2011,16238,15023,1215,7.5
"48189",48,189,2012,15861,14764,1097,6.9
"48189",48,189,2013,14811,12843,1968,13.3
"48189",48,189,2014,13525,12256,1269,9.4
"48189",48,189,2015,12875,12059,816,6.3
"48189",48,189,2016,12567,11862,705,5.6
"48189",48,189,2017,12418,11781,637,5.1
"48191",48,191,1990,2062,1938,124,6
"48191",48,191,1991,1954,1832,122,6.2
"48191",48,191,1992,2012,1855,157,7.8
"48191",48,191,1993,1915,1786,129,6.7
"48191",48,191,1994,1887,1740,147,7.8
"48191",48,191,1995,1786,1661,125,7
"48191",48,191,1996,1772,1639,133,7.5
"48191",48,191,1997,1702,1584,118,6.9
"48191",48,191,1998,1663,1542,121,7.3
"48191",48,191,1999,1607,1522,85,5.3
"48191",48,191,2000,1720,1630,90,5.2
"48191",48,191,2001,1740,1647,93,5.3
"48191",48,191,2002,1688,1584,104,6.2
"48191",48,191,2003,1739,1625,114,6.6
"48191",48,191,2004,1659,1551,108,6.5
"48191",48,191,2005,1585,1493,92,5.8
"48191",48,191,2006,1456,1367,89,6.1
"48191",48,191,2007,1398,1324,74,5.3
"48191",48,191,2008,1436,1357,79,5.5
"48191",48,191,2009,1462,1342,120,8.2
"48191",48,191,2010,1421,1292,129,9.1
"48191",48,191,2011,1401,1279,122,8.7
"48191",48,191,2012,1343,1239,104,7.7
"48191",48,191,2013,1290,1199,91,7.1
"48191",48,191,2014,1264,1185,79,6.3
"48191",48,191,2015,1202,1138,64,5.3
"48191",48,191,2016,1164,1086,78,6.7
"48191",48,191,2017,1129,1059,70,6.2
"48193",48,193,1990,3411,3242,169,5
"48193",48,193,1991,3462,3339,123,3.6
"48193",48,193,1992,3600,3473,127,3.5
"48193",48,193,1993,3794,3631,163,4.3
"48193",48,193,1994,3749,3629,120,3.2
"48193",48,193,1995,3888,3768,120,3.1
"48193",48,193,1996,3849,3713,136,3.5
"48193",48,193,1997,3808,3691,117,3.1
"48193",48,193,1998,4068,3904,164,4
"48193",48,193,1999,4008,3849,159,4
"48193",48,193,2000,4052,3901,151,3.7
"48193",48,193,2001,4212,4053,159,3.8
"48193",48,193,2002,4309,4120,189,4.4
"48193",48,193,2003,4484,4265,219,4.9
"48193",48,193,2004,4277,4083,194,4.5
"48193",48,193,2005,3958,3775,183,4.6
"48193",48,193,2006,3999,3832,167,4.2
"48193",48,193,2007,4024,3884,140,3.5
"48193",48,193,2008,4258,4107,151,3.5
"48193",48,193,2009,4352,4108,244,5.6
"48193",48,193,2010,3939,3671,268,6.8
"48193",48,193,2011,3880,3634,246,6.3
"48193",48,193,2012,3750,3532,218,5.8
"48193",48,193,2013,3622,3406,216,6
"48193",48,193,2014,3567,3403,164,4.6
"48193",48,193,2015,3480,3318,162,4.7
"48193",48,193,2016,3593,3417,176,4.9
"48193",48,193,2017,3607,3465,142,3.9
"48195",48,195,1990,2749,2681,68,2.5
"48195",48,195,1991,2827,2721,106,3.7
"48195",48,195,1992,2655,2559,96,3.6
"48195",48,195,1993,2550,2464,86,3.4
"48195",48,195,1994,2507,2437,70,2.8
"48195",48,195,1995,2429,2353,76,3.1
"48195",48,195,1996,2522,2437,85,3.4
"48195",48,195,1997,2510,2444,66,2.6
"48195",48,195,1998,2490,2424,66,2.7
"48195",48,195,1999,2462,2375,87,3.5
"48195",48,195,2000,2828,2745,83,2.9
"48195",48,195,2001,2875,2791,84,2.9
"48195",48,195,2002,2759,2660,99,3.6
"48195",48,195,2003,2884,2767,117,4.1
"48195",48,195,2004,2692,2592,100,3.7
"48195",48,195,2005,2472,2384,88,3.6
"48195",48,195,2006,2387,2302,85,3.6
"48195",48,195,2007,2505,2430,75,3
"48195",48,195,2008,2647,2562,85,3.2
"48195",48,195,2009,2785,2639,146,5.2
"48195",48,195,2010,3030,2899,131,4.3
"48195",48,195,2011,3047,2923,124,4.1
"48195",48,195,2012,3055,2951,104,3.4
"48195",48,195,2013,3129,3027,102,3.3
"48195",48,195,2014,3242,3160,82,2.5
"48195",48,195,2015,3109,3017,92,3
"48195",48,195,2016,2940,2848,92,3.1
"48195",48,195,2017,2856,2784,72,2.5
"48197",48,197,1990,2247,2109,138,6.1
"48197",48,197,1991,2110,2020,90,4.3
"48197",48,197,1992,2102,1997,105,5
"48197",48,197,1993,2070,1961,109,5.3
"48197",48,197,1994,2050,1958,92,4.5
"48197",48,197,1995,2084,2006,78,3.7
"48197",48,197,1996,2059,1950,109,5.3
"48197",48,197,1997,1979,1875,104,5.3
"48197",48,197,1998,1994,1881,113,5.7
"48197",48,197,1999,1916,1824,92,4.8
"48197",48,197,2000,2455,2366,89,3.6
"48197",48,197,2001,2441,2348,93,3.8
"48197",48,197,2002,2383,2253,130,5.5
"48197",48,197,2003,2375,2223,152,6.4
"48197",48,197,2004,2272,2157,115,5.1
"48197",48,197,2005,2292,2189,103,4.5
"48197",48,197,2006,2332,2239,93,4
"48197",48,197,2007,2321,2238,83,3.6
"48197",48,197,2008,2329,2247,82,3.5
"48197",48,197,2009,2264,2098,166,7.3
"48197",48,197,2010,1941,1780,161,8.3
"48197",48,197,2011,1873,1743,130,6.9
"48197",48,197,2012,1763,1659,104,5.9
"48197",48,197,2013,1699,1600,99,5.8
"48197",48,197,2014,1648,1567,81,4.9
"48197",48,197,2015,1619,1540,79,4.9
"48197",48,197,2016,1621,1558,63,3.9
"48197",48,197,2017,1654,1590,64,3.9
"48199",48,199,1990,19112,17906,1206,6.3
"48199",48,199,1991,20451,19100,1351,6.6
"48199",48,199,1992,21131,19527,1604,7.6
"48199",48,199,1993,21810,19667,2143,9.8
"48199",48,199,1994,21764,19912,1852,8.5
"48199",48,199,1995,22191,20308,1883,8.5
"48199",48,199,1996,22496,20660,1836,8.2
"48199",48,199,1997,23086,21457,1629,7.1
"48199",48,199,1998,23450,21940,1510,6.4
"48199",48,199,1999,23699,21847,1852,7.8
"48199",48,199,2000,23214,21933,1281,5.5
"48199",48,199,2001,23338,21902,1436,6.2
"48199",48,199,2002,24035,22278,1757,7.3
"48199",48,199,2003,24477,22584,1893,7.7
"48199",48,199,2004,24363,22577,1786,7.3
"48199",48,199,2005,24619,22996,1623,6.6
"48199",48,199,2006,25415,24094,1321,5.2
"48199",48,199,2007,25726,24548,1178,4.6
"48199",48,199,2008,26128,24757,1371,5.2
"48199",48,199,2009,27221,24898,2323,8.5
"48199",48,199,2010,25839,23282,2557,9.9
"48199",48,199,2011,26253,23766,2487,9.5
"48199",48,199,2012,25880,23700,2180,8.4
"48199",48,199,2013,25303,23267,2036,8
"48199",48,199,2014,25392,23804,1588,6.3
"48199",48,199,2015,24968,23562,1406,5.6
"48199",48,199,2016,25113,23586,1527,6.1
"48199",48,199,2017,25045,23511,1534,6.1
"48201",48,201,1990,1551276,1471869,79407,5.1
"48201",48,201,1991,1581870,1489888,91982,5.8
"48201",48,201,1992,1618174,1499537,118637,7.3
"48201",48,201,1993,1639780,1515728,124052,7.6
"48201",48,201,1994,1656582,1544366,112216,6.8
"48201",48,201,1995,1671553,1570944,100609,6
"48201",48,201,1996,1680877,1587636,93241,5.5
"48201",48,201,1997,1715363,1626564,88799,5.2
"48201",48,201,1998,1751260,1675586,75674,4.3
"48201",48,201,1999,1768585,1684805,83780,4.7
"48201",48,201,2000,1725910,1652532,73378,4.3
"48201",48,201,2001,1751413,1669710,81703,4.7
"48201",48,201,2002,1790572,1680755,109817,6.1
"48201",48,201,2003,1806134,1683596,122538,6.8
"48201",48,201,2004,1805276,1693835,111441,6.2
"48201",48,201,2005,1823699,1719989,103710,5.7
"48201",48,201,2006,1874936,1780465,94471,5
"48201",48,201,2007,1898209,1818000,80209,4.2
"48201",48,201,2008,1933140,1842516,90624,4.7
"48201",48,201,2009,1971402,1822227,149175,7.6
"48201",48,201,2010,2064026,1892849,171177,8.3
"48201",48,201,2011,2110507,1944945,165562,7.8
"48201",48,201,2012,2156942,2013828,143114,6.6
"48201",48,201,2013,2199353,2066248,133105,6.1
"48201",48,201,2014,2230152,2119161,110991,5
"48201",48,201,2015,2232553,2129050,103503,4.6
"48201",48,201,2016,2246239,2126642,119597,5.3
"48201",48,201,2017,2268944,2155485,113459,5
"48203",48,203,1990,25512,23827,1685,6.6
"48203",48,203,1991,25943,23701,2242,8.6
"48203",48,203,1992,26565,23919,2646,10
"48203",48,203,1993,26989,24264,2725,10.1
"48203",48,203,1994,27428,24770,2658,9.7
"48203",48,203,1995,27685,25350,2335,8.4
"48203",48,203,1996,28170,25437,2733,9.7
"48203",48,203,1997,28153,25844,2309,8.2
"48203",48,203,1998,28152,26007,2145,7.6
"48203",48,203,1999,27675,25733,1942,7
"48203",48,203,2000,29417,27973,1444,4.9
"48203",48,203,2001,29189,27607,1582,5.4
"48203",48,203,2002,29994,28004,1990,6.6
"48203",48,203,2003,30649,28617,2032,6.6
"48203",48,203,2004,31257,29489,1768,5.7
"48203",48,203,2005,31118,29386,1732,5.6
"48203",48,203,2006,31445,29855,1590,5.1
"48203",48,203,2007,32064,30653,1411,4.4
"48203",48,203,2008,32306,30819,1487,4.6
"48203",48,203,2009,32818,30134,2684,8.2
"48203",48,203,2010,30822,27934,2888,9.4
"48203",48,203,2011,31521,28848,2673,8.5
"48203",48,203,2012,31972,29608,2364,7.4
"48203",48,203,2013,32322,30108,2214,6.8
"48203",48,203,2014,32194,30425,1769,5.5
"48203",48,203,2015,31176,29551,1625,5.2
"48203",48,203,2016,29895,28100,1795,6
"48203",48,203,2017,29410,27880,1530,5.2
"48205",48,205,1990,1728,1701,27,1.6
"48205",48,205,1991,1826,1783,43,2.4
"48205",48,205,1992,1968,1921,47,2.4
"48205",48,205,1993,2106,2060,46,2.2
"48205",48,205,1994,2143,2099,44,2.1
"48205",48,205,1995,2776,2706,70,2.5
"48205",48,205,1996,2845,2783,62,2.2
"48205",48,205,1997,2793,2749,44,1.6
"48205",48,205,1998,2946,2901,45,1.5
"48205",48,205,1999,3008,2969,39,1.3
"48205",48,205,2000,2431,2355,76,3.1
"48205",48,205,2001,2453,2375,78,3.2
"48205",48,205,2002,2325,2239,86,3.7
"48205",48,205,2003,2569,2464,105,4.1
"48205",48,205,2004,2421,2330,91,3.8
"48205",48,205,2005,2276,2187,89,3.9
"48205",48,205,2006,2198,2111,87,4
"48205",48,205,2007,2287,2214,73,3.2
"48205",48,205,2008,2448,2368,80,3.3
"48205",48,205,2009,2466,2366,100,4.1
"48205",48,205,2010,2695,2583,112,4.2
"48205",48,205,2011,2813,2702,111,3.9
"48205",48,205,2012,2903,2806,97,3.3
"48205",48,205,2013,2932,2840,92,3.1
"48205",48,205,2014,2901,2828,73,2.5
"48205",48,205,2015,3002,2938,64,2.1
"48205",48,205,2016,2954,2895,59,2
"48205",48,205,2017,2947,2889,58,2
"48207",48,207,1990,3074,2977,97,3.2
"48207",48,207,1991,2872,2776,96,3.3
"48207",48,207,1992,2970,2842,128,4.3
"48207",48,207,1993,2953,2806,147,5
"48207",48,207,1994,3017,2841,176,5.8
"48207",48,207,1995,2883,2767,116,4
"48207",48,207,1996,2823,2703,120,4.3
"48207",48,207,1997,2756,2643,113,4.1
"48207",48,207,1998,2629,2529,100,3.8
"48207",48,207,1999,2720,2609,111,4.1
"48207",48,207,2000,2903,2781,122,4.2
"48207",48,207,2001,3118,2995,123,3.9
"48207",48,207,2002,2939,2787,152,5.2
"48207",48,207,2003,3142,2968,174,5.5
"48207",48,207,2004,3203,3064,139,4.3
"48207",48,207,2005,3147,3028,119,3.8
"48207",48,207,2006,2943,2828,115,3.9
"48207",48,207,2007,3054,2947,107,3.5
"48207",48,207,2008,3254,3150,104,3.2
"48207",48,207,2009,3240,3076,164,5.1
"48207",48,207,2010,2994,2831,163,5.4
"48207",48,207,2011,3039,2876,163,5.4
"48207",48,207,2012,2775,2627,148,5.3
"48207",48,207,2013,2712,2578,134,4.9
"48207",48,207,2014,2694,2588,106,3.9
"48207",48,207,2015,2580,2490,90,3.5
"48207",48,207,2016,2504,2398,106,4.2
"48207",48,207,2017,2432,2317,115,4.7
"48209",48,209,1990,34005,32243,1762,5.2
"48209",48,209,1991,34464,32939,1525,4.4
"48209",48,209,1992,35972,34596,1376,3.8
"48209",48,209,1993,38137,36903,1234,3.2
"48209",48,209,1994,40905,39632,1273,3.1
"48209",48,209,1995,43711,42360,1351,3.1
"48209",48,209,1996,46249,44840,1409,3
"48209",48,209,1997,48060,46530,1530,3.2
"48209",48,209,1998,50485,49095,1390,2.8
"48209",48,209,1999,53037,51597,1440,2.7
"48209",48,209,2000,56709,54900,1809,3.2
"48209",48,209,2001,57959,55698,2261,3.9
"48209",48,209,2002,61060,57727,3333,5.5
"48209",48,209,2003,62864,59214,3650,5.8
"48209",48,209,2004,64411,61133,3278,5.1
"48209",48,209,2005,67038,63996,3042,4.5
"48209",48,209,2006,69521,66632,2889,4.2
"48209",48,209,2007,73243,70537,2706,3.7
"48209",48,209,2008,76598,73340,3258,4.3
"48209",48,209,2009,78949,73750,5199,6.6
"48209",48,209,2010,80387,74737,5650,7
"48209",48,209,2011,83333,77746,5587,6.7
"48209",48,209,2012,85818,80810,5008,5.8
"48209",48,209,2013,89904,85104,4800,5.3
"48209",48,209,2014,94045,90032,4013,4.3
"48209",48,209,2015,98383,95015,3368,3.4
"48209",48,209,2016,104691,101202,3489,3.3
"48209",48,209,2017,108012,104634,3378,3.1
"48211",48,211,1990,1803,1758,45,2.5
"48211",48,211,1991,1859,1794,65,3.5
"48211",48,211,1992,1900,1803,97,5.1
"48211",48,211,1993,1880,1785,95,5.1
"48211",48,211,1994,1854,1777,77,4.2
"48211",48,211,1995,1865,1802,63,3.4
"48211",48,211,1996,1928,1871,57,3
"48211",48,211,1997,1901,1834,67,3.5
"48211",48,211,1998,1922,1868,54,2.8
"48211",48,211,1999,1877,1821,56,3
"48211",48,211,2000,1844,1791,53,2.9
"48211",48,211,2001,1975,1922,53,2.7
"48211",48,211,2002,2122,2054,68,3.2
"48211",48,211,2003,2345,2277,68,2.9
"48211",48,211,2004,2328,2254,74,3.2
"48211",48,211,2005,2251,2186,65,2.9
"48211",48,211,2006,2313,2251,62,2.7
"48211",48,211,2007,2646,2592,54,2
"48211",48,211,2008,3142,3083,59,1.9
"48211",48,211,2009,2617,2527,90,3.4
"48211",48,211,2010,2130,2046,84,3.9
"48211",48,211,2011,2390,2307,83,3.5
"48211",48,211,2012,2547,2473,74,2.9
"48211",48,211,2013,2476,2401,75,3
"48211",48,211,2014,2546,2485,61,2.4
"48211",48,211,2015,2299,2227,72,3.1
"48211",48,211,2016,2111,2032,79,3.7
"48211",48,211,2017,2335,2277,58,2.5
"48213",48,213,1990,25971,23521,2450,9.4
"48213",48,213,1991,25829,23208,2621,10.1
"48213",48,213,1992,25648,23412,2236,8.7
"48213",48,213,1993,25879,23960,1919,7.4
"48213",48,213,1994,26642,24928,1714,6.4
"48213",48,213,1995,27439,25807,1632,5.9
"48213",48,213,1996,28030,26539,1491,5.3
"48213",48,213,1997,29177,27806,1371,4.7
"48213",48,213,1998,29706,28458,1248,4.2
"48213",48,213,1999,30405,29333,1072,3.5
"48213",48,213,2000,32897,31530,1367,4.2
"48213",48,213,2001,33153,31628,1525,4.6
"48213",48,213,2002,33746,31790,1956,5.8
"48213",48,213,2003,34679,32544,2135,6.2
"48213",48,213,2004,34969,32840,2129,6.1
"48213",48,213,2005,34466,32483,1983,5.8
"48213",48,213,2006,34446,32682,1764,5.1
"48213",48,213,2007,34143,32642,1501,4.4
"48213",48,213,2008,34553,32747,1806,5.2
"48213",48,213,2009,35137,32304,2833,8.1
"48213",48,213,2010,34752,31691,3061,8.8
"48213",48,213,2011,35053,32068,2985,8.5
"48213",48,213,2012,34547,31932,2615,7.6
"48213",48,213,2013,34562,32104,2458,7.1
"48213",48,213,2014,34738,32801,1937,5.6
"48213",48,213,2015,34339,32673,1666,4.9
"48213",48,213,2016,35321,33670,1651,4.7
"48213",48,213,2017,35566,34090,1476,4.2
"48215",48,215,1990,165779,128595,37184,22.4
"48215",48,215,1991,166076,129858,36218,21.8
"48215",48,215,1992,172500,133971,38529,22.3
"48215",48,215,1993,176641,140307,36334,20.6
"48215",48,215,1994,183051,147033,36018,19.7
"48215",48,215,1995,187787,150439,37348,19.9
"48215",48,215,1996,189191,152777,36414,19.2
"48215",48,215,1997,192481,157788,34693,18
"48215",48,215,1998,194779,159775,35004,18
"48215",48,215,1999,195207,166747,28460,14.6
"48215",48,215,2000,211320,192190,19130,9.1
"48215",48,215,2001,219181,198257,20924,9.5
"48215",48,215,2002,231099,206937,24162,10.5
"48215",48,215,2003,245527,220128,25399,10.3
"48215",48,215,2004,254273,231420,22853,9
"48215",48,215,2005,260575,239969,20606,7.9
"48215",48,215,2006,265667,246227,19440,7.3
"48215",48,215,2007,271679,254038,17641,6.5
"48215",48,215,2008,282305,262201,20104,7.1
"48215",48,215,2009,296567,265434,31133,10.5
"48215",48,215,2010,318302,280884,37418,11.8
"48215",48,215,2011,326443,288558,37885,11.6
"48215",48,215,2012,328096,293300,34796,10.6
"48215",48,215,2013,331246,296978,34268,10.3
"48215",48,215,2014,332027,302957,29070,8.8
"48215",48,215,2015,330600,304446,26154,7.9
"48215",48,215,2016,336469,310204,26265,7.8
"48215",48,215,2017,341602,316347,25255,7.4
"48217",48,217,1990,11781,11032,749,6.4
"48217",48,217,1991,12243,11410,833,6.8
"48217",48,217,1992,12974,11778,1196,9.2
"48217",48,217,1993,13066,12126,940,7.2
"48217",48,217,1994,13485,12748,737,5.5
"48217",48,217,1995,14307,13661,646,4.5
"48217",48,217,1996,15043,14404,639,4.2
"48217",48,217,1997,15170,14506,664,4.4
"48217",48,217,1998,15933,15312,621,3.9
"48217",48,217,1999,16278,15698,580,3.6
"48217",48,217,2000,15243,14555,688,4.5
"48217",48,217,2001,15301,14439,862,5.6
"48217",48,217,2002,15364,14335,1029,6.7
"48217",48,217,2003,15386,14214,1172,7.6
"48217",48,217,2004,15370,14374,996,6.5
"48217",48,217,2005,15349,14389,960,6.3
"48217",48,217,2006,15118,14281,837,5.5
"48217",48,217,2007,15362,14652,710,4.6
"48217",48,217,2008,15945,15158,787,4.9
"48217",48,217,2009,16420,15136,1284,7.8
"48217",48,217,2010,15940,14604,1336,8.4
"48217",48,217,2011,15891,14582,1309,8.2
"48217",48,217,2012,15805,14711,1094,6.9
"48217",48,217,2013,15972,14946,1026,6.4
"48217",48,217,2014,15883,15046,837,5.3
"48217",48,217,2015,15603,14894,709,4.5
"48217",48,217,2016,15778,15083,695,4.4
"48217",48,217,2017,16142,15516,626,3.9
"48219",48,219,1990,11276,10713,563,5
"48219",48,219,1991,11291,10781,510,4.5
"48219",48,219,1992,11558,10859,699,6
"48219",48,219,1993,11866,11275,591,5
"48219",48,219,1994,11687,11050,637,5.5
"48219",48,219,1995,11359,10637,722,6.4
"48219",48,219,1996,11150,10573,577,5.2
"48219",48,219,1997,11612,11066,546,4.7
"48219",48,219,1998,11116,10437,679,6.1
"48219",48,219,1999,10877,10144,733,6.7
"48219",48,219,2000,10919,10480,439,4
"48219",48,219,2001,11307,10866,441,3.9
"48219",48,219,2002,11104,10539,565,5.1
"48219",48,219,2003,11702,11084,618,5.3
"48219",48,219,2004,11287,10745,542,4.8
"48219",48,219,2005,11049,10554,495,4.5
"48219",48,219,2006,11344,10875,469,4.1
"48219",48,219,2007,11376,10969,407,3.6
"48219",48,219,2008,11936,11497,439,3.7
"48219",48,219,2009,12196,11375,821,6.7
"48219",48,219,2010,11030,10252,778,7.1
"48219",48,219,2011,11360,10641,719,6.3
"48219",48,219,2012,11790,11167,623,5.3
"48219",48,219,2013,11924,11325,599,5
"48219",48,219,2014,12091,11625,466,3.9
"48219",48,219,2015,11709,11223,486,4.2
"48219",48,219,2016,11151,10634,517,4.6
"48219",48,219,2017,11270,10851,419,3.7
"48221",48,221,1990,13766,12302,1464,10.6
"48221",48,221,1991,13319,12484,835,6.3
"48221",48,221,1992,13933,12768,1165,8.4
"48221",48,221,1993,14568,12807,1761,12.1
"48221",48,221,1994,14309,13226,1083,7.6
"48221",48,221,1995,15000,14089,911,6.1
"48221",48,221,1996,15592,14849,743,4.8
"48221",48,221,1997,16125,15351,774,4.8
"48221",48,221,1998,16692,15965,727,4.4
"48221",48,221,1999,17368,16728,640,3.7
"48221",48,221,2000,20324,19527,797,3.9
"48221",48,221,2001,20591,19648,943,4.6
"48221",48,221,2002,21741,20485,1256,5.8
"48221",48,221,2003,22771,21341,1430,6.3
"48221",48,221,2004,22538,21208,1330,5.9
"48221",48,221,2005,22525,21350,1175,5.2
"48221",48,221,2006,22995,21877,1118,4.9
"48221",48,221,2007,23773,22805,968,4.1
"48221",48,221,2008,25244,24195,1049,4.2
"48221",48,221,2009,26231,24341,1890,7.2
"48221",48,221,2010,23352,21363,1989,8.5
"48221",48,221,2011,23627,21752,1875,7.9
"48221",48,221,2012,23783,22233,1550,6.5
"48221",48,221,2013,24016,22561,1455,6.1
"48221",48,221,2014,24258,23065,1193,4.9
"48221",48,221,2015,24516,23411,1105,4.5
"48221",48,221,2016,25222,24036,1186,4.7
"48221",48,221,2017,25691,24616,1075,4.2
"48223",48,223,1990,13983,13179,804,5.7
"48223",48,223,1991,14282,13176,1106,7.7
"48223",48,223,1992,15005,13773,1232,8.2
"48223",48,223,1993,15596,14507,1089,7
"48223",48,223,1994,15789,14678,1111,7
"48223",48,223,1995,15936,14946,990,6.2
"48223",48,223,1996,15981,15081,900,5.6
"48223",48,223,1997,15761,14993,768,4.9
"48223",48,223,1998,16034,15236,798,5
"48223",48,223,1999,15772,15084,688,4.4
"48223",48,223,2000,16398,15745,653,4
"48223",48,223,2001,16256,15527,729,4.5
"48223",48,223,2002,16604,15709,895,5.4
"48223",48,223,2003,16817,15815,1002,6
"48223",48,223,2004,17067,16176,891,5.2
"48223",48,223,2005,17449,16650,799,4.6
"48223",48,223,2006,17341,16617,724,4.2
"48223",48,223,2007,16946,16302,644,3.8
"48223",48,223,2008,17539,16823,716,4.1
"48223",48,223,2009,17826,16744,1082,6.1
"48223",48,223,2010,16624,15386,1238,7.4
"48223",48,223,2011,16864,15625,1239,7.3
"48223",48,223,2012,17087,15981,1106,6.5
"48223",48,223,2013,17273,16278,995,5.8
"48223",48,223,2014,17491,16672,819,4.7
"48223",48,223,2015,16999,16285,714,4.2
"48223",48,223,2016,17293,16604,689,4
"48223",48,223,2017,17145,16533,612,3.6
"48225",48,225,1990,8493,8057,436,5.1
"48225",48,225,1991,8397,7971,426,5.1
"48225",48,225,1992,8528,8058,470,5.5
"48225",48,225,1993,8407,7940,467,5.6
"48225",48,225,1994,8123,7767,356,4.4
"48225",48,225,1995,8343,7984,359,4.3
"48225",48,225,1996,8195,7896,299,3.6
"48225",48,225,1997,8560,8225,335,3.9
"48225",48,225,1998,8855,8501,354,4
"48225",48,225,1999,9162,8763,399,4.4
"48225",48,225,2000,9081,8618,463,5.1
"48225",48,225,2001,9546,9045,501,5.2
"48225",48,225,2002,9289,8678,611,6.6
"48225",48,225,2003,9818,9117,701,7.1
"48225",48,225,2004,9388,8752,636,6.8
"48225",48,225,2005,8494,7945,549,6.5
"48225",48,225,2006,8048,7558,490,6.1
"48225",48,225,2007,7853,7396,457,5.8
"48225",48,225,2008,7968,7459,509,6.4
"48225",48,225,2009,8214,7463,751,9.1
"48225",48,225,2010,10538,9730,808,7.7
"48225",48,225,2011,10660,9830,830,7.8
"48225",48,225,2012,10081,9366,715,7.1
"48225",48,225,2013,9852,9238,614,6.2
"48225",48,225,2014,9804,9318,486,5
"48225",48,225,2015,9929,9487,442,4.5
"48225",48,225,2016,10045,9582,463,4.6
"48225",48,225,2017,10556,10109,447,4.2
"48227",48,227,1990,14734,14020,714,4.8
"48227",48,227,1991,13583,12949,634,4.7
"48227",48,227,1992,14181,13242,939,6.6
"48227",48,227,1993,14040,13302,738,5.3
"48227",48,227,1994,13986,13394,592,4.2
"48227",48,227,1995,13907,13349,558,4
"48227",48,227,1996,13929,13349,580,4.2
"48227",48,227,1997,13898,13345,553,4
"48227",48,227,1998,14247,13551,696,4.9
"48227",48,227,1999,13695,12873,822,6
"48227",48,227,2000,13606,12920,686,5
"48227",48,227,2001,13983,13288,695,5
"48227",48,227,2002,14235,13336,899,6.3
"48227",48,227,2003,14225,13315,910,6.4
"48227",48,227,2004,13730,12949,781,5.7
"48227",48,227,2005,13311,12602,709,5.3
"48227",48,227,2006,13660,13001,659,4.8
"48227",48,227,2007,13881,13319,562,4
"48227",48,227,2008,13974,13342,632,4.5
"48227",48,227,2009,14327,13282,1045,7.3
"48227",48,227,2010,13223,12275,948,7.2
"48227",48,227,2011,13256,12390,866,6.5
"48227",48,227,2012,13403,12651,752,5.6
"48227",48,227,2013,13572,12840,732,5.4
"48227",48,227,2014,13593,12998,595,4.4
"48227",48,227,2015,13345,12731,614,4.6
"48227",48,227,2016,13188,12459,729,5.5
"48227",48,227,2017,13197,12629,568,4.3
"48229",48,229,1990,1260,1227,33,2.6
"48229",48,229,1991,1134,1106,28,2.5
"48229",48,229,1992,1227,1189,38,3.1
"48229",48,229,1993,1382,1336,46,3.3
"48229",48,229,1994,1601,1561,40,2.5
"48229",48,229,1995,1487,1458,29,2
"48229",48,229,1996,1464,1439,25,1.7
"48229",48,229,1997,1357,1321,36,2.7
"48229",48,229,1998,1433,1390,43,3
"48229",48,229,1999,1455,1404,51,3.5
"48229",48,229,2000,1318,1259,59,4.5
"48229",48,229,2001,1312,1242,70,5.3
"48229",48,229,2002,1291,1192,99,7.7
"48229",48,229,2003,1386,1278,108,7.8
"48229",48,229,2004,1353,1265,88,6.5
"48229",48,229,2005,1328,1236,92,6.9
"48229",48,229,2006,1424,1326,98,6.9
"48229",48,229,2007,1525,1449,76,5
"48229",48,229,2008,1592,1530,62,3.9
"48229",48,229,2009,1719,1626,93,5.4
"48229",48,229,2010,1413,1301,112,7.9
"48229",48,229,2011,1388,1277,111,8
"48229",48,229,2012,1326,1227,99,7.5
"48229",48,229,2013,1294,1204,90,7
"48229",48,229,2014,1251,1172,79,6.3
"48229",48,229,2015,1280,1208,72,5.6
"48229",48,229,2016,1539,1447,92,6
"48229",48,229,2017,1537,1445,92,6
"48231",48,231,1990,32511,30337,2174,6.7
"48231",48,231,1991,32028,29596,2432,7.6
"48231",48,231,1992,32737,29879,2858,8.7
"48231",48,231,1993,32920,30352,2568,7.8
"48231",48,231,1994,33768,31023,2745,8.1
"48231",48,231,1995,33609,31548,2061,6.1
"48231",48,231,1996,34629,32518,2111,6.1
"48231",48,231,1997,35343,33609,1734,4.9
"48231",48,231,1998,35501,34070,1431,4
"48231",48,231,1999,36411,35000,1411,3.9
"48231",48,231,2000,38897,37275,1622,4.2
"48231",48,231,2001,38670,36790,1880,4.9
"48231",48,231,2002,38691,36270,2421,6.3
"48231",48,231,2003,38296,35704,2592,6.8
"48231",48,231,2004,38360,36080,2280,5.9
"48231",48,231,2005,38516,36412,2104,5.5
"48231",48,231,2006,38463,36470,1993,5.2
"48231",48,231,2007,37612,35895,1717,4.6
"48231",48,231,2008,36921,34973,1948,5.3
"48231",48,231,2009,36422,33442,2980,8.2
"48231",48,231,2010,38126,34732,3394,8.9
"48231",48,231,2011,38438,35040,3398,8.8
"48231",48,231,2012,38424,35243,3181,8.3
"48231",48,231,2013,38180,35340,2840,7.4
"48231",48,231,2014,38573,36294,2279,5.9
"48231",48,231,2015,38873,37040,1833,4.7
"48231",48,231,2016,40441,38711,1730,4.3
"48231",48,231,2017,41487,39860,1627,3.9
"48233",48,233,1990,10852,10330,522,4.8
"48233",48,233,1991,11263,10618,645,5.7
"48233",48,233,1992,11137,10243,894,8
"48233",48,233,1993,10667,9737,930,8.7
"48233",48,233,1994,10436,9606,830,8
"48233",48,233,1995,10253,9528,725,7.1
"48233",48,233,1996,10041,9214,827,8.2
"48233",48,233,1997,9652,9047,605,6.3
"48233",48,233,1998,9766,9202,564,5.8
"48233",48,233,1999,9327,8609,718,7.7
"48233",48,233,2000,11023,10500,523,4.7
"48233",48,233,2001,11130,10657,473,4.2
"48233",48,233,2002,11093,10362,731,6.6
"48233",48,233,2003,10997,10276,721,6.6
"48233",48,233,2004,10528,9871,657,6.2
"48233",48,233,2005,10189,9670,519,5.1
"48233",48,233,2006,10997,10518,479,4.4
"48233",48,233,2007,11086,10649,437,3.9
"48233",48,233,2008,11220,10762,458,4.1
"48233",48,233,2009,11354,10585,769,6.8
"48233",48,233,2010,9707,8887,820,8.4
"48233",48,233,2011,9914,9132,782,7.9
"48233",48,233,2012,9828,9190,638,6.5
"48233",48,233,2013,9776,9172,604,6.2
"48233",48,233,2014,10519,10060,459,4.4
"48233",48,233,2015,9789,9358,431,4.4
"48233",48,233,2016,9617,9076,541,5.6
"48233",48,233,2017,9392,8827,565,6
"48235",48,235,1990,773,757,16,2.1
"48235",48,235,1991,870,837,33,3.8
"48235",48,235,1992,949,909,40,4.2
"48235",48,235,1993,945,913,32,3.4
"48235",48,235,1994,939,910,29,3.1
"48235",48,235,1995,904,874,30,3.3
"48235",48,235,1996,841,825,16,1.9
"48235",48,235,1997,751,736,15,2
"48235",48,235,1998,764,743,21,2.7
"48235",48,235,1999,701,671,30,4.3
"48235",48,235,2000,944,914,30,3.2
"48235",48,235,2001,931,901,30,3.2
"48235",48,235,2002,958,924,34,3.5
"48235",48,235,2003,972,930,42,4.3
"48235",48,235,2004,950,908,42,4.4
"48235",48,235,2005,957,923,34,3.6
"48235",48,235,2006,993,958,35,3.5
"48235",48,235,2007,924,897,27,2.9
"48235",48,235,2008,887,856,31,3.5
"48235",48,235,2009,921,873,48,5.2
"48235",48,235,2010,873,827,46,5.3
"48235",48,235,2011,877,830,47,5.4
"48235",48,235,2012,852,813,39,4.6
"48235",48,235,2013,851,815,36,4.2
"48235",48,235,2014,833,802,31,3.7
"48235",48,235,2015,799,770,29,3.6
"48235",48,235,2016,778,753,25,3.2
"48235",48,235,2017,774,751,23,3
"48237",48,237,1990,3067,2955,112,3.7
"48237",48,237,1991,3217,3059,158,4.9
"48237",48,237,1992,3228,3046,182,5.6
"48237",48,237,1993,3350,3210,140,4.2
"48237",48,237,1994,3322,3164,158,4.8
"48237",48,237,1995,3304,3159,145,4.4
"48237",48,237,1996,3346,3226,120,3.6
"48237",48,237,1997,3456,3341,115,3.3
"48237",48,237,1998,3588,3470,118,3.3
"48237",48,237,1999,3501,3351,150,4.3
"48237",48,237,2000,3795,3636,159,4.2
"48237",48,237,2001,3789,3626,163,4.3
"48237",48,237,2002,4096,3899,197,4.8
"48237",48,237,2003,4220,4003,217,5.1
"48237",48,237,2004,3913,3720,193,4.9
"48237",48,237,2005,4078,3889,189,4.6
"48237",48,237,2006,4360,4180,180,4.1
"48237",48,237,2007,4969,4819,150,3
"48237",48,237,2008,5444,5274,170,3.1
"48237",48,237,2009,5277,4948,329,6.2
"48237",48,237,2010,3664,3377,287,7.8
"48237",48,237,2011,3715,3457,258,6.9
"48237",48,237,2012,3804,3585,219,5.8
"48237",48,237,2013,4008,3795,213,5.3
"48237",48,237,2014,4307,4146,161,3.7
"48237",48,237,2015,4076,3904,172,4.2
"48237",48,237,2016,3848,3658,190,4.9
"48237",48,237,2017,3930,3783,147,3.7
"48239",48,239,1990,5512,5336,176,3.2
"48239",48,239,1991,5745,5531,214,3.7
"48239",48,239,1992,5854,5531,323,5.5
"48239",48,239,1993,6931,6620,311,4.5
"48239",48,239,1994,7538,7224,314,4.2
"48239",48,239,1995,8520,8180,340,4
"48239",48,239,1996,9129,8798,331,3.6
"48239",48,239,1997,8805,8472,333,3.8
"48239",48,239,1998,8542,8232,310,3.6
"48239",48,239,1999,8505,8221,284,3.3
"48239",48,239,2000,6813,6563,250,3.7
"48239",48,239,2001,6867,6562,305,4.4
"48239",48,239,2002,6724,6326,398,5.9
"48239",48,239,2003,6873,6474,399,5.8
"48239",48,239,2004,6709,6323,386,5.8
"48239",48,239,2005,6625,6299,326,4.9
"48239",48,239,2006,6400,6108,292,4.6
"48239",48,239,2007,6632,6384,248,3.7
"48239",48,239,2008,6806,6532,274,4
"48239",48,239,2009,6922,6411,511,7.4
"48239",48,239,2010,7131,6629,502,7
"48239",48,239,2011,7355,6897,458,6.2
"48239",48,239,2012,7438,7057,381,5.1
"48239",48,239,2013,7442,7070,372,5
"48239",48,239,2014,7632,7333,299,3.9
"48239",48,239,2015,7362,7086,276,3.7
"48239",48,239,2016,7262,6922,340,4.7
"48239",48,239,2017,7366,7072,294,4
"48241",48,241,1990,12497,11337,1160,9.3
"48241",48,241,1991,12983,11631,1352,10.4
"48241",48,241,1992,13827,12189,1638,11.8
"48241",48,241,1993,14746,12686,2060,14
"48241",48,241,1994,15723,14022,1701,10.8
"48241",48,241,1995,15653,13892,1761,11.3
"48241",48,241,1996,15618,13559,2059,13.2
"48241",48,241,1997,15199,13329,1870,12.3
"48241",48,241,1998,14965,13263,1702,11.4
"48241",48,241,1999,14669,12903,1766,12
"48241",48,241,2000,15360,14267,1093,7.1
"48241",48,241,2001,15540,14217,1323,8.5
"48241",48,241,2002,15899,14418,1481,9.3
"48241",48,241,2003,16198,14645,1553,9.6
"48241",48,241,2004,15781,14389,1392,8.8
"48241",48,241,2005,15584,14330,1254,8
"48241",48,241,2006,15573,14602,971,6.2
"48241",48,241,2007,15478,14614,864,5.6
"48241",48,241,2008,15463,14494,969,6.3
"48241",48,241,2009,15935,14324,1611,10.1
"48241",48,241,2010,14841,13004,1837,12.4
"48241",48,241,2011,15035,13180,1855,12.3
"48241",48,241,2012,14917,13329,1588,10.6
"48241",48,241,2013,14521,13002,1519,10.5
"48241",48,241,2014,14445,13269,1176,8.1
"48241",48,241,2015,13866,12831,1035,7.5
"48241",48,241,2016,13441,12411,1030,7.7
"48241",48,241,2017,13380,12384,996,7.4
"48243",48,243,1990,863,837,26,3
"48243",48,243,1991,1029,987,42,4.1
"48243",48,243,1992,1008,963,45,4.5
"48243",48,243,1993,1032,983,49,4.7
"48243",48,243,1994,1048,1010,38,3.6
"48243",48,243,1995,1096,1055,41,3.7
"48243",48,243,1996,1163,1130,33,2.8
"48243",48,243,1997,1395,1366,29,2.1
"48243",48,243,1998,1530,1496,34,2.2
"48243",48,243,1999,1858,1819,39,2.1
"48243",48,243,2000,1165,1121,44,3.8
"48243",48,243,2001,1202,1157,45,3.7
"48243",48,243,2002,1276,1218,58,4.5
"48243",48,243,2003,1358,1303,55,4.1
"48243",48,243,2004,1311,1262,49,3.7
"48243",48,243,2005,1203,1156,47,3.9
"48243",48,243,2006,1197,1149,48,4
"48243",48,243,2007,1180,1141,39,3.3
"48243",48,243,2008,1191,1148,43,3.6
"48243",48,243,2009,1200,1143,57,4.8
"48243",48,243,2010,1273,1210,63,4.9
"48243",48,243,2011,1251,1189,62,5
"48243",48,243,2012,1215,1156,59,4.9
"48243",48,243,2013,1162,1114,48,4.1
"48243",48,243,2014,1147,1106,41,3.6
"48243",48,243,2015,1079,1044,35,3.2
"48243",48,243,2016,1071,1040,31,2.9
"48243",48,243,2017,1052,1019,33,3.1
"48245",48,245,1990,112687,104700,7987,7.1
"48245",48,245,1991,118301,110178,8123,6.9
"48245",48,245,1992,121346,110681,10665,8.8
"48245",48,245,1993,121208,108645,12563,10.4
"48245",48,245,1994,119286,107789,11497,9.6
"48245",48,245,1995,118828,107868,10960,9.2
"48245",48,245,1996,116866,106607,10259,8.8
"48245",48,245,1997,117214,108539,8675,7.4
"48245",48,245,1998,116972,108876,8096,6.9
"48245",48,245,1999,116941,107297,9644,8.2
"48245",48,245,2000,112867,105605,7262,6.4
"48245",48,245,2001,111449,103562,7887,7.1
"48245",48,245,2002,112675,103864,8811,7.8
"48245",48,245,2003,114138,104372,9766,8.6
"48245",48,245,2004,111850,102830,9020,8.1
"48245",48,245,2005,111553,102875,8678,7.8
"48245",48,245,2006,111888,105151,6737,6
"48245",48,245,2007,112121,106045,6076,5.4
"48245",48,245,2008,113774,106314,7460,6.6
"48245",48,245,2009,115438,104421,11017,9.5
"48245",48,245,2010,113217,100371,12846,11.3
"48245",48,245,2011,115463,102305,13158,11.4
"48245",48,245,2012,113611,101055,12556,11.1
"48245",48,245,2013,111265,99171,12094,10.9
"48245",48,245,2014,110139,101022,9117,8.3
"48245",48,245,2015,107873,100367,7506,7
"48245",48,245,2016,107298,99789,7509,7
"48245",48,245,2017,107321,99467,7854,7.3
"48247",48,247,1990,2169,1928,241,11.1
"48247",48,247,1991,2067,1874,193,9.3
"48247",48,247,1992,2071,1807,264,12.7
"48247",48,247,1993,1928,1752,176,9.1
"48247",48,247,1994,1940,1769,171,8.8
"48247",48,247,1995,1987,1785,202,10.2
"48247",48,247,1996,2057,1874,183,8.9
"48247",48,247,1997,2124,1926,198,9.3
"48247",48,247,1998,2169,1951,218,10.1
"48247",48,247,1999,2270,1998,272,12
"48247",48,247,2000,2183,2054,129,5.9
"48247",48,247,2001,2205,2100,105,4.8
"48247",48,247,2002,2370,2222,148,6.2
"48247",48,247,2003,2471,2321,150,6.1
"48247",48,247,2004,2562,2437,125,4.9
"48247",48,247,2005,2616,2491,125,4.8
"48247",48,247,2006,2690,2575,115,4.3
"48247",48,247,2007,2735,2633,102,3.7
"48247",48,247,2008,2768,2664,104,3.8
"48247",48,247,2009,3008,2776,232,7.7
"48247",48,247,2010,2329,2089,240,10.3
"48247",48,247,2011,2330,2129,201,8.6
"48247",48,247,2012,2351,2196,155,6.6
"48247",48,247,2013,2326,2161,165,7.1
"48247",48,247,2014,2198,2065,133,6.1
"48247",48,247,2015,2026,1880,146,7.2
"48247",48,247,2016,1940,1755,185,9.5
"48247",48,247,2017,1894,1757,137,7.2
"48249",48,249,1990,15222,14095,1127,7.4
"48249",48,249,1991,15358,13834,1524,9.9
"48249",48,249,1992,15911,13861,2050,12.9
"48249",48,249,1993,16208,14629,1579,9.7
"48249",48,249,1994,16325,14740,1585,9.7
"48249",48,249,1995,16502,14789,1713,10.4
"48249",48,249,1996,16364,14815,1549,9.5
"48249",48,249,1997,16685,15384,1301,7.8
"48249",48,249,1998,17114,15626,1488,8.7
"48249",48,249,1999,17130,15231,1899,11.1
"48249",48,249,2000,16688,15702,986,5.9
"48249",48,249,2001,17453,16487,966,5.5
"48249",48,249,2002,18034,16747,1287,7.1
"48249",48,249,2003,19199,17864,1335,7
"48249",48,249,2004,19684,18434,1250,6.4
"48249",48,249,2005,19753,18664,1089,5.5
"48249",48,249,2006,20439,19492,947,4.6
"48249",48,249,2007,21118,20288,830,3.9
"48249",48,249,2008,21466,20570,896,4.2
"48249",48,249,2009,21655,19697,1958,9
"48249",48,249,2010,18257,16437,1820,10
"48249",48,249,2011,19762,18201,1561,7.9
"48249",48,249,2012,20652,19378,1274,6.2
"48249",48,249,2013,20143,18909,1234,6.1
"48249",48,249,2014,20106,19057,1049,5.2
"48249",48,249,2015,19203,17688,1515,7.9
"48249",48,249,2016,17429,15592,1837,10.5
"48249",48,249,2017,16709,15450,1259,7.5
"48251",48,251,1990,49786,47014,2772,5.6
"48251",48,251,1991,49414,46384,3030,6.1
"48251",48,251,1992,49951,46943,3008,6
"48251",48,251,1993,51120,48134,2986,5.8
"48251",48,251,1994,52327,49431,2896,5.5
"48251",48,251,1995,53932,51417,2515,4.7
"48251",48,251,1996,55953,53469,2484,4.4
"48251",48,251,1997,57407,55242,2165,3.8
"48251",48,251,1998,59646,57567,2079,3.5
"48251",48,251,1999,62249,60151,2098,3.4
"48251",48,251,2000,66490,64001,2489,3.7
"48251",48,251,2001,67485,64536,2949,4.4
"48251",48,251,2002,68760,64616,4144,6
"48251",48,251,2003,69838,65321,4517,6.5
"48251",48,251,2004,71219,67068,4151,5.8
"48251",48,251,2005,72108,68540,3568,4.9
"48251",48,251,2006,72573,69244,3329,4.6
"48251",48,251,2007,71728,68780,2948,4.1
"48251",48,251,2008,73137,69800,3337,4.6
"48251",48,251,2009,74920,68795,6125,8.2
"48251",48,251,2010,71940,65703,6237,8.7
"48251",48,251,2011,72762,67105,5657,7.8
"48251",48,251,2012,73166,68305,4861,6.6
"48251",48,251,2013,73689,69180,4509,6.1
"48251",48,251,2014,74371,70626,3745,5
"48251",48,251,2015,74229,70974,3255,4.4
"48251",48,251,2016,75904,72600,3304,4.4
"48251",48,251,2017,77413,74498,2915,3.8
"48253",48,253,1990,7391,7054,337,4.6
"48253",48,253,1991,8164,7812,352,4.3
"48253",48,253,1992,8073,7600,473,5.9
"48253",48,253,1993,9025,8664,361,4
"48253",48,253,1994,9866,9479,387,3.9
"48253",48,253,1995,10118,9787,331,3.3
"48253",48,253,1996,10280,9950,330,3.2
"48253",48,253,1997,10270,9957,313,3
"48253",48,253,1998,10299,9952,347,3.4
"48253",48,253,1999,9858,9513,345,3.5
"48253",48,253,2000,7688,7297,391,5.1
"48253",48,253,2001,7555,7167,388,5.1
"48253",48,253,2002,7845,7355,490,6.2
"48253",48,253,2003,8011,7492,519,6.5
"48253",48,253,2004,7933,7469,464,5.8
"48253",48,253,2005,7869,7446,423,5.4
"48253",48,253,2006,7985,7567,418,5.2
"48253",48,253,2007,7624,7267,357,4.7
"48253",48,253,2008,7766,7385,381,4.9
"48253",48,253,2009,7766,7171,595,7.7
"48253",48,253,2010,6161,5621,540,8.8
"48253",48,253,2011,6138,5630,508,8.3
"48253",48,253,2012,5905,5480,425,7.2
"48253",48,253,2013,5849,5456,393,6.7
"48253",48,253,2014,5805,5486,319,5.5
"48253",48,253,2015,5663,5353,310,5.5
"48253",48,253,2016,5614,5289,325,5.8
"48253",48,253,2017,5635,5335,300,5.3
"48255",48,255,1990,4979,4762,217,4.4
"48255",48,255,1991,5054,4793,261,5.2
"48255",48,255,1992,5110,4756,354,6.9
"48255",48,255,1993,5079,4746,333,6.6
"48255",48,255,1994,5432,5155,277,5.1
"48255",48,255,1995,5568,5186,382,6.9
"48255",48,255,1996,6073,5762,311,5.1
"48255",48,255,1997,6207,5937,270,4.3
"48255",48,255,1998,6163,5912,251,4.1
"48255",48,255,1999,5763,5531,232,4
"48255",48,255,2000,5382,5098,284,5.3
"48255",48,255,2001,5388,5089,299,5.5
"48255",48,255,2002,5455,5076,379,6.9
"48255",48,255,2003,5647,5235,412,7.3
"48255",48,255,2004,5613,5233,380,6.8
"48255",48,255,2005,5437,5092,345,6.3
"48255",48,255,2006,5321,4997,324,6.1
"48255",48,255,2007,5193,4906,287,5.5
"48255",48,255,2008,5282,4975,307,5.8
"48255",48,255,2009,5481,4989,492,9
"48255",48,255,2010,4869,4427,442,9.1
"48255",48,255,2011,4887,4508,379,7.8
"48255",48,255,2012,5288,4966,322,6.1
"48255",48,255,2013,5624,5323,301,5.4
"48255",48,255,2014,6275,6046,229,3.6
"48255",48,255,2015,6421,6150,271,4.2
"48255",48,255,2016,6266,5960,306,4.9
"48255",48,255,2017,6424,6200,224,3.5
"48257",48,257,1990,25342,23946,1396,5.5
"48257",48,257,1991,25556,23992,1564,6.1
"48257",48,257,1992,25709,24147,1562,6.1
"48257",48,257,1993,26681,25046,1635,6.1
"48257",48,257,1994,27855,26529,1326,4.8
"48257",48,257,1995,28726,27460,1266,4.4
"48257",48,257,1996,29716,28498,1218,4.1
"48257",48,257,1997,31504,29979,1525,4.8
"48257",48,257,1998,32169,30777,1392,4.3
"48257",48,257,1999,33494,32163,1331,4
"48257",48,257,2000,37629,36121,1508,4
"48257",48,257,2001,38728,36767,1961,5.1
"48257",48,257,2002,39580,36645,2935,7.4
"48257",48,257,2003,40844,37679,3165,7.7
"48257",48,257,2004,41772,39014,2758,6.6
"48257",48,257,2005,43006,40644,2362,5.5
"48257",48,257,2006,44396,42182,2214,5
"48257",48,257,2007,45212,43114,2098,4.6
"48257",48,257,2008,46316,43891,2425,5.2
"48257",48,257,2009,46868,43003,3865,8.2
"48257",48,257,2010,50807,46496,4311,8.5
"48257",48,257,2011,51525,47390,4135,8
"48257",48,257,2012,51625,48037,3588,7
"48257",48,257,2013,52451,49120,3331,6.4
"48257",48,257,2014,53609,50852,2757,5.1
"48257",48,257,2015,55017,52780,2237,4.1
"48257",48,257,2016,57813,55625,2188,3.8
"48257",48,257,2017,59437,57346,2091,3.5
"48259",48,259,1990,7419,7253,166,2.2
"48259",48,259,1991,7862,7655,207,2.6
"48259",48,259,1992,8273,8074,199,2.4
"48259",48,259,1993,8978,8770,208,2.3
"48259",48,259,1994,9785,9584,201,2.1
"48259",48,259,1995,10938,10722,216,2
"48259",48,259,1996,11770,11508,262,2.2
"48259",48,259,1997,12234,11912,322,2.6
"48259",48,259,1998,12600,12276,324,2.6
"48259",48,259,1999,13606,13303,303,2.2
"48259",48,259,2000,12109,11707,402,3.3
"48259",48,259,2001,12407,11933,474,3.8
"48259",48,259,2002,12856,12226,630,4.9
"48259",48,259,2003,13353,12652,701,5.2
"48259",48,259,2004,13685,13056,629,4.6
"48259",48,259,2005,14298,13703,595,4.2
"48259",48,259,2006,15059,14477,582,3.9
"48259",48,259,2007,15371,14841,530,3.4
"48259",48,259,2008,16134,15526,608,3.8
"48259",48,259,2009,16712,15767,945,5.7
"48259",48,259,2010,16412,15391,1021,6.2
"48259",48,259,2011,16921,15894,1027,6.1
"48259",48,259,2012,17476,16531,945,5.4
"48259",48,259,2013,18245,17320,925,5.1
"48259",48,259,2014,18681,17926,755,4
"48259",48,259,2015,19145,18518,627,3.3
"48259",48,259,2016,20309,19661,648,3.2
"48259",48,259,2017,20705,20070,635,3.1
"48261",48,261,1990,231,222,9,3.9
"48261",48,261,1991,211,206,5,2.4
"48261",48,261,1992,219,217,2,.9
"48261",48,261,1993,229,223,6,2.6
"48261",48,261,1994,220,216,4,1.8
"48261",48,261,1995,224,218,6,2.7
"48261",48,261,1996,227,218,9,4
"48261",48,261,1997,226,216,10,4.4
"48261",48,261,1998,240,232,8,3.3
"48261",48,261,1999,227,220,7,3.1
"48261",48,261,2000,207,200,7,3.4
"48261",48,261,2001,208,201,7,3.4
"48261",48,261,2002,215,205,10,4.7
"48261",48,261,2003,230,221,9,3.9
"48261",48,261,2004,239,229,10,4.2
"48261",48,261,2005,248,241,7,2.8
"48261",48,261,2006,244,237,7,2.9
"48261",48,261,2007,236,229,7,3
"48261",48,261,2008,238,230,8,3.4
"48261",48,261,2009,235,221,14,6
"48261",48,261,2010,219,204,15,6.8
"48261",48,261,2011,238,223,15,6.3
"48261",48,261,2012,254,241,13,5.1
"48261",48,261,2013,297,285,12,4
"48261",48,261,2014,338,328,10,3
"48261",48,261,2015,282,273,9,3.2
"48261",48,261,2016,217,207,10,4.6
"48261",48,261,2017,246,238,8,3.3
"48263",48,263,1990,458,450,8,1.7
"48263",48,263,1991,486,468,18,3.7
"48263",48,263,1992,472,453,19,4
"48263",48,263,1993,433,414,19,4.4
"48263",48,263,1994,369,353,16,4.3
"48263",48,263,1995,433,422,11,2.5
"48263",48,263,1996,421,410,11,2.6
"48263",48,263,1997,420,404,16,3.8
"48263",48,263,1998,448,434,14,3.1
"48263",48,263,1999,442,430,12,2.7
"48263",48,263,2000,444,427,17,3.8
"48263",48,263,2001,441,427,14,3.2
"48263",48,263,2002,440,422,18,4.1
"48263",48,263,2003,513,488,25,4.9
"48263",48,263,2004,486,464,22,4.5
"48263",48,263,2005,440,422,18,4.1
"48263",48,263,2006,404,388,16,4
"48263",48,263,2007,423,409,14,3.3
"48263",48,263,2008,441,423,18,4.1
"48263",48,263,2009,463,439,24,5.2
"48263",48,263,2010,559,532,27,4.8
"48263",48,263,2011,554,528,26,4.7
"48263",48,263,2012,553,531,22,4
"48263",48,263,2013,532,511,21,3.9
"48263",48,263,2014,513,495,18,3.5
"48263",48,263,2015,497,484,13,2.6
"48263",48,263,2016,469,455,14,3
"48263",48,263,2017,460,448,12,2.6
"48265",48,265,1990,15569,15154,415,2.7
"48265",48,265,1991,15763,15187,576,3.7
"48265",48,265,1992,16202,15515,687,4.2
"48265",48,265,1993,16662,16025,637,3.8
"48265",48,265,1994,16657,16042,615,3.7
"48265",48,265,1995,16947,16474,473,2.8
"48265",48,265,1996,17348,16864,484,2.8
"48265",48,265,1997,17398,16968,430,2.5
"48265",48,265,1998,17687,17231,456,2.6
"48265",48,265,1999,17566,17187,379,2.2
"48265",48,265,2000,19283,18557,726,3.8
"48265",48,265,2001,19487,18658,829,4.3
"48265",48,265,2002,19957,18931,1026,5.1
"48265",48,265,2003,21034,19930,1104,5.2
"48265",48,265,2004,21588,20580,1008,4.7
"48265",48,265,2005,22578,21655,923,4.1
"48265",48,265,2006,22493,21585,908,4
"48265",48,265,2007,22532,21758,774,3.4
"48265",48,265,2008,23078,22169,909,3.9
"48265",48,265,2009,23323,21976,1347,5.8
"48265",48,265,2010,21919,20457,1462,6.7
"48265",48,265,2011,21830,20375,1455,6.7
"48265",48,265,2012,21698,20432,1266,5.8
"48265",48,265,2013,21483,20299,1184,5.5
"48265",48,265,2014,21432,20493,939,4.4
"48265",48,265,2015,21163,20386,777,3.7
"48265",48,265,2016,21320,20554,766,3.6
"48265",48,265,2017,21290,20564,726,3.4
"48267",48,267,1990,2042,2002,40,2
"48267",48,267,1991,2100,2049,51,2.4
"48267",48,267,1992,2205,2138,67,3
"48267",48,267,1993,2284,2215,69,3
"48267",48,267,1994,2307,2225,82,3.6
"48267",48,267,1995,2257,2197,60,2.7
"48267",48,267,1996,2358,2312,46,2
"48267",48,267,1997,2397,2318,79,3.3
"48267",48,267,1998,2401,2347,54,2.2
"48267",48,267,1999,2384,2318,66,2.8
"48267",48,267,2000,2260,2182,78,3.5
"48267",48,267,2001,2290,2216,74,3.2
"48267",48,267,2002,2226,2134,92,4.1
"48267",48,267,2003,2302,2197,105,4.6
"48267",48,267,2004,2239,2143,96,4.3
"48267",48,267,2005,2264,2171,93,4.1
"48267",48,267,2006,2223,2139,84,3.8
"48267",48,267,2007,2229,2155,74,3.3
"48267",48,267,2008,2195,2114,81,3.7
"48267",48,267,2009,2145,2033,112,5.2
"48267",48,267,2010,2276,2140,136,6
"48267",48,267,2011,2234,2095,139,6.2
"48267",48,267,2012,2189,2082,107,4.9
"48267",48,267,2013,2162,2057,105,4.9
"48267",48,267,2014,2113,2031,82,3.9
"48267",48,267,2015,1998,1926,72,3.6
"48267",48,267,2016,1949,1875,74,3.8
"48267",48,267,2017,1897,1830,67,3.5
"48269",48,269,1990,210,206,4,1.9
"48269",48,269,1991,170,164,6,3.5
"48269",48,269,1992,137,133,4,2.9
"48269",48,269,1993,156,149,7,4.5
"48269",48,269,1994,151,145,6,4
"48269",48,269,1995,134,126,8,6
"48269",48,269,1996,115,107,8,7
"48269",48,269,1997,110,104,6,5.5
"48269",48,269,1998,125,116,9,7.2
"48269",48,269,1999,124,119,5,4
"48269",48,269,2000,212,205,7,3.3
"48269",48,269,2001,239,232,7,2.9
"48269",48,269,2002,247,240,7,2.8
"48269",48,269,2003,240,231,9,3.8
"48269",48,269,2004,214,207,7,3.3
"48269",48,269,2005,167,160,7,4.2
"48269",48,269,2006,160,153,7,4.4
"48269",48,269,2007,175,167,8,4.6
"48269",48,269,2008,178,170,8,4.5
"48269",48,269,2009,196,186,10,5.1
"48269",48,269,2010,278,266,12,4.3
"48269",48,269,2011,288,277,11,3.8
"48269",48,269,2012,247,236,11,4.5
"48269",48,269,2013,239,228,11,4.6
"48269",48,269,2014,225,216,9,4
"48269",48,269,2015,200,193,7,3.5
"48269",48,269,2016,177,170,7,4
"48269",48,269,2017,163,157,6,3.7
"48271",48,271,1990,1043,1005,38,3.6
"48271",48,271,1991,1122,1047,75,6.7
"48271",48,271,1992,1181,1067,114,9.7
"48271",48,271,1993,1178,1077,101,8.6
"48271",48,271,1994,1126,1042,84,7.5
"48271",48,271,1995,1110,1024,86,7.7
"48271",48,271,1996,1108,1025,83,7.5
"48271",48,271,1997,1090,996,94,8.6
"48271",48,271,1998,1124,1026,98,8.7
"48271",48,271,1999,1123,1034,89,7.9
"48271",48,271,2000,1209,1120,89,7.4
"48271",48,271,2001,1257,1171,86,6.8
"48271",48,271,2002,1341,1234,107,8
"48271",48,271,2003,1423,1314,109,7.7
"48271",48,271,2004,1470,1376,94,6.4
"48271",48,271,2005,1439,1352,87,6
"48271",48,271,2006,1332,1255,77,5.8
"48271",48,271,2007,1354,1291,63,4.7
"48271",48,271,2008,1373,1301,72,5.2
"48271",48,271,2009,1436,1325,111,7.7
"48271",48,271,2010,1270,1128,142,11.2
"48271",48,271,2011,1271,1142,129,10.1
"48271",48,271,2012,1263,1152,111,8.8
"48271",48,271,2013,1218,1102,116,9.5
"48271",48,271,2014,1229,1140,89,7.2
"48271",48,271,2015,1184,1109,75,6.3
"48271",48,271,2016,1154,1087,67,5.8
"48271",48,271,2017,1150,1087,63,5.5
"48273",48,273,1990,12656,11756,900,7.1
"48273",48,273,1991,12393,11527,866,7
"48273",48,273,1992,13104,12087,1017,7.8
"48273",48,273,1993,13521,12626,895,6.6
"48273",48,273,1994,13591,12544,1047,7.7
"48273",48,273,1995,13178,12142,1036,7.9
"48273",48,273,1996,13179,12246,933,7.1
"48273",48,273,1997,13081,12238,843,6.4
"48273",48,273,1998,13331,12429,902,6.8
"48273",48,273,1999,12891,12037,854,6.6
"48273",48,273,2000,13897,13204,693,5
"48273",48,273,2001,14061,13357,704,5
"48273",48,273,2002,14518,13603,915,6.3
"48273",48,273,2003,15696,14746,950,6.1
"48273",48,273,2004,15975,15090,885,5.5
"48273",48,273,2005,16308,15469,839,5.1
"48273",48,273,2006,16195,15464,731,4.5
"48273",48,273,2007,15963,15310,653,4.1
"48273",48,273,2008,16515,15821,694,4.2
"48273",48,273,2009,17029,15885,1144,6.7
"48273",48,273,2010,15030,13774,1256,8.4
"48273",48,273,2011,15389,14156,1233,8
"48273",48,273,2012,15418,14358,1060,6.9
"48273",48,273,2013,15445,14445,1000,6.5
"48273",48,273,2014,15261,14430,831,5.4
"48273",48,273,2015,14385,13537,848,5.9
"48273",48,273,2016,14083,13138,945,6.7
"48273",48,273,2017,13367,12572,795,5.9
"48275",48,275,1990,2087,2023,64,3.1
"48275",48,275,1991,2230,2156,74,3.3
"48275",48,275,1992,2467,2367,100,4.1
"48275",48,275,1993,2389,2303,86,3.6
"48275",48,275,1994,2601,2496,105,4
"48275",48,275,1995,2312,2216,96,4.2
"48275",48,275,1996,2228,2107,121,5.4
"48275",48,275,1997,2205,2092,113,5.1
"48275",48,275,1998,2093,1992,101,4.8
"48275",48,275,1999,1951,1844,107,5.5
"48275",48,275,2000,1860,1774,86,4.6
"48275",48,275,2001,1857,1778,79,4.3
"48275",48,275,2002,1864,1769,95,5.1
"48275",48,275,2003,2048,1936,112,5.5
"48275",48,275,2004,1945,1843,102,5.2
"48275",48,275,2005,1789,1704,85,4.8
"48275",48,275,2006,1757,1684,73,4.2
"48275",48,275,2007,1806,1740,66,3.7
"48275",48,275,2008,1806,1738,68,3.8
"48275",48,275,2009,1832,1726,106,5.8
"48275",48,275,2010,1909,1797,112,5.9
"48275",48,275,2011,1906,1796,110,5.8
"48275",48,275,2012,1817,1722,95,5.2
"48275",48,275,2013,1753,1659,94,5.4
"48275",48,275,2014,1739,1665,74,4.3
"48275",48,275,2015,1680,1617,63,3.8
"48275",48,275,2016,1556,1490,66,4.2
"48275",48,275,2017,1493,1434,59,4
"48277",48,277,1990,20397,18977,1420,7
"48277",48,277,1991,20471,18888,1583,7.7
"48277",48,277,1992,21160,19274,1886,8.9
"48277",48,277,1993,21938,20221,1717,7.8
"48277",48,277,1994,22465,20641,1824,8.1
"48277",48,277,1995,22008,20313,1695,7.7
"48277",48,277,1996,22037,20646,1391,6.3
"48277",48,277,1997,21882,20611,1271,5.8
"48277",48,277,1998,21789,20318,1471,6.8
"48277",48,277,1999,22273,20934,1339,6
"48277",48,277,2000,23080,21954,1126,4.9
"48277",48,277,2001,22877,21454,1423,6.2
"48277",48,277,2002,23468,21846,1622,6.9
"48277",48,277,2003,24064,22333,1731,7.2
"48277",48,277,2004,23439,21947,1492,6.4
"48277",48,277,2005,22980,21551,1429,6.2
"48277",48,277,2006,23642,22376,1266,5.4
"48277",48,277,2007,24128,23018,1110,4.6
"48277",48,277,2008,23489,22236,1253,5.3
"48277",48,277,2009,23503,21705,1798,7.7
"48277",48,277,2010,23300,21135,2165,9.3
"48277",48,277,2011,23383,21095,2288,9.8
"48277",48,277,2012,22646,20561,2085,9.2
"48277",48,277,2013,22306,20497,1809,8.1
"48277",48,277,2014,22143,20796,1347,6.1
"48277",48,277,2015,22164,21107,1057,4.8
"48277",48,277,2016,23186,22114,1072,4.6
"48277",48,277,2017,23680,22685,995,4.2
"48279",48,279,1990,6417,6134,283,4.4
"48279",48,279,1991,6372,6028,344,5.4
"48279",48,279,1992,6546,6074,472,7.2
"48279",48,279,1993,6760,6329,431,6.4
"48279",48,279,1994,6833,6427,406,5.9
"48279",48,279,1995,6821,6362,459,6.7
"48279",48,279,1996,6844,6427,417,6.1
"48279",48,279,1997,6604,6166,438,6.6
"48279",48,279,1998,6600,6173,427,6.5
"48279",48,279,1999,6466,6001,465,7.2
"48279",48,279,2000,6921,6582,339,4.9
"48279",48,279,2001,7218,6833,385,5.3
"48279",48,279,2002,7167,6775,392,5.5
"48279",48,279,2003,7571,7130,441,5.8
"48279",48,279,2004,7471,7049,422,5.6
"48279",48,279,2005,7213,6861,352,4.9
"48279",48,279,2006,7033,6710,323,4.6
"48279",48,279,2007,6969,6692,277,4
"48279",48,279,2008,7090,6780,310,4.4
"48279",48,279,2009,7081,6576,505,7.1
"48279",48,279,2010,6797,6283,514,7.6
"48279",48,279,2011,6730,6221,509,7.6
"48279",48,279,2012,6466,5951,515,8
"48279",48,279,2013,6148,5727,421,6.8
"48279",48,279,2014,6030,5679,351,5.8
"48279",48,279,2015,5504,5013,491,8.9
"48279",48,279,2016,5238,4898,340,6.5
"48279",48,279,2017,5194,4926,268,5.2
"48281",48,281,1990,6215,5834,381,6.1
"48281",48,281,1991,6189,5788,401,6.5
"48281",48,281,1992,6350,5909,441,6.9
"48281",48,281,1993,6635,6264,371,5.6
"48281",48,281,1994,6993,6618,375,5.4
"48281",48,281,1995,7194,6838,356,4.9
"48281",48,281,1996,7520,7143,377,5
"48281",48,281,1997,7394,7025,369,5
"48281",48,281,1998,7688,7351,337,4.4
"48281",48,281,1999,8044,7786,258,3.2
"48281",48,281,2000,8643,8315,328,3.8
"48281",48,281,2001,8848,8465,383,4.3
"48281",48,281,2002,9319,8837,482,5.2
"48281",48,281,2003,9520,9000,520,5.5
"48281",48,281,2004,10342,9878,464,4.5
"48281",48,281,2005,9922,9492,430,4.3
"48281",48,281,2006,10492,10075,417,4
"48281",48,281,2007,10107,9738,369,3.7
"48281",48,281,2008,10287,9871,416,4
"48281",48,281,2009,10492,9883,609,5.8
"48281",48,281,2010,9020,8379,641,7.1
"48281",48,281,2011,9139,8448,691,7.6
"48281",48,281,2012,9092,8445,647,7.1
"48281",48,281,2013,9130,8477,653,7.2
"48281",48,281,2014,8968,8465,503,5.6
"48281",48,281,2015,9048,8651,397,4.4
"48281",48,281,2016,9145,8765,380,4.2
"48281",48,281,2017,9235,8896,339,3.7
"48283",48,283,1990,2249,2098,151,6.7
"48283",48,283,1991,2377,2186,191,8
"48283",48,283,1992,2505,2255,250,10
"48283",48,283,1993,2653,2426,227,8.6
"48283",48,283,1994,2635,2416,219,8.3
"48283",48,283,1995,2641,2411,230,8.7
"48283",48,283,1996,2771,2550,221,8
"48283",48,283,1997,2867,2640,227,7.9
"48283",48,283,1998,2945,2689,256,8.7
"48283",48,283,1999,2886,2636,250,8.7
"48283",48,283,2000,2203,2049,154,7
"48283",48,283,2001,2215,2065,150,6.8
"48283",48,283,2002,2257,2067,190,8.4
"48283",48,283,2003,2366,2183,183,7.7
"48283",48,283,2004,2342,2188,154,6.6
"48283",48,283,2005,2597,2451,146,5.6
"48283",48,283,2006,2738,2601,137,5
"48283",48,283,2007,2754,2621,133,4.8
"48283",48,283,2008,2907,2752,155,5.3
"48283",48,283,2009,2920,2650,270,9.2
"48283",48,283,2010,2722,2479,243,8.9
"48283",48,283,2011,3136,2926,210,6.7
"48283",48,283,2012,3670,3507,163,4.4
"48283",48,283,2013,4177,4020,157,3.8
"48283",48,283,2014,4577,4436,141,3.1
"48283",48,283,2015,4265,4088,177,4.2
"48283",48,283,2016,3879,3679,200,5.2
"48283",48,283,2017,4203,4048,155,3.7
"48285",48,285,1990,8482,8367,115,1.4
"48285",48,285,1991,8649,8438,211,2.4
"48285",48,285,1992,8780,8542,238,2.7
"48285",48,285,1993,8911,8693,218,2.4
"48285",48,285,1994,9297,9048,249,2.7
"48285",48,285,1995,9457,9201,256,2.7
"48285",48,285,1996,9425,9149,276,2.9
"48285",48,285,1997,9235,9030,205,2.2
"48285",48,285,1998,9309,9100,209,2.2
"48285",48,285,1999,9504,9311,193,2
"48285",48,285,2000,9614,9315,299,3.1
"48285",48,285,2001,9406,9093,313,3.3
"48285",48,285,2002,9480,9084,396,4.2
"48285",48,285,2003,10106,9680,426,4.2
"48285",48,285,2004,10214,9850,364,3.6
"48285",48,285,2005,10355,9982,373,3.6
"48285",48,285,2006,10226,9856,370,3.6
"48285",48,285,2007,10104,9791,313,3.1
"48285",48,285,2008,9906,9566,340,3.4
"48285",48,285,2009,10006,9437,569,5.7
"48285",48,285,2010,9703,9033,670,6.9
"48285",48,285,2011,9621,9049,572,5.9
"48285",48,285,2012,9482,9024,458,4.8
"48285",48,285,2013,9230,8797,433,4.7
"48285",48,285,2014,8975,8624,351,3.9
"48285",48,285,2015,8798,8465,333,3.8
"48285",48,285,2016,8726,8358,368,4.2
"48285",48,285,2017,8712,8400,312,3.6
"48287",48,287,1990,6149,5834,315,5.1
"48287",48,287,1991,6308,6037,271,4.3
"48287",48,287,1992,6886,6613,273,4
"48287",48,287,1993,7142,6898,244,3.4
"48287",48,287,1994,7167,6898,269,3.8
"48287",48,287,1995,7303,6976,327,4.5
"48287",48,287,1996,7121,6810,311,4.4
"48287",48,287,1997,7172,6909,263,3.7
"48287",48,287,1998,7206,6933,273,3.8
"48287",48,287,1999,7198,6941,257,3.6
"48287",48,287,2000,8233,7945,288,3.5
"48287",48,287,2001,8311,7972,339,4.1
"48287",48,287,2002,8523,8095,428,5
"48287",48,287,2003,8743,8272,471,5.4
"48287",48,287,2004,8740,8340,400,4.6
"48287",48,287,2005,8656,8276,380,4.4
"48287",48,287,2006,8792,8445,347,3.9
"48287",48,287,2007,8865,8560,305,3.4
"48287",48,287,2008,8990,8642,348,3.9
"48287",48,287,2009,9113,8505,608,6.7
"48287",48,287,2010,8227,7631,596,7.2
"48287",48,287,2011,8870,8297,573,6.5
"48287",48,287,2012,9138,8645,493,5.4
"48287",48,287,2013,9140,8673,467,5.1
"48287",48,287,2014,9341,8969,372,4
"48287",48,287,2015,9294,8964,330,3.6
"48287",48,287,2016,9266,8917,349,3.8
"48287",48,287,2017,9625,9311,314,3.3
"48289",48,289,1990,5115,4804,311,6.1
"48289",48,289,1991,5006,4646,360,7.2
"48289",48,289,1992,5263,4820,443,8.4
"48289",48,289,1993,5418,4940,478,8.8
"48289",48,289,1994,5545,5104,441,8
"48289",48,289,1995,5484,5108,376,6.9
"48289",48,289,1996,5592,5210,382,6.8
"48289",48,289,1997,5546,5162,384,6.9
"48289",48,289,1998,5880,5487,393,6.7
"48289",48,289,1999,6340,5929,411,6.5
"48289",48,289,2000,7033,6677,356,5.1
"48289",48,289,2001,7165,6800,365,5.1
"48289",48,289,2002,7321,6821,500,6.8
"48289",48,289,2003,7465,6903,562,7.5
"48289",48,289,2004,7705,7227,478,6.2
"48289",48,289,2005,7702,7277,425,5.5
"48289",48,289,2006,7616,7237,379,5
"48289",48,289,2007,7562,7252,310,4.1
"48289",48,289,2008,7795,7463,332,4.3
"48289",48,289,2009,8250,7671,579,7
"48289",48,289,2010,7263,6620,643,8.9
"48289",48,289,2011,7158,6537,621,8.7
"48289",48,289,2012,6955,6442,513,7.4
"48289",48,289,2013,6965,6484,481,6.9
"48289",48,289,2014,7221,6837,384,5.3
"48289",48,289,2015,6927,6558,369,5.3
"48289",48,289,2016,6499,6079,420,6.5
"48289",48,289,2017,6160,5770,390,6.3
"48291",48,291,1990,23110,21563,1547,6.7
"48291",48,291,1991,23737,21641,2096,8.8
"48291",48,291,1992,24348,21746,2602,10.7
"48291",48,291,1993,25079,22252,2827,11.3
"48291",48,291,1994,25625,23283,2342,9.1
"48291",48,291,1995,27003,24803,2200,8.1
"48291",48,291,1996,27400,25160,2240,8.2
"48291",48,291,1997,28354,25923,2431,8.6
"48291",48,291,1998,28691,26782,1909,6.7
"48291",48,291,1999,29540,27346,2194,7.4
"48291",48,291,2000,30255,28492,1763,5.8
"48291",48,291,2001,30660,28792,1868,6.1
"48291",48,291,2002,31719,29117,2602,8.2
"48291",48,291,2003,31868,28933,2935,9.2
"48291",48,291,2004,31833,29056,2777,8.7
"48291",48,291,2005,31272,29160,2112,6.8
"48291",48,291,2006,30646,28892,1754,5.7
"48291",48,291,2007,30617,29033,1584,5.2
"48291",48,291,2008,30840,29027,1813,5.9
"48291",48,291,2009,31455,28264,3191,10.1
"48291",48,291,2010,30614,27040,3574,11.7
"48291",48,291,2011,30785,27372,3413,11.1
"48291",48,291,2012,30881,27924,2957,9.6
"48291",48,291,2013,31027,28265,2762,8.9
"48291",48,291,2014,30982,28763,2219,7.2
"48291",48,291,2015,30920,28789,2131,6.9
"48291",48,291,2016,31480,29115,2365,7.5
"48291",48,291,2017,31713,29466,2247,7.1
"48293",48,293,1990,8966,8576,390,4.3
"48293",48,293,1991,9130,8676,454,5
"48293",48,293,1992,9283,8755,528,5.7
"48293",48,293,1993,9353,8834,519,5.5
"48293",48,293,1994,9465,8915,550,5.8
"48293",48,293,1995,9491,8965,526,5.5
"48293",48,293,1996,9545,9009,536,5.6
"48293",48,293,1997,9281,8785,496,5.3
"48293",48,293,1998,9245,8774,471,5.1
"48293",48,293,1999,9186,8789,397,4.3
"48293",48,293,2000,9579,9130,449,4.7
"48293",48,293,2001,9852,9389,463,4.7
"48293",48,293,2002,10132,9559,573,5.7
"48293",48,293,2003,10410,9783,627,6
"48293",48,293,2004,10497,9943,554,5.3
"48293",48,293,2005,10327,9802,525,5.1
"48293",48,293,2006,10231,9750,481,4.7
"48293",48,293,2007,10322,9891,431,4.2
"48293",48,293,2008,10725,10263,462,4.3
"48293",48,293,2009,11233,10528,705,6.3
"48293",48,293,2010,9938,9155,783,7.9
"48293",48,293,2011,9576,8783,793,8.3
"48293",48,293,2012,9606,8945,661,6.9
"48293",48,293,2013,9484,8845,639,6.7
"48293",48,293,2014,9202,8665,537,5.8
"48293",48,293,2015,8572,8143,429,5
"48293",48,293,2016,8311,7846,465,5.6
"48293",48,293,2017,8315,7855,460,5.5
"48295",48,295,1990,1425,1391,34,2.4
"48295",48,295,1991,1425,1366,59,4.1
"48295",48,295,1992,1403,1338,65,4.6
"48295",48,295,1993,1382,1347,35,2.5
"48295",48,295,1994,1517,1485,32,2.1
"48295",48,295,1995,1605,1565,40,2.5
"48295",48,295,1996,1608,1570,38,2.4
"48295",48,295,1997,1617,1581,36,2.2
"48295",48,295,1998,1586,1547,39,2.5
"48295",48,295,1999,1514,1463,51,3.4
"48295",48,295,2000,1486,1436,50,3.4
"48295",48,295,2001,1489,1440,49,3.3
"48295",48,295,2002,1480,1417,63,4.3
"48295",48,295,2003,1625,1551,74,4.6
"48295",48,295,2004,1729,1668,61,3.5
"48295",48,295,2005,1662,1604,58,3.5
"48295",48,295,2006,1734,1677,57,3.3
"48295",48,295,2007,1840,1793,47,2.6
"48295",48,295,2008,1806,1755,51,2.8
"48295",48,295,2009,1730,1613,117,6.8
"48295",48,295,2010,1665,1567,98,5.9
"48295",48,295,2011,1743,1663,80,4.6
"48295",48,295,2012,1758,1690,68,3.9
"48295",48,295,2013,1721,1653,68,4
"48295",48,295,2014,1749,1690,59,3.4
"48295",48,295,2015,1723,1656,67,3.9
"48295",48,295,2016,1649,1576,73,4.4
"48295",48,295,2017,1633,1580,53,3.2
"48297",48,297,1990,4146,3987,159,3.8
"48297",48,297,1991,4263,4085,178,4.2
"48297",48,297,1992,4862,4610,252,5.2
"48297",48,297,1993,5274,5031,243,4.6
"48297",48,297,1994,4760,4503,257,5.4
"48297",48,297,1995,4532,4310,222,4.9
"48297",48,297,1996,4473,4299,174,3.9
"48297",48,297,1997,4489,4305,184,4.1
"48297",48,297,1998,4519,4322,197,4.4
"48297",48,297,1999,4399,4211,188,4.3
"48297",48,297,2000,4853,4636,217,4.5
"48297",48,297,2001,4957,4736,221,4.5
"48297",48,297,2002,4946,4680,266,5.4
"48297",48,297,2003,5216,4923,293,5.6
"48297",48,297,2004,5087,4830,257,5.1
"48297",48,297,2005,5031,4777,254,5
"48297",48,297,2006,5051,4824,227,4.5
"48297",48,297,2007,5027,4834,193,3.8
"48297",48,297,2008,5107,4892,215,4.2
"48297",48,297,2009,5197,4833,364,7
"48297",48,297,2010,4631,4292,339,7.3
"48297",48,297,2011,5234,4923,311,5.9
"48297",48,297,2012,5768,5505,263,4.6
"48297",48,297,2013,6032,5769,263,4.4
"48297",48,297,2014,6116,5898,218,3.6
"48297",48,297,2015,5885,5649,236,4
"48297",48,297,2016,5194,4886,308,5.9
"48297",48,297,2017,5376,5126,250,4.7
"48299",48,299,1990,3877,3758,119,3.1
"48299",48,299,1991,4314,4168,146,3.4
"48299",48,299,1992,4296,4096,200,4.7
"48299",48,299,1993,4512,4336,176,3.9
"48299",48,299,1994,4732,4561,171,3.6
"48299",48,299,1995,4763,4604,159,3.3
"48299",48,299,1996,4839,4663,176,3.6
"48299",48,299,1997,4937,4763,174,3.5
"48299",48,299,1998,5292,5117,175,3.3
"48299",48,299,1999,5609,5464,145,2.6
"48299",48,299,2000,7372,7066,306,4.2
"48299",48,299,2001,7496,7147,349,4.7
"48299",48,299,2002,7728,7284,444,5.7
"48299",48,299,2003,7987,7488,499,6.2
"48299",48,299,2004,7936,7481,455,5.7
"48299",48,299,2005,8021,7614,407,5.1
"48299",48,299,2006,8133,7755,378,4.6
"48299",48,299,2007,8151,7829,322,4
"48299",48,299,2008,8429,8072,357,4.2
"48299",48,299,2009,8522,7932,590,6.9
"48299",48,299,2010,7994,7350,644,8.1
"48299",48,299,2011,8014,7394,620,7.7
"48299",48,299,2012,8067,7519,548,6.8
"48299",48,299,2013,8109,7588,521,6.4
"48299",48,299,2014,8089,7671,418,5.2
"48299",48,299,2015,8142,7797,345,4.2
"48299",48,299,2016,8278,7933,345,4.2
"48299",48,299,2017,8319,8009,310,3.7
"48301",48,301,1990,64,61,3,4.7
"48301",48,301,1991,54,53,1,1.9
"48301",48,301,1992,79,75,4,5.1
"48301",48,301,1993,58,57,1,1.7
"48301",48,301,1994,76,69,7,9.2
"48301",48,301,1995,91,82,9,9.9
"48301",48,301,1996,92,85,7,7.6
"48301",48,301,1997,75,67,8,10.7
"48301",48,301,1998,82,74,8,9.8
"48301",48,301,1999,76,67,9,11.8
"48301",48,301,2000,49,45,4,8.2
"48301",48,301,2001,48,45,3,6.3
"48301",48,301,2002,48,45,3,6.3
"48301",48,301,2003,50,45,5,10
"48301",48,301,2004,58,54,4,6.9
"48301",48,301,2005,39,35,4,10.3
"48301",48,301,2006,38,34,4,10.5
"48301",48,301,2007,41,38,3,7.3
"48301",48,301,2008,43,40,3,7
"48301",48,301,2009,43,39,4,9.3
"48301",48,301,2010,71,67,4,5.6
"48301",48,301,2011,66,62,4,6.1
"48301",48,301,2012,67,63,4,6
"48301",48,301,2013,75,71,4,5.3
"48301",48,301,2014,78,74,4,5.1
"48301",48,301,2015,77,73,4,5.2
"48301",48,301,2016,86,82,4,4.7
"48301",48,301,2017,100,95,5,5
"48303",48,303,1990,113666,107849,5817,5.1
"48303",48,303,1991,113183,106885,6298,5.6
"48303",48,303,1992,115847,109227,6620,5.7
"48303",48,303,1993,117025,111560,5465,4.7
"48303",48,303,1994,117763,112741,5022,4.3
"48303",48,303,1995,120248,115360,4888,4.1
"48303",48,303,1996,121659,116807,4852,4
"48303",48,303,1997,123231,118455,4776,3.9
"48303",48,303,1998,122676,118499,4177,3.4
"48303",48,303,1999,123770,120171,3599,2.9
"48303",48,303,2000,128169,123663,4506,3.5
"48303",48,303,2001,131300,126517,4783,3.6
"48303",48,303,2002,132892,127084,5808,4.4
"48303",48,303,2003,135530,128994,6536,4.8
"48303",48,303,2004,136707,130613,6094,4.5
"48303",48,303,2005,137313,131720,5593,4.1
"48303",48,303,2006,137550,132153,5397,3.9
"48303",48,303,2007,136021,131183,4838,3.6
"48303",48,303,2008,138386,133296,5090,3.7
"48303",48,303,2009,141963,134337,7626,5.4
"48303",48,303,2010,143339,134372,8967,6.3
"48303",48,303,2011,145820,137065,8755,6
"48303",48,303,2012,145628,137841,7787,5.3
"48303",48,303,2013,147449,140162,7287,4.9
"48303",48,303,2014,147807,141989,5818,3.9
"48303",48,303,2015,149461,144381,5080,3.4
"48303",48,303,2016,153290,148099,5191,3.4
"48303",48,303,2017,155834,150896,4938,3.2
"48305",48,305,1990,3023,2938,85,2.8
"48305",48,305,1991,3014,2910,104,3.5
"48305",48,305,1992,2872,2737,135,4.7
"48305",48,305,1993,2933,2822,111,3.8
"48305",48,305,1994,3022,2883,139,4.6
"48305",48,305,1995,3057,2947,110,3.6
"48305",48,305,1996,3067,2945,122,4
"48305",48,305,1997,3076,2950,126,4.1
"48305",48,305,1998,2957,2817,140,4.7
"48305",48,305,1999,2882,2751,131,4.5
"48305",48,305,2000,2994,2873,121,4
"48305",48,305,2001,3039,2892,147,4.8
"48305",48,305,2002,3020,2871,149,4.9
"48305",48,305,2003,3189,3015,174,5.5
"48305",48,305,2004,2990,2819,171,5.7
"48305",48,305,2005,2831,2667,164,5.8
"48305",48,305,2006,2741,2589,152,5.5
"48305",48,305,2007,2674,2544,130,4.9
"48305",48,305,2008,2768,2640,128,4.6
"48305",48,305,2009,2870,2699,171,6
"48305",48,305,2010,3069,2867,202,6.6
"48305",48,305,2011,3084,2881,203,6.6
"48305",48,305,2012,2953,2775,178,6
"48305",48,305,2013,2859,2708,151,5.3
"48305",48,305,2014,2862,2737,125,4.4
"48305",48,305,2015,2760,2649,111,4
"48305",48,305,2016,2725,2617,108,4
"48305",48,305,2017,2720,2618,102,3.8
"48307",48,307,1990,3609,3221,388,10.8
"48307",48,307,1991,3518,3216,302,8.6
"48307",48,307,1992,3496,3215,281,8
"48307",48,307,1993,3729,3480,249,6.7
"48307",48,307,1994,3791,3516,275,7.3
"48307",48,307,1995,3903,3650,253,6.5
"48307",48,307,1996,3940,3759,181,4.6
"48307",48,307,1997,3812,3604,208,5.5
"48307",48,307,1998,3757,3516,241,6.4
"48307",48,307,1999,3712,3515,197,5.3
"48307",48,307,2000,3696,3502,194,5.2
"48307",48,307,2001,3664,3450,214,5.8
"48307",48,307,2002,3637,3434,203,5.6
"48307",48,307,2003,4007,3798,209,5.2
"48307",48,307,2004,3863,3625,238,6.2
"48307",48,307,2005,3757,3569,188,5
"48307",48,307,2006,3708,3541,167,4.5
"48307",48,307,2007,3700,3559,141,3.8
"48307",48,307,2008,3979,3824,155,3.9
"48307",48,307,2009,3936,3624,312,7.9
"48307",48,307,2010,4097,3810,287,7
"48307",48,307,2011,4360,4102,258,5.9
"48307",48,307,2012,4402,4165,237,5.4
"48307",48,307,2013,4272,4047,225,5.3
"48307",48,307,2014,4113,3940,173,4.2
"48307",48,307,2015,3920,3732,188,4.8
"48307",48,307,2016,3703,3537,166,4.5
"48307",48,307,2017,3703,3570,133,3.6
"48309",48,309,1990,92695,86369,6326,6.8
"48309",48,309,1991,93463,86857,6606,7.1
"48309",48,309,1992,94608,88306,6302,6.7
"48309",48,309,1993,95408,89967,5441,5.7
"48309",48,309,1994,97556,92899,4657,4.8
"48309",48,309,1995,99332,94731,4601,4.6
"48309",48,309,1996,99390,94906,4484,4.5
"48309",48,309,1997,100705,96117,4588,4.6
"48309",48,309,1998,100447,96066,4381,4.4
"48309",48,309,1999,101970,98561,3409,3.3
"48309",48,309,2000,103923,99660,4263,4.1
"48309",48,309,2001,103945,99033,4912,4.7
"48309",48,309,2002,106240,100218,6022,5.7
"48309",48,309,2003,108552,102006,6546,6
"48309",48,309,2004,109975,104145,5830,5.3
"48309",48,309,2005,112002,106373,5629,5
"48309",48,309,2006,111630,106324,5306,4.8
"48309",48,309,2007,110278,105656,4622,4.2
"48309",48,309,2008,110920,105956,4964,4.5
"48309",48,309,2009,113759,106094,7665,6.7
"48309",48,309,2010,112900,104593,8307,7.4
"48309",48,309,2011,113365,104945,8420,7.4
"48309",48,309,2012,112372,104910,7462,6.6
"48309",48,309,2013,112195,105259,6936,6.2
"48309",48,309,2014,112906,107210,5696,5
"48309",48,309,2015,112473,107905,4568,4.1
"48309",48,309,2016,115893,111313,4580,4
"48309",48,309,2017,118021,113478,4543,3.8
"48311",48,311,1990,366,363,3,.8
"48311",48,311,1991,323,316,7,2.2
"48311",48,311,1992,336,330,6,1.8
"48311",48,311,1993,313,300,13,4.2
"48311",48,311,1994,281,273,8,2.8
"48311",48,311,1995,276,268,8,2.9
"48311",48,311,1996,273,267,6,2.2
"48311",48,311,1997,253,243,10,4
"48311",48,311,1998,279,268,11,3.9
"48311",48,311,1999,282,268,14,5
"48311",48,311,2000,400,384,16,4
"48311",48,311,2001,439,422,17,3.9
"48311",48,311,2002,434,415,19,4.4
"48311",48,311,2003,458,435,23,5
"48311",48,311,2004,433,412,21,4.8
"48311",48,311,2005,381,361,20,5.2
"48311",48,311,2006,341,321,20,5.9
"48311",48,311,2007,336,319,17,5.1
"48311",48,311,2008,333,315,18,5.4
"48311",48,311,2009,360,335,25,6.9
"48311",48,311,2010,487,466,21,4.3
"48311",48,311,2011,660,640,20,3
"48311",48,311,2012,745,727,18,2.4
"48311",48,311,2013,882,859,23,2.6
"48311",48,311,2014,1060,1039,21,2
"48311",48,311,2015,968,948,20,2.1
"48311",48,311,2016,860,842,18,2.1
"48311",48,311,2017,740,726,14,1.9
"48313",48,313,1990,3950,3736,214,5.4
"48313",48,313,1991,3989,3814,175,4.4
"48313",48,313,1992,4081,3939,142,3.5
"48313",48,313,1993,4036,3835,201,5
"48313",48,313,1994,4058,3905,153,3.8
"48313",48,313,1995,4156,3987,169,4.1
"48313",48,313,1996,4101,3942,159,3.9
"48313",48,313,1997,4453,4280,173,3.9
"48313",48,313,1998,4195,4050,145,3.5
"48313",48,313,1999,4270,4118,152,3.6
"48313",48,313,2000,4852,4618,234,4.8
"48313",48,313,2001,4942,4687,255,5.2
"48313",48,313,2002,5001,4703,298,6
"48313",48,313,2003,5195,4856,339,6.5
"48313",48,313,2004,5035,4730,305,6.1
"48313",48,313,2005,4922,4638,284,5.8
"48313",48,313,2006,4944,4686,258,5.2
"48313",48,313,2007,4980,4751,229,4.6
"48313",48,313,2008,4977,4720,257,5.2
"48313",48,313,2009,5328,4934,394,7.4
"48313",48,313,2010,4753,4353,400,8.4
"48313",48,313,2011,4682,4295,387,8.3
"48313",48,313,2012,4654,4325,329,7.1
"48313",48,313,2013,4820,4508,312,6.5
"48313",48,313,2014,5025,4781,244,4.9
"48313",48,313,2015,5112,4893,219,4.3
"48313",48,313,2016,4760,4518,242,5.1
"48313",48,313,2017,4669,4452,217,4.6
"48315",48,315,1990,3792,3513,279,7.4
"48315",48,315,1991,3712,3352,360,9.7
"48315",48,315,1992,3885,3378,507,13.1
"48315",48,315,1993,3980,3521,459,11.5
"48315",48,315,1994,4032,3596,436,10.8
"48315",48,315,1995,3935,3524,411,10.4
"48315",48,315,1996,3948,3478,470,11.9
"48315",48,315,1997,3961,3508,453,11.4
"48315",48,315,1998,3869,3482,387,10
"48315",48,315,1999,3883,3532,351,9
"48315",48,315,2000,4654,4360,294,6.3
"48315",48,315,2001,4613,4312,301,6.5
"48315",48,315,2002,4714,4365,349,7.4
"48315",48,315,2003,4943,4572,371,7.5
"48315",48,315,2004,4883,4580,303,6.2
"48315",48,315,2005,5063,4775,288,5.7
"48315",48,315,2006,4999,4735,264,5.3
"48315",48,315,2007,5072,4842,230,4.5
"48315",48,315,2008,5000,4750,250,5
"48315",48,315,2009,5132,4603,529,10.3
"48315",48,315,2010,4503,3972,531,11.8
"48315",48,315,2011,4423,3962,461,10.4
"48315",48,315,2012,4351,3954,397,9.1
"48315",48,315,2013,4541,4175,366,8.1
"48315",48,315,2014,4481,4192,289,6.4
"48315",48,315,2015,4410,4124,286,6.5
"48315",48,315,2016,4334,4030,304,7
"48315",48,315,2017,4350,4104,246,5.7
"48317",48,317,1990,2020,1986,34,1.7
"48317",48,317,1991,1888,1849,39,2.1
"48317",48,317,1992,1848,1797,51,2.8
"48317",48,317,1993,1973,1918,55,2.8
"48317",48,317,1994,1986,1922,64,3.2
"48317",48,317,1995,1889,1835,54,2.9
"48317",48,317,1996,1796,1730,66,3.7
"48317",48,317,1997,1740,1655,85,4.9
"48317",48,317,1998,1711,1627,84,4.9
"48317",48,317,1999,1779,1679,100,5.6
"48317",48,317,2000,2137,2053,84,3.9
"48317",48,317,2001,2185,2097,88,4
"48317",48,317,2002,2220,2116,104,4.7
"48317",48,317,2003,2359,2252,107,4.5
"48317",48,317,2004,2232,2123,109,4.9
"48317",48,317,2005,2113,2020,93,4.4
"48317",48,317,2006,2127,2039,88,4.1
"48317",48,317,2007,2130,2054,76,3.6
"48317",48,317,2008,2233,2155,78,3.5
"48317",48,317,2009,2246,2138,108,4.8
"48317",48,317,2010,2196,2064,132,6
"48317",48,317,2011,2351,2220,131,5.6
"48317",48,317,2012,2416,2307,109,4.5
"48317",48,317,2013,2551,2443,108,4.2
"48317",48,317,2014,2687,2596,91,3.4
"48317",48,317,2015,2581,2491,90,3.5
"48317",48,317,2016,2478,2369,109,4.4
"48317",48,317,2017,2568,2486,82,3.2
"48319",48,319,1990,1544,1502,42,2.7
"48319",48,319,1991,1525,1480,45,3
"48319",48,319,1992,1578,1516,62,3.9
"48319",48,319,1993,1603,1547,56,3.5
"48319",48,319,1994,1598,1552,46,2.9
"48319",48,319,1995,1625,1582,43,2.6
"48319",48,319,1996,1607,1566,41,2.6
"48319",48,319,1997,1562,1506,56,3.6
"48319",48,319,1998,1541,1500,41,2.7
"48319",48,319,1999,1557,1517,40,2.6
"48319",48,319,2000,2023,1964,59,2.9
"48319",48,319,2001,2105,2044,61,2.9
"48319",48,319,2002,2237,2158,79,3.5
"48319",48,319,2003,2315,2230,85,3.7
"48319",48,319,2004,2280,2200,80,3.5
"48319",48,319,2005,2385,2314,71,3
"48319",48,319,2006,2428,2356,72,3
"48319",48,319,2007,2372,2307,65,2.7
"48319",48,319,2008,2346,2276,70,3
"48319",48,319,2009,2399,2279,120,5
"48319",48,319,2010,1991,1866,125,6.3
"48319",48,319,2011,1965,1847,118,6
"48319",48,319,2012,1970,1867,103,5.2
"48319",48,319,2013,1959,1852,107,5.5
"48319",48,319,2014,1897,1810,87,4.6
"48319",48,319,2015,1802,1733,69,3.8
"48319",48,319,2016,1787,1723,64,3.6
"48319",48,319,2017,1799,1739,60,3.3
"48321",48,321,1990,17394,15600,1794,10.3
"48321",48,321,1991,17618,15645,1973,11.2
"48321",48,321,1992,18065,15301,2764,15.3
"48321",48,321,1993,17909,15250,2659,14.8
"48321",48,321,1994,17872,15257,2615,14.6
"48321",48,321,1995,17422,14942,2480,14.2
"48321",48,321,1996,16283,14070,2213,13.6
"48321",48,321,1997,16721,14488,2233,13.4
"48321",48,321,1998,16929,14958,1971,11.6
"48321",48,321,1999,16332,14636,1696,10.4
"48321",48,321,2000,17312,16174,1138,6.6
"48321",48,321,2001,17441,16107,1334,7.6
"48321",48,321,2002,17118,15546,1572,9.2
"48321",48,321,2003,17369,15615,1754,10.1
"48321",48,321,2004,17000,15416,1584,9.3
"48321",48,321,2005,16325,14998,1327,8.1
"48321",48,321,2006,15965,14847,1118,7
"48321",48,321,2007,16480,15508,972,5.9
"48321",48,321,2008,17035,15899,1136,6.7
"48321",48,321,2009,17837,16059,1778,10
"48321",48,321,2010,18158,16075,2083,11.5
"48321",48,321,2011,17794,15732,2062,11.6
"48321",48,321,2012,17106,15374,1732,10.1
"48321",48,321,2013,16851,15215,1636,9.7
"48321",48,321,2014,16680,15372,1308,7.8
"48321",48,321,2015,17163,16007,1156,6.7
"48321",48,321,2016,16851,15620,1231,7.3
"48321",48,321,2017,16930,15703,1227,7.2
"48323",48,323,1990,15618,10897,4721,30.2
"48323",48,323,1991,16321,10716,5605,34.3
"48323",48,323,1992,17015,11200,5815,34.2
"48323",48,323,1993,17293,12155,5138,29.7
"48323",48,323,1994,17654,12573,5081,28.8
"48323",48,323,1995,18343,12882,5461,29.8
"48323",48,323,1996,18161,12710,5451,30
"48323",48,323,1997,17579,12757,4822,27.4
"48323",48,323,1998,18351,13570,4781,26.1
"48323",48,323,1999,18248,14306,3942,21.6
"48323",48,323,2000,16493,14048,2445,14.8
"48323",48,323,2001,16593,13692,2901,17.5
"48323",48,323,2002,17294,13909,3385,19.6
"48323",48,323,2003,18585,15324,3261,17.5
"48323",48,323,2004,18651,15908,2743,14.7
"48323",48,323,2005,19087,16543,2544,13.3
"48323",48,323,2006,19535,17030,2505,12.8
"48323",48,323,2007,19826,17576,2250,11.3
"48323",48,323,2008,20816,18619,2197,10.6
"48323",48,323,2009,22722,19467,3255,14.3
"48323",48,323,2010,23525,19959,3566,15.2
"48323",48,323,2011,23914,20560,3354,14
"48323",48,323,2012,23373,20445,2928,12.5
"48323",48,323,2013,23667,20712,2955,12.5
"48323",48,323,2014,23397,20836,2561,10.9
"48323",48,323,2015,23622,21109,2513,10.6
"48323",48,323,2016,24190,21474,2716,11.2
"48323",48,323,2017,23860,21651,2209,9.3
"48325",48,325,1990,11704,11071,633,5.4
"48325",48,325,1991,11946,11275,671,5.6
"48325",48,325,1992,12197,11436,761,6.2
"48325",48,325,1993,13222,12566,656,5
"48325",48,325,1994,13702,13145,557,4.1
"48325",48,325,1995,14804,14210,594,4
"48325",48,325,1996,15280,14786,494,3.2
"48325",48,325,1997,15324,14676,648,4.2
"48325",48,325,1998,15696,14959,737,4.7
"48325",48,325,1999,15930,15382,548,3.4
"48325",48,325,2000,17979,17274,705,3.9
"48325",48,325,2001,18232,17419,813,4.5
"48325",48,325,2002,18599,17615,984,5.3
"48325",48,325,2003,18968,17852,1116,5.9
"48325",48,325,2004,19154,18100,1054,5.5
"48325",48,325,2005,19420,18465,955,4.9
"48325",48,325,2006,19749,18850,899,4.6
"48325",48,325,2007,19395,18592,803,4.1
"48325",48,325,2008,19712,18727,985,5
"48325",48,325,2009,19878,18553,1325,6.7
"48325",48,325,2010,20017,18509,1508,7.5
"48325",48,325,2011,20245,18733,1512,7.5
"48325",48,325,2012,20208,18884,1324,6.6
"48325",48,325,2013,20326,19091,1235,6.1
"48325",48,325,2014,20403,19402,1001,4.9
"48325",48,325,2015,20406,19515,891,4.4
"48325",48,325,2016,20953,20031,922,4.4
"48325",48,325,2017,21273,20459,814,3.8
"48327",48,327,1990,943,905,38,4
"48327",48,327,1991,954,922,32,3.4
"48327",48,327,1992,1010,963,47,4.7
"48327",48,327,1993,1025,988,37,3.6
"48327",48,327,1994,1042,1013,29,2.8
"48327",48,327,1995,1033,1013,20,1.9
"48327",48,327,1996,1090,1061,29,2.7
"48327",48,327,1997,1054,1014,40,3.8
"48327",48,327,1998,1111,1071,40,3.6
"48327",48,327,1999,1042,1010,32,3.1
"48327",48,327,2000,1171,1130,41,3.5
"48327",48,327,2001,1133,1082,51,4.5
"48327",48,327,2002,1134,1077,57,5
"48327",48,327,2003,1170,1106,64,5.5
"48327",48,327,2004,1145,1081,64,5.6
"48327",48,327,2005,1090,1040,50,4.6
"48327",48,327,2006,1067,1023,44,4.1
"48327",48,327,2007,1066,1029,37,3.5
"48327",48,327,2008,1089,1042,47,4.3
"48327",48,327,2009,1103,1030,73,6.6
"48327",48,327,2010,1004,930,74,7.4
"48327",48,327,2011,945,877,68,7.2
"48327",48,327,2012,972,911,61,6.3
"48327",48,327,2013,920,866,54,5.9
"48327",48,327,2014,886,844,42,4.7
"48327",48,327,2015,856,812,44,5.1
"48327",48,327,2016,816,779,37,4.5
"48327",48,327,2017,807,768,39,4.8
"48329",48,329,1990,54553,51636,2917,5.3
"48329",48,329,1991,56139,53443,2696,4.8
"48329",48,329,1992,57851,53703,4148,7.2
"48329",48,329,1993,58460,54566,3894,6.7
"48329",48,329,1994,59258,55855,3403,5.7
"48329",48,329,1995,59674,56755,2919,4.9
"48329",48,329,1996,59839,57109,2730,4.6
"48329",48,329,1997,62527,60110,2417,3.9
"48329",48,329,1998,64315,61598,2717,4.2
"48329",48,329,1999,61269,56994,4275,7
"48329",48,329,2000,58272,55862,2410,4.1
"48329",48,329,2001,59805,57566,2239,3.7
"48329",48,329,2002,61211,58259,2952,4.8
"48329",48,329,2003,62896,59801,3095,4.9
"48329",48,329,2004,63962,61201,2761,4.3
"48329",48,329,2005,66317,63868,2449,3.7
"48329",48,329,2006,69629,67308,2321,3.3
"48329",48,329,2007,71276,69256,2020,2.8
"48329",48,329,2008,75209,73067,2142,2.8
"48329",48,329,2009,74935,70765,4170,5.6
"48329",48,329,2010,71331,67155,4176,5.9
"48329",48,329,2011,76676,73030,3646,4.8
"48329",48,329,2012,82219,79026,3193,3.9
"48329",48,329,2013,86065,82915,3150,3.7
"48329",48,329,2014,90947,88337,2610,2.9
"48329",48,329,2015,88310,85257,3053,3.5
"48329",48,329,2016,84892,81155,3737,4.4
"48329",48,329,2017,89359,86673,2686,3
"48331",48,331,1990,9551,8977,574,6
"48331",48,331,1991,9872,9366,506,5.1
"48331",48,331,1992,10353,9800,553,5.3
"48331",48,331,1993,10268,9592,676,6.6
"48331",48,331,1994,9850,9166,684,6.9
"48331",48,331,1995,9659,9100,559,5.8
"48331",48,331,1996,9499,8981,518,5.5
"48331",48,331,1997,9535,8984,551,5.8
"48331",48,331,1998,9634,9202,432,4.5
"48331",48,331,1999,9482,9093,389,4.1
"48331",48,331,2000,11612,11178,434,3.7
"48331",48,331,2001,11771,11244,527,4.5
"48331",48,331,2002,11885,11160,725,6.1
"48331",48,331,2003,12020,11235,785,6.5
"48331",48,331,2004,11840,11152,688,5.8
"48331",48,331,2005,12157,11538,619,5.1
"48331",48,331,2006,12106,11557,549,4.5
"48331",48,331,2007,12218,11712,506,4.1
"48331",48,331,2008,11973,11329,644,5.4
"48331",48,331,2009,11455,10208,1247,10.9
"48331",48,331,2010,10539,9362,1177,11.2
"48331",48,331,2011,10409,9350,1059,10.2
"48331",48,331,2012,10280,9398,882,8.6
"48331",48,331,2013,10128,9334,794,7.8
"48331",48,331,2014,10228,9594,634,6.2
"48331",48,331,2015,10112,9583,529,5.2
"48331",48,331,2016,10250,9721,529,5.2
"48331",48,331,2017,10057,9551,506,5
"48333",48,333,1990,1974,1917,57,2.9
"48333",48,333,1991,2053,1990,63,3.1
"48333",48,333,1992,2114,2045,69,3.3
"48333",48,333,1993,2114,2039,75,3.5
"48333",48,333,1994,2219,2132,87,3.9
"48333",48,333,1995,2241,2164,77,3.4
"48333",48,333,1996,2307,2221,86,3.7
"48333",48,333,1997,2288,2227,61,2.7
"48333",48,333,1998,2319,2251,68,2.9
"48333",48,333,1999,2344,2296,48,2
"48333",48,333,2000,2464,2377,87,3.5
"48333",48,333,2001,2462,2374,88,3.6
"48333",48,333,2002,2520,2410,110,4.4
"48333",48,333,2003,2716,2600,116,4.3
"48333",48,333,2004,2693,2582,111,4.1
"48333",48,333,2005,2547,2448,99,3.9
"48333",48,333,2006,2401,2305,96,4
"48333",48,333,2007,2291,2208,83,3.6
"48333",48,333,2008,2337,2247,90,3.9
"48333",48,333,2009,2450,2319,131,5.3
"48333",48,333,2010,2190,2051,139,6.3
"48333",48,333,2011,2173,2036,137,6.3
"48333",48,333,2012,2101,1987,114,5.4
"48333",48,333,2013,2071,1962,109,5.3
"48333",48,333,2014,2049,1960,89,4.3
"48333",48,333,2015,1988,1915,73,3.7
"48333",48,333,2016,1920,1841,79,4.1
"48333",48,333,2017,1917,1850,67,3.5
"48335",48,335,1990,3298,3075,223,6.8
"48335",48,335,1991,3234,2970,264,8.2
"48335",48,335,1992,3293,2952,341,10.4
"48335",48,335,1993,3216,2995,221,6.9
"48335",48,335,1994,3426,3202,224,6.5
"48335",48,335,1995,3323,3114,209,6.3
"48335",48,335,1996,3248,3023,225,6.9
"48335",48,335,1997,3238,3062,176,5.4
"48335",48,335,1998,3468,3203,265,7.6
"48335",48,335,1999,3362,3143,219,6.5
"48335",48,335,2000,3434,3246,188,5.5
"48335",48,335,2001,3449,3252,197,5.7
"48335",48,335,2002,3430,3178,252,7.3
"48335",48,335,2003,3555,3293,262,7.4
"48335",48,335,2004,3444,3203,241,7
"48335",48,335,2005,3363,3150,213,6.3
"48335",48,335,2006,3360,3163,197,5.9
"48335",48,335,2007,3273,3105,168,5.1
"48335",48,335,2008,3297,3119,178,5.4
"48335",48,335,2009,3498,3207,291,8.3
"48335",48,335,2010,2971,2727,244,8.2
"48335",48,335,2011,2943,2722,221,7.5
"48335",48,335,2012,2878,2706,172,6
"48335",48,335,2013,2878,2719,159,5.5
"48335",48,335,2014,2905,2781,124,4.3
"48335",48,335,2015,2742,2588,154,5.6
"48335",48,335,2016,2604,2422,182,7
"48335",48,335,2017,2531,2392,139,5.5
"48337",48,337,1990,7492,7171,321,4.3
"48337",48,337,1991,7742,7291,451,5.8
"48337",48,337,1992,7850,7284,566,7.2
"48337",48,337,1993,7731,7230,501,6.5
"48337",48,337,1994,7858,7361,497,6.3
"48337",48,337,1995,7964,7496,468,5.9
"48337",48,337,1996,7715,7343,372,4.8
"48337",48,337,1997,7646,7330,316,4.1
"48337",48,337,1998,7530,7197,333,4.4
"48337",48,337,1999,7360,7022,338,4.6
"48337",48,337,2000,9245,8810,435,4.7
"48337",48,337,2001,9014,8598,416,4.6
"48337",48,337,2002,9166,8620,546,6
"48337",48,337,2003,9536,8950,586,6.1
"48337",48,337,2004,9627,9130,497,5.2
"48337",48,337,2005,9784,9350,434,4.4
"48337",48,337,2006,9980,9577,403,4
"48337",48,337,2007,10256,9898,358,3.5
"48337",48,337,2008,10648,10272,376,3.5
"48337",48,337,2009,10695,9934,761,7.1
"48337",48,337,2010,9424,8670,754,8
"48337",48,337,2011,9602,8978,624,6.5
"48337",48,337,2012,9852,9319,533,5.4
"48337",48,337,2013,10367,9857,510,4.9
"48337",48,337,2014,10137,9735,402,4
"48337",48,337,2015,9696,9285,411,4.2
"48337",48,337,2016,9015,8569,446,4.9
"48337",48,337,2017,9083,8718,365,4
"48339",48,339,1990,93956,89317,4639,4.9
"48339",48,339,1991,97843,92596,5247,5.4
"48339",48,339,1992,102526,95983,6543,6.4
"48339",48,339,1993,106474,100223,6251,5.9
"48339",48,339,1994,111146,105601,5545,5
"48339",48,339,1995,116438,111297,5141,4.4
"48339",48,339,1996,121842,116881,4961,4.1
"48339",48,339,1997,129349,124370,4979,3.8
"48339",48,339,1998,137422,132840,4582,3.3
"48339",48,339,1999,144083,139252,4831,3.4
"48339",48,339,2000,152809,147292,5517,3.6
"48339",48,339,2001,160068,153806,6262,3.9
"48339",48,339,2002,168171,159597,8574,5.1
"48339",48,339,2003,175113,165222,9891,5.6
"48339",48,339,2004,181827,172362,9465,5.2
"48339",48,339,2005,189082,180109,8973,4.7
"48339",48,339,2006,195209,186669,8540,4.4
"48339",48,339,2007,202727,194979,7748,3.8
"48339",48,339,2008,212306,203395,8911,4.2
"48339",48,339,2009,220240,205009,15231,6.9
"48339",48,339,2010,224426,207496,16930,7.5
"48339",48,339,2011,231782,215406,16376,7.1
"48339",48,339,2012,239219,225006,14213,5.9
"48339",48,339,2013,246342,233018,13324,5.4
"48339",48,339,2014,253834,242633,11201,4.4
"48339",48,339,2015,258004,247065,10939,4.2
"48339",48,339,2016,265406,252409,12997,4.9
"48339",48,339,2017,267342,255765,11577,4.3
"48341",48,341,1990,8551,8297,254,3
"48341",48,341,1991,8565,8233,332,3.9
"48341",48,341,1992,8600,8268,332,3.9
"48341",48,341,1993,8778,8452,326,3.7
"48341",48,341,1994,9113,8804,309,3.4
"48341",48,341,1995,9018,8656,362,4
"48341",48,341,1996,9100,8764,336,3.7
"48341",48,341,1997,9177,8867,310,3.4
"48341",48,341,1998,9360,9065,295,3.2
"48341",48,341,1999,9279,8993,286,3.1
"48341",48,341,2000,9704,9389,315,3.2
"48341",48,341,2001,10066,9732,334,3.3
"48341",48,341,2002,10199,9785,414,4.1
"48341",48,341,2003,10379,9888,491,4.7
"48341",48,341,2004,10350,9913,437,4.2
"48341",48,341,2005,10233,9846,387,3.8
"48341",48,341,2006,10371,10021,350,3.4
"48341",48,341,2007,10644,10337,307,2.9
"48341",48,341,2008,11237,10892,345,3.1
"48341",48,341,2009,11510,10976,534,4.6
"48341",48,341,2010,11549,10930,619,5.4
"48341",48,341,2011,11759,11192,567,4.8
"48341",48,341,2012,11589,11088,501,4.3
"48341",48,341,2013,11440,10953,487,4.3
"48341",48,341,2014,11298,10906,392,3.5
"48341",48,341,2015,11102,10756,346,3.1
"48341",48,341,2016,11173,10842,331,3
"48341",48,341,2017,11012,10693,319,2.9
"48343",48,343,1990,5950,5391,559,9.4
"48343",48,343,1991,6060,5304,756,12.5
"48343",48,343,1992,6006,5185,821,13.7
"48343",48,343,1993,5924,5294,630,10.6
"48343",48,343,1994,5979,5324,655,11
"48343",48,343,1995,5915,5323,592,10
"48343",48,343,1996,6133,5631,502,8.2
"48343",48,343,1997,6260,5757,503,8
"48343",48,343,1998,6543,5698,845,12.9
"48343",48,343,1999,6333,5634,699,11
"48343",48,343,2000,5949,5574,375,6.3
"48343",48,343,2001,5924,5517,407,6.9
"48343",48,343,2002,5996,5424,572,9.5
"48343",48,343,2003,6116,5580,536,8.8
"48343",48,343,2004,5991,5545,446,7.4
"48343",48,343,2005,6093,5723,370,6.1
"48343",48,343,2006,6155,5824,331,5.4
"48343",48,343,2007,6044,5730,314,5.2
"48343",48,343,2008,6064,5703,361,6
"48343",48,343,2009,6080,5177,903,14.9
"48343",48,343,2010,5769,4975,794,13.8
"48343",48,343,2011,5814,5116,698,12
"48343",48,343,2012,5837,5268,569,9.7
"48343",48,343,2013,5841,5281,560,9.6
"48343",48,343,2014,5626,5186,440,7.8
"48343",48,343,2015,5309,4843,466,8.8
"48343",48,343,2016,4884,4350,534,10.9
"48343",48,343,2017,4653,4251,402,8.6
"48345",48,345,1990,724,710,14,1.9
"48345",48,345,1991,765,741,24,3.1
"48345",48,345,1992,799,763,36,4.5
"48345",48,345,1993,793,762,31,3.9
"48345",48,345,1994,752,730,22,2.9
"48345",48,345,1995,715,684,31,4.3
"48345",48,345,1996,674,648,26,3.9
"48345",48,345,1997,607,585,22,3.6
"48345",48,345,1998,605,583,22,3.6
"48345",48,345,1999,590,581,9,1.5
"48345",48,345,2000,705,681,24,3.4
"48345",48,345,2001,678,654,24,3.5
"48345",48,345,2002,683,655,28,4.1
"48345",48,345,2003,733,704,29,4
"48345",48,345,2004,702,670,32,4.6
"48345",48,345,2005,669,642,27,4
"48345",48,345,2006,630,605,25,4
"48345",48,345,2007,683,656,27,4
"48345",48,345,2008,691,661,30,4.3
"48345",48,345,2009,686,649,37,5.4
"48345",48,345,2010,624,585,39,6.3
"48345",48,345,2011,594,553,41,6.9
"48345",48,345,2012,522,491,31,5.9
"48345",48,345,2013,502,472,30,6
"48345",48,345,2014,497,476,21,4.2
"48345",48,345,2015,492,475,17,3.5
"48345",48,345,2016,507,489,18,3.6
"48345",48,345,2017,490,472,18,3.7
"48347",48,347,1990,26147,24399,1748,6.7
"48347",48,347,1991,26331,24735,1596,6.1
"48347",48,347,1992,26303,24707,1596,6.1
"48347",48,347,1993,26561,25273,1288,4.8
"48347",48,347,1994,26858,25599,1259,4.7
"48347",48,347,1995,27629,26289,1340,4.8
"48347",48,347,1996,27892,26400,1492,5.3
"48347",48,347,1997,27034,25706,1328,4.9
"48347",48,347,1998,25284,24119,1165,4.6
"48347",48,347,1999,25385,24396,989,3.9
"48347",48,347,2000,29104,27849,1255,4.3
"48347",48,347,2001,29717,28331,1386,4.7
"48347",48,347,2002,30134,28474,1660,5.5
"48347",48,347,2003,31027,29203,1824,5.9
"48347",48,347,2004,31596,29906,1690,5.3
"48347",48,347,2005,31075,29454,1621,5.2
"48347",48,347,2006,30710,29265,1445,4.7
"48347",48,347,2007,30250,29007,1243,4.1
"48347",48,347,2008,30808,29484,1324,4.3
"48347",48,347,2009,31827,29766,2061,6.5
"48347",48,347,2010,30782,28593,2189,7.1
"48347",48,347,2011,30628,28488,2140,7
"48347",48,347,2012,29573,27609,1964,6.6
"48347",48,347,2013,29229,27325,1904,6.5
"48347",48,347,2014,28628,27101,1527,5.3
"48347",48,347,2015,28107,26789,1318,4.7
"48347",48,347,2016,28658,27317,1341,4.7
"48347",48,347,2017,28538,27325,1213,4.3
"48349",48,349,1990,18656,17223,1433,7.7
"48349",48,349,1991,18667,17128,1539,8.2
"48349",48,349,1992,19193,17734,1459,7.6
"48349",48,349,1993,19369,17858,1511,7.8
"48349",48,349,1994,20465,19304,1161,5.7
"48349",48,349,1995,21218,20057,1161,5.5
"48349",48,349,1996,21151,19942,1209,5.7
"48349",48,349,1997,21259,20139,1120,5.3
"48349",48,349,1998,21264,20171,1093,5.1
"48349",48,349,1999,21649,20679,970,4.5
"48349",48,349,2000,21126,20083,1043,4.9
"48349",48,349,2001,21163,20018,1145,5.4
"48349",48,349,2002,21879,20382,1497,6.8
"48349",48,349,2003,21800,20131,1669,7.7
"48349",48,349,2004,21410,20012,1398,6.5
"48349",48,349,2005,21441,20210,1231,5.7
"48349",48,349,2006,21095,19931,1164,5.5
"48349",48,349,2007,20632,19629,1003,4.9
"48349",48,349,2008,20892,19756,1136,5.4
"48349",48,349,2009,21318,19645,1673,7.8
"48349",48,349,2010,22776,20878,1898,8.3
"48349",48,349,2011,23085,21215,1870,8.1
"48349",48,349,2012,23250,21561,1689,7.3
"48349",48,349,2013,23391,21863,1528,6.5
"48349",48,349,2014,23140,21936,1204,5.2
"48349",48,349,2015,22868,21908,960,4.2
"48349",48,349,2016,22726,21776,950,4.2
"48349",48,349,2017,22752,21857,895,3.9
"48351",48,351,1990,4960,4491,469,9.5
"48351",48,351,1991,5092,4562,530,10.4
"48351",48,351,1992,5399,4754,645,11.9
"48351",48,351,1993,5718,4962,756,13.2
"48351",48,351,1994,6202,5475,727,11.7
"48351",48,351,1995,6282,5585,697,11.1
"48351",48,351,1996,6054,5342,712,11.8
"48351",48,351,1997,6026,5243,783,13
"48351",48,351,1998,5855,5140,715,12.2
"48351",48,351,1999,5826,5022,804,13.8
"48351",48,351,2000,6109,5629,480,7.9
"48351",48,351,2001,5956,5369,587,9.9
"48351",48,351,2002,6058,5348,710,11.7
"48351",48,351,2003,6041,5291,750,12.4
"48351",48,351,2004,5895,5271,624,10.6
"48351",48,351,2005,5771,5239,532,9.2
"48351",48,351,2006,5658,5254,404,7.1
"48351",48,351,2007,5750,5382,368,6.4
"48351",48,351,2008,5721,5304,417,7.3
"48351",48,351,2009,5853,5182,671,11.5
"48351",48,351,2010,5939,5185,754,12.7
"48351",48,351,2011,6040,5271,769,12.7
"48351",48,351,2012,5805,5163,642,11.1
"48351",48,351,2013,5606,5003,603,10.8
"48351",48,351,2014,5560,5100,460,8.3
"48351",48,351,2015,5363,4960,403,7.5
"48351",48,351,2016,5342,4919,423,7.9
"48351",48,351,2017,5312,4894,418,7.9
"48353",48,353,1990,7735,7137,598,7.7
"48353",48,353,1991,7675,7107,568,7.4
"48353",48,353,1992,7861,7206,655,8.3
"48353",48,353,1993,7769,7163,606,7.8
"48353",48,353,1994,7702,7103,599,7.8
"48353",48,353,1995,7729,7190,539,7
"48353",48,353,1996,7697,7121,576,7.5
"48353",48,353,1997,7324,6847,477,6.5
"48353",48,353,1998,7435,6954,481,6.5
"48353",48,353,1999,7114,6693,421,5.9
"48353",48,353,2000,7346,6995,351,4.8
"48353",48,353,2001,7218,6852,366,5.1
"48353",48,353,2002,7384,6978,406,5.5
"48353",48,353,2003,7690,7236,454,5.9
"48353",48,353,2004,7586,7182,404,5.3
"48353",48,353,2005,7559,7205,354,4.7
"48353",48,353,2006,7580,7255,325,4.3
"48353",48,353,2007,7535,7260,275,3.6
"48353",48,353,2008,7707,7412,295,3.8
"48353",48,353,2009,7857,7364,493,6.3
"48353",48,353,2010,7331,6781,550,7.5
"48353",48,353,2011,7352,6837,515,7
"48353",48,353,2012,7092,6672,420,5.9
"48353",48,353,2013,6968,6571,397,5.7
"48353",48,353,2014,7048,6746,302,4.3
"48353",48,353,2015,6907,6628,279,4
"48353",48,353,2016,6852,6523,329,4.8
"48353",48,353,2017,6778,6503,275,4.1
"48355",48,355,1990,136119,126927,9192,6.8
"48355",48,355,1991,138218,126855,11363,8.2
"48355",48,355,1992,143144,129330,13814,9.7
"48355",48,355,1993,143653,130870,12783,8.9
"48355",48,355,1994,146107,132811,13296,9.1
"48355",48,355,1995,146376,133148,13228,9
"48355",48,355,1996,148922,136259,12663,8.5
"48355",48,355,1997,148710,137286,11424,7.7
"48355",48,355,1998,146316,136227,10089,6.9
"48355",48,355,1999,146488,136770,9718,6.6
"48355",48,355,2000,148091,140405,7686,5.2
"48355",48,355,2001,149202,141346,7856,5.3
"48355",48,355,2002,151976,142724,9252,6.1
"48355",48,355,2003,155966,145883,10083,6.5
"48355",48,355,2004,156366,146986,9380,6
"48355",48,355,2005,156542,148088,8454,5.4
"48355",48,355,2006,157316,149713,7603,4.8
"48355",48,355,2007,157697,151010,6687,4.2
"48355",48,355,2008,162404,155143,7261,4.5
"48355",48,355,2009,165625,154451,11174,6.7
"48355",48,355,2010,162502,149312,13190,8.1
"48355",48,355,2011,164278,151227,13051,7.9
"48355",48,355,2012,167030,156062,10968,6.6
"48355",48,355,2013,168310,158015,10295,6.1
"48355",48,355,2014,168240,159650,8590,5.1
"48355",48,355,2015,165671,157500,8171,4.9
"48355",48,355,2016,167447,158022,9425,5.6
"48355",48,355,2017,167523,158495,9028,5.4
"48357",48,357,1990,4500,4373,127,2.8
"48357",48,357,1991,4401,4219,182,4.1
"48357",48,357,1992,4431,4127,304,6.9
"48357",48,357,1993,4495,4311,184,4.1
"48357",48,357,1994,4596,4415,181,3.9
"48357",48,357,1995,4409,4250,159,3.6
"48357",48,357,1996,4651,4491,160,3.4
"48357",48,357,1997,4673,4544,129,2.8
"48357",48,357,1998,5147,4988,159,3.1
"48357",48,357,1999,5270,5053,217,4.1
"48357",48,357,2000,4776,4629,147,3.1
"48357",48,357,2001,4937,4786,151,3.1
"48357",48,357,2002,4712,4525,187,4
"48357",48,357,2003,5013,4820,193,3.8
"48357",48,357,2004,4925,4756,169,3.4
"48357",48,357,2005,5023,4863,160,3.2
"48357",48,357,2006,5086,4933,153,3
"48357",48,357,2007,5226,5090,136,2.6
"48357",48,357,2008,5611,5458,153,2.7
"48357",48,357,2009,5502,5176,326,5.9
"48357",48,357,2010,4868,4580,288,5.9
"48357",48,357,2011,5108,4862,246,4.8
"48357",48,357,2012,5320,5115,205,3.9
"48357",48,357,2013,5430,5226,204,3.8
"48357",48,357,2014,5573,5407,166,3
"48357",48,357,2015,5268,5044,224,4.3
"48357",48,357,2016,4654,4410,244,5.2
"48357",48,357,2017,4504,4338,166,3.7
"48359",48,359,1990,1050,998,52,5
"48359",48,359,1991,1134,1070,64,5.6
"48359",48,359,1992,1157,1084,73,6.3
"48359",48,359,1993,1167,1097,70,6
"48359",48,359,1994,1174,1117,57,4.9
"48359",48,359,1995,1145,1094,51,4.5
"48359",48,359,1996,1166,1120,46,3.9
"48359",48,359,1997,1129,1082,47,4.2
"48359",48,359,1998,1142,1105,37,3.2
"48359",48,359,1999,1231,1205,26,2.1
"48359",48,359,2000,1155,1118,37,3.2
"48359",48,359,2001,1169,1133,36,3.1
"48359",48,359,2002,1182,1135,47,4
"48359",48,359,2003,1243,1185,58,4.7
"48359",48,359,2004,1157,1112,45,3.9
"48359",48,359,2005,1058,1018,40,3.8
"48359",48,359,2006,1017,976,41,4
"48359",48,359,2007,932,896,36,3.9
"48359",48,359,2008,902,862,40,4.4
"48359",48,359,2009,923,871,52,5.6
"48359",48,359,2010,961,917,44,4.6
"48359",48,359,2011,980,938,42,4.3
"48359",48,359,2012,951,910,41,4.3
"48359",48,359,2013,961,918,43,4.5
"48359",48,359,2014,941,907,34,3.6
"48359",48,359,2015,913,886,27,3
"48359",48,359,2016,907,880,27,3
"48359",48,359,2017,890,868,22,2.5
"48361",48,361,1990,38299,34866,3433,9
"48361",48,361,1991,40577,36877,3700,9.1
"48361",48,361,1992,42089,37258,4831,11.5
"48361",48,361,1993,43232,36837,6395,14.8
"48361",48,361,1994,42049,36718,5331,12.7
"48361",48,361,1995,41925,36705,5220,12.5
"48361",48,361,1996,41128,36600,4528,11
"48361",48,361,1997,41680,37598,4082,9.8
"48361",48,361,1998,41688,37844,3844,9.2
"48361",48,361,1999,41793,37485,4308,10.3
"48361",48,361,2000,40681,37896,2785,6.8
"48361",48,361,2001,40471,37268,3203,7.9
"48361",48,361,2002,40921,37417,3504,8.6
"48361",48,361,2003,41602,37718,3884,9.3
"48361",48,361,2004,40826,37285,3541,8.7
"48361",48,361,2005,40782,37526,3256,8
"48361",48,361,2006,40968,38592,2376,5.8
"48361",48,361,2007,40595,38499,2096,5.2
"48361",48,361,2008,41201,38584,2617,6.4
"48361",48,361,2009,41400,37325,4075,9.8
"48361",48,361,2010,38466,33983,4483,11.7
"48361",48,361,2011,39187,34675,4512,11.5
"48361",48,361,2012,38882,34818,4064,10.5
"48361",48,361,2013,37976,34026,3950,10.4
"48361",48,361,2014,37893,34873,3020,8
"48361",48,361,2015,37152,34727,2425,6.5
"48361",48,361,2016,37284,34786,2498,6.7
"48361",48,361,2017,37246,34692,2554,6.9
"48363",48,363,1990,11310,10581,729,6.4
"48363",48,363,1991,11494,10509,985,8.6
"48363",48,363,1992,11867,10723,1144,9.6
"48363",48,363,1993,12092,10923,1169,9.7
"48363",48,363,1994,12601,11477,1124,8.9
"48363",48,363,1995,12698,11617,1081,8.5
"48363",48,363,1996,12529,11566,963,7.7
"48363",48,363,1997,12322,11497,825,6.7
"48363",48,363,1998,12562,11888,674,5.4
"48363",48,363,1999,12360,11833,527,4.3
"48363",48,363,2000,13357,12809,548,4.1
"48363",48,363,2001,13288,12669,619,4.7
"48363",48,363,2002,13195,12393,802,6.1
"48363",48,363,2003,13582,12765,817,6
"48363",48,363,2004,13626,12903,723,5.3
"48363",48,363,2005,14208,13564,644,4.5
"48363",48,363,2006,14387,13775,612,4.3
"48363",48,363,2007,13864,13358,506,3.6
"48363",48,363,2008,14014,13435,579,4.1
"48363",48,363,2009,14210,13096,1114,7.8
"48363",48,363,2010,13254,12111,1143,8.6
"48363",48,363,2011,13481,12414,1067,7.9
"48363",48,363,2012,13418,12514,904,6.7
"48363",48,363,2013,13386,12510,876,6.5
"48363",48,363,2014,13376,12688,688,5.1
"48363",48,363,2015,13156,12472,684,5.2
"48363",48,363,2016,13227,12504,723,5.5
"48363",48,363,2017,13403,12859,544,4.1
"48365",48,365,1990,8976,8392,584,6.5
"48365",48,365,1991,8133,7331,802,9.9
"48365",48,365,1992,8087,7158,929,11.5
"48365",48,365,1993,8295,7456,839,10.1
"48365",48,365,1994,8235,7320,915,11.1
"48365",48,365,1995,8190,7316,874,10.7
"48365",48,365,1996,8178,7308,870,10.6
"48365",48,365,1997,7980,7236,744,9.3
"48365",48,365,1998,8073,7289,784,9.7
"48365",48,365,1999,8073,7272,801,9.9
"48365",48,365,2000,10407,9827,580,5.6
"48365",48,365,2001,10638,10054,584,5.5
"48365",48,365,2002,10848,10110,738,6.8
"48365",48,365,2003,11116,10350,766,6.9
"48365",48,365,2004,11317,10681,636,5.6
"48365",48,365,2005,11619,11050,569,4.9
"48365",48,365,2006,11995,11479,516,4.3
"48365",48,365,2007,12376,11909,467,3.8
"48365",48,365,2008,12999,12499,500,3.8
"48365",48,365,2009,13199,12230,969,7.3
"48365",48,365,2010,11404,10373,1031,9
"48365",48,365,2011,11944,10968,976,8.2
"48365",48,365,2012,12322,11477,845,6.9
"48365",48,365,2013,12748,11960,788,6.2
"48365",48,365,2014,12560,11940,620,4.9
"48365",48,365,2015,11560,10957,603,5.2
"48365",48,365,2016,10211,9480,731,7.2
"48365",48,365,2017,10320,9756,564,5.5
"48367",48,367,1990,32823,31320,1503,4.6
"48367",48,367,1991,33384,31122,2262,6.8
"48367",48,367,1992,33745,31555,2190,6.5
"48367",48,367,1993,34581,32544,2037,5.9
"48367",48,367,1994,35702,33746,1956,5.5
"48367",48,367,1995,36453,34809,1644,4.5
"48367",48,367,1996,37795,36409,1386,3.7
"48367",48,367,1997,39049,37811,1238,3.2
"48367",48,367,1998,40954,39765,1189,2.9
"48367",48,367,1999,42773,41599,1174,2.7
"48367",48,367,2000,46358,44720,1638,3.5
"48367",48,367,2001,46847,45022,1825,3.9
"48367",48,367,2002,47674,45164,2510,5.3
"48367",48,367,2003,48543,45829,2714,5.6
"48367",48,367,2004,49545,47007,2538,5.1
"48367",48,367,2005,50654,48241,2413,4.8
"48367",48,367,2006,51851,49486,2365,4.6
"48367",48,367,2007,52087,50013,2074,4
"48367",48,367,2008,53223,50895,2328,4.4
"48367",48,367,2009,54611,50466,4145,7.6
"48367",48,367,2010,56408,52113,4295,7.6
"48367",48,367,2011,57353,53403,3950,6.9
"48367",48,367,2012,57922,54485,3437,5.9
"48367",48,367,2013,58687,55438,3249,5.5
"48367",48,367,2014,59108,56412,2696,4.6
"48367",48,367,2015,59517,57048,2469,4.1
"48367",48,367,2016,61160,58675,2485,4.1
"48367",48,367,2017,62302,60152,2150,3.5
"48369",48,369,1990,4408,4241,167,3.8
"48369",48,369,1991,4249,4097,152,3.6
"48369",48,369,1992,4325,4127,198,4.6
"48369",48,369,1993,4420,4225,195,4.4
"48369",48,369,1994,4501,4320,181,4
"48369",48,369,1995,4448,4274,174,3.9
"48369",48,369,1996,4447,4264,183,4.1
"48369",48,369,1997,4478,4318,160,3.6
"48369",48,369,1998,4437,4304,133,3
"48369",48,369,1999,4457,4342,115,2.6
"48369",48,369,2000,4499,4348,151,3.4
"48369",48,369,2001,4603,4435,168,3.6
"48369",48,369,2002,4652,4463,189,4.1
"48369",48,369,2003,5026,4819,207,4.1
"48369",48,369,2004,4849,4631,218,4.5
"48369",48,369,2005,4594,4413,181,3.9
"48369",48,369,2006,4369,4204,165,3.8
"48369",48,369,2007,4352,4216,136,3.1
"48369",48,369,2008,4471,4322,149,3.3
"48369",48,369,2009,4622,4419,203,4.4
"48369",48,369,2010,5353,5117,236,4.4
"48369",48,369,2011,5292,5057,235,4.4
"48369",48,369,2012,5006,4800,206,4.1
"48369",48,369,2013,5068,4872,196,3.9
"48369",48,369,2014,5127,4971,156,3
"48369",48,369,2015,4964,4847,117,2.4
"48369",48,369,2016,4939,4815,124,2.5
"48369",48,369,2017,4913,4791,122,2.5
"48371",48,371,1990,6219,5854,365,5.9
"48371",48,371,1991,6554,5996,558,8.5
"48371",48,371,1992,6679,5992,687,10.3
"48371",48,371,1993,6652,6144,508,7.6
"48371",48,371,1994,6941,6429,512,7.4
"48371",48,371,1995,7164,6696,468,6.5
"48371",48,371,1996,6899,6466,433,6.3
"48371",48,371,1997,6737,6325,412,6.1
"48371",48,371,1998,6743,6280,463,6.9
"48371",48,371,1999,6721,6156,565,8.4
"48371",48,371,2000,7000,6651,349,5
"48371",48,371,2001,7009,6655,354,5.1
"48371",48,371,2002,7172,6716,456,6.4
"48371",48,371,2003,7373,6920,453,6.1
"48371",48,371,2004,7114,6695,419,5.9
"48371",48,371,2005,6650,6308,342,5.1
"48371",48,371,2006,6713,6403,310,4.6
"48371",48,371,2007,6555,6281,274,4.2
"48371",48,371,2008,7055,6742,313,4.4
"48371",48,371,2009,8410,7687,723,8.6
"48371",48,371,2010,7180,6653,527,7.3
"48371",48,371,2011,7199,6767,432,6
"48371",48,371,2012,6993,6635,358,5.1
"48371",48,371,2013,6705,6343,362,5.4
"48371",48,371,2014,6864,6579,285,4.2
"48371",48,371,2015,6860,6506,354,5.2
"48371",48,371,2016,6484,6103,381,5.9
"48371",48,371,2017,6515,6221,294,4.5
"48373",48,373,1990,11666,10948,718,6.2
"48373",48,373,1991,12027,11157,870,7.2
"48373",48,373,1992,13065,11919,1146,8.8
"48373",48,373,1993,13499,12339,1160,8.6
"48373",48,373,1994,14404,13315,1089,7.6
"48373",48,373,1995,14617,13752,865,5.9
"48373",48,373,1996,14993,14143,850,5.7
"48373",48,373,1997,15011,14074,937,6.2
"48373",48,373,1998,15029,14103,926,6.2
"48373",48,373,1999,15055,14196,859,5.7
"48373",48,373,2000,15901,14977,924,5.8
"48373",48,373,2001,16002,15012,990,6.2
"48373",48,373,2002,16544,15253,1291,7.8
"48373",48,373,2003,17179,15787,1392,8.1
"48373",48,373,2004,17309,16078,1231,7.1
"48373",48,373,2005,16734,15598,1136,6.8
"48373",48,373,2006,16914,15894,1020,6
"48373",48,373,2007,16600,15638,962,5.8
"48373",48,373,2008,16766,15735,1031,6.1
"48373",48,373,2009,17978,16347,1631,9.1
"48373",48,373,2010,17563,15861,1702,9.7
"48373",48,373,2011,17651,16004,1647,9.3
"48373",48,373,2012,17542,16136,1406,8
"48373",48,373,2013,17371,16030,1341,7.7
"48373",48,373,2014,17228,16120,1108,6.4
"48373",48,373,2015,17026,15996,1030,6
"48373",48,373,2016,17349,16253,1096,6.3
"48373",48,373,2017,17435,16386,1049,6
"48375",48,375,1990,47288,44358,2930,6.2
"48375",48,375,1991,47466,44674,2792,5.9
"48375",48,375,1992,48972,45884,3088,6.3
"48375",48,375,1993,49852,47062,2790,5.6
"48375",48,375,1994,52018,49692,2326,4.5
"48375",48,375,1995,54375,51783,2592,4.8
"48375",48,375,1996,54352,51677,2675,4.9
"48375",48,375,1997,54543,51292,3251,6
"48375",48,375,1998,55029,51896,3133,5.7
"48375",48,375,1999,55586,52322,3264,5.9
"48375",48,375,2000,53014,50203,2811,5.3
"48375",48,375,2001,53010,50164,2846,5.4
"48375",48,375,2002,54822,51334,3488,6.4
"48375",48,375,2003,56957,53188,3769,6.6
"48375",48,375,2004,57194,54067,3127,5.5
"48375",48,375,2005,56544,53955,2589,4.6
"48375",48,375,2006,57651,55232,2419,4.2
"48375",48,375,2007,56684,54536,2148,3.8
"48375",48,375,2008,56622,54363,2259,4
"48375",48,375,2009,57625,54156,3469,6
"48375",48,375,2010,58038,54385,3653,6.3
"48375",48,375,2011,58757,55265,3492,5.9
"48375",48,375,2012,58335,55218,3117,5.3
"48375",48,375,2013,57539,54644,2895,5
"48375",48,375,2014,56845,54597,2248,4
"48375",48,375,2015,56208,54338,1870,3.3
"48375",48,375,2016,56055,54180,1875,3.3
"48375",48,375,2017,55923,54137,1786,3.2
"48377",48,377,1990,3115,2654,461,14.8
"48377",48,377,1991,2803,2203,600,21.4
"48377",48,377,1992,3198,2201,997,31.2
"48377",48,377,1993,3406,2268,1138,33.4
"48377",48,377,1994,3591,2292,1299,36.2
"48377",48,377,1995,3623,2244,1379,38.1
"48377",48,377,1996,3394,2195,1199,35.3
"48377",48,377,1997,3348,2243,1105,33
"48377",48,377,1998,3723,2616,1107,29.7
"48377",48,377,1999,3493,2433,1060,30.3
"48377",48,377,2000,3186,2662,524,16.4
"48377",48,377,2001,3300,2794,506,15.3
"48377",48,377,2002,3419,2881,538,15.7
"48377",48,377,2003,3621,3057,564,15.6
"48377",48,377,2004,3512,3016,496,14.1
"48377",48,377,2005,3241,2884,357,11
"48377",48,377,2006,3214,2876,338,10.5
"48377",48,377,2007,3209,2925,284,8.9
"48377",48,377,2008,3343,2997,346,10.3
"48377",48,377,2009,3744,3139,605,16.2
"48377",48,377,2010,3743,3052,691,18.5
"48377",48,377,2011,3781,3207,574,15.2
"48377",48,377,2012,3827,3319,508,13.3
"48377",48,377,2013,3757,3274,483,12.9
"48377",48,377,2014,3412,3015,397,11.6
"48377",48,377,2015,3113,2782,331,10.6
"48377",48,377,2016,3073,2745,328,10.7
"48377",48,377,2017,3024,2741,283,9.4
"48379",48,379,1990,2959,2802,157,5.3
"48379",48,379,1991,3216,3008,208,6.5
"48379",48,379,1992,3136,2923,213,6.8
"48379",48,379,1993,3127,2944,183,5.9
"48379",48,379,1994,3302,3129,173,5.2
"48379",48,379,1995,3586,3412,174,4.9
"48379",48,379,1996,3554,3389,165,4.6
"48379",48,379,1997,3580,3388,192,5.4
"48379",48,379,1998,3810,3646,164,4.3
"48379",48,379,1999,3713,3569,144,3.9
"48379",48,379,2000,4365,4196,169,3.9
"48379",48,379,2001,4463,4240,223,5
"48379",48,379,2002,4484,4185,299,6.7
"48379",48,379,2003,4690,4342,348,7.4
"48379",48,379,2004,4884,4581,303,6.2
"48379",48,379,2005,5087,4814,273,5.4
"48379",48,379,2006,5120,4874,246,4.8
"48379",48,379,2007,5118,4903,215,4.2
"48379",48,379,2008,5056,4801,255,5
"48379",48,379,2009,5116,4707,409,8
"48379",48,379,2010,5166,4712,454,8.8
"48379",48,379,2011,5168,4744,424,8.2
"48379",48,379,2012,5232,4866,366,7
"48379",48,379,2013,5339,5011,328,6.1
"48379",48,379,2014,5406,5140,266,4.9
"48379",48,379,2015,5407,5161,246,4.5
"48379",48,379,2016,5544,5322,222,4
"48379",48,379,2017,5666,5466,200,3.5
"48381",48,381,1990,50504,48631,1873,3.7
"48381",48,381,1991,50682,48823,1859,3.7
"48381",48,381,1992,52271,50392,1879,3.6
"48381",48,381,1993,53577,51840,1737,3.2
"48381",48,381,1994,55957,54482,1475,2.6
"48381",48,381,1995,56991,55350,1641,2.9
"48381",48,381,1996,57099,55381,1718,3
"48381",48,381,1997,56570,55526,1044,1.8
"48381",48,381,1998,57533,56587,946,1.6
"48381",48,381,1999,57929,57087,842,1.5
"48381",48,381,2000,60362,58861,1501,2.5
"48381",48,381,2001,60421,58878,1543,2.6
"48381",48,381,2002,61981,60125,1856,3
"48381",48,381,2003,63866,61806,2060,3.2
"48381",48,381,2004,65375,63302,2073,3.2
"48381",48,381,2005,65374,63116,2258,3.5
"48381",48,381,2006,66827,64646,2181,3.3
"48381",48,381,2007,66973,65024,1949,2.9
"48381",48,381,2008,67704,65608,2096,3.1
"48381",48,381,2009,69158,65971,3187,4.6
"48381",48,381,2010,66245,62819,3426,5.2
"48381",48,381,2011,68124,64749,3375,5
"48381",48,381,2012,68125,65112,3013,4.4
"48381",48,381,2013,68531,65580,2951,4.3
"48381",48,381,2014,68845,66472,2373,3.4
"48381",48,381,2015,69033,67037,1996,2.9
"48381",48,381,2016,70531,68451,2080,2.9
"48381",48,381,2017,70283,68303,1980,2.8
"48383",48,383,1990,1989,1924,65,3.3
"48383",48,383,1991,1980,1907,73,3.7
"48383",48,383,1992,1987,1877,110,5.5
"48383",48,383,1993,1975,1865,110,5.6
"48383",48,383,1994,1960,1868,92,4.7
"48383",48,383,1995,2017,1941,76,3.8
"48383",48,383,1996,1978,1908,70,3.5
"48383",48,383,1997,1936,1855,81,4.2
"48383",48,383,1998,1945,1824,121,6.2
"48383",48,383,1999,1888,1722,166,8.8
"48383",48,383,2000,1626,1570,56,3.4
"48383",48,383,2001,1665,1610,55,3.3
"48383",48,383,2002,1607,1539,68,4.2
"48383",48,383,2003,1673,1607,66,3.9
"48383",48,383,2004,1924,1862,62,3.2
"48383",48,383,2005,2183,2129,54,2.5
"48383",48,383,2006,2286,2230,56,2.4
"48383",48,383,2007,2395,2346,49,2
"48383",48,383,2008,2542,2490,52,2
"48383",48,383,2009,2215,2082,133,6
"48383",48,383,2010,1912,1806,106,5.5
"48383",48,383,2011,2018,1930,88,4.4
"48383",48,383,2012,2078,2007,71,3.4
"48383",48,383,2013,1959,1881,78,4
"48383",48,383,2014,2077,2011,66,3.2
"48383",48,383,2015,1927,1840,87,4.5
"48383",48,383,2016,1698,1593,105,6.2
"48383",48,383,2017,1772,1704,68,3.8
"48385",48,385,1990,1030,958,72,7
"48385",48,385,1991,1040,978,62,6
"48385",48,385,1992,1089,999,90,8.3
"48385",48,385,1993,1149,1072,77,6.7
"48385",48,385,1994,1198,1120,78,6.5
"48385",48,385,1995,1294,1231,63,4.9
"48385",48,385,1996,1287,1219,68,5.3
"48385",48,385,1997,1246,1173,73,5.9
"48385",48,385,1998,1250,1202,48,3.8
"48385",48,385,1999,1339,1294,45,3.4
"48385",48,385,2000,1390,1329,61,4.4
"48385",48,385,2001,1309,1236,73,5.6
"48385",48,385,2002,1335,1246,89,6.7
"48385",48,385,2003,1384,1297,87,6.3
"48385",48,385,2004,1387,1315,72,5.2
"48385",48,385,2005,1320,1254,66,5
"48385",48,385,2006,1344,1279,65,4.8
"48385",48,385,2007,1372,1319,53,3.9
"48385",48,385,2008,1458,1404,54,3.7
"48385",48,385,2009,1537,1452,85,5.5
"48385",48,385,2010,1137,1033,104,9.1
"48385",48,385,2011,1136,1024,112,9.9
"48385",48,385,2012,1067,967,100,9.4
"48385",48,385,2013,1063,978,85,8
"48385",48,385,2014,1059,993,66,6.2
"48385",48,385,2015,1062,1008,54,5.1
"48385",48,385,2016,1039,980,59,5.7
"48385",48,385,2017,1049,989,60,5.7
"48387",48,387,1990,5764,5331,433,7.5
"48387",48,387,1991,5745,5210,535,9.3
"48387",48,387,1992,5957,5427,530,8.9
"48387",48,387,1993,5947,5483,464,7.8
"48387",48,387,1994,6035,5559,476,7.9
"48387",48,387,1995,6191,5747,444,7.2
"48387",48,387,1996,6200,5753,447,7.2
"48387",48,387,1997,6007,5568,439,7.3
"48387",48,387,1998,6072,5670,402,6.6
"48387",48,387,1999,5974,5678,296,5
"48387",48,387,2000,6790,6462,328,4.8
"48387",48,387,2001,6693,6146,547,8.2
"48387",48,387,2002,6448,5935,513,8
"48387",48,387,2003,6487,6009,478,7.4
"48387",48,387,2004,6446,6020,426,6.6
"48387",48,387,2005,6261,5875,386,6.2
"48387",48,387,2006,6228,5887,341,5.5
"48387",48,387,2007,6056,5757,299,4.9
"48387",48,387,2008,5924,5543,381,6.4
"48387",48,387,2009,6010,5460,550,9.2
"48387",48,387,2010,5580,4936,644,11.5
"48387",48,387,2011,5493,4829,664,12.1
"48387",48,387,2012,5263,4700,563,10.7
"48387",48,387,2013,5142,4625,517,10.1
"48387",48,387,2014,4937,4554,383,7.8
"48387",48,387,2015,4905,4597,308,6.3
"48387",48,387,2016,5022,4733,289,5.8
"48387",48,387,2017,5215,4945,270,5.2
"48389",48,389,1990,6622,6054,568,8.6
"48389",48,389,1991,6736,6035,701,10.4
"48389",48,389,1992,6917,5888,1029,14.9
"48389",48,389,1993,7031,6024,1007,14.3
"48389",48,389,1994,7015,6084,931,13.3
"48389",48,389,1995,7015,6284,731,10.4
"48389",48,389,1996,7120,6344,776,10.9
"48389",48,389,1997,6531,5938,593,9.1
"48389",48,389,1998,6762,6025,737,10.9
"48389",48,389,1999,7293,6466,827,11.3
"48389",48,389,2000,5044,4605,439,8.7
"48389",48,389,2001,4987,4624,363,7.3
"48389",48,389,2002,5050,4340,710,14.1
"48389",48,389,2003,4755,4217,538,11.3
"48389",48,389,2004,4385,4012,373,8.5
"48389",48,389,2005,4230,3915,315,7.4
"48389",48,389,2006,4122,3870,252,6.1
"48389",48,389,2007,4089,3878,211,5.2
"48389",48,389,2008,4177,3938,239,5.7
"48389",48,389,2009,4687,4151,536,11.4
"48389",48,389,2010,5748,5239,509,8.9
"48389",48,389,2011,5543,5098,445,8
"48389",48,389,2012,5345,4984,361,6.8
"48389",48,389,2013,5631,5306,325,5.8
"48389",48,389,2014,5759,5528,231,4
"48389",48,389,2015,5674,5402,272,4.8
"48389",48,389,2016,6023,5703,320,5.3
"48389",48,389,2017,6917,6672,245,3.5
"48391",48,391,1990,3379,3268,111,3.3
"48391",48,391,1991,3323,3187,136,4.1
"48391",48,391,1992,3318,3129,189,5.7
"48391",48,391,1993,3287,3090,197,6
"48391",48,391,1994,3290,3055,235,7.1
"48391",48,391,1995,3058,2883,175,5.7
"48391",48,391,1996,3004,2857,147,4.9
"48391",48,391,1997,2967,2788,179,6
"48391",48,391,1998,2967,2825,142,4.8
"48391",48,391,1999,2894,2734,160,5.5
"48391",48,391,2000,3695,3539,156,4.2
"48391",48,391,2001,3638,3473,165,4.5
"48391",48,391,2002,3677,3488,189,5.1
"48391",48,391,2003,3888,3703,185,4.8
"48391",48,391,2004,3930,3722,208,5.3
"48391",48,391,2005,3852,3661,191,5
"48391",48,391,2006,3807,3634,173,4.5
"48391",48,391,2007,3863,3721,142,3.7
"48391",48,391,2008,4036,3881,155,3.8
"48391",48,391,2009,4141,3875,266,6.4
"48391",48,391,2010,3328,3037,291,8.7
"48391",48,391,2011,3419,3160,259,7.6
"48391",48,391,2012,3509,3298,211,6
"48391",48,391,2013,3563,3371,192,5.4
"48391",48,391,2014,3600,3447,153,4.3
"48391",48,391,2015,3303,3128,175,5.3
"48391",48,391,2016,3130,2923,207,6.6
"48391",48,391,2017,3112,2932,180,5.8
"48393",48,393,1990,576,549,27,4.7
"48393",48,393,1991,540,529,11,2
"48393",48,393,1992,561,532,29,5.2
"48393",48,393,1993,553,535,18,3.3
"48393",48,393,1994,560,531,29,5.2
"48393",48,393,1995,519,506,13,2.5
"48393",48,393,1996,515,502,13,2.5
"48393",48,393,1997,523,508,15,2.9
"48393",48,393,1998,488,468,20,4.1
"48393",48,393,1999,434,422,12,2.8
"48393",48,393,2000,514,501,13,2.5
"48393",48,393,2001,521,508,13,2.5
"48393",48,393,2002,523,506,17,3.3
"48393",48,393,2003,513,494,19,3.7
"48393",48,393,2004,536,515,21,3.9
"48393",48,393,2005,551,533,18,3.3
"48393",48,393,2006,554,537,17,3.1
"48393",48,393,2007,561,548,13,2.3
"48393",48,393,2008,568,554,14,2.5
"48393",48,393,2009,583,555,28,4.8
"48393",48,393,2010,480,454,26,5.4
"48393",48,393,2011,480,456,24,5
"48393",48,393,2012,472,448,24,5.1
"48393",48,393,2013,451,431,20,4.4
"48393",48,393,2014,450,434,16,3.6
"48393",48,393,2015,455,437,18,4
"48393",48,393,2016,441,421,20,4.5
"48393",48,393,2017,437,421,16,3.7
"48395",48,395,1990,6289,5897,392,6.2
"48395",48,395,1991,6324,5854,470,7.4
"48395",48,395,1992,6718,6230,488,7.3
"48395",48,395,1993,6750,6315,435,6.4
"48395",48,395,1994,6827,6416,411,6
"48395",48,395,1995,6767,6320,447,6.6
"48395",48,395,1996,6612,6217,395,6
"48395",48,395,1997,6331,5944,387,6.1
"48395",48,395,1998,6441,6124,317,4.9
"48395",48,395,1999,6316,6019,297,4.7
"48395",48,395,2000,6969,6650,319,4.6
"48395",48,395,2001,7106,6760,346,4.9
"48395",48,395,2002,7241,6832,409,5.6
"48395",48,395,2003,7392,6934,458,6.2
"48395",48,395,2004,7453,7055,398,5.3
"48395",48,395,2005,7558,7182,376,5
"48395",48,395,2006,7459,7100,359,4.8
"48395",48,395,2007,6906,6562,344,5
"48395",48,395,2008,6938,6596,342,4.9
"48395",48,395,2009,7221,6656,565,7.8
"48395",48,395,2010,7561,6865,696,9.2
"48395",48,395,2011,7544,6851,693,9.2
"48395",48,395,2012,7290,6704,586,8
"48395",48,395,2013,7289,6778,511,7
"48395",48,395,2014,7148,6764,384,5.4
"48395",48,395,2015,7242,6897,345,4.8
"48395",48,395,2016,7242,6876,366,5.1
"48395",48,395,2017,7351,7007,344,4.7
"48397",48,397,1990,14640,14088,552,3.8
"48397",48,397,1991,15202,14495,707,4.7
"48397",48,397,1992,16153,15345,808,5
"48397",48,397,1993,16727,16060,667,4
"48397",48,397,1994,17699,17103,596,3.4
"48397",48,397,1995,18504,17902,602,3.3
"48397",48,397,1996,19391,18841,550,2.8
"48397",48,397,1997,20482,19947,535,2.6
"48397",48,397,1998,21272,20813,459,2.2
"48397",48,397,1999,22699,22228,471,2.1
"48397",48,397,2000,24320,23596,724,3
"48397",48,397,2001,25767,24724,1043,4
"48397",48,397,2002,27265,25726,1539,5.6
"48397",48,397,2003,28683,27011,1672,5.8
"48397",48,397,2004,30244,28672,1572,5.2
"48397",48,397,2005,32378,30852,1526,4.7
"48397",48,397,2006,35178,33628,1550,4.4
"48397",48,397,2007,36927,35492,1435,3.9
"48397",48,397,2008,38135,36433,1702,4.5
"48397",48,397,2009,39332,36512,2820,7.2
"48397",48,397,2010,39439,36524,2915,7.4
"48397",48,397,2011,40616,37737,2879,7.1
"48397",48,397,2012,41195,38649,2546,6.2
"48397",48,397,2013,42276,39844,2432,5.8
"48397",48,397,2014,43416,41458,1958,4.5
"48397",48,397,2015,44862,43181,1681,3.7
"48397",48,397,2016,47263,45608,1655,3.5
"48397",48,397,2017,48621,47011,1610,3.3
"48399",48,399,1990,5220,5028,192,3.7
"48399",48,399,1991,5290,5100,190,3.6
"48399",48,399,1992,5320,5074,246,4.6
"48399",48,399,1993,5379,5116,263,4.9
"48399",48,399,1994,5434,5258,176,3.2
"48399",48,399,1995,5376,5183,193,3.6
"48399",48,399,1996,5363,5205,158,2.9
"48399",48,399,1997,5212,5035,177,3.4
"48399",48,399,1998,5192,4960,232,4.5
"48399",48,399,1999,5184,4939,245,4.7
"48399",48,399,2000,5289,5041,248,4.7
"48399",48,399,2001,5205,4971,234,4.5
"48399",48,399,2002,5178,4926,252,4.9
"48399",48,399,2003,4934,4658,276,5.6
"48399",48,399,2004,4843,4603,240,5
"48399",48,399,2005,4611,4373,238,5.2
"48399",48,399,2006,4395,4161,234,5.3
"48399",48,399,2007,4415,4223,192,4.3
"48399",48,399,2008,4456,4245,211,4.7
"48399",48,399,2009,4561,4220,341,7.5
"48399",48,399,2010,5129,4702,427,8.3
"48399",48,399,2011,5108,4734,374,7.3
"48399",48,399,2012,5061,4781,280,5.5
"48399",48,399,2013,4979,4717,262,5.3
"48399",48,399,2014,4973,4762,211,4.2
"48399",48,399,2015,4667,4494,173,3.7
"48399",48,399,2016,4639,4456,183,3.9
"48399",48,399,2017,4563,4391,172,3.8
"48401",48,401,1990,19758,18361,1397,7.1
"48401",48,401,1991,21538,19924,1614,7.5
"48401",48,401,1992,21570,19872,1698,7.9
"48401",48,401,1993,21019,19331,1688,8
"48401",48,401,1994,20625,19091,1534,7.4
"48401",48,401,1995,20164,18735,1429,7.1
"48401",48,401,1996,20757,19404,1353,6.5
"48401",48,401,1997,20579,19279,1300,6.3
"48401",48,401,1998,20861,19619,1242,6
"48401",48,401,1999,21036,19805,1231,5.9
"48401",48,401,2000,21093,20060,1033,4.9
"48401",48,401,2001,21317,20226,1091,5.1
"48401",48,401,2002,21384,19981,1403,6.6
"48401",48,401,2003,21775,20311,1464,6.7
"48401",48,401,2004,22492,21222,1270,5.6
"48401",48,401,2005,22712,21527,1185,5.2
"48401",48,401,2006,22891,21834,1057,4.6
"48401",48,401,2007,23413,22450,963,4.1
"48401",48,401,2008,24069,23046,1023,4.3
"48401",48,401,2009,24266,22379,1887,7.8
"48401",48,401,2010,23961,22091,1870,7.8
"48401",48,401,2011,24286,22576,1710,7
"48401",48,401,2012,24590,23046,1544,6.3
"48401",48,401,2013,24311,22801,1510,6.2
"48401",48,401,2014,24206,23016,1190,4.9
"48401",48,401,2015,22825,21740,1085,4.8
"48401",48,401,2016,22334,21032,1302,5.8
"48401",48,401,2017,22113,20995,1118,5.1
"48403",48,403,1990,3376,3138,238,7
"48403",48,403,1991,3371,3072,299,8.9
"48403",48,403,1992,3509,3118,391,11.1
"48403",48,403,1993,3613,3199,414,11.5
"48403",48,403,1994,3704,3371,333,9
"48403",48,403,1995,3747,3433,314,8.4
"48403",48,403,1996,4016,3640,376,9.4
"48403",48,403,1997,4004,3660,344,8.6
"48403",48,403,1998,4084,3719,365,8.9
"48403",48,403,1999,4069,3671,398,9.8
"48403",48,403,2000,3772,3457,315,8.4
"48403",48,403,2001,3749,3362,387,10.3
"48403",48,403,2002,3758,3276,482,12.8
"48403",48,403,2003,3786,3292,494,13
"48403",48,403,2004,3762,3341,421,11.2
"48403",48,403,2005,3444,3104,340,9.9
"48403",48,403,2006,3416,3120,296,8.7
"48403",48,403,2007,3384,3113,271,8
"48403",48,403,2008,3392,3090,302,8.9
"48403",48,403,2009,3540,3010,530,15
"48403",48,403,2010,3654,3058,596,16.3
"48403",48,403,2011,3462,2917,545,15.7
"48403",48,403,2012,3388,2895,493,14.6
"48403",48,403,2013,3561,3101,460,12.9
"48403",48,403,2014,3542,3168,374,10.6
"48403",48,403,2015,3498,3173,325,9.3
"48403",48,403,2016,3477,3151,326,9.4
"48403",48,403,2017,3538,3235,303,8.6
"48405",48,405,1990,3009,2859,150,5
"48405",48,405,1991,3277,3072,205,6.3
"48405",48,405,1992,3442,3211,231,6.7
"48405",48,405,1993,3152,2934,218,6.9
"48405",48,405,1994,3106,2921,185,6
"48405",48,405,1995,3228,3045,183,5.7
"48405",48,405,1996,3477,3240,237,6.8
"48405",48,405,1997,3377,3137,240,7.1
"48405",48,405,1998,3411,3169,242,7.1
"48405",48,405,1999,3157,2950,207,6.6
"48405",48,405,2000,3749,3554,195,5.2
"48405",48,405,2001,3787,3574,213,5.6
"48405",48,405,2002,3826,3553,273,7.1
"48405",48,405,2003,3912,3640,272,7
"48405",48,405,2004,3806,3540,266,7
"48405",48,405,2005,3599,3346,253,7
"48405",48,405,2006,3545,3324,221,6.2
"48405",48,405,2007,3498,3310,188,5.4
"48405",48,405,2008,3500,3285,215,6.1
"48405",48,405,2009,3605,3242,363,10.1
"48405",48,405,2010,3193,2779,414,13
"48405",48,405,2011,3154,2708,446,14.1
"48405",48,405,2012,3027,2660,367,12.1
"48405",48,405,2013,2936,2595,341,11.6
"48405",48,405,2014,2826,2556,270,9.6
"48405",48,405,2015,2796,2543,253,9
"48405",48,405,2016,2798,2548,250,8.9
"48405",48,405,2017,2872,2658,214,7.5
"48407",48,407,1990,6077,5821,256,4.2
"48407",48,407,1991,6603,6258,345,5.2
"48407",48,407,1992,7175,6720,455,6.3
"48407",48,407,1993,7505,7120,385,5.1
"48407",48,407,1994,7763,7371,392,5
"48407",48,407,1995,7580,7237,343,4.5
"48407",48,407,1996,7817,7472,345,4.4
"48407",48,407,1997,7763,7389,374,4.8
"48407",48,407,1998,8220,7866,354,4.3
"48407",48,407,1999,8606,8262,344,4
"48407",48,407,2000,9400,8964,436,4.6
"48407",48,407,2001,9529,9054,475,5
"48407",48,407,2002,9726,9110,616,6.3
"48407",48,407,2003,9931,9252,679,6.8
"48407",48,407,2004,10075,9429,646,6.4
"48407",48,407,2005,10161,9531,630,6.2
"48407",48,407,2006,9939,9360,579,5.8
"48407",48,407,2007,9972,9460,512,5.1
"48407",48,407,2008,10072,9495,577,5.7
"48407",48,407,2009,10139,9197,942,9.3
"48407",48,407,2010,11230,10110,1120,10
"48407",48,407,2011,11367,10270,1097,9.7
"48407",48,407,2012,11474,10529,945,8.2
"48407",48,407,2013,11454,10588,866,7.6
"48407",48,407,2014,11413,10756,657,5.8
"48407",48,407,2015,11281,10649,632,5.6
"48407",48,407,2016,11406,10691,715,6.3
"48407",48,407,2017,11436,10792,644,5.6
"48409",48,409,1990,24994,23253,1741,7
"48409",48,409,1991,25627,23176,2451,9.6
"48409",48,409,1992,27015,23762,3253,12
"48409",48,409,1993,27402,24838,2564,9.4
"48409",48,409,1994,28111,25213,2898,10.3
"48409",48,409,1995,28653,25849,2804,9.8
"48409",48,409,1996,29203,26754,2449,8.4
"48409",48,409,1997,29807,27457,2350,7.9
"48409",48,409,1998,29795,27733,2062,6.9
"48409",48,409,1999,30157,28220,1937,6.4
"48409",48,409,2000,27483,25882,1601,5.8
"48409",48,409,2001,27709,26062,1647,5.9
"48409",48,409,2002,28216,26298,1918,6.8
"48409",48,409,2003,28958,26879,2079,7.2
"48409",48,409,2004,29412,27180,2232,7.6
"48409",48,409,2005,29557,27529,2028,6.9
"48409",48,409,2006,29405,27805,1600,5.4
"48409",48,409,2007,29076,27668,1408,4.8
"48409",48,409,2008,29870,28293,1577,5.3
"48409",48,409,2009,30628,28009,2619,8.6
"48409",48,409,2010,30434,27243,3191,10.5
"48409",48,409,2011,30231,27295,2936,9.7
"48409",48,409,2012,30435,28129,2306,7.6
"48409",48,409,2013,30665,28462,2203,7.2
"48409",48,409,2014,30685,28772,1913,6.2
"48409",48,409,2015,30206,28240,1966,6.5
"48409",48,409,2016,30554,28275,2279,7.5
"48409",48,409,2017,30647,28314,2333,7.6
"48411",48,411,1990,2197,2058,139,6.3
"48411",48,411,1991,2082,1942,140,6.7
"48411",48,411,1992,2169,2022,147,6.8
"48411",48,411,1993,2242,2143,99,4.4
"48411",48,411,1994,2303,2212,91,4
"48411",48,411,1995,2351,2262,89,3.8
"48411",48,411,1996,2381,2243,138,5.8
"48411",48,411,1997,2501,2359,142,5.7
"48411",48,411,1998,2551,2449,102,4
"48411",48,411,1999,2575,2451,124,4.8
"48411",48,411,2000,2808,2691,117,4.2
"48411",48,411,2001,2869,2744,125,4.4
"48411",48,411,2002,2764,2629,135,4.9
"48411",48,411,2003,2836,2687,149,5.3
"48411",48,411,2004,2761,2617,144,5.2
"48411",48,411,2005,2639,2508,131,5
"48411",48,411,2006,2555,2430,125,4.9
"48411",48,411,2007,2470,2356,114,4.6
"48411",48,411,2008,2411,2280,131,5.4
"48411",48,411,2009,2455,2281,174,7.1
"48411",48,411,2010,2559,2401,158,6.2
"48411",48,411,2011,2522,2369,153,6.1
"48411",48,411,2012,2295,2152,143,6.2
"48411",48,411,2013,2273,2143,130,5.7
"48411",48,411,2014,2231,2138,93,4.2
"48411",48,411,2015,2244,2162,82,3.7
"48411",48,411,2016,2443,2360,83,3.4
"48411",48,411,2017,2411,2334,77,3.2
"48413",48,413,1990,1285,1224,61,4.7
"48413",48,413,1991,1286,1218,68,5.3
"48413",48,413,1992,1330,1222,108,8.1
"48413",48,413,1993,1332,1249,83,6.2
"48413",48,413,1994,1349,1286,63,4.7
"48413",48,413,1995,1413,1344,69,4.9
"48413",48,413,1996,1425,1353,72,5.1
"48413",48,413,1997,1482,1428,54,3.6
"48413",48,413,1998,1521,1456,65,4.3
"48413",48,413,1999,1497,1411,86,5.7
"48413",48,413,2000,1509,1453,56,3.7
"48413",48,413,2001,1575,1525,50,3.2
"48413",48,413,2002,1430,1362,68,4.8
"48413",48,413,2003,1519,1456,63,4.1
"48413",48,413,2004,1442,1387,55,3.8
"48413",48,413,2005,1362,1308,54,4
"48413",48,413,2006,1356,1305,51,3.8
"48413",48,413,2007,1415,1366,49,3.5
"48413",48,413,2008,1469,1420,49,3.3
"48413",48,413,2009,1510,1369,141,9.3
"48413",48,413,2010,1634,1510,124,7.6
"48413",48,413,2011,1699,1603,96,5.7
"48413",48,413,2012,1781,1710,71,4
"48413",48,413,2013,1803,1739,64,3.5
"48413",48,413,2014,1780,1726,54,3
"48413",48,413,2015,1500,1421,79,5.3
"48413",48,413,2016,1418,1344,74,5.2
"48413",48,413,2017,1338,1289,49,3.7
"48415",48,415,1990,8075,7718,357,4.4
"48415",48,415,1991,8160,7752,408,5
"48415",48,415,1992,8163,7495,668,8.2
"48415",48,415,1993,7886,7389,497,6.3
"48415",48,415,1994,8211,7717,494,6
"48415",48,415,1995,7919,7552,367,4.6
"48415",48,415,1996,7829,7482,347,4.4
"48415",48,415,1997,8134,7769,365,4.5
"48415",48,415,1998,8081,7649,432,5.3
"48415",48,415,1999,7409,6813,596,8
"48415",48,415,2000,7235,6891,344,4.8
"48415",48,415,2001,7233,6854,379,5.2
"48415",48,415,2002,7037,6599,438,6.2
"48415",48,415,2003,7260,6825,435,6
"48415",48,415,2004,7212,6825,387,5.4
"48415",48,415,2005,7095,6743,352,5
"48415",48,415,2006,7111,6779,332,4.7
"48415",48,415,2007,7288,7014,274,3.8
"48415",48,415,2008,7541,7241,300,4
"48415",48,415,2009,7763,7240,523,6.7
"48415",48,415,2010,7101,6619,482,6.8
"48415",48,415,2011,7407,6987,420,5.7
"48415",48,415,2012,8118,7755,363,4.5
"48415",48,415,2013,8566,8210,356,4.2
"48415",48,415,2014,8612,8326,286,3.3
"48415",48,415,2015,8161,7823,338,4.1
"48415",48,415,2016,7394,6959,435,5.9
"48415",48,415,2017,6982,6677,305,4.4
"48417",48,417,1990,1523,1482,41,2.7
"48417",48,417,1991,1504,1460,44,2.9
"48417",48,417,1992,1481,1422,59,4
"48417",48,417,1993,1537,1474,63,4.1
"48417",48,417,1994,1539,1474,65,4.2
"48417",48,417,1995,1462,1411,51,3.5
"48417",48,417,1996,1475,1411,64,4.3
"48417",48,417,1997,1413,1355,58,4.1
"48417",48,417,1998,1409,1332,77,5.5
"48417",48,417,1999,1336,1266,70,5.2
"48417",48,417,2000,1646,1590,56,3.4
"48417",48,417,2001,1737,1682,55,3.2
"48417",48,417,2002,1868,1792,76,4.1
"48417",48,417,2003,1970,1894,76,3.9
"48417",48,417,2004,2058,1994,64,3.1
"48417",48,417,2005,1933,1875,58,3
"48417",48,417,2006,2011,1950,61,3
"48417",48,417,2007,2045,1992,53,2.6
"48417",48,417,2008,2144,2088,56,2.6
"48417",48,417,2009,2127,2042,85,4
"48417",48,417,2010,1904,1798,106,5.6
"48417",48,417,2011,2007,1912,95,4.7
"48417",48,417,2012,2214,2136,78,3.5
"48417",48,417,2013,2298,2222,76,3.3
"48417",48,417,2014,2374,2309,65,2.7
"48417",48,417,2015,2081,2022,59,2.8
"48417",48,417,2016,1874,1802,72,3.8
"48417",48,417,2017,1875,1819,56,3
"48419",48,419,1990,8728,8207,521,6
"48419",48,419,1991,9027,8226,801,8.9
"48419",48,419,1992,9380,8562,818,8.7
"48419",48,419,1993,9736,8946,790,8.1
"48419",48,419,1994,9879,9141,738,7.5
"48419",48,419,1995,10169,9507,662,6.5
"48419",48,419,1996,9814,9097,717,7.3
"48419",48,419,1997,9488,8808,680,7.2
"48419",48,419,1998,9553,8958,595,6.2
"48419",48,419,1999,9362,8715,647,6.9
"48419",48,419,2000,11365,10778,587,5.2
"48419",48,419,2001,11735,11097,638,5.4
"48419",48,419,2002,11980,11161,819,6.8
"48419",48,419,2003,12562,11685,877,7
"48419",48,419,2004,12175,11431,744,6.1
"48419",48,419,2005,11709,11022,687,5.9
"48419",48,419,2006,11942,11355,587,4.9
"48419",48,419,2007,12175,11665,510,4.2
"48419",48,419,2008,12421,11834,587,4.7
"48419",48,419,2009,12613,11696,917,7.3
"48419",48,419,2010,11839,10837,1002,8.5
"48419",48,419,2011,11977,10952,1025,8.6
"48419",48,419,2012,12126,11246,880,7.3
"48419",48,419,2013,11631,10768,863,7.4
"48419",48,419,2014,11613,10935,678,5.8
"48419",48,419,2015,11368,10771,597,5.3
"48419",48,419,2016,10935,10279,656,6
"48419",48,419,2017,10781,10229,552,5.1
"48421",48,421,1990,1423,1398,25,1.8
"48421",48,421,1991,1420,1376,44,3.1
"48421",48,421,1992,1380,1341,39,2.8
"48421",48,421,1993,1407,1367,40,2.8
"48421",48,421,1994,1378,1337,41,3
"48421",48,421,1995,1387,1356,31,2.2
"48421",48,421,1996,1410,1373,37,2.6
"48421",48,421,1997,1407,1374,33,2.3
"48421",48,421,1998,1414,1389,25,1.8
"48421",48,421,1999,1511,1491,20,1.3
"48421",48,421,2000,1629,1585,44,2.7
"48421",48,421,2001,1687,1640,47,2.8
"48421",48,421,2002,1709,1651,58,3.4
"48421",48,421,2003,1684,1623,61,3.6
"48421",48,421,2004,1580,1524,56,3.5
"48421",48,421,2005,1388,1329,59,4.3
"48421",48,421,2006,1312,1260,52,4
"48421",48,421,2007,1341,1295,46,3.4
"48421",48,421,2008,1455,1401,54,3.7
"48421",48,421,2009,1444,1381,63,4.4
"48421",48,421,2010,1555,1484,71,4.6
"48421",48,421,2011,1578,1506,72,4.6
"48421",48,421,2012,1504,1441,63,4.2
"48421",48,421,2013,1480,1420,60,4.1
"48421",48,421,2014,1505,1458,47,3.1
"48421",48,421,2015,1419,1380,39,2.7
"48421",48,421,2016,1348,1309,39,2.9
"48421",48,421,2017,1289,1249,40,3.1
"48423",48,423,1990,75737,70988,4749,6.3
"48423",48,423,1991,77197,71965,5232,6.8
"48423",48,423,1992,79106,73521,5585,7.1
"48423",48,423,1993,80853,75119,5734,7.1
"48423",48,423,1994,82794,77960,4834,5.8
"48423",48,423,1995,84926,80217,4709,5.5
"48423",48,423,1996,86861,81248,5613,6.5
"48423",48,423,1997,89190,83734,5456,6.1
"48423",48,423,1998,89518,84883,4635,5.2
"48423",48,423,1999,90059,86177,3882,4.3
"48423",48,423,2000,86479,82708,3771,4.4
"48423",48,423,2001,87341,83085,4256,4.9
"48423",48,423,2002,89929,84889,5040,5.6
"48423",48,423,2003,92322,86852,5470,5.9
"48423",48,423,2004,94369,89387,4982,5.3
"48423",48,423,2005,95360,90560,4800,5
"48423",48,423,2006,96249,91791,4458,4.6
"48423",48,423,2007,96729,92718,4011,4.1
"48423",48,423,2008,98652,93896,4756,4.8
"48423",48,423,2009,100397,92806,7591,7.6
"48423",48,423,2010,101151,93110,8041,7.9
"48423",48,423,2011,102136,94189,7947,7.8
"48423",48,423,2012,101770,94614,7156,7
"48423",48,423,2013,101647,94998,6649,6.5
"48423",48,423,2014,102258,96937,5321,5.2
"48423",48,423,2015,103648,99018,4630,4.5
"48423",48,423,2016,105252,100495,4757,4.5
"48423",48,423,2017,105896,101599,4297,4.1
"48425",48,425,1990,2641,2202,439,16.6
"48425",48,425,1991,3295,3101,194,5.9
"48425",48,425,1992,3650,3398,252,6.9
"48425",48,425,1993,2587,2136,451,17.4
"48425",48,425,1994,2196,1891,305,13.9
"48425",48,425,1995,2227,1963,264,11.9
"48425",48,425,1996,2141,1942,199,9.3
"48425",48,425,1997,2055,1866,189,9.2
"48425",48,425,1998,2023,1873,150,7.4
"48425",48,425,1999,2054,1943,111,5.4
"48425",48,425,2000,3465,3323,142,4.1
"48425",48,425,2001,3453,3300,153,4.4
"48425",48,425,2002,3641,3435,206,5.7
"48425",48,425,2003,3808,3567,241,6.3
"48425",48,425,2004,3723,3520,203,5.5
"48425",48,425,2005,3686,3487,199,5.4
"48425",48,425,2006,3746,3567,179,4.8
"48425",48,425,2007,3887,3716,171,4.4
"48425",48,425,2008,4107,3924,183,4.5
"48425",48,425,2009,4224,3924,300,7.1
"48425",48,425,2010,4043,3721,322,8
"48425",48,425,2011,4084,3767,317,7.8
"48425",48,425,2012,4143,3869,274,6.6
"48425",48,425,2013,4147,3897,250,6
"48425",48,425,2014,4136,3924,212,5.1
"48425",48,425,2015,4107,3901,206,5
"48425",48,425,2016,4124,3926,198,4.8
"48425",48,425,2017,4218,4028,190,4.5
"48427",48,427,1990,18510,11025,7485,40.4
"48427",48,427,1991,19500,11836,7664,39.3
"48427",48,427,1992,19183,12676,6507,33.9
"48427",48,427,1993,20195,14148,6047,29.9
"48427",48,427,1994,20843,15098,5745,27.6
"48427",48,427,1995,21749,15506,6243,28.7
"48427",48,427,1996,21848,15648,6200,28.4
"48427",48,427,1997,20729,14919,5810,28
"48427",48,427,1998,21664,15682,5982,27.6
"48427",48,427,1999,21360,16078,5282,24.7
"48427",48,427,2000,17725,14791,2934,16.6
"48427",48,427,2001,18614,15684,2930,15.7
"48427",48,427,2002,19937,16620,3317,16.6
"48427",48,427,2003,21130,17779,3351,15.9
"48427",48,427,2004,21337,18286,3051,14.3
"48427",48,427,2005,21176,18415,2761,13
"48427",48,427,2006,21432,18955,2477,11.6
"48427",48,427,2007,21264,19022,2242,10.5
"48427",48,427,2008,22243,19728,2515,11.3
"48427",48,427,2009,24428,20415,4013,16.4
"48427",48,427,2010,26074,21565,4509,17.3
"48427",48,427,2011,26168,21930,4238,16.2
"48427",48,427,2012,26036,22252,3784,14.5
"48427",48,427,2013,26344,22402,3942,15
"48427",48,427,2014,25993,22451,3542,13.6
"48427",48,427,2015,25855,22376,3479,13.5
"48427",48,427,2016,26299,22789,3510,13.3
"48427",48,427,2017,26049,23009,3040,11.7
"48429",48,429,1990,3793,3634,159,4.2
"48429",48,429,1991,3696,3546,150,4.1
"48429",48,429,1992,3762,3547,215,5.7
"48429",48,429,1993,3950,3671,279,7.1
"48429",48,429,1994,4075,3821,254,6.2
"48429",48,429,1995,4073,3893,180,4.4
"48429",48,429,1996,4233,4076,157,3.7
"48429",48,429,1997,4328,4164,164,3.8
"48429",48,429,1998,4298,4103,195,4.5
"48429",48,429,1999,4148,3962,186,4.5
"48429",48,429,2000,4377,4191,186,4.2
"48429",48,429,2001,4337,4158,179,4.1
"48429",48,429,2002,4341,4061,280,6.5
"48429",48,429,2003,4210,3906,304,7.2
"48429",48,429,2004,4233,4021,212,5
"48429",48,429,2005,4299,4102,197,4.6
"48429",48,429,2006,4419,4240,179,4.1
"48429",48,429,2007,4470,4314,156,3.5
"48429",48,429,2008,4679,4510,169,3.6
"48429",48,429,2009,4629,4316,313,6.8
"48429",48,429,2010,4245,3928,317,7.5
"48429",48,429,2011,4440,4095,345,7.8
"48429",48,429,2012,4384,4124,260,5.9
"48429",48,429,2013,4207,3990,217,5.2
"48429",48,429,2014,4291,4104,187,4.4
"48429",48,429,2015,4104,3932,172,4.2
"48429",48,429,2016,4010,3799,211,5.3
"48429",48,429,2017,4030,3841,189,4.7
"48431",48,431,1990,653,640,13,2
"48431",48,431,1991,672,656,16,2.4
"48431",48,431,1992,739,722,17,2.3
"48431",48,431,1993,763,732,31,4.1
"48431",48,431,1994,721,686,35,4.9
"48431",48,431,1995,659,619,40,6.1
"48431",48,431,1996,629,604,25,4
"48431",48,431,1997,670,652,18,2.7
"48431",48,431,1998,696,672,24,3.4
"48431",48,431,1999,671,643,28,4.2
"48431",48,431,2000,730,706,24,3.3
"48431",48,431,2001,760,733,27,3.6
"48431",48,431,2002,840,808,32,3.8
"48431",48,431,2003,948,916,32,3.4
"48431",48,431,2004,882,853,29,3.3
"48431",48,431,2005,937,911,26,2.8
"48431",48,431,2006,870,843,27,3.1
"48431",48,431,2007,790,768,22,2.8
"48431",48,431,2008,849,825,24,2.8
"48431",48,431,2009,855,819,36,4.2
"48431",48,431,2010,675,643,32,4.7
"48431",48,431,2011,682,649,33,4.8
"48431",48,431,2012,720,695,25,3.5
"48431",48,431,2013,752,723,29,3.9
"48431",48,431,2014,812,788,24,3
"48431",48,431,2015,746,721,25,3.4
"48431",48,431,2016,669,643,26,3.9
"48431",48,431,2017,607,584,23,3.8
"48433",48,433,1990,896,860,36,4
"48433",48,433,1991,837,797,40,4.8
"48433",48,433,1992,905,764,141,15.6
"48433",48,433,1993,816,755,61,7.5
"48433",48,433,1994,819,791,28,3.4
"48433",48,433,1995,837,804,33,3.9
"48433",48,433,1996,812,784,28,3.4
"48433",48,433,1997,785,750,35,4.5
"48433",48,433,1998,742,698,44,5.9
"48433",48,433,1999,695,656,39,5.6
"48433",48,433,2000,822,787,35,4.3
"48433",48,433,2001,854,817,37,4.3
"48433",48,433,2002,848,812,36,4.2
"48433",48,433,2003,865,827,38,4.4
"48433",48,433,2004,852,815,37,4.3
"48433",48,433,2005,822,793,29,3.5
"48433",48,433,2006,874,845,29,3.3
"48433",48,433,2007,878,850,28,3.2
"48433",48,433,2008,860,832,28,3.3
"48433",48,433,2009,849,813,36,4.2
"48433",48,433,2010,746,703,43,5.8
"48433",48,433,2011,746,705,41,5.5
"48433",48,433,2012,748,715,33,4.4
"48433",48,433,2013,707,674,33,4.7
"48433",48,433,2014,697,670,27,3.9
"48433",48,433,2015,662,633,29,4.4
"48433",48,433,2016,639,611,28,4.4
"48433",48,433,2017,621,600,21,3.4
"48435",48,435,1990,2061,1957,104,5
"48435",48,435,1991,2204,2064,140,6.4
"48435",48,435,1992,2152,1981,171,7.9
"48435",48,435,1993,2136,2034,102,4.8
"48435",48,435,1994,2088,2002,86,4.1
"48435",48,435,1995,2168,2082,86,4
"48435",48,435,1996,2269,2183,86,3.8
"48435",48,435,1997,2152,2086,66,3.1
"48435",48,435,1998,2207,2113,94,4.3
"48435",48,435,1999,2047,1898,149,7.3
"48435",48,435,2000,2157,2075,82,3.8
"48435",48,435,2001,2264,2189,75,3.3
"48435",48,435,2002,2382,2291,91,3.8
"48435",48,435,2003,2487,2402,85,3.4
"48435",48,435,2004,2588,2513,75,2.9
"48435",48,435,2005,2695,2619,76,2.8
"48435",48,435,2006,2832,2757,75,2.6
"48435",48,435,2007,3105,3040,65,2.1
"48435",48,435,2008,3515,3446,69,2
"48435",48,435,2009,3449,3204,245,7.1
"48435",48,435,2010,1990,1799,191,9.6
"48435",48,435,2011,1947,1815,132,6.8
"48435",48,435,2012,2012,1917,95,4.7
"48435",48,435,2013,2065,1971,94,4.6
"48435",48,435,2014,2022,1950,72,3.6
"48435",48,435,2015,1718,1614,104,6.1
"48435",48,435,2016,1588,1462,126,7.9
"48435",48,435,2017,1514,1437,77,5.1
"48437",48,437,1990,3726,3609,117,3.1
"48437",48,437,1991,3688,3560,128,3.5
"48437",48,437,1992,4041,3820,221,5.5
"48437",48,437,1993,4114,3925,189,4.6
"48437",48,437,1994,4113,3946,167,4.1
"48437",48,437,1995,4052,3855,197,4.9
"48437",48,437,1996,3846,3675,171,4.4
"48437",48,437,1997,3693,3526,167,4.5
"48437",48,437,1998,3710,3568,142,3.8
"48437",48,437,1999,3600,3458,142,3.9
"48437",48,437,2000,3886,3732,154,4
"48437",48,437,2001,3907,3743,164,4.2
"48437",48,437,2002,3917,3730,187,4.8
"48437",48,437,2003,4043,3832,211,5.2
"48437",48,437,2004,3882,3672,210,5.4
"48437",48,437,2005,3608,3438,170,4.7
"48437",48,437,2006,3500,3346,154,4.4
"48437",48,437,2007,3486,3338,148,4.2
"48437",48,437,2008,3556,3399,157,4.4
"48437",48,437,2009,3648,3439,209,5.7
"48437",48,437,2010,3182,2973,209,6.6
"48437",48,437,2011,3152,2940,212,6.7
"48437",48,437,2012,3050,2869,181,5.9
"48437",48,437,2013,2964,2714,250,8.4
"48437",48,437,2014,2881,2705,176,6.1
"48437",48,437,2015,2730,2600,130,4.8
"48437",48,437,2016,2710,2595,115,4.2
"48437",48,437,2017,2687,2578,109,4.1
"48439",48,439,1990,666412,631417,34995,5.3
"48439",48,439,1991,675940,628939,47001,7
"48439",48,439,1992,682332,633647,48685,7.1
"48439",48,439,1993,690393,646660,43733,6.3
"48439",48,439,1994,703724,664415,39309,5.6
"48439",48,439,1995,713338,678383,34955,4.9
"48439",48,439,1996,726191,697490,28701,4
"48439",48,439,1997,739565,713030,26535,3.6
"48439",48,439,1998,757445,732087,25358,3.3
"48439",48,439,1999,777430,753001,24429,3.1
"48439",48,439,2000,794779,766783,27996,3.5
"48439",48,439,2001,802338,767054,35284,4.4
"48439",48,439,2002,815484,766183,49301,6
"48439",48,439,2003,820450,768791,51659,6.3
"48439",48,439,2004,829589,783919,45670,5.5
"48439",48,439,2005,843857,800439,43418,5.1
"48439",48,439,2006,859737,819239,40498,4.7
"48439",48,439,2007,868680,831857,36823,4.2
"48439",48,439,2008,880826,838778,42048,4.8
"48439",48,439,2009,896305,827369,68936,7.7
"48439",48,439,2010,924951,849576,75375,8.1
"48439",48,439,2011,950514,878726,71788,7.6
"48439",48,439,2012,966259,903315,62944,6.5
"48439",48,439,2013,981537,922170,59367,6
"48439",48,439,2014,991015,941186,49829,5
"48439",48,439,2015,990682,949513,41169,4.2
"48439",48,439,2016,1009291,969161,40130,4
"48439",48,439,2017,1033317,995339,37978,3.7
"48441",48,441,1990,55912,52403,3509,6.3
"48441",48,441,1991,55683,52659,3024,5.4
"48441",48,441,1992,57487,54336,3151,5.5
"48441",48,441,1993,57920,54697,3223,5.6
"48441",48,441,1994,58209,55229,2980,5.1
"48441",48,441,1995,59819,56723,3096,5.2
"48441",48,441,1996,60310,57329,2981,4.9
"48441",48,441,1997,60439,58026,2413,4
"48441",48,441,1998,60594,58390,2204,3.6
"48441",48,441,1999,59807,57563,2244,3.8
"48441",48,441,2000,61423,58955,2468,4
"48441",48,441,2001,61582,58886,2696,4.4
"48441",48,441,2002,63354,60223,3131,4.9
"48441",48,441,2003,64835,61492,3343,5.2
"48441",48,441,2004,64786,61854,2932,4.5
"48441",48,441,2005,65219,62551,2668,4.1
"48441",48,441,2006,66352,63802,2550,3.8
"48441",48,441,2007,65430,63191,2239,3.4
"48441",48,441,2008,67133,64668,2465,3.7
"48441",48,441,2009,67826,64023,3803,5.6
"48441",48,441,2010,64285,59931,4354,6.8
"48441",48,441,2011,64678,60429,4249,6.6
"48441",48,441,2012,64485,60834,3651,5.7
"48441",48,441,2013,64664,61254,3410,5.3
"48441",48,441,2014,64418,61706,2712,4.2
"48441",48,441,2015,63301,60982,2319,3.7
"48441",48,441,2016,63183,60821,2362,3.7
"48441",48,441,2017,64051,61784,2267,3.5
"48443",48,443,1990,650,640,10,1.5
"48443",48,443,1991,621,602,19,3.1
"48443",48,443,1992,636,597,39,6.1
"48443",48,443,1993,595,557,38,6.4
"48443",48,443,1994,584,552,32,5.5
"48443",48,443,1995,592,564,28,4.7
"48443",48,443,1996,570,546,24,4.2
"48443",48,443,1997,466,434,32,6.9
"48443",48,443,1998,529,505,24,4.5
"48443",48,443,1999,705,675,30,4.3
"48443",48,443,2000,514,494,20,3.9
"48443",48,443,2001,495,470,25,5.1
"48443",48,443,2002,494,465,29,5.9
"48443",48,443,2003,499,463,36,7.2
"48443",48,443,2004,417,392,25,6
"48443",48,443,2005,383,356,27,7
"48443",48,443,2006,386,365,21,5.4
"48443",48,443,2007,357,339,18,5
"48443",48,443,2008,330,308,22,6.7
"48443",48,443,2009,382,347,35,9.2
"48443",48,443,2010,501,467,34,6.8
"48443",48,443,2011,518,486,32,6.2
"48443",48,443,2012,549,523,26,4.7
"48443",48,443,2013,525,499,26,5
"48443",48,443,2014,480,458,22,4.6
"48443",48,443,2015,434,413,21,4.8
"48443",48,443,2016,405,389,16,4
"48443",48,443,2017,391,372,19,4.9
"48445",48,445,1990,5928,5556,372,6.3
"48445",48,445,1991,6137,5837,300,4.9
"48445",48,445,1992,6077,5560,517,8.5
"48445",48,445,1993,6064,5638,426,7
"48445",48,445,1994,6154,5694,460,7.5
"48445",48,445,1995,6015,5571,444,7.4
"48445",48,445,1996,6052,5699,353,5.8
"48445",48,445,1997,6307,5954,353,5.6
"48445",48,445,1998,5777,5365,412,7.1
"48445",48,445,1999,5634,5233,401,7.1
"48445",48,445,2000,5612,5339,273,4.9
"48445",48,445,2001,5775,5467,308,5.3
"48445",48,445,2002,5583,5257,326,5.8
"48445",48,445,2003,5840,5454,386,6.6
"48445",48,445,2004,5705,5349,356,6.2
"48445",48,445,2005,5756,5431,325,5.6
"48445",48,445,2006,5619,5330,289,5.1
"48445",48,445,2007,5712,5452,260,4.6
"48445",48,445,2008,5860,5617,243,4.1
"48445",48,445,2009,6029,5615,414,6.9
"48445",48,445,2010,5756,5328,428,7.4
"48445",48,445,2011,5853,5437,416,7.1
"48445",48,445,2012,5666,5295,371,6.5
"48445",48,445,2013,5533,5205,328,5.9
"48445",48,445,2014,5612,5371,241,4.3
"48445",48,445,2015,5398,5146,252,4.7
"48445",48,445,2016,5341,5086,255,4.8
"48445",48,445,2017,5245,4983,262,5
"48447",48,447,1990,878,866,12,1.4
"48447",48,447,1991,926,909,17,1.8
"48447",48,447,1992,927,907,20,2.2
"48447",48,447,1993,917,897,20,2.2
"48447",48,447,1994,904,862,42,4.6
"48447",48,447,1995,849,818,31,3.7
"48447",48,447,1996,810,783,27,3.3
"48447",48,447,1997,766,743,23,3
"48447",48,447,1998,772,754,18,2.3
"48447",48,447,1999,742,720,22,3
"48447",48,447,2000,976,943,33,3.4
"48447",48,447,2001,989,958,31,3.1
"48447",48,447,2002,1000,958,42,4.2
"48447",48,447,2003,1027,980,47,4.6
"48447",48,447,2004,978,940,38,3.9
"48447",48,447,2005,931,899,32,3.4
"48447",48,447,2006,971,937,34,3.5
"48447",48,447,2007,969,933,36,3.7
"48447",48,447,2008,942,910,32,3.4
"48447",48,447,2009,1033,983,50,4.8
"48447",48,447,2010,877,824,53,6
"48447",48,447,2011,873,812,61,7
"48447",48,447,2012,830,786,44,5.3
"48447",48,447,2013,796,756,40,5
"48447",48,447,2014,833,800,33,4
"48447",48,447,2015,780,755,25,3.2
"48447",48,447,2016,742,716,26,3.5
"48447",48,447,2017,692,662,30,4.3
"48449",48,449,1990,11656,10854,802,6.9
"48449",48,449,1991,11808,10798,1010,8.6
"48449",48,449,1992,11958,10798,1160,9.7
"48449",48,449,1993,11788,10720,1068,9.1
"48449",48,449,1994,11956,10855,1101,9.2
"48449",48,449,1995,11993,11040,953,7.9
"48449",48,449,1996,12484,11563,921,7.4
"48449",48,449,1997,12772,11954,818,6.4
"48449",48,449,1998,12732,11898,834,6.6
"48449",48,449,1999,12650,11924,726,5.7
"48449",48,449,2000,12775,12218,557,4.4
"48449",48,449,2001,13366,12768,598,4.5
"48449",48,449,2002,13950,13182,768,5.5
"48449",48,449,2003,14531,13707,824,5.7
"48449",48,449,2004,14784,14050,734,5
"48449",48,449,2005,14690,13997,693,4.7
"48449",48,449,2006,14488,13868,620,4.3
"48449",48,449,2007,14278,13748,530,3.7
"48449",48,449,2008,14104,13504,600,4.3
"48449",48,449,2009,14308,13274,1034,7.2
"48449",48,449,2010,13988,12795,1193,8.5
"48449",48,449,2011,13719,12590,1129,8.2
"48449",48,449,2012,13267,12272,995,7.5
"48449",48,449,2013,13079,12107,972,7.4
"48449",48,449,2014,12910,12097,813,6.3
"48449",48,449,2015,12728,11993,735,5.8
"48449",48,449,2016,12855,12063,792,6.2
"48449",48,449,2017,12954,12262,692,5.3
"48451",48,451,1990,46357,43598,2759,6
"48451",48,451,1991,47023,44679,2344,5
"48451",48,451,1992,48694,46193,2501,5.1
"48451",48,451,1993,49238,46700,2538,5.2
"48451",48,451,1994,49699,47411,2288,4.6
"48451",48,451,1995,50172,48097,2075,4.1
"48451",48,451,1996,50608,48793,1815,3.6
"48451",48,451,1997,51996,50168,1828,3.5
"48451",48,451,1998,52230,50084,2146,4.1
"48451",48,451,1999,50321,48138,2183,4.3
"48451",48,451,2000,50754,48790,1964,3.9
"48451",48,451,2001,51330,49351,1979,3.9
"48451",48,451,2002,52183,49684,2499,4.8
"48451",48,451,2003,52791,50101,2690,5.1
"48451",48,451,2004,52101,49659,2442,4.7
"48451",48,451,2005,51839,49600,2239,4.3
"48451",48,451,2006,52123,49975,2148,4.1
"48451",48,451,2007,51711,49822,1889,3.7
"48451",48,451,2008,51656,49548,2108,4.1
"48451",48,451,2009,52792,49458,3334,6.3
"48451",48,451,2010,52595,49149,3446,6.6
"48451",48,451,2011,53262,49931,3331,6.3
"48451",48,451,2012,53790,50921,2869,5.3
"48451",48,451,2013,54242,51444,2798,5.2
"48451",48,451,2014,54668,52465,2203,4
"48451",48,451,2015,54503,52270,2233,4.1
"48451",48,451,2016,54152,51729,2423,4.5
"48451",48,451,2017,54003,52016,1987,3.7
"48453",48,453,1990,335174,318591,16583,4.9
"48453",48,453,1991,343861,327734,16127,4.7
"48453",48,453,1992,362733,346538,16195,4.5
"48453",48,453,1993,381622,366733,14889,3.9
"48453",48,453,1994,401101,386927,14174,3.5
"48453",48,453,1995,417895,404744,13151,3.1
"48453",48,453,1996,428045,414024,14021,3.3
"48453",48,453,1997,436973,423041,13932,3.2
"48453",48,453,1998,449531,436822,12709,2.8
"48453",48,453,1999,464021,453127,10894,2.3
"48453",48,453,2000,491981,477302,14679,3
"48453",48,453,2001,493452,471949,21503,4.4
"48453",48,453,2002,490142,460978,29164,6
"48453",48,453,2003,488352,459021,29331,6
"48453",48,453,2004,492613,467543,25070,5.1
"48453",48,453,2005,502123,479587,22536,4.5
"48453",48,453,2006,515190,494371,20819,4
"48453",48,453,2007,528962,510019,18943,3.6
"48453",48,453,2008,536895,514368,22527,4.2
"48453",48,453,2009,547413,510814,36599,6.7
"48453",48,453,2010,575630,536660,38970,6.8
"48453",48,453,2011,594040,556184,37856,6.4
"48453",48,453,2012,612264,578608,33656,5.5
"48453",48,453,2013,629919,598189,31730,5
"48453",48,453,2014,644428,618143,26285,4.1
"48453",48,453,2015,655166,633703,21463,3.3
"48453",48,453,2016,676998,655491,21507,3.2
"48453",48,453,2017,698755,677830,20925,3
"48455",48,455,1990,4440,4232,208,4.7
"48455",48,455,1991,4570,4310,260,5.7
"48455",48,455,1992,4837,4563,274,5.7
"48455",48,455,1993,4886,4576,310,6.3
"48455",48,455,1994,4996,4711,285,5.7
"48455",48,455,1995,4930,4652,278,5.6
"48455",48,455,1996,4775,4523,252,5.3
"48455",48,455,1997,4702,4456,246,5.2
"48455",48,455,1998,4781,4522,259,5.4
"48455",48,455,1999,5801,5495,306,5.3
"48455",48,455,2000,5764,5461,303,5.3
"48455",48,455,2001,5637,5308,329,5.8
"48455",48,455,2002,5707,5309,398,7
"48455",48,455,2003,5976,5546,430,7.2
"48455",48,455,2004,5977,5564,413,6.9
"48455",48,455,2005,5803,5436,367,6.3
"48455",48,455,2006,5751,5420,331,5.8
"48455",48,455,2007,5840,5563,277,4.7
"48455",48,455,2008,5793,5479,314,5.4
"48455",48,455,2009,5905,5405,500,8.5
"48455",48,455,2010,5783,5232,551,9.5
"48455",48,455,2011,5719,5173,546,9.5
"48455",48,455,2012,5574,5118,456,8.2
"48455",48,455,2013,5569,5153,416,7.5
"48455",48,455,2014,5524,5192,332,6
"48455",48,455,2015,5477,5155,322,5.9
"48455",48,455,2016,5472,5140,332,6.1
"48455",48,455,2017,5366,5070,296,5.5
"48457",48,457,1990,6528,6118,410,6.3
"48457",48,457,1991,6738,6229,509,7.6
"48457",48,457,1992,6833,6205,628,9.2
"48457",48,457,1993,7073,6313,760,10.7
"48457",48,457,1994,7289,6648,641,8.8
"48457",48,457,1995,7502,6917,585,7.8
"48457",48,457,1996,7118,6199,919,12.9
"48457",48,457,1997,6564,5875,689,10.5
"48457",48,457,1998,6465,5929,536,8.3
"48457",48,457,1999,6440,5862,578,9
"48457",48,457,2000,7930,7402,528,6.7
"48457",48,457,2001,8113,7526,587,7.2
"48457",48,457,2002,8407,7641,766,9.1
"48457",48,457,2003,8730,7916,814,9.3
"48457",48,457,2004,8524,7842,682,8
"48457",48,457,2005,8360,7747,613,7.3
"48457",48,457,2006,8194,7682,512,6.2
"48457",48,457,2007,8044,7607,437,5.4
"48457",48,457,2008,8239,7749,490,5.9
"48457",48,457,2009,8442,7620,822,9.7
"48457",48,457,2010,7904,6973,931,11.8
"48457",48,457,2011,7842,6898,944,12
"48457",48,457,2012,7580,6770,810,10.7
"48457",48,457,2013,7602,6822,780,10.3
"48457",48,457,2014,7576,6972,604,8
"48457",48,457,2015,7361,6846,515,7
"48457",48,457,2016,7200,6675,525,7.3
"48457",48,457,2017,7058,6542,516,7.3
"48459",48,459,1990,14084,13242,842,6
"48459",48,459,1991,14623,13513,1110,7.6
"48459",48,459,1992,14992,13770,1222,8.2
"48459",48,459,1993,15151,14056,1095,7.2
"48459",48,459,1994,15471,14579,892,5.8
"48459",48,459,1995,16007,14977,1030,6.4
"48459",48,459,1996,16152,15132,1020,6.3
"48459",48,459,1997,16736,15661,1075,6.4
"48459",48,459,1998,17000,15838,1162,6.8
"48459",48,459,1999,17040,15982,1058,6.2
"48459",48,459,2000,16521,15721,800,4.8
"48459",48,459,2001,16807,15936,871,5.2
"48459",48,459,2002,17228,16135,1093,6.3
"48459",48,459,2003,17682,16534,1148,6.5
"48459",48,459,2004,18383,17343,1040,5.7
"48459",48,459,2005,18761,17831,930,5
"48459",48,459,2006,18822,17962,860,4.6
"48459",48,459,2007,19147,18387,760,4
"48459",48,459,2008,19783,18953,830,4.2
"48459",48,459,2009,19653,18165,1488,7.6
"48459",48,459,2010,18283,16675,1608,8.8
"48459",48,459,2011,18615,17133,1482,8
"48459",48,459,2012,18727,17465,1262,6.7
"48459",48,459,2013,18538,17353,1185,6.4
"48459",48,459,2014,18577,17624,953,5.1
"48459",48,459,2015,17961,17019,942,5.2
"48459",48,459,2016,17862,16718,1144,6.4
"48459",48,459,2017,17613,16689,924,5.2
"48461",48,461,1990,1875,1827,48,2.6
"48461",48,461,1991,1924,1869,55,2.9
"48461",48,461,1992,1932,1813,119,6.2
"48461",48,461,1993,1914,1808,106,5.5
"48461",48,461,1994,1906,1816,90,4.7
"48461",48,461,1995,1869,1791,78,4.2
"48461",48,461,1996,1792,1730,62,3.5
"48461",48,461,1997,1658,1603,55,3.3
"48461",48,461,1998,1627,1533,94,5.8
"48461",48,461,1999,1574,1453,121,7.7
"48461",48,461,2000,1511,1439,72,4.8
"48461",48,461,2001,1569,1504,65,4.1
"48461",48,461,2002,1529,1445,84,5.5
"48461",48,461,2003,1548,1465,83,5.4
"48461",48,461,2004,1562,1489,73,4.7
"48461",48,461,2005,1678,1613,65,3.9
"48461",48,461,2006,1604,1544,60,3.7
"48461",48,461,2007,1661,1611,50,3
"48461",48,461,2008,1775,1720,55,3.1
"48461",48,461,2009,1817,1718,99,5.4
"48461",48,461,2010,1552,1457,95,6.1
"48461",48,461,2011,1571,1488,83,5.3
"48461",48,461,2012,1591,1527,64,4
"48461",48,461,2013,1710,1640,70,4.1
"48461",48,461,2014,1875,1815,60,3.2
"48461",48,461,2015,1783,1713,70,3.9
"48461",48,461,2016,1578,1494,84,5.3
"48461",48,461,2017,1543,1484,59,3.8
"48463",48,463,1990,10817,9470,1347,12.5
"48463",48,463,1991,10590,9380,1210,11.4
"48463",48,463,1992,10315,8834,1481,14.4
"48463",48,463,1993,10397,9122,1275,12.3
"48463",48,463,1994,10675,9456,1219,11.4
"48463",48,463,1995,10935,9650,1285,11.8
"48463",48,463,1996,10986,9717,1269,11.6
"48463",48,463,1997,10750,9456,1294,12
"48463",48,463,1998,11314,10147,1167,10.3
"48463",48,463,1999,11016,10126,890,8.1
"48463",48,463,2000,11392,10748,644,5.7
"48463",48,463,2001,11357,10626,731,6.4
"48463",48,463,2002,11695,10833,862,7.4
"48463",48,463,2003,12068,11145,923,7.6
"48463",48,463,2004,12089,11245,844,7
"48463",48,463,2005,11690,10980,710,6.1
"48463",48,463,2006,11350,10678,672,5.9
"48463",48,463,2007,10957,10386,571,5.2
"48463",48,463,2008,11154,10520,634,5.7
"48463",48,463,2009,11591,10674,917,7.9
"48463",48,463,2010,11826,10769,1057,8.9
"48463",48,463,2011,12144,11066,1078,8.9
"48463",48,463,2012,11952,11004,948,7.9
"48463",48,463,2013,11949,11114,835,7
"48463",48,463,2014,11685,11021,664,5.7
"48463",48,463,2015,11671,11084,587,5
"48463",48,463,2016,11786,11161,625,5.3
"48463",48,463,2017,11714,11168,546,4.7
"48465",48,465,1990,15133,13156,1977,13.1
"48465",48,465,1991,15916,13741,2175,13.7
"48465",48,465,1992,17195,14696,2499,14.5
"48465",48,465,1993,17482,15280,2202,12.6
"48465",48,465,1994,18192,16020,2172,11.9
"48465",48,465,1995,18142,16135,2007,11.1
"48465",48,465,1996,18121,15946,2175,12
"48465",48,465,1997,17465,15487,1978,11.3
"48465",48,465,1998,17866,16165,1701,9.5
"48465",48,465,1999,18129,16596,1533,8.5
"48465",48,465,2000,17348,16270,1078,6.2
"48465",48,465,2001,17712,16608,1104,6.2
"48465",48,465,2002,18864,17517,1347,7.1
"48465",48,465,2003,19479,17952,1527,7.8
"48465",48,465,2004,19658,18271,1387,7.1
"48465",48,465,2005,20042,18733,1309,6.5
"48465",48,465,2006,20210,19009,1201,5.9
"48465",48,465,2007,20220,19130,1090,5.4
"48465",48,465,2008,20417,19243,1174,5.8
"48465",48,465,2009,20998,19063,1935,9.2
"48465",48,465,2010,20619,18704,1915,9.3
"48465",48,465,2011,20461,18625,1836,9
"48465",48,465,2012,20013,18489,1524,7.6
"48465",48,465,2013,19633,18180,1453,7.4
"48465",48,465,2014,19384,18271,1113,5.7
"48465",48,465,2015,19556,18383,1173,6
"48465",48,465,2016,20102,18847,1255,6.2
"48465",48,465,2017,20007,18991,1016,5.1
"48467",48,467,1990,16553,15608,945,5.7
"48467",48,467,1991,17465,16272,1193,6.8
"48467",48,467,1992,17791,16556,1235,6.9
"48467",48,467,1993,18240,17103,1137,6.2
"48467",48,467,1994,18709,17821,888,4.7
"48467",48,467,1995,19164,18394,770,4
"48467",48,467,1996,19477,18718,759,3.9
"48467",48,467,1997,19599,18757,842,4.3
"48467",48,467,1998,19881,19049,832,4.2
"48467",48,467,1999,20470,19785,685,3.3
"48467",48,467,2000,22609,21721,888,3.9
"48467",48,467,2001,23118,22078,1040,4.5
"48467",48,467,2002,24207,22795,1412,5.8
"48467",48,467,2003,24893,23379,1514,6.1
"48467",48,467,2004,24971,23622,1349,5.4
"48467",48,467,2005,25337,24068,1269,5
"48467",48,467,2006,25197,24056,1141,4.5
"48467",48,467,2007,25331,24354,977,3.9
"48467",48,467,2008,25539,24430,1109,4.3
"48467",48,467,2009,25941,24141,1800,6.9
"48467",48,467,2010,23601,21620,1981,8.4
"48467",48,467,2011,23741,21848,1893,8
"48467",48,467,2012,23620,21982,1638,6.9
"48467",48,467,2013,23851,22295,1556,6.5
"48467",48,467,2014,23901,22639,1262,5.3
"48467",48,467,2015,24191,23105,1086,4.5
"48467",48,467,2016,24809,23741,1068,4.3
"48467",48,467,2017,25311,24368,943,3.7
"48469",48,469,1990,36301,34655,1646,4.5
"48469",48,469,1991,38691,36951,1740,4.5
"48469",48,469,1992,39963,37551,2412,6
"48469",48,469,1993,40809,38540,2269,5.6
"48469",48,469,1994,42119,39621,2498,5.9
"48469",48,469,1995,41824,39266,2558,6.1
"48469",48,469,1996,42033,39890,2143,5.1
"48469",48,469,1997,43317,41167,2150,5
"48469",48,469,1998,43310,41315,1995,4.6
"48469",48,469,1999,43261,41438,1823,4.2
"48469",48,469,2000,43154,41566,1588,3.7
"48469",48,469,2001,43189,41359,1830,4.2
"48469",48,469,2002,43407,40989,2418,5.6
"48469",48,469,2003,43450,40948,2502,5.8
"48469",48,469,2004,43302,41052,2250,5.2
"48469",48,469,2005,43899,41913,1986,4.5
"48469",48,469,2006,44317,42524,1793,4
"48469",48,469,2007,44439,42916,1523,3.4
"48469",48,469,2008,45203,43500,1703,3.8
"48469",48,469,2009,45385,42248,3137,6.9
"48469",48,469,2010,43079,39778,3301,7.7
"48469",48,469,2011,43741,40791,2950,6.7
"48469",48,469,2012,45250,42723,2527,5.6
"48469",48,469,2013,45837,43393,2444,5.3
"48469",48,469,2014,46261,44338,1923,4.2
"48469",48,469,2015,45297,43402,1895,4.2
"48469",48,469,2016,43635,41270,2365,5.4
"48469",48,469,2017,42923,40853,2070,4.8
"48471",48,471,1990,19731,18826,905,4.6
"48471",48,471,1991,19861,19170,691,3.5
"48471",48,471,1992,20608,19925,683,3.3
"48471",48,471,1993,20782,20118,664,3.2
"48471",48,471,1994,22083,21502,581,2.6
"48471",48,471,1995,22640,22086,554,2.4
"48471",48,471,1996,22561,21971,590,2.6
"48471",48,471,1997,23339,22745,594,2.5
"48471",48,471,1998,23289,22777,512,2.2
"48471",48,471,1999,23469,22958,511,2.2
"48471",48,471,2000,25139,23980,1159,4.6
"48471",48,471,2001,25037,23721,1316,5.3
"48471",48,471,2002,25569,24081,1488,5.8
"48471",48,471,2003,26041,24335,1706,6.6
"48471",48,471,2004,26132,24580,1552,5.9
"48471",48,471,2005,26030,24571,1459,5.6
"48471",48,471,2006,26213,24817,1396,5.3
"48471",48,471,2007,25823,24613,1210,4.7
"48471",48,471,2008,26305,24943,1362,5.2
"48471",48,471,2009,27669,25736,1933,7
"48471",48,471,2010,23234,21436,1798,7.7
"48471",48,471,2011,23171,21352,1819,7.9
"48471",48,471,2012,23153,21545,1608,6.9
"48471",48,471,2013,23123,21594,1529,6.6
"48471",48,471,2014,23156,21899,1257,5.4
"48471",48,471,2015,22959,21799,1160,5.1
"48471",48,471,2016,23743,22499,1244,5.2
"48471",48,471,2017,23625,22536,1089,4.6
"48473",48,473,1990,10772,10231,541,5
"48473",48,473,1991,10941,10394,547,5
"48473",48,473,1992,10975,10410,565,5.1
"48473",48,473,1993,11169,10636,533,4.8
"48473",48,473,1994,11593,11056,537,4.6
"48473",48,473,1995,11629,11015,614,5.3
"48473",48,473,1996,11892,11330,562,4.7
"48473",48,473,1997,12243,11616,627,5.1
"48473",48,473,1998,12530,11980,550,4.4
"48473",48,473,1999,12906,12225,681,5.3
"48473",48,473,2000,15332,14662,670,4.4
"48473",48,473,2001,15428,14741,687,4.5
"48473",48,473,2002,15833,14898,935,5.9
"48473",48,473,2003,16084,15026,1058,6.6
"48473",48,473,2004,15891,14907,984,6.2
"48473",48,473,2005,15833,14961,872,5.5
"48473",48,473,2006,15701,14872,829,5.3
"48473",48,473,2007,16028,15312,716,4.5
"48473",48,473,2008,16157,15356,801,5
"48473",48,473,2009,16440,15085,1355,8.2
"48473",48,473,2010,19960,18234,1726,8.6
"48473",48,473,2011,20344,18677,1667,8.2
"48473",48,473,2012,20499,19065,1434,7
"48473",48,473,2013,20839,19492,1347,6.5
"48473",48,473,2014,21320,20231,1089,5.1
"48473",48,473,2015,21643,20606,1037,4.8
"48473",48,473,2016,22130,20895,1235,5.6
"48473",48,473,2017,22201,21120,1081,4.9
"48475",48,475,1990,5398,5064,334,6.2
"48475",48,475,1991,5300,5001,299,5.6
"48475",48,475,1992,4990,4483,507,10.2
"48475",48,475,1993,4791,4344,447,9.3
"48475",48,475,1994,4772,4362,410,8.6
"48475",48,475,1995,4607,4294,313,6.8
"48475",48,475,1996,4456,4168,288,6.5
"48475",48,475,1997,4499,4204,295,6.6
"48475",48,475,1998,4701,4325,376,8
"48475",48,475,1999,4357,3843,514,11.8
"48475",48,475,2000,4454,4179,275,6.2
"48475",48,475,2001,4469,4218,251,5.6
"48475",48,475,2002,4398,4062,336,7.6
"48475",48,475,2003,4406,4078,328,7.4
"48475",48,475,2004,4385,4103,282,6.4
"48475",48,475,2005,4464,4220,244,5.5
"48475",48,475,2006,4718,4501,217,4.6
"48475",48,475,2007,4860,4682,178,3.7
"48475",48,475,2008,5071,4874,197,3.9
"48475",48,475,2009,5033,4591,442,8.8
"48475",48,475,2010,4631,4239,392,8.5
"48475",48,475,2011,4940,4619,321,6.5
"48475",48,475,2012,5356,5098,258,4.8
"48475",48,475,2013,5520,5261,259,4.7
"48475",48,475,2014,5922,5710,212,3.6
"48475",48,475,2015,5908,5655,253,4.3
"48475",48,475,2016,5385,5078,307,5.7
"48475",48,475,2017,5546,5321,225,4.1
"48477",48,477,1990,12840,12421,419,3.3
"48477",48,477,1991,13122,12764,358,2.7
"48477",48,477,1992,13382,12981,401,3
"48477",48,477,1993,13614,13195,419,3.1
"48477",48,477,1994,14126,13694,432,3.1
"48477",48,477,1995,14666,14228,438,3
"48477",48,477,1996,14972,14556,416,2.8
"48477",48,477,1997,14915,14509,406,2.7
"48477",48,477,1998,15021,14647,374,2.5
"48477",48,477,1999,14916,14509,407,2.7
"48477",48,477,2000,15100,14544,556,3.7
"48477",48,477,2001,15178,14626,552,3.6
"48477",48,477,2002,15545,14836,709,4.6
"48477",48,477,2003,16020,15179,841,5.2
"48477",48,477,2004,15888,15093,795,5
"48477",48,477,2005,16168,15430,738,4.6
"48477",48,477,2006,16031,15358,673,4.2
"48477",48,477,2007,16030,15447,583,3.6
"48477",48,477,2008,16370,15725,645,3.9
"48477",48,477,2009,16966,15944,1022,6
"48477",48,477,2010,15561,14439,1122,7.2
"48477",48,477,2011,15682,14646,1036,6.6
"48477",48,477,2012,15646,14766,880,5.6
"48477",48,477,2013,15728,14867,861,5.5
"48477",48,477,2014,15700,14979,721,4.6
"48477",48,477,2015,15347,14617,730,4.8
"48477",48,477,2016,15054,14290,764,5.1
"48477",48,477,2017,14856,14229,627,4.2
"48479",48,479,1990,55453,48777,6676,12
"48479",48,479,1991,58345,51817,6528,11.2
"48479",48,479,1992,61563,54800,6763,11
"48479",48,479,1993,64696,57902,6794,10.5
"48479",48,479,1994,68262,61642,6620,9.7
"48479",48,479,1995,70569,59679,10890,15.4
"48479",48,479,1996,69207,60315,8892,12.8
"48479",48,479,1997,70556,63257,7299,10.3
"48479",48,479,1998,72462,65627,6835,9.4
"48479",48,479,1999,72932,66647,6285,8.6
"48479",48,479,2000,70985,66705,4280,6
"48479",48,479,2001,73104,68340,4764,6.5
"48479",48,479,2002,78022,72359,5663,7.3
"48479",48,479,2003,81198,75249,5949,7.3
"48479",48,479,2004,83109,77585,5524,6.6
"48479",48,479,2005,85624,80484,5140,6
"48479",48,479,2006,87892,83168,4724,5.4
"48479",48,479,2007,89295,85129,4166,4.7
"48479",48,479,2008,92361,87472,4889,5.3
"48479",48,479,2009,94138,86110,8028,8.5
"48479",48,479,2010,105016,96364,8652,8.2
"48479",48,479,2011,107892,99885,8007,7.4
"48479",48,479,2012,109145,102072,7073,6.5
"48479",48,479,2013,110366,103601,6765,6.1
"48479",48,479,2014,111193,105546,5647,5.1
"48479",48,479,2015,111696,106415,5281,4.7
"48479",48,479,2016,113642,108086,5556,4.9
"48479",48,479,2017,114696,109922,4774,4.2
"48481",48,481,1990,19070,18289,781,4.1
"48481",48,481,1991,18567,17644,923,5
"48481",48,481,1992,19580,18268,1312,6.7
"48481",48,481,1993,19448,18034,1414,7.3
"48481",48,481,1994,19424,18110,1314,6.8
"48481",48,481,1995,19521,18249,1272,6.5
"48481",48,481,1996,19269,18051,1218,6.3
"48481",48,481,1997,19052,17889,1163,6.1
"48481",48,481,1998,19076,18017,1059,5.6
"48481",48,481,1999,19379,18323,1056,5.4
"48481",48,481,2000,20207,19347,860,4.3
"48481",48,481,2001,20379,19444,935,4.6
"48481",48,481,2002,20639,19444,1195,5.8
"48481",48,481,2003,21463,20142,1321,6.2
"48481",48,481,2004,21401,20198,1203,5.6
"48481",48,481,2005,20740,19685,1055,5.1
"48481",48,481,2006,20548,19572,976,4.7
"48481",48,481,2007,20580,19730,850,4.1
"48481",48,481,2008,20875,19969,906,4.3
"48481",48,481,2009,21209,19729,1480,7
"48481",48,481,2010,21279,19431,1848,8.7
"48481",48,481,2011,21498,19723,1775,8.3
"48481",48,481,2012,21437,19987,1450,6.8
"48481",48,481,2013,21509,20226,1283,6
"48481",48,481,2014,21574,20569,1005,4.7
"48481",48,481,2015,21213,20278,935,4.4
"48481",48,481,2016,21033,19976,1057,5
"48481",48,481,2017,21054,20114,940,4.5
"48483",48,483,1990,2750,2679,71,2.6
"48483",48,483,1991,2673,2556,117,4.4
"48483",48,483,1992,2761,2589,172,6.2
"48483",48,483,1993,2677,2556,121,4.5
"48483",48,483,1994,2767,2661,106,3.8
"48483",48,483,1995,2820,2712,108,3.8
"48483",48,483,1996,2879,2756,123,4.3
"48483",48,483,1997,2833,2754,79,2.8
"48483",48,483,1998,2795,2703,92,3.3
"48483",48,483,1999,2753,2633,120,4.4
"48483",48,483,2000,2708,2603,105,3.9
"48483",48,483,2001,2725,2621,104,3.8
"48483",48,483,2002,2759,2633,126,4.6
"48483",48,483,2003,2802,2685,117,4.2
"48483",48,483,2004,2795,2689,106,3.8
"48483",48,483,2005,2676,2571,105,3.9
"48483",48,483,2006,2803,2711,92,3.3
"48483",48,483,2007,3052,2976,76,2.5
"48483",48,483,2008,3391,3310,81,2.4
"48483",48,483,2009,3212,3030,182,5.7
"48483",48,483,2010,2732,2565,167,6.1
"48483",48,483,2011,2856,2715,141,4.9
"48483",48,483,2012,2895,2769,126,4.4
"48483",48,483,2013,3137,3002,135,4.3
"48483",48,483,2014,3082,2972,110,3.6
"48483",48,483,2015,2819,2710,109,3.9
"48483",48,483,2016,2477,2360,117,4.7
"48483",48,483,2017,2357,2261,96,4.1
"48485",48,485,1990,57020,53202,3818,6.7
"48485",48,485,1991,56579,52586,3993,7.1
"48485",48,485,1992,56658,52881,3777,6.7
"48485",48,485,1993,57998,54677,3321,5.7
"48485",48,485,1994,59073,55917,3156,5.3
"48485",48,485,1995,60560,57623,2937,4.8
"48485",48,485,1996,61471,58587,2884,4.7
"48485",48,485,1997,61745,58976,2769,4.5
"48485",48,485,1998,61420,58402,3018,4.9
"48485",48,485,1999,60137,57249,2888,4.8
"48485",48,485,2000,60999,58206,2793,4.6
"48485",48,485,2001,62011,59231,2780,4.5
"48485",48,485,2002,62819,59108,3711,5.9
"48485",48,485,2003,63130,59368,3762,6
"48485",48,485,2004,62691,59474,3217,5.1
"48485",48,485,2005,62488,59542,2946,4.7
"48485",48,485,2006,62656,59938,2718,4.3
"48485",48,485,2007,61745,59170,2575,4.2
"48485",48,485,2008,61098,58148,2950,4.8
"48485",48,485,2009,61406,56779,4627,7.5
"48485",48,485,2010,59280,54681,4599,7.8
"48485",48,485,2011,59026,54960,4066,6.9
"48485",48,485,2012,58468,54914,3554,6.1
"48485",48,485,2013,57339,53984,3355,5.9
"48485",48,485,2014,56512,53760,2752,4.9
"48485",48,485,2015,55280,52914,2366,4.3
"48485",48,485,2016,55367,52960,2407,4.3
"48485",48,485,2017,55970,53903,2067,3.7
"48487",48,487,1990,7146,6846,300,4.2
"48487",48,487,1991,7190,6775,415,5.8
"48487",48,487,1992,7322,6956,366,5
"48487",48,487,1993,7281,7013,268,3.7
"48487",48,487,1994,7226,6937,289,4
"48487",48,487,1995,7218,6957,261,3.6
"48487",48,487,1996,7129,6804,325,4.6
"48487",48,487,1997,7118,6864,254,3.6
"48487",48,487,1998,7237,7000,237,3.3
"48487",48,487,1999,7427,7240,187,2.5
"48487",48,487,2000,7233,6963,270,3.7
"48487",48,487,2001,7334,7062,272,3.7
"48487",48,487,2002,7427,7081,346,4.7
"48487",48,487,2003,7540,7167,373,4.9
"48487",48,487,2004,7407,7088,319,4.3
"48487",48,487,2005,7518,7228,290,3.9
"48487",48,487,2006,7870,7589,281,3.6
"48487",48,487,2007,7660,7403,257,3.4
"48487",48,487,2008,7587,7320,267,3.5
"48487",48,487,2009,7874,7504,370,4.7
"48487",48,487,2010,6140,5657,483,7.9
"48487",48,487,2011,6039,5601,438,7.3
"48487",48,487,2012,5924,5568,356,6
"48487",48,487,2013,5779,5445,334,5.8
"48487",48,487,2014,5296,5036,260,4.9
"48487",48,487,2015,5105,4859,246,4.8
"48487",48,487,2016,5039,4802,237,4.7
"48487",48,487,2017,4950,4718,232,4.7
"48489",48,489,1990,7204,6002,1202,16.7
"48489",48,489,1991,7096,5813,1283,18.1
"48489",48,489,1992,7527,5914,1613,21.4
"48489",48,489,1993,7393,5706,1687,22.8
"48489",48,489,1994,7661,5995,1666,21.7
"48489",48,489,1995,7667,6050,1617,21.1
"48489",48,489,1996,7691,6055,1636,21.3
"48489",48,489,1997,7421,5791,1630,22
"48489",48,489,1998,7363,5808,1555,21.1
"48489",48,489,1999,6913,5757,1156,16.7
"48489",48,489,2000,7288,6574,714,9.8
"48489",48,489,2001,7230,6443,787,10.9
"48489",48,489,2002,7278,6362,916,12.6
"48489",48,489,2003,7632,6731,901,11.8
"48489",48,489,2004,7385,6557,828,11.2
"48489",48,489,2005,7521,6807,714,9.5
"48489",48,489,2006,7619,6930,689,9
"48489",48,489,2007,7539,6932,607,8.1
"48489",48,489,2008,7705,7027,678,8.8
"48489",48,489,2009,8388,7388,1000,11.9
"48489",48,489,2010,7781,6656,1125,14.5
"48489",48,489,2011,7721,6450,1271,16.5
"48489",48,489,2012,7428,6254,1174,15.8
"48489",48,489,2013,7436,6263,1173,15.8
"48489",48,489,2014,7171,6283,888,12.4
"48489",48,489,2015,6741,5863,878,13
"48489",48,489,2016,6489,5695,794,12.2
"48489",48,489,2017,6303,5609,694,11
"48491",48,491,1990,78524,75169,3355,4.3
"48491",48,491,1991,81396,78546,2850,3.5
"48491",48,491,1992,87099,84365,2734,3.1
"48491",48,491,1993,94245,91794,2451,2.6
"48491",48,491,1994,103041,101012,2029,2
"48491",48,491,1995,110528,108397,2131,1.9
"48491",48,491,1996,119574,117214,2360,2
"48491",48,491,1997,127761,125130,2631,2.1
"48491",48,491,1998,136637,134001,2636,1.9
"48491",48,491,1999,148450,146034,2416,1.6
"48491",48,491,2000,145239,141290,3949,2.7
"48491",48,491,2001,153827,147548,6279,4.1
"48491",48,491,2002,159667,150689,8978,5.6
"48491",48,491,2003,164784,155457,9327,5.7
"48491",48,491,2004,170837,162914,7923,4.6
"48491",48,491,2005,179531,171343,8188,4.6
"48491",48,491,2006,188614,180737,7877,4.2
"48491",48,491,2007,193070,185976,7094,3.7
"48491",48,491,2008,202236,193231,9005,4.5
"48491",48,491,2009,209947,194545,15402,7.3
"48491",48,491,2010,222584,206458,16126,7.2
"48491",48,491,2011,230895,215239,15656,6.8
"48491",48,491,2012,237421,223585,13836,5.8
"48491",48,491,2013,246626,233607,13019,5.3
"48491",48,491,2014,255361,244237,11124,4.4
"48491",48,491,2015,263790,254693,9097,3.4
"48491",48,491,2016,278109,268782,9327,3.4
"48491",48,491,2017,287330,278071,9259,3.2
"48493",48,493,1990,10407,9983,424,4.1
"48493",48,493,1991,10612,10157,455,4.3
"48493",48,493,1992,11078,10581,497,4.5
"48493",48,493,1993,11527,11127,400,3.5
"48493",48,493,1994,12303,11923,380,3.1
"48493",48,493,1995,13215,12809,406,3.1
"48493",48,493,1996,13800,13412,388,2.8
"48493",48,493,1997,14674,14245,429,2.9
"48493",48,493,1998,15058,14609,449,3
"48493",48,493,1999,15678,15269,409,2.6
"48493",48,493,2000,15531,14970,561,3.6
"48493",48,493,2001,15863,15196,667,4.2
"48493",48,493,2002,16403,15544,859,5.2
"48493",48,493,2003,16894,15935,959,5.7
"48493",48,493,2004,17301,16433,868,5
"48493",48,493,2005,17687,16840,847,4.8
"48493",48,493,2006,18229,17428,801,4.4
"48493",48,493,2007,18150,17416,734,4
"48493",48,493,2008,18724,17866,858,4.6
"48493",48,493,2009,18901,17673,1228,6.5
"48493",48,493,2010,21235,19785,1450,6.8
"48493",48,493,2011,21547,20142,1405,6.5
"48493",48,493,2012,21732,20528,1204,5.5
"48493",48,493,2013,22213,21045,1168,5.3
"48493",48,493,2014,22549,21613,936,4.2
"48493",48,493,2015,22955,22085,870,3.8
"48493",48,493,2016,23708,22782,926,3.9
"48493",48,493,2017,24155,23320,835,3.5
"48495",48,495,1990,3427,3249,178,5.2
"48495",48,495,1991,3482,3273,209,6
"48495",48,495,1992,3564,3198,366,10.3
"48495",48,495,1993,3363,3048,315,9.4
"48495",48,495,1994,3158,2811,347,11
"48495",48,495,1995,3066,2825,241,7.9
"48495",48,495,1996,3024,2792,232,7.7
"48495",48,495,1997,3067,2849,218,7.1
"48495",48,495,1998,3152,2862,290,9.2
"48495",48,495,1999,3052,2634,418,13.7
"48495",48,495,2000,2934,2768,166,5.7
"48495",48,495,2001,2942,2779,163,5.5
"48495",48,495,2002,2995,2734,261,8.7
"48495",48,495,2003,3066,2839,227,7.4
"48495",48,495,2004,3072,2886,186,6.1
"48495",48,495,2005,3034,2890,144,4.7
"48495",48,495,2006,3213,3088,125,3.9
"48495",48,495,2007,3341,3236,105,3.1
"48495",48,495,2008,3454,3325,129,3.7
"48495",48,495,2009,3411,3093,318,9.3
"48495",48,495,2010,2898,2632,266,9.2
"48495",48,495,2011,3051,2834,217,7.1
"48495",48,495,2012,3186,3006,180,5.6
"48495",48,495,2013,3322,3147,175,5.3
"48495",48,495,2014,3286,3142,144,4.4
"48495",48,495,2015,3100,2924,176,5.7
"48495",48,495,2016,3064,2828,236,7.7
"48495",48,495,2017,3235,3066,169,5.2
"48497",48,497,1990,15890,15191,699,4.4
"48497",48,497,1991,16389,15405,984,6
"48497",48,497,1992,17416,16325,1091,6.3
"48497",48,497,1993,17970,17041,929,5.2
"48497",48,497,1994,18819,17971,848,4.5
"48497",48,497,1995,19818,18982,836,4.2
"48497",48,497,1996,20578,19864,714,3.5
"48497",48,497,1997,21425,20738,687,3.2
"48497",48,497,1998,22955,22225,730,3.2
"48497",48,497,1999,23426,22745,681,2.9
"48497",48,497,2000,25344,24477,867,3.4
"48497",48,497,2001,25871,24820,1051,4.1
"48497",48,497,2002,26364,24943,1421,5.4
"48497",48,497,2003,26768,25215,1553,5.8
"48497",48,497,2004,27104,25711,1393,5.1
"48497",48,497,2005,27596,26298,1298,4.7
"48497",48,497,2006,27861,26648,1213,4.4
"48497",48,497,2007,27323,26194,1129,4.1
"48497",48,497,2008,27517,26332,1185,4.3
"48497",48,497,2009,28244,25790,2454,8.7
"48497",48,497,2010,27668,25269,2399,8.7
"48497",48,497,2011,28152,26022,2130,7.6
"48497",48,497,2012,28255,26432,1823,6.5
"48497",48,497,2013,28410,26707,1703,6
"48497",48,497,2014,28492,27104,1388,4.9
"48497",48,497,2015,28650,27323,1327,4.6
"48497",48,497,2016,29372,27985,1387,4.7
"48497",48,497,2017,29844,28659,1185,4
"48499",48,499,1990,12679,11944,735,5.8
"48499",48,499,1991,13167,12303,864,6.6
"48499",48,499,1992,13898,12950,948,6.8
"48499",48,499,1993,14266,13361,905,6.3
"48499",48,499,1994,14274,13403,871,6.1
"48499",48,499,1995,13926,13158,768,5.5
"48499",48,499,1996,14363,13502,861,6
"48499",48,499,1997,13555,12754,801,5.9
"48499",48,499,1998,13720,12956,764,5.6
"48499",48,499,1999,13960,13267,693,5
"48499",48,499,2000,16282,15468,814,5
"48499",48,499,2001,16380,15481,899,5.5
"48499",48,499,2002,16943,15857,1086,6.4
"48499",48,499,2003,17479,16312,1167,6.7
"48499",48,499,2004,17433,16376,1057,6.1
"48499",48,499,2005,17600,16625,975,5.5
"48499",48,499,2006,17846,16942,904,5.1
"48499",48,499,2007,17919,17119,800,4.5
"48499",48,499,2008,18054,17148,906,5
"48499",48,499,2009,18606,17120,1486,8
"48499",48,499,2010,16969,15432,1537,9.1
"48499",48,499,2011,16973,15506,1467,8.6
"48499",48,499,2012,16735,15420,1315,7.9
"48499",48,499,2013,16725,15507,1218,7.3
"48499",48,499,2014,16768,15769,999,6
"48499",48,499,2015,16746,15860,886,5.3
"48499",48,499,2016,17209,16305,904,5.3
"48499",48,499,2017,17323,16512,811,4.7
"48501",48,501,1990,3929,3807,122,3.1
"48501",48,501,1991,4134,3985,149,3.6
"48501",48,501,1992,3959,3678,281,7.1
"48501",48,501,1993,3847,3582,265,6.9
"48501",48,501,1994,3816,3595,221,5.8
"48501",48,501,1995,3699,3497,202,5.5
"48501",48,501,1996,3709,3512,197,5.3
"48501",48,501,1997,3414,3221,193,5.7
"48501",48,501,1998,3439,3198,241,7
"48501",48,501,1999,3567,3217,350,9.8
"48501",48,501,2000,3317,3144,173,5.2
"48501",48,501,2001,3503,3353,150,4.3
"48501",48,501,2002,3289,3111,178,5.4
"48501",48,501,2003,3401,3216,185,5.4
"48501",48,501,2004,3311,3144,167,5
"48501",48,501,2005,3285,3132,153,4.7
"48501",48,501,2006,3579,3438,141,3.9
"48501",48,501,2007,3874,3749,125,3.2
"48501",48,501,2008,4085,3961,124,3
"48501",48,501,2009,4101,3789,312,7.6
"48501",48,501,2010,3690,3433,257,7
"48501",48,501,2011,4165,3948,217,5.2
"48501",48,501,2012,4336,4162,174,4
"48501",48,501,2013,4214,4051,163,3.9
"48501",48,501,2014,4294,4165,129,3
"48501",48,501,2015,4043,3891,152,3.8
"48501",48,501,2016,3753,3574,179,4.8
"48501",48,501,2017,3818,3683,135,3.5
"48503",48,503,1990,8599,8309,290,3.4
"48503",48,503,1991,8743,8245,498,5.7
"48503",48,503,1992,8846,8158,688,7.8
"48503",48,503,1993,8926,8295,631,7.1
"48503",48,503,1994,8730,7967,763,8.7
"48503",48,503,1995,8749,8124,625,7.1
"48503",48,503,1996,8498,7904,594,7
"48503",48,503,1997,8369,7824,545,6.5
"48503",48,503,1998,8294,7779,515,6.2
"48503",48,503,1999,8243,7800,443,5.4
"48503",48,503,2000,8843,8406,437,4.9
"48503",48,503,2001,8750,8320,430,4.9
"48503",48,503,2002,8910,8388,522,5.9
"48503",48,503,2003,8959,8425,534,6
"48503",48,503,2004,9011,8550,461,5.1
"48503",48,503,2005,9348,8952,396,4.2
"48503",48,503,2006,9655,9289,366,3.8
"48503",48,503,2007,9541,9236,305,3.2
"48503",48,503,2008,9811,9476,335,3.4
"48503",48,503,2009,9671,9048,623,6.4
"48503",48,503,2010,8646,7982,664,7.7
"48503",48,503,2011,8593,7978,615,7.2
"48503",48,503,2012,8570,8081,489,5.7
"48503",48,503,2013,8574,8132,442,5.2
"48503",48,503,2014,8671,8318,353,4.1
"48503",48,503,2015,8462,8102,360,4.3
"48503",48,503,2016,8293,7930,363,4.4
"48503",48,503,2017,8082,7776,306,3.8
"48505",48,505,1990,3000,2616,384,12.8
"48505",48,505,1991,3200,2749,451,14.1
"48505",48,505,1992,3473,2853,620,17.9
"48505",48,505,1993,3626,3025,601,16.6
"48505",48,505,1994,3938,3350,588,14.9
"48505",48,505,1995,4260,3734,526,12.3
"48505",48,505,1996,4427,4024,403,9.1
"48505",48,505,1997,4117,3720,397,9.6
"48505",48,505,1998,4673,4139,534,11.4
"48505",48,505,1999,4560,3951,609,13.4
"48505",48,505,2000,3984,3667,317,8
"48505",48,505,2001,4152,3852,300,7.2
"48505",48,505,2002,4461,4072,389,8.7
"48505",48,505,2003,4710,4297,413,8.8
"48505",48,505,2004,4886,4533,353,7.2
"48505",48,505,2005,5061,4724,337,6.7
"48505",48,505,2006,4916,4617,299,6.1
"48505",48,505,2007,4943,4682,261,5.3
"48505",48,505,2008,5162,4879,283,5.5
"48505",48,505,2009,5326,4748,578,10.9
"48505",48,505,2010,5761,5162,599,10.4
"48505",48,505,2011,6467,5944,523,8.1
"48505",48,505,2012,6819,6387,432,6.3
"48505",48,505,2013,7064,6624,440,6.2
"48505",48,505,2014,6939,6579,360,5.2
"48505",48,505,2015,6185,5713,472,7.6
"48505",48,505,2016,5197,4638,559,10.8
"48505",48,505,2017,5445,5045,400,7.3
"48507",48,507,1990,4716,3736,980,20.8
"48507",48,507,1991,4695,3685,1010,21.5
"48507",48,507,1992,4805,3556,1249,26
"48507",48,507,1993,4728,3586,1142,24.2
"48507",48,507,1994,4798,3562,1236,25.8
"48507",48,507,1995,4669,3477,1192,25.5
"48507",48,507,1996,4482,3421,1061,23.7
"48507",48,507,1997,4282,3231,1051,24.5
"48507",48,507,1998,4369,3438,931,21.3
"48507",48,507,1999,4203,3470,733,17.4
"48507",48,507,2000,3713,3255,458,12.3
"48507",48,507,2001,3746,3251,495,13.2
"48507",48,507,2002,3929,3362,567,14.4
"48507",48,507,2003,4192,3615,577,13.8
"48507",48,507,2004,4014,3516,498,12.4
"48507",48,507,2005,3846,3401,445,11.6
"48507",48,507,2006,3749,3311,438,11.7
"48507",48,507,2007,3713,3322,391,10.5
"48507",48,507,2008,3642,3257,385,10.6
"48507",48,507,2009,3922,3354,568,14.5
"48507",48,507,2010,4557,3924,633,13.9
"48507",48,507,2011,4590,3944,646,14.1
"48507",48,507,2012,4390,3797,593,13.5
"48507",48,507,2013,4011,3430,581,14.5
"48507",48,507,2014,3898,3425,473,12.1
"48507",48,507,2015,3804,3379,425,11.2
"48507",48,507,2016,3878,3340,538,13.9
"48507",48,507,2017,3719,3306,413,11.1
"49001",49,1,1990,1863,1787,76,4.1
"49001",49,1,1991,2009,1923,86,4.3
"49001",49,1,1992,2040,1939,101,5
"49001",49,1,1993,2135,2034,101,4.7
"49001",49,1,1994,2203,2117,86,3.9
"49001",49,1,1995,2348,2254,94,4
"49001",49,1,1996,2500,2370,130,5.2
"49001",49,1,1997,2554,2431,123,4.8
"49001",49,1,1998,2504,2384,120,4.8
"49001",49,1,1999,2461,2371,90,3.7
"49001",49,1,2000,2703,2610,93,3.4
"49001",49,1,2001,2976,2861,115,3.9
"49001",49,1,2002,3093,2949,144,4.7
"49001",49,1,2003,2945,2791,154,5.2
"49001",49,1,2004,3043,2907,136,4.5
"49001",49,1,2005,3071,2944,127,4.1
"49001",49,1,2006,3119,3024,95,3
"49001",49,1,2007,3175,3095,80,2.5
"49001",49,1,2008,3118,3010,108,3.5
"49001",49,1,2009,3550,3332,218,6.1
"49001",49,1,2010,3157,2843,314,9.9
"49001",49,1,2011,3044,2800,244,8
"49001",49,1,2012,2902,2725,177,6.1
"49001",49,1,2013,3021,2880,141,4.7
"49001",49,1,2014,2967,2847,120,4
"49001",49,1,2015,3123,3005,118,3.8
"49001",49,1,2016,3088,2936,152,4.9
"49001",49,1,2017,3093,2966,127,4.1
"49003",49,3,1990,16194,15463,731,4.5
"49003",49,3,1991,16225,15579,646,4
"49003",49,3,1992,16116,15273,843,5.2
"49003",49,3,1993,17493,16576,917,5.2
"49003",49,3,1994,18026,17142,884,4.9
"49003",49,3,1995,17833,17011,822,4.6
"49003",49,3,1996,17964,17206,758,4.2
"49003",49,3,1997,18714,17998,716,3.8
"49003",49,3,1998,19318,18413,905,4.7
"49003",49,3,1999,18327,17500,827,4.5
"49003",49,3,2000,20084,19342,742,3.7
"49003",49,3,2001,20494,19549,945,4.6
"49003",49,3,2002,21085,19898,1187,5.6
"49003",49,3,2003,21318,20138,1180,5.5
"49003",49,3,2004,22033,20924,1109,5
"49003",49,3,2005,22413,21449,964,4.3
"49003",49,3,2006,22846,22115,731,3.2
"49003",49,3,2007,23460,22834,626,2.7
"49003",49,3,2008,23701,22746,955,4
"49003",49,3,2009,23220,21350,1870,8.1
"49003",49,3,2010,23644,21640,2004,8.5
"49003",49,3,2011,23186,21444,1742,7.5
"49003",49,3,2012,22948,21626,1322,5.8
"49003",49,3,2013,23161,22064,1097,4.7
"49003",49,3,2014,23436,22527,909,3.9
"49003",49,3,2015,24030,23142,888,3.7
"49003",49,3,2016,24779,23916,863,3.5
"49003",49,3,2017,25535,24699,836,3.3
"49005",49,5,1990,33262,31933,1329,4
"49005",49,5,1991,34535,33350,1185,3.4
"49005",49,5,1992,36328,35005,1323,3.6
"49005",49,5,1993,38747,37547,1200,3.1
"49005",49,5,1994,40550,39340,1210,3
"49005",49,5,1995,41627,40352,1275,3.1
"49005",49,5,1996,41976,40754,1222,2.9
"49005",49,5,1997,43172,42052,1120,2.6
"49005",49,5,1998,44632,43279,1353,3
"49005",49,5,1999,45162,43988,1174,2.6
"49005",49,5,2000,48230,46887,1343,2.8
"49005",49,5,2001,50088,48361,1727,3.4
"49005",49,5,2002,52540,50331,2209,4.2
"49005",49,5,2003,54001,51881,2120,3.9
"49005",49,5,2004,56173,54129,2044,3.6
"49005",49,5,2005,57222,55373,1849,3.2
"49005",49,5,2006,58285,56941,1344,2.3
"49005",49,5,2007,60730,59486,1244,2
"49005",49,5,2008,61540,59844,1696,2.8
"49005",49,5,2009,62057,58660,3397,5.5
"49005",49,5,2010,57249,53768,3481,6.1
"49005",49,5,2011,56612,53638,2974,5.3
"49005",49,5,2012,56972,54422,2550,4.5
"49005",49,5,2013,57784,55494,2290,4
"49005",49,5,2014,58904,57015,1889,3.2
"49005",49,5,2015,60175,58330,1845,3.1
"49005",49,5,2016,61470,59597,1873,3
"49005",49,5,2017,63040,61291,1749,2.8
"49007",49,7,1990,8659,7981,678,7.8
"49007",49,7,1991,8718,8007,711,8.2
"49007",49,7,1992,8993,8149,844,9.4
"49007",49,7,1993,9032,8367,665,7.4
"49007",49,7,1994,9341,8635,706,7.6
"49007",49,7,1995,9131,8538,593,6.5
"49007",49,7,1996,9425,8861,564,6
"49007",49,7,1997,9691,9200,491,5.1
"49007",49,7,1998,9871,9264,607,6.1
"49007",49,7,1999,9886,9222,664,6.7
"49007",49,7,2000,9275,8754,521,5.6
"49007",49,7,2001,9080,8498,582,6.4
"49007",49,7,2002,9439,8778,661,7
"49007",49,7,2003,9359,8637,722,7.7
"49007",49,7,2004,9305,8692,613,6.6
"49007",49,7,2005,9541,9077,464,4.9
"49007",49,7,2006,9883,9540,343,3.5
"49007",49,7,2007,9635,9283,352,3.7
"49007",49,7,2008,10117,9683,434,4.3
"49007",49,7,2009,10485,9659,826,7.9
"49007",49,7,2010,9910,9057,853,8.6
"49007",49,7,2011,9547,8824,723,7.6
"49007",49,7,2012,9263,8610,653,7
"49007",49,7,2013,8948,8383,565,6.3
"49007",49,7,2014,8702,8255,447,5.1
"49007",49,7,2015,8729,8232,497,5.7
"49007",49,7,2016,8366,7869,497,5.9
"49007",49,7,2017,8372,7946,426,5.1
"49009",49,9,1990,353,347,6,1.7
"49009",49,9,1991,393,381,12,3.1
"49009",49,9,1992,405,386,19,4.7
"49009",49,9,1993,397,382,15,3.8
"49009",49,9,1994,471,447,24,5.1
"49009",49,9,1995,447,419,28,6.3
"49009",49,9,1996,412,395,17,4.1
"49009",49,9,1997,409,392,17,4.2
"49009",49,9,1998,424,408,16,3.8
"49009",49,9,1999,447,432,15,3.4
"49009",49,9,2000,463,445,18,3.9
"49009",49,9,2001,472,449,23,4.9
"49009",49,9,2002,509,484,25,4.9
"49009",49,9,2003,483,457,26,5.4
"49009",49,9,2004,499,472,27,5.4
"49009",49,9,2005,503,477,26,5.2
"49009",49,9,2006,506,482,24,4.7
"49009",49,9,2007,518,500,18,3.5
"49009",49,9,2008,451,433,18,4
"49009",49,9,2009,479,451,28,5.8
"49009",49,9,2010,495,459,36,7.3
"49009",49,9,2011,471,442,29,6.2
"49009",49,9,2012,436,414,22,5
"49009",49,9,2013,429,408,21,4.9
"49009",49,9,2014,431,413,18,4.2
"49009",49,9,2015,468,446,22,4.7
"49009",49,9,2016,465,441,24,5.2
"49009",49,9,2017,443,421,22,5
"49011",49,11,1990,87062,83588,3474,4
"49011",49,11,1991,90209,86340,3869,4.3
"49011",49,11,1992,94265,90165,4100,4.3
"49011",49,11,1993,100270,96576,3694,3.7
"49011",49,11,1994,105839,102144,3695,3.5
"49011",49,11,1995,105972,102394,3578,3.4
"49011",49,11,1996,111279,107818,3461,3.1
"49011",49,11,1997,115830,112343,3487,3
"49011",49,11,1998,120576,116554,4022,3.3
"49011",49,11,1999,124606,120604,4002,3.2
"49011",49,11,2000,120157,116416,3741,3.1
"49011",49,11,2001,121979,117006,4973,4.1
"49011",49,11,2002,124888,118588,6300,5
"49011",49,11,2003,128457,121880,6577,5.1
"49011",49,11,2004,132408,126235,6173,4.7
"49011",49,11,2005,135870,130515,5355,3.9
"49011",49,11,2006,140621,136545,4076,2.9
"49011",49,11,2007,144613,140977,3636,2.5
"49011",49,11,2008,145534,140609,4925,3.4
"49011",49,11,2009,144875,135345,9530,6.6
"49011",49,11,2010,146959,136698,10261,7
"49011",49,11,2011,146629,137787,8842,6
"49011",49,11,2012,148630,141372,7258,4.9
"49011",49,11,2013,152577,146091,6486,4.3
"49011",49,11,2014,155909,150319,5590,3.6
"49011",49,11,2015,160321,154896,5425,3.4
"49011",49,11,2016,164977,159781,5196,3.1
"49011",49,11,2017,170335,165116,5219,3.1
"49013",49,13,1990,5016,4608,408,8.1
"49013",49,13,1991,5187,4787,400,7.7
"49013",49,13,1992,5449,4975,474,8.7
"49013",49,13,1993,5757,5262,495,8.6
"49013",49,13,1994,5882,5293,589,10
"49013",49,13,1995,5761,5233,528,9.2
"49013",49,13,1996,5801,5319,482,8.3
"49013",49,13,1997,5925,5532,393,6.6
"49013",49,13,1998,6120,5672,448,7.3
"49013",49,13,1999,5950,5411,539,9.1
"49013",49,13,2000,6128,5826,302,4.9
"49013",49,13,2001,6768,6412,356,5.3
"49013",49,13,2002,7013,6540,473,6.7
"49013",49,13,2003,6882,6420,462,6.7
"49013",49,13,2004,7278,6870,408,5.6
"49013",49,13,2005,7690,7358,332,4.3
"49013",49,13,2006,8494,8252,242,2.8
"49013",49,13,2007,9218,9011,207,2.2
"49013",49,13,2008,10294,10020,274,2.7
"49013",49,13,2009,10348,9466,882,8.5
"49013",49,13,2010,8166,7385,781,9.6
"49013",49,13,2011,8445,7882,563,6.7
"49013",49,13,2012,9150,8720,430,4.7
"49013",49,13,2013,9299,8899,400,4.3
"49013",49,13,2014,9582,9233,349,3.6
"49013",49,13,2015,8827,8162,665,7.5
"49013",49,13,2016,8143,7421,722,8.9
"49013",49,13,2017,8104,7638,466,5.8
"49015",49,15,1990,4186,3843,343,8.2
"49015",49,15,1991,4043,3660,383,9.5
"49015",49,15,1992,4491,4096,395,8.8
"49015",49,15,1993,4139,3802,337,8.1
"49015",49,15,1994,4184,3850,334,8
"49015",49,15,1995,4228,3895,333,7.9
"49015",49,15,1996,4192,3880,312,7.4
"49015",49,15,1997,4180,3904,276,6.6
"49015",49,15,1998,4233,3905,328,7.7
"49015",49,15,1999,4024,3741,283,7
"49015",49,15,2000,4728,4501,227,4.8
"49015",49,15,2001,4764,4445,319,6.7
"49015",49,15,2002,4793,4451,342,7.1
"49015",49,15,2003,4881,4490,391,8
"49015",49,15,2004,5119,4770,349,6.8
"49015",49,15,2005,5125,4864,261,5.1
"49015",49,15,2006,5235,5052,183,3.5
"49015",49,15,2007,5134,4962,172,3.4
"49015",49,15,2008,5055,4862,193,3.8
"49015",49,15,2009,5248,4878,370,7.1
"49015",49,15,2010,5290,4906,384,7.3
"49015",49,15,2011,5070,4698,372,7.3
"49015",49,15,2012,4746,4405,341,7.2
"49015",49,15,2013,4713,4426,287,6.1
"49015",49,15,2014,4616,4369,247,5.4
"49015",49,15,2015,4413,4145,268,6.1
"49015",49,15,2016,4282,4014,268,6.3
"49015",49,15,2017,4255,4035,220,5.2
"49017",49,17,1990,2071,1878,193,9.3
"49017",49,17,1991,2144,1903,241,11.2
"49017",49,17,1992,2269,1961,308,13.6
"49017",49,17,1993,2350,2121,229,9.7
"49017",49,17,1994,2545,2274,271,10.6
"49017",49,17,1995,2641,2315,326,12.3
"49017",49,17,1996,2668,2404,264,9.9
"49017",49,17,1997,2754,2521,233,8.5
"49017",49,17,1998,2745,2510,235,8.6
"49017",49,17,1999,2878,2657,221,7.7
"49017",49,17,2000,2483,2315,168,6.8
"49017",49,17,2001,2577,2372,205,8
"49017",49,17,2002,2593,2350,243,9.4
"49017",49,17,2003,2550,2321,229,9
"49017",49,17,2004,2656,2448,208,7.8
"49017",49,17,2005,2699,2506,193,7.2
"49017",49,17,2006,2677,2543,134,5
"49017",49,17,2007,2727,2602,125,4.6
"49017",49,17,2008,2817,2645,172,6.1
"49017",49,17,2009,2873,2573,300,10.4
"49017",49,17,2010,3074,2760,314,10.2
"49017",49,17,2011,2962,2646,316,10.7
"49017",49,17,2012,2857,2586,271,9.5
"49017",49,17,2013,2781,2525,256,9.2
"49017",49,17,2014,2719,2480,239,8.8
"49017",49,17,2015,2762,2515,247,8.9
"49017",49,17,2016,2806,2571,235,8.4
"49017",49,17,2017,2934,2714,220,7.5
"49019",49,19,1990,3329,3086,243,7.3
"49019",49,19,1991,3544,3300,244,6.9
"49019",49,19,1992,4079,3779,300,7.4
"49019",49,19,1993,4658,4361,297,6.4
"49019",49,19,1994,4914,4581,333,6.8
"49019",49,19,1995,4959,4630,329,6.6
"49019",49,19,1996,5060,4710,350,6.9
"49019",49,19,1997,5213,4881,332,6.4
"49019",49,19,1998,5332,4952,380,7.1
"49019",49,19,1999,5568,5217,351,6.3
"49019",49,19,2000,4645,4341,304,6.5
"49019",49,19,2001,4729,4401,328,6.9
"49019",49,19,2002,4799,4437,362,7.5
"49019",49,19,2003,4893,4527,366,7.5
"49019",49,19,2004,4826,4472,354,7.3
"49019",49,19,2005,5028,4712,316,6.3
"49019",49,19,2006,5030,4786,244,4.9
"49019",49,19,2007,5170,4932,238,4.6
"49019",49,19,2008,5261,4951,310,5.9
"49019",49,19,2009,5402,4872,530,9.8
"49019",49,19,2010,5323,4764,559,10.5
"49019",49,19,2011,5317,4797,520,9.8
"49019",49,19,2012,5409,4954,455,8.4
"49019",49,19,2013,5455,5033,422,7.7
"49019",49,19,2014,5527,5174,353,6.4
"49019",49,19,2015,5624,5282,342,6.1
"49019",49,19,2016,5748,5411,337,5.9
"49019",49,19,2017,5971,5653,318,5.3
"49021",49,21,1990,9185,8718,467,5.1
"49021",49,21,1991,9568,9076,492,5.1
"49021",49,21,1992,10178,9787,391,3.8
"49021",49,21,1993,11183,10758,425,3.8
"49021",49,21,1994,12263,11825,438,3.6
"49021",49,21,1995,12996,12560,436,3.4
"49021",49,21,1996,13392,12896,496,3.7
"49021",49,21,1997,14236,13757,479,3.4
"49021",49,21,1998,14913,14345,568,3.8
"49021",49,21,1999,15116,14583,533,3.5
"49021",49,21,2000,16898,16349,549,3.2
"49021",49,21,2001,17247,16466,781,4.5
"49021",49,21,2002,17734,16799,935,5.3
"49021",49,21,2003,17900,16963,937,5.2
"49021",49,21,2004,18764,17902,862,4.6
"49021",49,21,2005,19873,19101,772,3.9
"49021",49,21,2006,20944,20335,609,2.9
"49021",49,21,2007,21007,20399,608,2.9
"49021",49,21,2008,20845,19930,915,4.4
"49021",49,21,2009,20949,19109,1840,8.8
"49021",49,21,2010,20414,18457,1957,9.6
"49021",49,21,2011,19868,18227,1641,8.3
"49021",49,21,2012,19470,18140,1330,6.8
"49021",49,21,2013,19376,18301,1075,5.5
"49021",49,21,2014,19928,19023,905,4.5
"49021",49,21,2015,20376,19470,906,4.4
"49021",49,21,2016,21549,20612,937,4.3
"49021",49,21,2017,22381,21450,931,4.2
"49023",49,23,1990,2702,2573,129,4.8
"49023",49,23,1991,3000,2840,160,5.3
"49023",49,23,1992,3143,2913,230,7.3
"49023",49,23,1993,3270,3069,201,6.1
"49023",49,23,1994,3333,3176,157,4.7
"49023",49,23,1995,3343,3181,162,4.8
"49023",49,23,1996,3403,3268,135,4
"49023",49,23,1997,3441,3308,133,3.9
"49023",49,23,1998,3622,3461,161,4.4
"49023",49,23,1999,3611,3439,172,4.8
"49023",49,23,2000,3752,3619,133,3.5
"49023",49,23,2001,3775,3590,185,4.9
"49023",49,23,2002,3691,3416,275,7.5
"49023",49,23,2003,3683,3421,262,7.1
"49023",49,23,2004,3826,3583,243,6.4
"49023",49,23,2005,3916,3729,187,4.8
"49023",49,23,2006,4036,3887,149,3.7
"49023",49,23,2007,4112,3983,129,3.1
"49023",49,23,2008,3949,3732,217,5.5
"49023",49,23,2009,3963,3566,397,10
"49023",49,23,2010,4612,4191,421,9.1
"49023",49,23,2011,4595,4219,376,8.2
"49023",49,23,2012,4625,4343,282,6.1
"49023",49,23,2013,4697,4460,237,5
"49023",49,23,2014,4798,4602,196,4.1
"49023",49,23,2015,4949,4753,196,4
"49023",49,23,2016,5238,5048,190,3.6
"49023",49,23,2017,5466,5282,184,3.4
"49025",49,25,1990,2540,2386,154,6.1
"49025",49,25,1991,2661,2461,200,7.5
"49025",49,25,1992,2865,2647,218,7.6
"49025",49,25,1993,2523,2350,173,6.9
"49025",49,25,1994,2720,2481,239,8.8
"49025",49,25,1995,2707,2474,233,8.6
"49025",49,25,1996,2579,2391,188,7.3
"49025",49,25,1997,2619,2488,131,5
"49025",49,25,1998,2708,2605,103,3.8
"49025",49,25,1999,2800,2696,104,3.7
"49025",49,25,2000,3028,2913,115,3.8
"49025",49,25,2001,3169,3033,136,4.3
"49025",49,25,2002,2982,2823,159,5.3
"49025",49,25,2003,3112,2936,176,5.7
"49025",49,25,2004,3246,3065,181,5.6
"49025",49,25,2005,3265,3105,160,4.9
"49025",49,25,2006,3438,3315,123,3.6
"49025",49,25,2007,3491,3381,110,3.2
"49025",49,25,2008,3482,3337,145,4.2
"49025",49,25,2009,3519,3252,267,7.6
"49025",49,25,2010,3561,3278,283,7.9
"49025",49,25,2011,3492,3232,260,7.4
"49025",49,25,2012,3462,3232,230,6.6
"49025",49,25,2013,3474,3288,186,5.4
"49025",49,25,2014,3565,3395,170,4.8
"49025",49,25,2015,3634,3473,161,4.4
"49025",49,25,2016,3707,3566,141,3.8
"49025",49,25,2017,3770,3641,129,3.4
"49027",49,27,1990,4650,4438,212,4.6
"49027",49,27,1991,4699,4457,242,5.2
"49027",49,27,1992,4688,4401,287,6.1
"49027",49,27,1993,4715,4462,253,5.4
"49027",49,27,1994,4752,4525,227,4.8
"49027",49,27,1995,4715,4488,227,4.8
"49027",49,27,1996,4743,4546,197,4.2
"49027",49,27,1997,4756,4572,184,3.9
"49027",49,27,1998,4718,4499,219,4.6
"49027",49,27,1999,4643,4447,196,4.2
"49027",49,27,2000,5190,5011,179,3.4
"49027",49,27,2001,5650,5418,232,4.1
"49027",49,27,2002,6163,5881,282,4.6
"49027",49,27,2003,5932,5634,298,5
"49027",49,27,2004,6142,5847,295,4.8
"49027",49,27,2005,6092,5847,245,4
"49027",49,27,2006,6188,6006,182,2.9
"49027",49,27,2007,6207,6052,155,2.5
"49027",49,27,2008,6051,5849,202,3.3
"49027",49,27,2009,6479,6118,361,5.6
"49027",49,27,2010,6421,6023,398,6.2
"49027",49,27,2011,6169,5842,327,5.3
"49027",49,27,2012,5938,5661,277,4.7
"49027",49,27,2013,5902,5660,242,4.1
"49027",49,27,2014,5966,5758,208,3.5
"49027",49,27,2015,6138,5923,215,3.5
"49027",49,27,2016,6236,6029,207,3.3
"49027",49,27,2017,6508,6294,214,3.3
"49029",49,29,1990,2515,2385,130,5.2
"49029",49,29,1991,2595,2461,134,5.2
"49029",49,29,1992,2932,2779,153,5.2
"49029",49,29,1993,2972,2809,163,5.5
"49029",49,29,1994,3062,2911,151,4.9
"49029",49,29,1995,3398,3241,157,4.6
"49029",49,29,1996,3493,3348,145,4.2
"49029",49,29,1997,3615,3475,140,3.9
"49029",49,29,1998,3686,3544,142,3.9
"49029",49,29,1999,3563,3424,139,3.9
"49029",49,29,2000,3417,3300,117,3.4
"49029",49,29,2001,3464,3329,135,3.9
"49029",49,29,2002,3549,3359,190,5.4
"49029",49,29,2003,3589,3403,186,5.2
"49029",49,29,2004,3683,3506,177,4.8
"49029",49,29,2005,3818,3659,159,4.2
"49029",49,29,2006,3942,3823,119,3
"49029",49,29,2007,3994,3889,105,2.6
"49029",49,29,2008,4060,3925,135,3.3
"49029",49,29,2009,4066,3811,255,6.3
"49029",49,29,2010,4274,3980,294,6.9
"49029",49,29,2011,4245,4002,243,5.7
"49029",49,29,2012,4333,4120,213,4.9
"49029",49,29,2013,4505,4323,182,4
"49029",49,29,2014,4692,4531,161,3.4
"49029",49,29,2015,4939,4785,154,3.1
"49029",49,29,2016,5162,5009,153,3
"49029",49,29,2017,5328,5175,153,2.9
"49031",49,31,1990,470,436,34,7.2
"49031",49,31,1991,504,454,50,9.9
"49031",49,31,1992,465,432,33,7.1
"49031",49,31,1993,469,442,27,5.8
"49031",49,31,1994,495,453,42,8.5
"49031",49,31,1995,489,460,29,5.9
"49031",49,31,1996,523,499,24,4.6
"49031",49,31,1997,521,495,26,5
"49031",49,31,1998,526,501,25,4.8
"49031",49,31,1999,539,507,32,5.9
"49031",49,31,2000,626,598,28,4.5
"49031",49,31,2001,773,728,45,5.8
"49031",49,31,2002,749,702,47,6.3
"49031",49,31,2003,803,759,44,5.5
"49031",49,31,2004,868,830,38,4.4
"49031",49,31,2005,851,817,34,4
"49031",49,31,2006,891,864,27,3
"49031",49,31,2007,927,906,21,2.3
"49031",49,31,2008,902,876,26,2.9
"49031",49,31,2009,894,835,59,6.6
"49031",49,31,2010,572,514,58,10.1
"49031",49,31,2011,530,477,53,10
"49031",49,31,2012,492,451,41,8.3
"49031",49,31,2013,484,447,37,7.6
"49031",49,31,2014,460,427,33,7.2
"49031",49,31,2015,466,436,30,6.4
"49031",49,31,2016,460,433,27,5.9
"49031",49,31,2017,490,466,24,4.9
"49033",49,33,1990,718,703,15,2.1
"49033",49,33,1991,750,730,20,2.7
"49033",49,33,1992,761,733,28,3.7
"49033",49,33,1993,792,768,24,3
"49033",49,33,1994,836,803,33,3.9
"49033",49,33,1995,892,857,35,3.9
"49033",49,33,1996,969,935,34,3.5
"49033",49,33,1997,938,907,31,3.3
"49033",49,33,1998,981,948,33,3.4
"49033",49,33,1999,992,957,35,3.5
"49033",49,33,2000,1045,1014,31,3
"49033",49,33,2001,1174,1136,38,3.2
"49033",49,33,2002,1257,1206,51,4.1
"49033",49,33,2003,1260,1210,50,4
"49033",49,33,2004,1338,1293,45,3.4
"49033",49,33,2005,1290,1250,40,3.1
"49033",49,33,2006,1407,1375,32,2.3
"49033",49,33,2007,1444,1415,29,2
"49033",49,33,2008,1424,1386,38,2.7
"49033",49,33,2009,1461,1387,74,5.1
"49033",49,33,2010,1039,964,75,7.2
"49033",49,33,2011,982,911,71,7.2
"49033",49,33,2012,946,896,50,5.3
"49033",49,33,2013,984,939,45,4.6
"49033",49,33,2014,1006,967,39,3.9
"49033",49,33,2015,1048,1010,38,3.6
"49033",49,33,2016,1100,1065,35,3.2
"49033",49,33,2017,1155,1118,37,3.2
"49035",49,35,1990,371230,357125,14105,3.8
"49035",49,35,1991,383573,367107,16466,4.3
"49035",49,35,1992,399276,381651,17625,4.4
"49035",49,35,1993,421124,406071,15053,3.6
"49035",49,35,1994,441569,426786,14783,3.3
"49035",49,35,1995,454011,440443,13568,3
"49035",49,35,1996,461186,447880,13306,2.9
"49035",49,35,1997,474401,461067,13334,2.8
"49035",49,35,1998,483047,467234,15813,3.3
"49035",49,35,1999,490026,474240,15786,3.2
"49035",49,35,2000,486372,471013,15359,3.2
"49035",49,35,2001,492535,470934,21601,4.4
"49035",49,35,2002,495252,465786,29466,5.9
"49035",49,35,2003,496311,467810,28501,5.7
"49035",49,35,2004,500677,475564,25113,5
"49035",49,35,2005,517454,496679,20775,4
"49035",49,35,2006,534687,519133,15554,2.9
"49035",49,35,2007,550691,536924,13767,2.5
"49035",49,35,2008,557692,538772,18920,3.4
"49035",49,35,2009,553693,514653,39040,7.1
"49035",49,35,2010,548378,506309,42069,7.7
"49035",49,35,2011,546296,510115,36181,6.6
"49035",49,35,2012,556484,527250,29234,5.3
"49035",49,35,2013,569638,544635,25003,4.4
"49035",49,35,2014,575842,554611,21231,3.7
"49035",49,35,2015,586753,566890,19863,3.4
"49035",49,35,2016,603897,584758,19139,3.2
"49035",49,35,2017,621759,602541,19218,3.1
"49037",49,37,1990,4141,3773,368,8.9
"49037",49,37,1991,4160,3717,443,10.6
"49037",49,37,1992,4459,4012,447,10
"49037",49,37,1993,5092,4726,366,7.2
"49037",49,37,1994,5152,4727,425,8.2
"49037",49,37,1995,5218,4774,444,8.5
"49037",49,37,1996,5098,4618,480,9.4
"49037",49,37,1997,4893,4468,425,8.7
"49037",49,37,1998,4987,4592,395,7.9
"49037",49,37,1999,5032,4652,380,7.6
"49037",49,37,2000,4724,4348,376,8
"49037",49,37,2001,4579,4195,384,8.4
"49037",49,37,2002,4777,4367,410,8.6
"49037",49,37,2003,4739,4307,432,9.1
"49037",49,37,2004,4853,4408,445,9.2
"49037",49,37,2005,4787,4410,377,7.9
"49037",49,37,2006,4885,4586,299,6.1
"49037",49,37,2007,4970,4712,258,5.2
"49037",49,37,2008,5007,4689,318,6.4
"49037",49,37,2009,5292,4667,625,11.8
"49037",49,37,2010,6087,5424,663,10.9
"49037",49,37,2011,5954,5359,595,10
"49037",49,37,2012,5695,5193,502,8.8
"49037",49,37,2013,5676,5224,452,8
"49037",49,37,2014,5610,5175,435,7.8
"49037",49,37,2015,5730,5278,452,7.9
"49037",49,37,2016,5764,5299,465,8.1
"49037",49,37,2017,5820,5399,421,7.2
"49039",49,39,1990,6432,5739,693,10.8
"49039",49,39,1991,6781,6062,719,10.6
"49039",49,39,1992,6852,6218,634,9.3
"49039",49,39,1993,7171,6715,456,6.4
"49039",49,39,1994,7515,7008,507,6.7
"49039",49,39,1995,7783,7317,466,6
"49039",49,39,1996,8254,7757,497,6
"49039",49,39,1997,8589,8126,463,5.4
"49039",49,39,1998,9009,8477,532,5.9
"49039",49,39,1999,8957,8486,471,5.3
"49039",49,39,2000,9683,9257,426,4.4
"49039",49,39,2001,10068,9528,540,5.4
"49039",49,39,2002,10202,9533,669,6.6
"49039",49,39,2003,10308,9608,700,6.8
"49039",49,39,2004,10470,9818,652,6.2
"49039",49,39,2005,10563,10003,560,5.3
"49039",49,39,2006,10662,10262,400,3.8
"49039",49,39,2007,10955,10618,337,3.1
"49039",49,39,2008,11113,10643,470,4.2
"49039",49,39,2009,11335,10382,953,8.4
"49039",49,39,2010,11461,10426,1035,9
"49039",49,39,2011,11110,10235,875,7.9
"49039",49,39,2012,11253,10532,721,6.4
"49039",49,39,2013,11058,10436,622,5.6
"49039",49,39,2014,11071,10566,505,4.6
"49039",49,39,2015,11443,10970,473,4.1
"49039",49,39,2016,11843,11373,470,4
"49039",49,39,2017,12064,11590,474,3.9
"49041",49,41,1990,6340,5987,353,5.6
"49041",49,41,1991,6550,6067,483,7.4
"49041",49,41,1992,6684,6217,467,7
"49041",49,41,1993,7129,6741,388,5.4
"49041",49,41,1994,7471,7109,362,4.8
"49041",49,41,1995,7634,7253,381,5
"49041",49,41,1996,7852,7493,359,4.6
"49041",49,41,1997,8098,7776,322,4
"49041",49,41,1998,8307,7932,375,4.5
"49041",49,41,1999,8436,8092,344,4.1
"49041",49,41,2000,8337,8014,323,3.9
"49041",49,41,2001,8576,8180,396,4.6
"49041",49,41,2002,8859,8354,505,5.7
"49041",49,41,2003,8756,8250,506,5.8
"49041",49,41,2004,9233,8755,478,5.2
"49041",49,41,2005,9149,8742,407,4.4
"49041",49,41,2006,9390,9089,301,3.2
"49041",49,41,2007,9479,9220,259,2.7
"49041",49,41,2008,9630,9243,387,4
"49041",49,41,2009,9876,9099,777,7.9
"49041",49,41,2010,9727,8917,810,8.3
"49041",49,41,2011,9502,8796,706,7.4
"49041",49,41,2012,9421,8844,577,6.1
"49041",49,41,2013,9265,8762,503,5.4
"49041",49,41,2014,9271,8853,418,4.5
"49041",49,41,2015,9532,9107,425,4.5
"49041",49,41,2016,9625,9204,421,4.4
"49041",49,41,2017,9907,9523,384,3.9
"49043",49,43,1990,8050,7549,501,6.2
"49043",49,43,1991,8513,7916,597,7
"49043",49,43,1992,9309,8681,628,6.7
"49043",49,43,1993,10356,9831,525,5.1
"49043",49,43,1994,11380,10872,508,4.5
"49043",49,43,1995,12056,11586,470,3.9
"49043",49,43,1996,12752,12310,442,3.5
"49043",49,43,1997,13396,12928,468,3.5
"49043",49,43,1998,14170,13546,624,4.4
"49043",49,43,1999,14700,14021,679,4.6
"49043",49,43,2000,18262,17627,635,3.5
"49043",49,43,2001,18879,18001,878,4.7
"49043",49,43,2002,19446,18173,1273,6.5
"49043",49,43,2003,19879,18653,1226,6.2
"49043",49,43,2004,20464,19401,1063,5.2
"49043",49,43,2005,21457,20604,853,4
"49043",49,43,2006,21768,21143,625,2.9
"49043",49,43,2007,21785,21243,542,2.5
"49043",49,43,2008,22102,21372,730,3.3
"49043",49,43,2009,22210,20658,1552,7
"49043",49,43,2010,20857,19313,1544,7.4
"49043",49,43,2011,21205,19912,1293,6.1
"49043",49,43,2012,21523,20463,1060,4.9
"49043",49,43,2013,22039,21124,915,4.2
"49043",49,43,2014,22543,21769,774,3.4
"49043",49,43,2015,23120,22355,765,3.3
"49043",49,43,2016,23964,23212,752,3.1
"49043",49,43,2017,24597,23839,758,3.1
"49045",49,45,1990,12378,11712,666,5.4
"49045",49,45,1991,12131,11470,661,5.4
"49045",49,45,1992,12657,11876,781,6.2
"49045",49,45,1993,12161,11491,670,5.5
"49045",49,45,1994,11665,10988,677,5.8
"49045",49,45,1995,11470,10836,634,5.5
"49045",49,45,1996,11733,11134,599,5.1
"49045",49,45,1997,11771,11240,531,4.5
"49045",49,45,1998,12014,11424,590,4.9
"49045",49,45,1999,12264,11619,645,5.3
"49045",49,45,2000,20262,19518,744,3.7
"49045",49,45,2001,21395,20371,1024,4.8
"49045",49,45,2002,22322,20907,1415,6.3
"49045",49,45,2003,23242,21788,1454,6.3
"49045",49,45,2004,23967,22658,1309,5.5
"49045",49,45,2005,25165,24068,1097,4.4
"49045",49,45,2006,26296,25437,859,3.3
"49045",49,45,2007,26910,26153,757,2.8
"49045",49,45,2008,27933,26862,1071,3.8
"49045",49,45,2009,28202,25975,2227,7.9
"49045",49,45,2010,27454,25163,2291,8.3
"49045",49,45,2011,27279,25330,1949,7.1
"49045",49,45,2012,27746,26087,1659,6
"49045",49,45,2013,28488,26941,1547,5.4
"49045",49,45,2014,28914,27524,1390,4.8
"49045",49,45,2015,29601,28374,1227,4.1
"49045",49,45,2016,30948,29773,1175,3.8
"49045",49,45,2017,31829,30675,1154,3.6
"49047",49,47,1990,8892,8360,532,6
"49047",49,47,1991,9390,8833,557,5.9
"49047",49,47,1992,9771,9045,726,7.4
"49047",49,47,1993,10030,9297,733,7.3
"49047",49,47,1994,10205,9445,760,7.4
"49047",49,47,1995,10321,9600,721,7
"49047",49,47,1996,10205,9472,733,7.2
"49047",49,47,1997,10645,10041,604,5.7
"49047",49,47,1998,10897,10249,648,5.9
"49047",49,47,1999,11175,10420,755,6.8
"49047",49,47,2000,11400,10917,483,4.2
"49047",49,47,2001,12212,11667,545,4.5
"49047",49,47,2002,12619,11857,762,6
"49047",49,47,2003,13094,12342,752,5.7
"49047",49,47,2004,13803,13104,699,5.1
"49047",49,47,2005,14669,14121,548,3.7
"49047",49,47,2006,16300,15902,398,2.4
"49047",49,47,2007,17270,16913,357,2.1
"49047",49,47,2008,18583,18158,425,2.3
"49047",49,47,2009,17684,16211,1473,8.3
"49047",49,47,2010,15189,13896,1293,8.5
"49047",49,47,2011,15518,14585,933,6
"49047",49,47,2012,15981,15271,710,4.4
"49047",49,47,2013,15671,14989,682,4.4
"49047",49,47,2014,16000,15427,573,3.6
"49047",49,47,2015,15339,14295,1044,6.8
"49047",49,47,2016,14184,12864,1320,9.3
"49047",49,47,2017,13936,13089,847,6.1
"49049",49,49,1990,117241,112049,5192,4.4
"49049",49,49,1991,123864,118402,5462,4.4
"49049",49,49,1992,128210,122880,5330,4.2
"49049",49,49,1993,136781,131876,4905,3.6
"49049",49,49,1994,145410,140821,4589,3.2
"49049",49,49,1995,148968,144727,4241,2.8
"49049",49,49,1996,153849,149485,4364,2.8
"49049",49,49,1997,158141,153939,4202,2.7
"49049",49,49,1998,165275,160251,5024,3
"49049",49,49,1999,170285,165233,5052,3
"49049",49,49,2000,181131,175815,5316,2.9
"49049",49,49,2001,183457,175924,7533,4.1
"49049",49,49,2002,186116,175244,10872,5.8
"49049",49,49,2003,188833,178807,10026,5.3
"49049",49,49,2004,197086,187702,9384,4.8
"49049",49,49,2005,205142,197112,8030,3.9
"49049",49,49,2006,214250,208141,6109,2.9
"49049",49,49,2007,223138,217722,5416,2.4
"49049",49,49,2008,223222,215381,7841,3.5
"49049",49,49,2009,221538,206001,15537,7
"49049",49,49,2010,229820,212729,17091,7.4
"49049",49,49,2011,231181,216636,14545,6.3
"49049",49,49,2012,238745,226892,11853,5
"49049",49,49,2013,248743,238194,10549,4.2
"49049",49,49,2014,255288,246367,8921,3.5
"49049",49,49,2015,266645,257951,8694,3.3
"49049",49,49,2016,279993,271355,8638,3.1
"49049",49,49,2017,292474,283950,8524,2.9
"49051",49,51,1990,4560,4266,294,6.4
"49051",49,51,1991,4621,4260,361,7.8
"49051",49,51,1992,4834,4468,366,7.6
"49051",49,51,1993,5086,4769,317,6.2
"49051",49,51,1994,5372,5063,309,5.8
"49051",49,51,1995,5429,5158,271,5
"49051",49,51,1996,5644,5404,240,4.3
"49051",49,51,1997,5902,5667,235,4
"49051",49,51,1998,6196,5899,297,4.8
"49051",49,51,1999,6436,6128,308,4.8
"49051",49,51,2000,7781,7509,272,3.5
"49051",49,51,2001,7909,7550,359,4.5
"49051",49,51,2002,8228,7708,520,6.3
"49051",49,51,2003,8487,7969,518,6.1
"49051",49,51,2004,8788,8312,476,5.4
"49051",49,51,2005,9309,8926,383,4.1
"49051",49,51,2006,10137,9816,321,3.2
"49051",49,51,2007,10732,10459,273,2.5
"49051",49,51,2008,10303,9922,381,3.7
"49051",49,51,2009,10020,9182,838,8.4
"49051",49,51,2010,11360,10405,955,8.4
"49051",49,51,2011,11381,10584,797,7
"49051",49,51,2012,11651,10981,670,5.8
"49051",49,51,2013,12196,11627,569,4.7
"49051",49,51,2014,12721,12239,482,3.8
"49051",49,51,2015,13288,12821,467,3.5
"49051",49,51,2016,13955,13484,471,3.4
"49051",49,51,2017,14632,14156,476,3.3
"49053",49,53,1990,19312,18554,758,3.9
"49053",49,53,1991,21165,20205,960,4.5
"49053",49,53,1992,22935,21952,983,4.3
"49053",49,53,1993,26202,25247,955,3.6
"49053",49,53,1994,30467,29551,916,3
"49053",49,53,1995,32773,31716,1057,3.2
"49053",49,53,1996,34701,33493,1208,3.5
"49053",49,53,1997,35432,34246,1186,3.3
"49053",49,53,1998,37212,35850,1362,3.7
"49053",49,53,1999,38714,37380,1334,3.4
"49053",49,53,2000,39358,37977,1381,3.5
"49053",49,53,2001,42021,40287,1734,4.1
"49053",49,53,2002,44723,42371,2352,5.3
"49053",49,53,2003,47554,45016,2538,5.3
"49053",49,53,2004,52089,49571,2518,4.8
"49053",49,53,2005,56944,54639,2305,4
"49053",49,53,2006,61333,59487,1846,3
"49053",49,53,2007,63506,61762,1744,2.7
"49053",49,53,2008,61770,58841,2929,4.7
"49053",49,53,2009,60001,54133,5868,9.8
"49053",49,53,2010,56776,50821,5955,10.5
"49053",49,53,2011,55996,51025,4971,8.9
"49053",49,53,2012,57216,53281,3935,6.9
"49053",49,53,2013,59344,56072,3272,5.5
"49053",49,53,2014,61525,58819,2706,4.4
"49053",49,53,2015,63800,61197,2603,4.1
"49053",49,53,2016,67517,64995,2522,3.7
"49053",49,53,2017,70817,68367,2450,3.5
"49055",49,55,1990,944,862,82,8.7
"49055",49,55,1991,966,876,90,9.3
"49055",49,55,1992,1055,970,85,8.1
"49055",49,55,1993,1087,1007,80,7.4
"49055",49,55,1994,1178,1086,92,7.8
"49055",49,55,1995,1324,1241,83,6.3
"49055",49,55,1996,1339,1267,72,5.4
"49055",49,55,1997,1406,1335,71,5
"49055",49,55,1998,1485,1396,89,6
"49055",49,55,1999,1485,1403,82,5.5
"49055",49,55,2000,1318,1258,60,4.6
"49055",49,55,2001,1442,1369,73,5.1
"49055",49,55,2002,1438,1346,92,6.4
"49055",49,55,2003,1321,1230,91,6.9
"49055",49,55,2004,1354,1265,89,6.6
"49055",49,55,2005,1337,1265,72,5.4
"49055",49,55,2006,1386,1326,60,4.3
"49055",49,55,2007,1399,1342,57,4.1
"49055",49,55,2008,1392,1316,76,5.5
"49055",49,55,2009,1479,1359,120,8.1
"49055",49,55,2010,1576,1441,135,8.6
"49055",49,55,2011,1430,1286,144,10.1
"49055",49,55,2012,1355,1209,146,10.8
"49055",49,55,2013,1378,1228,150,10.9
"49055",49,55,2014,1386,1255,131,9.5
"49055",49,55,2015,1417,1288,129,9.1
"49055",49,55,2016,1432,1321,111,7.8
"49055",49,55,2017,1472,1363,109,7.4
"49057",49,57,1990,77917,73947,3970,5.1
"49057",49,57,1991,79824,75582,4242,5.3
"49057",49,57,1992,83340,78378,4962,6
"49057",49,57,1993,87844,83322,4522,5.1
"49057",49,57,1994,91990,87828,4162,4.5
"49057",49,57,1995,92238,88347,3891,4.2
"49057",49,57,1996,95976,92067,3909,4.1
"49057",49,57,1997,98988,95072,3916,4
"49057",49,57,1998,101324,96571,4753,4.7
"49057",49,57,1999,102837,98407,4430,4.3
"49057",49,57,2000,100567,96313,4254,4.2
"49057",49,57,2001,101828,96548,5280,5.2
"49057",49,57,2002,103897,97432,6465,6.2
"49057",49,57,2003,105669,98908,6761,6.4
"49057",49,57,2004,107171,101293,5878,5.5
"49057",49,57,2005,108209,103267,4942,4.6
"49057",49,57,2006,109819,106125,3694,3.4
"49057",49,57,2007,112739,109285,3454,3.1
"49057",49,57,2008,113853,109052,4801,4.2
"49057",49,57,2009,114652,105022,9630,8.4
"49057",49,57,2010,113259,103288,9971,8.8
"49057",49,57,2011,112431,103607,8824,7.8
"49057",49,57,2012,113321,106127,7194,6.3
"49057",49,57,2013,114544,108338,6206,5.4
"49057",49,57,2014,114919,109861,5058,4.4
"49057",49,57,2015,117485,112666,4819,4.1
"49057",49,57,2016,120584,115956,4628,3.8
"49057",49,57,2017,124363,119813,4550,3.7
"50001",50,1,1990,18320,17539,781,4.3
"50001",50,1,1991,18270,17080,1190,6.5
"50001",50,1,1992,18401,17144,1257,6.8
"50001",50,1,1993,18307,17158,1149,6.3
"50001",50,1,1994,18391,17418,973,5.3
"50001",50,1,1995,18507,17686,821,4.4
"50001",50,1,1996,18875,18026,849,4.5
"50001",50,1,1997,19116,18366,750,3.9
"50001",50,1,1998,19586,18884,702,3.6
"50001",50,1,1999,20243,19620,623,3.1
"50001",50,1,2000,19571,19057,514,2.6
"50001",50,1,2001,20427,19800,627,3.1
"50001",50,1,2002,20757,20015,742,3.6
"50001",50,1,2003,21036,20216,820,3.9
"50001",50,1,2004,20997,20267,730,3.5
"50001",50,1,2005,21560,20856,704,3.3
"50001",50,1,2006,21898,21176,722,3.3
"50001",50,1,2007,21557,20726,831,3.9
"50001",50,1,2008,21667,20706,961,4.4
"50001",50,1,2009,21909,20568,1341,6.1
"50001",50,1,2010,21241,20005,1236,5.8
"50001",50,1,2011,21098,20057,1041,4.9
"50001",50,1,2012,20868,19926,942,4.5
"50001",50,1,2013,20786,19928,858,4.1
"50001",50,1,2014,20823,20050,773,3.7
"50001",50,1,2015,20682,19964,718,3.5
"50001",50,1,2016,20846,20224,622,3
"50001",50,1,2017,20842,20256,586,2.8
"50003",50,3,1990,18735,17702,1033,5.5
"50003",50,3,1991,18158,17129,1029,5.7
"50003",50,3,1992,18558,17460,1098,5.9
"50003",50,3,1993,18677,17783,894,4.8
"50003",50,3,1994,19129,18232,897,4.7
"50003",50,3,1995,19448,18614,834,4.3
"50003",50,3,1996,19795,18903,892,4.5
"50003",50,3,1997,19717,18873,844,4.3
"50003",50,3,1998,20158,19371,787,3.9
"50003",50,3,1999,20480,19752,728,3.6
"50003",50,3,2000,19677,19096,581,3
"50003",50,3,2001,20013,19252,761,3.8
"50003",50,3,2002,20168,19227,941,4.7
"50003",50,3,2003,19951,19003,948,4.8
"50003",50,3,2004,19774,18989,785,4
"50003",50,3,2005,20089,19361,728,3.6
"50003",50,3,2006,20675,19925,750,3.6
"50003",50,3,2007,20477,19650,827,4
"50003",50,3,2008,20536,19549,987,4.8
"50003",50,3,2009,20622,19046,1576,7.6
"50003",50,3,2010,20339,18932,1407,6.9
"50003",50,3,2011,19961,18687,1274,6.4
"50003",50,3,2012,19663,18506,1157,5.9
"50003",50,3,2013,19275,18271,1004,5.2
"50003",50,3,2014,18675,17817,858,4.6
"50003",50,3,2015,18565,17782,783,4.2
"50003",50,3,2016,18439,17743,696,3.8
"50003",50,3,2017,18438,17770,668,3.6
"50005",50,5,1990,14250,13383,867,6.1
"50005",50,5,1991,14357,13253,1104,7.7
"50005",50,5,1992,14943,13913,1030,6.9
"50005",50,5,1993,14730,13707,1023,6.9
"50005",50,5,1994,14760,13834,926,6.3
"50005",50,5,1995,14832,13933,899,6.1
"50005",50,5,1996,15085,14153,932,6.2
"50005",50,5,1997,15238,14429,809,5.3
"50005",50,5,1998,15129,14407,722,4.8
"50005",50,5,1999,15261,14654,607,4
"50005",50,5,2000,15289,14776,513,3.4
"50005",50,5,2001,15633,15014,619,4
"50005",50,5,2002,15954,15165,789,4.9
"50005",50,5,2003,16280,15458,822,5
"50005",50,5,2004,16381,15690,691,4.2
"50005",50,5,2005,16451,15817,634,3.9
"50005",50,5,2006,16945,16249,696,4.1
"50005",50,5,2007,16729,15982,747,4.5
"50005",50,5,2008,16816,15943,873,5.2
"50005",50,5,2009,16778,15476,1302,7.8
"50005",50,5,2010,16785,15649,1136,6.8
"50005",50,5,2011,16597,15551,1046,6.3
"50005",50,5,2012,16137,15130,1007,6.2
"50005",50,5,2013,15757,14921,836,5.3
"50005",50,5,2014,15275,14539,736,4.8
"50005",50,5,2015,15073,14370,703,4.7
"50005",50,5,2016,14896,14274,622,4.2
"50005",50,5,2017,14714,14170,544,3.7
"50007",50,7,1990,77122,74043,3079,4
"50007",50,7,1991,76546,72781,3765,4.9
"50007",50,7,1992,78485,75072,3413,4.3
"50007",50,7,1993,80702,77673,3029,3.8
"50007",50,7,1994,81708,79131,2577,3.2
"50007",50,7,1995,83366,80967,2399,2.9
"50007",50,7,1996,85383,82994,2389,2.8
"50007",50,7,1997,86658,84456,2202,2.5
"50007",50,7,1998,89540,87521,2019,2.3
"50007",50,7,1999,90556,88876,1680,1.9
"50007",50,7,2000,84114,82190,1924,2.3
"50007",50,7,2001,85086,82694,2392,2.8
"50007",50,7,2002,86110,83091,3019,3.5
"50007",50,7,2003,86525,83243,3282,3.8
"50007",50,7,2004,87043,84276,2767,3.2
"50007",50,7,2005,87236,84544,2692,3.1
"50007",50,7,2006,88480,85605,2875,3.2
"50007",50,7,2007,88330,85355,2975,3.4
"50007",50,7,2008,88974,85422,3552,4
"50007",50,7,2009,90375,85311,5064,5.6
"50007",50,7,2010,94581,90040,4541,4.8
"50007",50,7,2011,95502,91483,4019,4.2
"50007",50,7,2012,95835,92217,3618,3.8
"50007",50,7,2013,95084,91824,3260,3.4
"50007",50,7,2014,95549,92655,2894,3
"50007",50,7,2015,94808,92227,2581,2.7
"50007",50,7,2016,95181,92791,2390,2.5
"50007",50,7,2017,95645,93463,2182,2.3
"50009",50,9,1990,2792,2558,234,8.4
"50009",50,9,1991,2771,2501,270,9.7
"50009",50,9,1992,2854,2617,237,8.3
"50009",50,9,1993,2849,2626,223,7.8
"50009",50,9,1994,2803,2629,174,6.2
"50009",50,9,1995,2852,2646,206,7.2
"50009",50,9,1996,2829,2606,223,7.9
"50009",50,9,1997,2839,2648,191,6.7
"50009",50,9,1998,2847,2677,170,6
"50009",50,9,1999,2911,2745,166,5.7
"50009",50,9,2000,3224,3095,129,4
"50009",50,9,2001,3251,3112,139,4.3
"50009",50,9,2002,3286,3105,181,5.5
"50009",50,9,2003,3244,3085,159,4.9
"50009",50,9,2004,3242,3112,130,4
"50009",50,9,2005,3222,3101,121,3.8
"50009",50,9,2006,3290,3161,129,3.9
"50009",50,9,2007,3264,3092,172,5.3
"50009",50,9,2008,3260,3059,201,6.2
"50009",50,9,2009,3318,3022,296,8.9
"50009",50,9,2010,3171,2855,316,10
"50009",50,9,2011,3059,2803,256,8.4
"50009",50,9,2012,2933,2697,236,8
"50009",50,9,2013,2841,2649,192,6.8
"50009",50,9,2014,2770,2606,164,5.9
"50009",50,9,2015,2755,2596,159,5.8
"50009",50,9,2016,2701,2565,136,5
"50009",50,9,2017,2680,2555,125,4.7
"50011",50,11,1990,20898,19667,1231,5.9
"50011",50,11,1991,21101,19502,1599,7.6
"50011",50,11,1992,21513,20093,1420,6.6
"50011",50,11,1993,22004,20692,1312,6
"50011",50,11,1994,21997,20835,1162,5.3
"50011",50,11,1995,22230,21174,1056,4.8
"50011",50,11,1996,22731,21664,1067,4.7
"50011",50,11,1997,22984,22046,938,4.1
"50011",50,11,1998,23262,22487,775,3.3
"50011",50,11,1999,23879,23175,704,2.9
"50011",50,11,2000,24212,23494,718,3
"50011",50,11,2001,24676,23784,892,3.6
"50011",50,11,2002,25102,24042,1060,4.2
"50011",50,11,2003,25470,24269,1201,4.7
"50011",50,11,2004,25732,24696,1036,4
"50011",50,11,2005,25936,24955,981,3.8
"50011",50,11,2006,26432,25334,1098,4.2
"50011",50,11,2007,25965,24842,1123,4.3
"50011",50,11,2008,25996,24715,1281,4.9
"50011",50,11,2009,26617,24876,1741,6.5
"50011",50,11,2010,27686,26107,1579,5.7
"50011",50,11,2011,27902,26462,1440,5.2
"50011",50,11,2012,27854,26607,1247,4.5
"50011",50,11,2013,27490,26340,1150,4.2
"50011",50,11,2014,27475,26390,1085,3.9
"50011",50,11,2015,27281,26308,973,3.6
"50011",50,11,2016,27346,26494,852,3.1
"50011",50,11,2017,27427,26587,840,3.1
"50013",50,13,1990,2814,2619,195,6.9
"50013",50,13,1991,2874,2634,240,8.4
"50013",50,13,1992,2949,2710,239,8.1
"50013",50,13,1993,3045,2810,235,7.7
"50013",50,13,1994,3037,2817,220,7.2
"50013",50,13,1995,3077,2888,189,6.1
"50013",50,13,1996,3198,2988,210,6.6
"50013",50,13,1997,3314,3124,190,5.7
"50013",50,13,1998,3356,3200,156,4.6
"50013",50,13,1999,3502,3337,165,4.7
"50013",50,13,2000,3737,3591,146,3.9
"50013",50,13,2001,3858,3699,159,4.1
"50013",50,13,2002,3985,3790,195,4.9
"50013",50,13,2003,4116,3888,228,5.5
"50013",50,13,2004,4187,3990,197,4.7
"50013",50,13,2005,4248,4035,213,5
"50013",50,13,2006,4326,4101,225,5.2
"50013",50,13,2007,4197,3968,229,5.5
"50013",50,13,2008,4271,4012,259,6.1
"50013",50,13,2009,4262,3931,331,7.8
"50013",50,13,2010,4134,3848,286,6.9
"50013",50,13,2011,4167,3901,266,6.4
"50013",50,13,2012,4132,3909,223,5.4
"50013",50,13,2013,4054,3872,182,4.5
"50013",50,13,2014,4068,3886,182,4.5
"50013",50,13,2015,3933,3776,157,4
"50013",50,13,2016,3974,3825,149,3.7
"50013",50,13,2017,3993,3853,140,3.5
"50015",50,15,1990,10592,9875,717,6.8
"50015",50,15,1991,10251,9323,928,9.1
"50015",50,15,1992,10747,9846,901,8.4
"50015",50,15,1993,10979,10192,787,7.2
"50015",50,15,1994,11008,10290,718,6.5
"50015",50,15,1995,11280,10609,671,5.9
"50015",50,15,1996,11560,10810,750,6.5
"50015",50,15,1997,11869,11233,636,5.4
"50015",50,15,1998,11930,11368,562,4.7
"50015",50,15,1999,11993,11521,472,3.9
"50015",50,15,2000,13188,12767,421,3.2
"50015",50,15,2001,13427,12947,480,3.6
"50015",50,15,2002,13810,13230,580,4.2
"50015",50,15,2003,14012,13339,673,4.8
"50015",50,15,2004,14320,13732,588,4.1
"50015",50,15,2005,14587,14019,568,3.9
"50015",50,15,2006,15152,14524,628,4.1
"50015",50,15,2007,15112,14395,717,4.7
"50015",50,15,2008,15140,14315,825,5.4
"50015",50,15,2009,15694,14507,1187,7.6
"50015",50,15,2010,14496,13392,1104,7.6
"50015",50,15,2011,14552,13541,1011,6.9
"50015",50,15,2012,14041,13148,893,6.4
"50015",50,15,2013,13883,13094,789,5.7
"50015",50,15,2014,13757,13052,705,5.1
"50015",50,15,2015,13769,13130,639,4.6
"50015",50,15,2016,13913,13324,589,4.2
"50015",50,15,2017,14102,13543,559,4
"50017",50,17,1990,14117,13423,694,4.9
"50017",50,17,1991,14166,13239,927,6.5
"50017",50,17,1992,14047,13313,734,5.2
"50017",50,17,1993,14510,13915,595,4.1
"50017",50,17,1994,14856,14327,529,3.6
"50017",50,17,1995,15071,14518,553,3.7
"50017",50,17,1996,15180,14681,499,3.3
"50017",50,17,1997,15666,15181,485,3.1
"50017",50,17,1998,15853,15431,422,2.7
"50017",50,17,1999,15923,15557,366,2.3
"50017",50,17,2000,15339,14964,375,2.4
"50017",50,17,2001,15686,15243,443,2.8
"50017",50,17,2002,16134,15531,603,3.7
"50017",50,17,2003,16271,15647,624,3.8
"50017",50,17,2004,16162,15611,551,3.4
"50017",50,17,2005,16158,15634,524,3.2
"50017",50,17,2006,16673,16115,558,3.3
"50017",50,17,2007,16481,15866,615,3.7
"50017",50,17,2008,16312,15591,721,4.4
"50017",50,17,2009,16638,15605,1033,6.2
"50017",50,17,2010,16725,15743,982,5.9
"50017",50,17,2011,16597,15711,886,5.3
"50017",50,17,2012,16450,15676,774,4.7
"50017",50,17,2013,16176,15512,664,4.1
"50017",50,17,2014,15897,15288,609,3.8
"50017",50,17,2015,15883,15338,545,3.4
"50017",50,17,2016,15891,15396,495,3.1
"50017",50,17,2017,15934,15445,489,3.1
"50019",50,19,1990,11884,10971,913,7.7
"50019",50,19,1991,11972,10679,1293,10.8
"50019",50,19,1992,12109,10910,1199,9.9
"50019",50,19,1993,12290,11226,1064,8.7
"50019",50,19,1994,12445,11392,1053,8.5
"50019",50,19,1995,12532,11455,1077,8.6
"50019",50,19,1996,12280,11213,1067,8.7
"50019",50,19,1997,12357,11392,965,7.8
"50019",50,19,1998,12317,11443,874,7.1
"50019",50,19,1999,12536,11786,750,6
"50019",50,19,2000,12781,12219,562,4.4
"50019",50,19,2001,13279,12594,685,5.2
"50019",50,19,2002,13567,12739,828,6.1
"50019",50,19,2003,13828,12973,855,6.2
"50019",50,19,2004,13973,13260,713,5.1
"50019",50,19,2005,14087,13374,713,5.1
"50019",50,19,2006,14568,13788,780,5.4
"50019",50,19,2007,14364,13489,875,6.1
"50019",50,19,2008,14244,13256,988,6.9
"50019",50,19,2009,14587,13250,1337,9.2
"50019",50,19,2010,14213,12948,1265,8.9
"50019",50,19,2011,14169,12973,1196,8.4
"50019",50,19,2012,14120,13028,1092,7.7
"50019",50,19,2013,13824,12881,943,6.8
"50019",50,19,2014,13625,12772,853,6.3
"50019",50,19,2015,13589,12828,761,5.6
"50019",50,19,2016,13531,12820,711,5.3
"50019",50,19,2017,13720,13025,695,5.1
"50021",50,21,1990,32592,31024,1568,4.8
"50021",50,21,1991,31996,29790,2206,6.9
"50021",50,21,1992,32170,29787,2383,7.4
"50021",50,21,1993,32167,30207,1960,6.1
"50021",50,21,1994,31503,29810,1693,5.4
"50021",50,21,1995,32167,30638,1529,4.8
"50021",50,21,1996,32467,30855,1612,5
"50021",50,21,1997,32833,31312,1521,4.6
"50021",50,21,1998,32856,31581,1275,3.9
"50021",50,21,1999,32059,30861,1198,3.7
"50021",50,21,2000,33166,32119,1047,3.2
"50021",50,21,2001,33952,32758,1194,3.5
"50021",50,21,2002,34535,33128,1407,4.1
"50021",50,21,2003,34671,33053,1618,4.7
"50021",50,21,2004,35108,33692,1416,4
"50021",50,21,2005,35775,34466,1309,3.7
"50021",50,21,2006,36110,34684,1426,3.9
"50021",50,21,2007,35702,34142,1560,4.4
"50021",50,21,2008,35725,33764,1961,5.5
"50021",50,21,2009,35660,32831,2829,7.9
"50021",50,21,2010,33590,31105,2485,7.4
"50021",50,21,2011,33287,31025,2262,6.8
"50021",50,21,2012,32799,30755,2044,6.2
"50021",50,21,2013,32280,30562,1718,5.3
"50021",50,21,2014,31774,30275,1499,4.7
"50021",50,21,2015,31255,29925,1330,4.3
"50021",50,21,2016,31448,30256,1192,3.8
"50021",50,21,2017,30931,29839,1092,3.5
"50023",50,23,1990,29680,28087,1593,5.4
"50023",50,23,1991,29875,27729,2146,7.2
"50023",50,23,1992,29531,27507,2024,6.9
"50023",50,23,1993,30316,28675,1641,5.4
"50023",50,23,1994,30678,29202,1476,4.8
"50023",50,23,1995,30838,29353,1485,4.8
"50023",50,23,1996,30880,29384,1496,4.8
"50023",50,23,1997,31118,29649,1469,4.7
"50023",50,23,1998,31245,29968,1277,4.1
"50023",50,23,1999,31919,30878,1041,3.3
"50023",50,23,2000,32417,31536,881,2.7
"50023",50,23,2001,32640,31547,1093,3.3
"50023",50,23,2002,33464,32054,1410,4.2
"50023",50,23,2003,33896,32413,1483,4.4
"50023",50,23,2004,33898,32617,1281,3.8
"50023",50,23,2005,34179,32960,1219,3.6
"50023",50,23,2006,34540,33218,1322,3.8
"50023",50,23,2007,34153,32760,1393,4.1
"50023",50,23,2008,34349,32724,1625,4.7
"50023",50,23,2009,34838,32645,2193,6.3
"50023",50,23,2010,35117,33049,2068,5.9
"50023",50,23,2011,34863,33028,1835,5.3
"50023",50,23,2012,34630,32998,1632,4.7
"50023",50,23,2013,34583,33092,1491,4.3
"50023",50,23,2014,34263,32939,1324,3.9
"50023",50,23,2015,34037,32849,1188,3.5
"50023",50,23,2016,33887,32804,1083,3.2
"50023",50,23,2017,34124,33115,1009,3
"50025",50,25,1990,21756,20712,1044,4.8
"50025",50,25,1991,22051,20647,1404,6.4
"50025",50,25,1992,22356,21155,1201,5.4
"50025",50,25,1993,22739,21839,900,4
"50025",50,25,1994,23402,22432,970,4.1
"50025",50,25,1995,23618,22665,953,4
"50025",50,25,1996,23590,22679,911,3.9
"50025",50,25,1997,22970,22109,861,3.7
"50025",50,25,1998,23857,23112,745,3.1
"50025",50,25,1999,23678,23021,657,2.8
"50025",50,25,2000,24074,23394,680,2.8
"50025",50,25,2001,24073,23301,772,3.2
"50025",50,25,2002,24705,23874,831,3.4
"50025",50,25,2003,24702,23749,953,3.9
"50025",50,25,2004,24720,23860,860,3.5
"50025",50,25,2005,24992,24153,839,3.4
"50025",50,25,2006,24887,23953,934,3.8
"50025",50,25,2007,24701,23696,1005,4.1
"50025",50,25,2008,24819,23689,1130,4.6
"50025",50,25,2009,25259,23672,1587,6.3
"50025",50,25,2010,25435,23873,1562,6.1
"50025",50,25,2011,24980,23580,1400,5.6
"50025",50,25,2012,24668,23393,1275,5.2
"50025",50,25,2013,24092,22966,1126,4.7
"50025",50,25,2014,23519,22559,960,4.1
"50025",50,25,2015,23441,22605,836,3.6
"50025",50,25,2016,23207,22434,773,3.3
"50025",50,25,2017,22954,22247,707,3.1
"50027",50,27,1990,29203,27907,1296,4.4
"50027",50,27,1991,29186,27387,1799,6.2
"50027",50,27,1992,28904,27276,1628,5.6
"50027",50,27,1993,29269,27962,1307,4.5
"50027",50,27,1994,29890,28834,1056,3.5
"50027",50,27,1995,30029,28996,1033,3.4
"50027",50,27,1996,30104,29091,1013,3.4
"50027",50,27,1997,31171,30225,946,3
"50027",50,27,1998,31792,30950,842,2.6
"50027",50,27,1999,31986,31196,790,2.5
"50027",50,27,2000,30600,29831,769,2.5
"50027",50,27,2001,31052,30141,911,2.9
"50027",50,27,2002,31546,30437,1109,3.5
"50027",50,27,2003,31968,30783,1185,3.7
"50027",50,27,2004,32134,31103,1031,3.2
"50027",50,27,2005,32241,31280,961,3
"50027",50,27,2006,33021,32032,989,3
"50027",50,27,2007,32699,31596,1103,3.4
"50027",50,27,2008,32782,31539,1243,3.8
"50027",50,27,2009,33304,31379,1925,5.8
"50027",50,27,2010,31889,29942,1947,6.1
"50027",50,27,2011,31373,29660,1713,5.5
"50027",50,27,2012,30725,29295,1430,4.7
"50027",50,27,2013,30322,29054,1268,4.2
"50027",50,27,2014,29705,28612,1093,3.7
"50027",50,27,2015,29449,28501,948,3.2
"50027",50,27,2016,29316,28454,862,2.9
"50027",50,27,2017,29258,28508,750,2.6
"51001",51,1,1990,15110,14280,830,5.5
"51001",51,1,1991,15489,14387,1102,7.1
"51001",51,1,1992,15722,14257,1465,9.3
"51001",51,1,1993,15637,14245,1392,8.9
"51001",51,1,1994,15384,14146,1238,8
"51001",51,1,1995,15377,14109,1268,8.2
"51001",51,1,1996,15034,13654,1380,9.2
"51001",51,1,1997,14724,13373,1351,9.2
"51001",51,1,1998,14437,13489,948,6.6
"51001",51,1,1999,14764,13823,941,6.4
"51001",51,1,2000,18126,17583,543,3
"51001",51,1,2001,18346,17726,620,3.4
"51001",51,1,2002,19016,18222,794,4.2
"51001",51,1,2003,19225,18384,841,4.4
"51001",51,1,2004,19062,18160,902,4.7
"51001",51,1,2005,18785,17901,884,4.7
"51001",51,1,2006,18569,17774,795,4.3
"51001",51,1,2007,18780,18008,772,4.1
"51001",51,1,2008,18991,18044,947,5
"51001",51,1,2009,19704,18425,1279,6.5
"51001",51,1,2010,16805,15479,1326,7.9
"51001",51,1,2011,16591,15198,1393,8.4
"51001",51,1,2012,16419,15126,1293,7.9
"51001",51,1,2013,16230,15058,1172,7.2
"51001",51,1,2014,16062,14986,1076,6.7
"51001",51,1,2015,15877,15012,865,5.4
"51001",51,1,2016,15779,15002,777,4.9
"51001",51,1,2017,15948,15179,769,4.8
"51003",51,3,1990,35137,34383,754,2.1
"51003",51,3,1991,35314,34110,1204,3.4
"51003",51,3,1992,36323,34935,1388,3.8
"51003",51,3,1993,35977,34971,1006,2.8
"51003",51,3,1994,36599,35735,864,2.4
"51003",51,3,1995,36834,36115,719,2
"51003",51,3,1996,38366,37545,821,2.1
"51003",51,3,1997,38314,37679,635,1.7
"51003",51,3,1998,39643,39183,460,1.2
"51003",51,3,1999,39966,39520,446,1.1
"51003",51,3,2000,43562,42810,752,1.7
"51003",51,3,2001,44165,43207,958,2.2
"51003",51,3,2002,44322,42928,1394,3.1
"51003",51,3,2003,44702,43179,1523,3.4
"51003",51,3,2004,45638,44201,1437,3.1
"51003",51,3,2005,47414,46060,1354,2.9
"51003",51,3,2006,49842,48619,1223,2.5
"51003",51,3,2007,51326,50177,1149,2.2
"51003",51,3,2008,52650,51083,1567,3
"51003",51,3,2009,51932,49269,2663,5.1
"51003",51,3,2010,50987,47937,3050,6
"51003",51,3,2011,52161,49252,2909,5.6
"51003",51,3,2012,52640,49887,2753,5.2
"51003",51,3,2013,52528,49982,2546,4.8
"51003",51,3,2014,53593,51179,2414,4.5
"51003",51,3,2015,53914,51809,2105,3.9
"51003",51,3,2016,54377,52429,1948,3.6
"51003",51,3,2017,55748,53905,1843,3.3
"51005",51,5,1990,8597,7916,681,7.9
"51005",51,5,1991,8965,8063,902,10.1
"51005",51,5,1992,8007,7251,756,9.4
"51005",51,5,1993,8666,8043,623,7.2
"51005",51,5,1994,8482,7713,769,9.1
"51005",51,5,1995,8577,8029,548,6.4
"51005",51,5,1996,8532,8049,483,5.7
"51005",51,5,1997,8566,8069,497,5.8
"51005",51,5,1998,8502,8060,442,5.2
"51005",51,5,1999,8202,7737,465,5.7
"51005",51,5,2000,7732,7496,236,3.1
"51005",51,5,2001,7796,7469,327,4.2
"51005",51,5,2002,8026,7600,426,5.3
"51005",51,5,2003,7983,7613,370,4.6
"51005",51,5,2004,7458,7103,355,4.8
"51005",51,5,2005,7466,7112,354,4.7
"51005",51,5,2006,7342,6985,357,4.9
"51005",51,5,2007,6979,6675,304,4.4
"51005",51,5,2008,6882,6510,372,5.4
"51005",51,5,2009,7071,6427,644,9.1
"51005",51,5,2010,7951,7264,687,8.6
"51005",51,5,2011,7908,7286,622,7.9
"51005",51,5,2012,7802,7249,553,7.1
"51005",51,5,2013,7516,7020,496,6.6
"51005",51,5,2014,7196,6769,427,5.9
"51005",51,5,2015,7048,6691,357,5.1
"51005",51,5,2016,6924,6568,356,5.1
"51005",51,5,2017,6842,6509,333,4.9
"51007",51,7,1990,4325,4170,155,3.6
"51007",51,7,1991,4572,4272,300,6.6
"51007",51,7,1992,4553,4175,378,8.3
"51007",51,7,1993,4504,4215,289,6.4
"51007",51,7,1994,4511,4222,289,6.4
"51007",51,7,1995,4390,4162,228,5.2
"51007",51,7,1996,4301,4139,162,3.8
"51007",51,7,1997,4625,4410,215,4.6
"51007",51,7,1998,5047,4912,135,2.7
"51007",51,7,1999,5140,5013,127,2.5
"51007",51,7,2000,5866,5748,118,2
"51007",51,7,2001,5920,5769,151,2.6
"51007",51,7,2002,5997,5765,232,3.9
"51007",51,7,2003,5954,5720,234,3.9
"51007",51,7,2004,6086,5865,221,3.6
"51007",51,7,2005,6317,6098,219,3.5
"51007",51,7,2006,6481,6284,197,3
"51007",51,7,2007,6564,6383,181,2.8
"51007",51,7,2008,6762,6459,303,4.5
"51007",51,7,2009,6649,6134,515,7.7
"51007",51,7,2010,6227,5699,528,8.5
"51007",51,7,2011,6262,5793,469,7.5
"51007",51,7,2012,6219,5813,406,6.5
"51007",51,7,2013,6172,5806,366,5.9
"51007",51,7,2014,6209,5881,328,5.3
"51007",51,7,2015,6191,5914,277,4.5
"51007",51,7,2016,6190,5924,266,4.3
"51007",51,7,2017,6246,5996,250,4
"51009",51,9,1990,14416,13676,740,5.1
"51009",51,9,1991,14827,13928,899,6.1
"51009",51,9,1992,14846,13888,958,6.5
"51009",51,9,1993,14724,14080,644,4.4
"51009",51,9,1994,14912,14251,661,4.4
"51009",51,9,1995,14904,14356,548,3.7
"51009",51,9,1996,14607,14026,581,4
"51009",51,9,1997,14254,13797,457,3.2
"51009",51,9,1998,14337,14011,326,2.3
"51009",51,9,1999,14688,14431,257,1.7
"51009",51,9,2000,15411,15082,329,2.1
"51009",51,9,2001,15178,14623,555,3.7
"51009",51,9,2002,15200,14365,835,5.5
"51009",51,9,2003,15152,14397,755,5
"51009",51,9,2004,15033,14336,697,4.6
"51009",51,9,2005,15320,14685,635,4.1
"51009",51,9,2006,15529,15023,506,3.3
"51009",51,9,2007,15528,14988,540,3.5
"51009",51,9,2008,16024,15364,660,4.1
"51009",51,9,2009,15627,14417,1210,7.7
"51009",51,9,2010,16352,15030,1322,8.1
"51009",51,9,2011,16181,15003,1178,7.3
"51009",51,9,2012,16069,14993,1076,6.7
"51009",51,9,2013,15798,14830,968,6.1
"51009",51,9,2014,15629,14779,850,5.4
"51009",51,9,2015,15279,14549,730,4.8
"51009",51,9,2016,14970,14309,661,4.4
"51009",51,9,2017,15085,14455,630,4.2
"51011",51,11,1990,6266,5936,330,5.3
"51011",51,11,1991,6495,6036,459,7.1
"51011",51,11,1992,6792,6170,622,9.2
"51011",51,11,1993,6267,5808,459,7.3
"51011",51,11,1994,6163,5746,417,6.8
"51011",51,11,1995,6027,5662,365,6.1
"51011",51,11,1996,5802,5460,342,5.9
"51011",51,11,1997,5787,5459,328,5.7
"51011",51,11,1998,5657,5428,229,4
"51011",51,11,1999,5421,5207,214,3.9
"51011",51,11,2000,6767,6599,168,2.5
"51011",51,11,2001,6730,6438,292,4.3
"51011",51,11,2002,6707,6324,383,5.7
"51011",51,11,2003,6691,6317,374,5.6
"51011",51,11,2004,6686,6377,309,4.6
"51011",51,11,2005,6824,6500,324,4.7
"51011",51,11,2006,6961,6704,257,3.7
"51011",51,11,2007,6997,6725,272,3.9
"51011",51,11,2008,7297,6972,325,4.5
"51011",51,11,2009,7141,6577,564,7.9
"51011",51,11,2010,7343,6711,632,8.6
"51011",51,11,2011,7262,6684,578,8
"51011",51,11,2012,7222,6685,537,7.4
"51011",51,11,2013,7158,6696,462,6.5
"51011",51,11,2014,7116,6708,408,5.7
"51011",51,11,2015,7038,6694,344,4.9
"51011",51,11,2016,6988,6658,330,4.7
"51011",51,11,2017,7022,6709,313,4.5
"51013",51,13,1990,108861,106694,2167,2
"51013",51,13,1991,109170,105348,3822,3.5
"51013",51,13,1992,109801,105014,4787,4.4
"51013",51,13,1993,109698,104721,4977,4.5
"51013",51,13,1994,109823,105996,3827,3.5
"51013",51,13,1995,109621,105723,3898,3.6
"51013",51,13,1996,105413,102000,3413,3.2
"51013",51,13,1997,105923,103362,2561,2.4
"51013",51,13,1998,105900,104138,1762,1.7
"51013",51,13,1999,106826,105149,1677,1.6
"51013",51,13,2000,119330,117448,1882,1.6
"51013",51,13,2001,119188,116308,2880,2.4
"51013",51,13,2002,121119,117495,3624,3
"51013",51,13,2003,120433,117196,3237,2.7
"51013",51,13,2004,121992,118967,3025,2.5
"51013",51,13,2005,123328,120442,2886,2.3
"51013",51,13,2006,127332,124804,2528,2
"51013",51,13,2007,131366,128839,2527,1.9
"51013",51,13,2008,136705,133349,3356,2.5
"51013",51,13,2009,137201,131357,5844,4.3
"51013",51,13,2010,137368,131701,5667,4.1
"51013",51,13,2011,141853,136519,5334,3.8
"51013",51,13,2012,144012,139012,5000,3.5
"51013",51,13,2013,145047,140035,5012,3.5
"51013",51,13,2014,144531,139786,4745,3.3
"51013",51,13,2015,144282,140217,4065,2.8
"51013",51,13,2016,146166,142308,3858,2.6
"51013",51,13,2017,149627,145904,3723,2.5
"51015",51,15,1990,29209,28025,1184,4.1
"51015",51,15,1991,29864,28127,1737,5.8
"51015",51,15,1992,30364,28554,1810,6
"51015",51,15,1993,29760,28343,1417,4.8
"51015",51,15,1994,30147,28579,1568,5.2
"51015",51,15,1995,30357,28569,1788,5.9
"51015",51,15,1996,30867,29661,1206,3.9
"51015",51,15,1997,31560,30624,936,3
"51015",51,15,1998,31072,30380,692,2.2
"51015",51,15,1999,31895,31150,745,2.3
"51015",51,15,2000,34596,33919,677,2
"51015",51,15,2001,35182,34201,981,2.8
"51015",51,15,2002,35520,34269,1251,3.5
"51015",51,15,2003,35899,34665,1234,3.4
"51015",51,15,2004,35322,34209,1113,3.2
"51015",51,15,2005,36267,35148,1119,3.1
"51015",51,15,2006,36838,35860,978,2.7
"51015",51,15,2007,37183,36204,979,2.6
"51015",51,15,2008,37888,36518,1370,3.6
"51015",51,15,2009,38435,35964,2471,6.4
"51015",51,15,2010,37130,34481,2649,7.1
"51015",51,15,2011,37430,35060,2370,6.3
"51015",51,15,2012,37041,34897,2144,5.8
"51015",51,15,2013,36891,34964,1927,5.2
"51015",51,15,2014,36843,35111,1732,4.7
"51015",51,15,2015,36642,35139,1503,4.1
"51015",51,15,2016,36792,35433,1359,3.7
"51015",51,15,2017,36841,35575,1266,3.4
"51017",51,17,1990,2637,2317,320,12.1
"51017",51,17,1991,2759,2434,325,11.8
"51017",51,17,1992,2893,2564,329,11.4
"51017",51,17,1993,2835,2569,266,9.4
"51017",51,17,1994,2966,2553,413,13.9
"51017",51,17,1995,2656,2406,250,9.4
"51017",51,17,1996,2348,2182,166,7.1
"51017",51,17,1997,2348,2191,157,6.7
"51017",51,17,1998,2319,2176,143,6.2
"51017",51,17,1999,2392,2280,112,4.7
"51017",51,17,2000,2738,2664,74,2.7
"51017",51,17,2001,2716,2614,102,3.8
"51017",51,17,2002,2803,2679,124,4.4
"51017",51,17,2003,2870,2738,132,4.6
"51017",51,17,2004,2797,2694,103,3.7
"51017",51,17,2005,2927,2822,105,3.6
"51017",51,17,2006,2893,2798,95,3.3
"51017",51,17,2007,2930,2837,93,3.2
"51017",51,17,2008,2798,2684,114,4.1
"51017",51,17,2009,2690,2523,167,6.2
"51017",51,17,2010,2509,2320,189,7.5
"51017",51,17,2011,2576,2413,163,6.3
"51017",51,17,2012,2587,2436,151,5.8
"51017",51,17,2013,2577,2441,136,5.3
"51017",51,17,2014,2592,2476,116,4.5
"51017",51,17,2015,2536,2433,103,4.1
"51017",51,17,2016,2492,2399,93,3.7
"51017",51,17,2017,2452,2371,81,3.3
"51019",51,19,1990,27799,26587,1212,4.4
"51019",51,19,1991,29349,27751,1598,5.4
"51019",51,19,1992,30182,28505,1677,5.6
"51019",51,19,1993,30605,29376,1229,4
"51019",51,19,1994,31348,30342,1006,3.2
"51019",51,19,1995,31526,30548,978,3.1
"51019",51,19,1996,32106,31024,1082,3.4
"51019",51,19,1997,31680,30649,1031,3.3
"51019",51,19,1998,32618,31848,770,2.4
"51019",51,19,1999,33508,32840,668,2
"51019",51,19,2000,34724,34038,686,2
"51019",51,19,2001,34296,33157,1139,3.3
"51019",51,19,2002,34735,33115,1620,4.7
"51019",51,19,2003,34981,33518,1463,4.2
"51019",51,19,2004,35313,33930,1383,3.9
"51019",51,19,2005,36472,35191,1281,3.5
"51019",51,19,2006,37654,36524,1130,3
"51019",51,19,2007,37721,36597,1124,3
"51019",51,19,2008,38609,37194,1415,3.7
"51019",51,19,2009,37706,35138,2568,6.8
"51019",51,19,2010,39053,36302,2751,7
"51019",51,19,2011,38817,36307,2510,6.5
"51019",51,19,2012,38326,36038,2288,6
"51019",51,19,2013,38232,36052,2180,5.7
"51019",51,19,2014,38441,36471,1970,5.1
"51019",51,19,2015,38228,36531,1697,4.4
"51019",51,19,2016,37909,36346,1563,4.1
"51019",51,19,2017,38238,36740,1498,3.9
"51021",51,21,1990,3243,3050,193,6
"51021",51,21,1991,3616,3381,235,6.5
"51021",51,21,1992,3680,3444,236,6.4
"51021",51,21,1993,3409,3178,231,6.8
"51021",51,21,1994,3580,3301,279,7.8
"51021",51,21,1995,3586,3348,238,6.6
"51021",51,21,1996,3564,3314,250,7
"51021",51,21,1997,3535,3308,227,6.4
"51021",51,21,1998,3484,3336,148,4.2
"51021",51,21,1999,3479,3325,154,4.4
"51021",51,21,2000,2933,2779,154,5.3
"51021",51,21,2001,3048,2875,173,5.7
"51021",51,21,2002,3016,2856,160,5.3
"51021",51,21,2003,3020,2868,152,5
"51021",51,21,2004,2951,2814,137,4.6
"51021",51,21,2005,3060,2937,123,4
"51021",51,21,2006,3222,3100,122,3.8
"51021",51,21,2007,3385,3257,128,3.8
"51021",51,21,2008,3496,3330,166,4.7
"51021",51,21,2009,3595,3329,266,7.4
"51021",51,21,2010,2895,2646,249,8.6
"51021",51,21,2011,2859,2647,212,7.4
"51021",51,21,2012,2876,2674,202,7
"51021",51,21,2013,2877,2682,195,6.8
"51021",51,21,2014,2866,2693,173,6
"51021",51,21,2015,2781,2623,158,5.7
"51021",51,21,2016,2736,2591,145,5.3
"51021",51,21,2017,2731,2610,121,4.4
"51023",51,23,1990,13771,13279,492,3.6
"51023",51,23,1991,14422,13597,825,5.7
"51023",51,23,1992,14764,13936,828,5.6
"51023",51,23,1993,14898,14251,647,4.3
"51023",51,23,1994,15293,14797,496,3.2
"51023",51,23,1995,15897,15488,409,2.6
"51023",51,23,1996,16014,15606,408,2.5
"51023",51,23,1997,16140,15650,490,3
"51023",51,23,1998,16597,16197,400,2.4
"51023",51,23,1999,16673,16376,297,1.8
"51023",51,23,2000,16473,16178,295,1.8
"51023",51,23,2001,16684,16238,446,2.7
"51023",51,23,2002,17118,16491,627,3.7
"51023",51,23,2003,16788,16187,601,3.6
"51023",51,23,2004,16656,16095,561,3.4
"51023",51,23,2005,17017,16499,518,3
"51023",51,23,2006,17430,16976,454,2.6
"51023",51,23,2007,17421,16962,459,2.6
"51023",51,23,2008,17759,17180,579,3.3
"51023",51,23,2009,17491,16391,1100,6.3
"51023",51,23,2010,17700,16559,1141,6.4
"51023",51,23,2011,17729,16689,1040,5.9
"51023",51,23,2012,17727,16756,971,5.5
"51023",51,23,2013,17629,16703,926,5.3
"51023",51,23,2014,17687,16822,865,4.9
"51023",51,23,2015,17388,16659,729,4.2
"51023",51,23,2016,17325,16690,635,3.7
"51023",51,23,2017,17325,16705,620,3.6
"51025",51,25,1990,7148,6462,686,9.6
"51025",51,25,1991,7474,6475,999,13.4
"51025",51,25,1992,7558,6777,781,10.3
"51025",51,25,1993,7440,6844,596,8
"51025",51,25,1994,6902,6344,558,8.1
"51025",51,25,1995,6811,6338,473,6.9
"51025",51,25,1996,6619,6136,483,7.3
"51025",51,25,1997,6843,6411,432,6.3
"51025",51,25,1998,7336,7024,312,4.3
"51025",51,25,1999,7673,7364,309,4
"51025",51,25,2000,6851,6609,242,3.5
"51025",51,25,2001,6859,6486,373,5.4
"51025",51,25,2002,6826,6389,437,6.4
"51025",51,25,2003,6912,6429,483,7
"51025",51,25,2004,6731,6285,446,6.6
"51025",51,25,2005,6761,6410,351,5.2
"51025",51,25,2006,6832,6499,333,4.9
"51025",51,25,2007,6873,6543,330,4.8
"51025",51,25,2008,7044,6578,466,6.6
"51025",51,25,2009,7195,6388,807,11.2
"51025",51,25,2010,6953,6168,785,11.3
"51025",51,25,2011,6818,6098,720,10.6
"51025",51,25,2012,6732,6052,680,10.1
"51025",51,25,2013,6659,6035,624,9.4
"51025",51,25,2014,6467,5944,523,8.1
"51025",51,25,2015,6332,5901,431,6.8
"51025",51,25,2016,6202,5830,372,6
"51025",51,25,2017,6006,5676,330,5.5
"51027",51,27,1990,11418,10132,1286,11.3
"51027",51,27,1991,11887,10089,1798,15.1
"51027",51,27,1992,11595,9732,1863,16.1
"51027",51,27,1993,10849,9191,1658,15.3
"51027",51,27,1994,10643,8700,1943,18.3
"51027",51,27,1995,9586,8289,1297,13.5
"51027",51,27,1996,9523,8081,1442,15.1
"51027",51,27,1997,9621,8261,1360,14.1
"51027",51,27,1998,8955,7675,1280,14.3
"51027",51,27,1999,8373,7218,1155,13.8
"51027",51,27,2000,8738,8223,515,5.9
"51027",51,27,2001,8881,8344,537,6
"51027",51,27,2002,8983,8344,639,7.1
"51027",51,27,2003,8838,8220,618,7
"51027",51,27,2004,8317,7834,483,5.8
"51027",51,27,2005,8401,7947,454,5.4
"51027",51,27,2006,8419,7997,422,5
"51027",51,27,2007,8657,8235,422,4.9
"51027",51,27,2008,8950,8502,448,5
"51027",51,27,2009,9236,8448,788,8.5
"51027",51,27,2010,8326,7497,829,10
"51027",51,27,2011,8475,7750,725,8.6
"51027",51,27,2012,8589,7807,782,9.1
"51027",51,27,2013,8169,7269,900,11
"51027",51,27,2014,7771,6956,815,10.5
"51027",51,27,2015,7277,6487,790,10.9
"51027",51,27,2016,6853,6113,740,10.8
"51027",51,27,2017,6703,6193,510,7.6
"51029",51,29,1990,5555,5253,302,5.4
"51029",51,29,1991,5836,5374,462,7.9
"51029",51,29,1992,5753,5344,409,7.1
"51029",51,29,1993,5748,5416,332,5.8
"51029",51,29,1994,6098,5814,284,4.7
"51029",51,29,1995,6298,5984,314,5
"51029",51,29,1996,6245,5928,317,5.1
"51029",51,29,1997,6285,5915,370,5.9
"51029",51,29,1998,6174,5854,320,5.2
"51029",51,29,1999,6004,5757,247,4.1
"51029",51,29,2000,6145,5947,198,3.2
"51029",51,29,2001,6204,5990,214,3.4
"51029",51,29,2002,6229,5988,241,3.9
"51029",51,29,2003,6425,6144,281,4.4
"51029",51,29,2004,6666,6377,289,4.3
"51029",51,29,2005,6783,6486,297,4.4
"51029",51,29,2006,6836,6589,247,3.6
"51029",51,29,2007,6998,6756,242,3.5
"51029",51,29,2008,7268,6911,357,4.9
"51029",51,29,2009,7372,6775,597,8.1
"51029",51,29,2010,6568,5868,700,10.7
"51029",51,29,2011,6594,5963,631,9.6
"51029",51,29,2012,6474,5922,552,8.5
"51029",51,29,2013,6408,5900,508,7.9
"51029",51,29,2014,6302,5872,430,6.8
"51029",51,29,2015,6293,5920,373,5.9
"51029",51,29,2016,6258,5916,342,5.5
"51029",51,29,2017,6406,6060,346,5.4
"51031",51,31,1990,26019,24638,1381,5.3
"51031",51,31,1991,26795,25192,1603,6
"51031",51,31,1992,27053,25212,1841,6.8
"51031",51,31,1993,26686,25506,1180,4.4
"51031",51,31,1994,26675,25533,1142,4.3
"51031",51,31,1995,26687,25619,1068,4
"51031",51,31,1996,26232,25209,1023,3.9
"51031",51,31,1997,25980,24994,986,3.8
"51031",51,31,1998,26105,25377,728,2.8
"51031",51,31,1999,26510,25931,579,2.2
"51031",51,31,2000,26509,25892,617,2.3
"51031",51,31,2001,26134,25019,1115,4.3
"51031",51,31,2002,26392,24876,1516,5.7
"51031",51,31,2003,26171,24862,1309,5
"51031",51,31,2004,25990,24834,1156,4.4
"51031",51,31,2005,26677,25613,1064,4
"51031",51,31,2006,27168,26281,887,3.3
"51031",51,31,2007,27253,26320,933,3.4
"51031",51,31,2008,27915,26807,1108,4
"51031",51,31,2009,27137,25175,1962,7.2
"51031",51,31,2010,27756,25614,2142,7.7
"51031",51,31,2011,27607,25629,1978,7.2
"51031",51,31,2012,27088,25336,1752,6.5
"51031",51,31,2013,26938,25332,1606,6
"51031",51,31,2014,26633,25199,1434,5.4
"51031",51,31,2015,26223,24982,1241,4.7
"51031",51,31,2016,25904,24745,1159,4.5
"51031",51,31,2017,26129,25031,1098,4.2
"51033",51,33,1990,9948,9205,743,7.5
"51033",51,33,1991,10256,9136,1120,10.9
"51033",51,33,1992,10754,9508,1246,11.6
"51033",51,33,1993,10505,9551,954,9.1
"51033",51,33,1994,10449,9695,754,7.2
"51033",51,33,1995,10187,9426,761,7.5
"51033",51,33,1996,10038,9207,831,8.3
"51033",51,33,1997,10205,9441,764,7.5
"51033",51,33,1998,10117,9611,506,5
"51033",51,33,1999,10572,10226,346,3.3
"51033",51,33,2000,10999,10758,241,2.2
"51033",51,33,2001,11072,10735,337,3
"51033",51,33,2002,11285,10799,486,4.3
"51033",51,33,2003,11490,10999,491,4.3
"51033",51,33,2004,11947,11463,484,4.1
"51033",51,33,2005,12862,12369,493,3.8
"51033",51,33,2006,13560,13095,465,3.4
"51033",51,33,2007,13902,13385,517,3.7
"51033",51,33,2008,14271,13588,683,4.8
"51033",51,33,2009,14126,12941,1185,8.4
"51033",51,33,2010,14342,12972,1370,9.6
"51033",51,33,2011,14477,13175,1302,9
"51033",51,33,2012,14504,13373,1131,7.8
"51033",51,33,2013,14580,13550,1030,7.1
"51033",51,33,2014,14772,13858,914,6.2
"51033",51,33,2015,14732,13981,751,5.1
"51033",51,33,2016,14836,14169,667,4.5
"51033",51,33,2017,15099,14448,651,4.3
"51035",51,35,1990,13637,12595,1042,7.6
"51035",51,35,1991,14199,12868,1331,9.4
"51035",51,35,1992,14651,13457,1194,8.1
"51035",51,35,1993,14096,13262,834,5.9
"51035",51,35,1994,14097,13440,657,4.7
"51035",51,35,1995,14108,13422,686,4.9
"51035",51,35,1996,14021,13178,843,6
"51035",51,35,1997,13694,13130,564,4.1
"51035",51,35,1998,13719,12977,742,5.4
"51035",51,35,1999,13957,13018,939,6.7
"51035",51,35,2000,14817,14215,602,4.1
"51035",51,35,2001,14830,13803,1027,6.9
"51035",51,35,2002,14782,13802,980,6.6
"51035",51,35,2003,14855,14024,831,5.6
"51035",51,35,2004,14464,13732,732,5.1
"51035",51,35,2005,14383,13570,813,5.7
"51035",51,35,2006,13826,13097,729,5.3
"51035",51,35,2007,13901,13116,785,5.6
"51035",51,35,2008,14058,13124,934,6.6
"51035",51,35,2009,14407,12848,1559,10.8
"51035",51,35,2010,14004,12388,1616,11.5
"51035",51,35,2011,13629,12284,1345,9.9
"51035",51,35,2012,13494,12343,1151,8.5
"51035",51,35,2013,13264,12164,1100,8.3
"51035",51,35,2014,13188,12300,888,6.7
"51035",51,35,2015,13049,12351,698,5.3
"51035",51,35,2016,12944,12273,671,5.2
"51035",51,35,2017,12997,12392,605,4.7
"51036",51,36,1990,3405,3225,180,5.3
"51036",51,36,1991,3503,3196,307,8.8
"51036",51,36,1992,3564,3215,349,9.8
"51036",51,36,1993,3593,3293,300,8.3
"51036",51,36,1994,3611,3373,238,6.6
"51036",51,36,1995,3667,3454,213,5.8
"51036",51,36,1996,3591,3416,175,4.9
"51036",51,36,1997,3633,3461,172,4.7
"51036",51,36,1998,3725,3603,122,3.3
"51036",51,36,1999,3759,3656,103,2.7
"51036",51,36,2000,3616,3526,90,2.5
"51036",51,36,2001,3698,3517,181,4.9
"51036",51,36,2002,3725,3530,195,5.2
"51036",51,36,2003,3728,3539,189,5.1
"51036",51,36,2004,3743,3551,192,5.1
"51036",51,36,2005,3757,3592,165,4.4
"51036",51,36,2006,3837,3684,153,4
"51036",51,36,2007,3809,3660,149,3.9
"51036",51,36,2008,3886,3692,194,5
"51036",51,36,2009,3833,3488,345,9
"51036",51,36,2010,3901,3527,374,9.6
"51036",51,36,2011,3937,3583,354,9
"51036",51,36,2012,3854,3552,302,7.8
"51036",51,36,2013,3789,3532,257,6.8
"51036",51,36,2014,3719,3496,223,6
"51036",51,36,2015,3717,3519,198,5.3
"51036",51,36,2016,3715,3544,171,4.6
"51036",51,36,2017,3772,3591,181,4.8
"51037",51,37,1990,5740,5158,582,10.1
"51037",51,37,1991,5630,5224,406,7.2
"51037",51,37,1992,6024,5377,647,10.7
"51037",51,37,1993,5756,5225,531,9.2
"51037",51,37,1994,5564,5216,348,6.3
"51037",51,37,1995,5707,5294,413,7.2
"51037",51,37,1996,5824,5312,512,8.8
"51037",51,37,1997,6096,5712,384,6.3
"51037",51,37,1998,5994,5773,221,3.7
"51037",51,37,1999,6072,5883,189,3.1
"51037",51,37,2000,5518,5343,175,3.2
"51037",51,37,2001,5480,5243,237,4.3
"51037",51,37,2002,5542,5127,415,7.5
"51037",51,37,2003,5636,5268,368,6.5
"51037",51,37,2004,5511,5175,336,6.1
"51037",51,37,2005,5424,4976,448,8.3
"51037",51,37,2006,5257,4904,353,6.7
"51037",51,37,2007,5268,4988,280,5.3
"51037",51,37,2008,5435,5114,321,5.9
"51037",51,37,2009,5548,5037,511,9.2
"51037",51,37,2010,5356,4820,536,10
"51037",51,37,2011,5399,4871,528,9.8
"51037",51,37,2012,5365,4898,467,8.7
"51037",51,37,2013,5314,4900,414,7.8
"51037",51,37,2014,5300,4941,359,6.8
"51037",51,37,2015,5251,4951,300,5.7
"51037",51,37,2016,5246,4981,265,5.1
"51037",51,37,2017,5250,5001,249,4.7
"51041",51,41,1990,119955,116138,3817,3.2
"51041",51,41,1991,125829,120241,5588,4.4
"51041",51,41,1992,130074,123622,6452,5
"51041",51,41,1993,129819,124319,5500,4.2
"51041",51,41,1994,134476,129495,4981,3.7
"51041",51,41,1995,136015,131832,4183,3.1
"51041",51,41,1996,133958,129845,4113,3.1
"51041",51,41,1997,134931,131275,3656,2.7
"51041",51,41,1998,139335,136397,2938,2.1
"51041",51,41,1999,141187,138501,2686,1.9
"51041",51,41,2000,142307,139745,2562,1.8
"51041",51,41,2001,144983,141222,3761,2.6
"51041",51,41,2002,147501,142446,5055,3.4
"51041",51,41,2003,149730,144448,5282,3.5
"51041",51,41,2004,153616,148428,5188,3.4
"51041",51,41,2005,158613,153561,5052,3.2
"51041",51,41,2006,164168,159569,4599,2.8
"51041",51,41,2007,165682,161332,4350,2.6
"51041",51,41,2008,169943,163728,6215,3.7
"51041",51,41,2009,167338,156218,11120,6.6
"51041",51,41,2010,168602,156307,12295,7.3
"51041",51,41,2011,171539,159940,11599,6.8
"51041",51,41,2012,172990,162433,10557,6.1
"51041",51,41,2013,174669,164793,9876,5.7
"51041",51,41,2014,177421,168309,9112,5.1
"51041",51,41,2015,177952,170285,7667,4.3
"51041",51,41,2016,180468,173436,7032,3.9
"51041",51,41,2017,183860,177184,6676,3.6
"51043",51,43,1990,6441,6251,190,2.9
"51043",51,43,1991,6471,6117,354,5.5
"51043",51,43,1992,6394,6063,331,5.2
"51043",51,43,1993,6269,6059,210,3.3
"51043",51,43,1994,6308,6135,173,2.7
"51043",51,43,1995,6418,6223,195,3
"51043",51,43,1996,6322,6132,190,3
"51043",51,43,1997,6370,6210,160,2.5
"51043",51,43,1998,6404,6284,120,1.9
"51043",51,43,1999,6495,6399,96,1.5
"51043",51,43,2000,6908,6798,110,1.6
"51043",51,43,2001,7068,6910,158,2.2
"51043",51,43,2002,7068,6853,215,3
"51043",51,43,2003,7106,6885,221,3.1
"51043",51,43,2004,7387,7174,213,2.9
"51043",51,43,2005,7738,7537,201,2.6
"51043",51,43,2006,8054,7855,199,2.5
"51043",51,43,2007,8017,7802,215,2.7
"51043",51,43,2008,8195,7915,280,3.4
"51043",51,43,2009,8102,7591,511,6.3
"51043",51,43,2010,7695,7181,514,6.7
"51043",51,43,2011,7773,7328,445,5.7
"51043",51,43,2012,7737,7332,405,5.2
"51043",51,43,2013,7623,7261,362,4.7
"51043",51,43,2014,7545,7213,332,4.4
"51043",51,43,2015,7430,7134,296,4
"51043",51,43,2016,7423,7156,267,3.6
"51043",51,43,2017,7519,7261,258,3.4
"51045",51,45,1990,2214,2077,137,6.2
"51045",51,45,1991,2397,2213,184,7.7
"51045",51,45,1992,3380,3214,166,4.9
"51045",51,45,1993,2447,2293,154,6.3
"51045",51,45,1994,2406,2265,141,5.9
"51045",51,45,1995,2436,2323,113,4.6
"51045",51,45,1996,2378,2272,106,4.5
"51045",51,45,1997,2472,2365,107,4.3
"51045",51,45,1998,2179,2028,151,6.9
"51045",51,45,1999,2080,1992,88,4.2
"51045",51,45,2000,2503,2442,61,2.4
"51045",51,45,2001,2505,2432,73,2.9
"51045",51,45,2002,2534,2431,103,4.1
"51045",51,45,2003,2487,2385,102,4.1
"51045",51,45,2004,2471,2372,99,4
"51045",51,45,2005,2500,2402,98,3.9
"51045",51,45,2006,2556,2467,89,3.5
"51045",51,45,2007,2559,2464,95,3.7
"51045",51,45,2008,2552,2450,102,4
"51045",51,45,2009,2443,2263,180,7.4
"51045",51,45,2010,2441,2247,194,7.9
"51045",51,45,2011,2481,2294,187,7.5
"51045",51,45,2012,2465,2292,173,7
"51045",51,45,2013,2456,2283,173,7
"51045",51,45,2014,2458,2302,156,6.3
"51045",51,45,2015,2380,2249,131,5.5
"51045",51,45,2016,2347,2234,113,4.8
"51045",51,45,2017,2336,2234,102,4.4
"51047",51,47,1990,14360,13829,531,3.7
"51047",51,47,1991,14996,13939,1057,7
"51047",51,47,1992,15087,14025,1062,7
"51047",51,47,1993,14696,14084,612,4.2
"51047",51,47,1994,14990,14324,666,4.4
"51047",51,47,1995,15725,15019,706,4.5
"51047",51,47,1996,15654,14920,734,4.7
"51047",51,47,1997,15536,15037,499,3.2
"51047",51,47,1998,15923,15588,335,2.1
"51047",51,47,1999,16259,15936,323,2
"51047",51,47,2000,16930,16604,326,1.9
"51047",51,47,2001,17352,16898,454,2.6
"51047",51,47,2002,17557,16890,667,3.8
"51047",51,47,2003,17933,17208,725,4
"51047",51,47,2004,17939,17294,645,3.6
"51047",51,47,2005,19022,18391,631,3.3
"51047",51,47,2006,20066,19410,656,3.3
"51047",51,47,2007,20225,19497,728,3.6
"51047",51,47,2008,20962,19956,1006,4.8
"51047",51,47,2009,21308,19622,1686,7.9
"51047",51,47,2010,23263,21591,1672,7.2
"51047",51,47,2011,23397,21908,1489,6.4
"51047",51,47,2012,23362,22034,1328,5.7
"51047",51,47,2013,23378,22123,1255,5.4
"51047",51,47,2014,23348,22177,1171,5
"51047",51,47,2015,23103,22098,1005,4.4
"51047",51,47,2016,23415,22498,917,3.9
"51047",51,47,2017,23786,22926,860,3.6
"51049",51,49,1990,3875,3698,177,4.6
"51049",51,49,1991,4087,3819,268,6.6
"51049",51,49,1992,4302,3991,311,7.2
"51049",51,49,1993,4083,3864,219,5.4
"51049",51,49,1994,3955,3841,114,2.9
"51049",51,49,1995,4002,3896,106,2.6
"51049",51,49,1996,3925,3812,113,2.9
"51049",51,49,1997,3895,3708,187,4.8
"51049",51,49,1998,3745,3638,107,2.9
"51049",51,49,1999,3794,3720,74,2
"51049",51,49,2000,4237,4142,95,2.2
"51049",51,49,2001,4214,4096,118,2.8
"51049",51,49,2002,4237,4081,156,3.7
"51049",51,49,2003,4276,4103,173,4
"51049",51,49,2004,4310,4136,174,4
"51049",51,49,2005,4452,4277,175,3.9
"51049",51,49,2006,4523,4366,157,3.5
"51049",51,49,2007,4592,4445,147,3.2
"51049",51,49,2008,4699,4475,224,4.8
"51049",51,49,2009,4598,4262,336,7.3
"51049",51,49,2010,4523,4141,382,8.4
"51049",51,49,2011,4561,4212,349,7.7
"51049",51,49,2012,4528,4205,323,7.1
"51049",51,49,2013,4508,4208,300,6.7
"51049",51,49,2014,4538,4259,279,6.1
"51049",51,49,2015,4555,4320,235,5.2
"51049",51,49,2016,4597,4383,214,4.7
"51049",51,49,2017,4634,4438,196,4.2
"51051",51,51,1990,6247,5195,1052,16.8
"51051",51,51,1991,6360,5287,1073,16.9
"51051",51,51,1992,6443,5307,1136,17.6
"51051",51,51,1993,6288,5310,978,15.6
"51051",51,51,1994,6451,5236,1215,18.8
"51051",51,51,1995,6278,5055,1223,19.5
"51051",51,51,1996,5967,4738,1229,20.6
"51051",51,51,1997,5837,4894,943,16.2
"51051",51,51,1998,5740,4824,916,16
"51051",51,51,1999,5392,4725,667,12.4
"51051",51,51,2000,5365,5052,313,5.8
"51051",51,51,2001,5491,5104,387,7
"51051",51,51,2002,5650,5206,444,7.9
"51051",51,51,2003,5796,5304,492,8.5
"51051",51,51,2004,5558,5206,352,6.3
"51051",51,51,2005,5720,5350,370,6.5
"51051",51,51,2006,5660,5369,291,5.1
"51051",51,51,2007,5787,5484,303,5.2
"51051",51,51,2008,6074,5727,347,5.7
"51051",51,51,2009,6442,5884,558,8.7
"51051",51,51,2010,5513,4934,579,10.5
"51051",51,51,2011,5459,4920,539,9.9
"51051",51,51,2012,5217,4661,556,10.7
"51051",51,51,2013,5347,4750,597,11.2
"51051",51,51,2014,5196,4666,530,10.2
"51051",51,51,2015,4911,4415,496,10.1
"51051",51,51,2016,4570,4112,458,10
"51051",51,51,2017,4408,4085,323,7.3
"51053",51,53,1990,10530,9994,536,5.1
"51053",51,53,1991,10807,10031,776,7.2
"51053",51,53,1992,11276,10397,879,7.8
"51053",51,53,1993,10495,9790,705,6.7
"51053",51,53,1994,11238,10569,669,6
"51053",51,53,1995,11112,10614,498,4.5
"51053",51,53,1996,11558,11095,463,4
"51053",51,53,1997,11636,11201,435,3.7
"51053",51,53,1998,12041,11724,317,2.6
"51053",51,53,1999,12144,11839,305,2.5
"51053",51,53,2000,12037,11784,253,2.1
"51053",51,53,2001,11981,11618,363,3
"51053",51,53,2002,12074,11590,484,4
"51053",51,53,2003,12110,11617,493,4.1
"51053",51,53,2004,12280,11798,482,3.9
"51053",51,53,2005,12594,12072,522,4.1
"51053",51,53,2006,12770,12362,408,3.2
"51053",51,53,2007,12841,12399,442,3.4
"51053",51,53,2008,13191,12593,598,4.5
"51053",51,53,2009,13060,12011,1049,8
"51053",51,53,2010,13566,12367,1199,8.8
"51053",51,53,2011,13643,12555,1088,8
"51053",51,53,2012,13637,12603,1034,7.6
"51053",51,53,2013,13541,12544,997,7.4
"51053",51,53,2014,13462,12591,871,6.5
"51053",51,53,2015,13311,12589,722,5.4
"51053",51,53,2016,13427,12766,661,4.9
"51053",51,53,2017,13588,12976,612,4.5
"51057",51,57,1990,4373,4076,297,6.8
"51057",51,57,1991,4674,4277,397,8.5
"51057",51,57,1992,4750,4378,372,7.8
"51057",51,57,1993,4758,4423,335,7
"51057",51,57,1994,4643,4335,308,6.6
"51057",51,57,1995,4635,4271,364,7.9
"51057",51,57,1996,4510,4106,404,9
"51057",51,57,1997,4399,4089,310,7
"51057",51,57,1998,4332,4091,241,5.6
"51057",51,57,1999,4372,4174,198,4.5
"51057",51,57,2000,5151,5013,138,2.7
"51057",51,57,2001,5258,5087,171,3.3
"51057",51,57,2002,5335,5098,237,4.4
"51057",51,57,2003,5313,5026,287,5.4
"51057",51,57,2004,5341,5109,232,4.3
"51057",51,57,2005,5388,5135,253,4.7
"51057",51,57,2006,5432,5217,215,4
"51057",51,57,2007,5491,5290,201,3.7
"51057",51,57,2008,5650,5357,293,5.2
"51057",51,57,2009,5821,5351,470,8.1
"51057",51,57,2010,5715,5196,519,9.1
"51057",51,57,2011,5699,5226,473,8.3
"51057",51,57,2012,5742,5321,421,7.3
"51057",51,57,2013,5685,5307,378,6.6
"51057",51,57,2014,5682,5319,363,6.4
"51057",51,57,2015,5511,5214,297,5.4
"51057",51,57,2016,5517,5247,270,4.9
"51057",51,57,2017,5470,5196,274,5
"51059",51,59,1990,485432,475838,9594,2
"51059",51,59,1991,494334,478675,15659,3.2
"51059",51,59,1992,501227,482515,18712,3.7
"51059",51,59,1993,503911,486732,17179,3.4
"51059",51,59,1994,512251,496677,15574,3
"51059",51,59,1995,513279,498634,14645,2.9
"51059",51,59,1996,508305,494436,13869,2.7
"51059",51,59,1997,511399,500193,11206,2.2
"51059",51,59,1998,522884,514618,8266,1.6
"51059",51,59,1999,537477,529145,8332,1.6
"51059",51,59,2000,550713,541678,9035,1.6
"51059",51,59,2001,556089,541978,14111,2.5
"51059",51,59,2002,552845,534079,18766,3.4
"51059",51,59,2003,547743,530829,16914,3.1
"51059",51,59,2004,554326,538900,15426,2.8
"51059",51,59,2005,568187,553530,14657,2.6
"51059",51,59,2006,577489,564587,12902,2.2
"51059",51,59,2007,581377,568732,12645,2.2
"51059",51,59,2008,592899,576057,16842,2.8
"51059",51,59,2009,587584,559644,27940,4.8
"51059",51,59,2010,610521,579499,31022,5.1
"51059",51,59,2011,620197,590687,29510,4.8
"51059",51,59,2012,623843,595687,28156,4.5
"51059",51,59,2013,624266,596686,27580,4.4
"51059",51,59,2014,619812,593857,25955,4.2
"51059",51,59,2015,613618,591702,21916,3.6
"51059",51,59,2016,615851,595796,20055,3.3
"51059",51,59,2017,629698,610531,19167,3
"51061",51,61,1990,26639,25950,689,2.6
"51061",51,61,1991,27273,25967,1306,4.8
"51061",51,61,1992,27633,26234,1399,5.1
"51061",51,61,1993,27030,26112,918,3.4
"51061",51,61,1994,27291,26406,885,3.2
"51061",51,61,1995,27102,26222,880,3.2
"51061",51,61,1996,26683,25906,777,2.9
"51061",51,61,1997,27030,26393,637,2.4
"51061",51,61,1998,27749,27260,489,1.8
"51061",51,61,1999,28561,28148,413,1.4
"51061",51,61,2000,30217,29747,470,1.6
"51061",51,61,2001,31078,30409,669,2.2
"51061",51,61,2002,31829,30844,985,3.1
"51061",51,61,2003,32377,31367,1010,3.1
"51061",51,61,2004,33627,32674,953,2.8
"51061",51,61,2005,35413,34463,950,2.7
"51061",51,61,2006,36551,35651,900,2.5
"51061",51,61,2007,36930,36005,925,2.5
"51061",51,61,2008,37829,36566,1263,3.3
"51061",51,61,2009,37407,35359,2048,5.5
"51061",51,61,2010,35763,33552,2211,6.2
"51061",51,61,2011,36128,34138,1990,5.5
"51061",51,61,2012,36022,34169,1853,5.1
"51061",51,61,2013,35911,34139,1772,4.9
"51061",51,61,2014,35919,34267,1652,4.6
"51061",51,61,2015,35726,34315,1411,3.9
"51061",51,61,2016,35872,34611,1261,3.5
"51061",51,61,2017,36391,35199,1192,3.3
"51063",51,63,1990,6195,5683,512,8.3
"51063",51,63,1991,6439,5752,687,10.7
"51063",51,63,1992,6513,5918,595,9.1
"51063",51,63,1993,6394,5904,490,7.7
"51063",51,63,1994,6392,5987,405,6.3
"51063",51,63,1995,6464,6136,328,5.1
"51063",51,63,1996,6479,6139,340,5.2
"51063",51,63,1997,6507,6261,246,3.8
"51063",51,63,1998,6449,6259,190,2.9
"51063",51,63,1999,6791,6493,298,4.4
"51063",51,63,2000,6977,6717,260,3.7
"51063",51,63,2001,6855,6560,295,4.3
"51063",51,63,2002,6765,6467,298,4.4
"51063",51,63,2003,7269,6975,294,4
"51063",51,63,2004,6884,6599,285,4.1
"51063",51,63,2005,7094,6830,264,3.7
"51063",51,63,2006,6998,6768,230,3.3
"51063",51,63,2007,7107,6859,248,3.5
"51063",51,63,2008,7162,6846,316,4.4
"51063",51,63,2009,7336,6776,560,7.6
"51063",51,63,2010,8134,7567,567,7
"51063",51,63,2011,8334,7806,528,6.3
"51063",51,63,2012,8378,7903,475,5.7
"51063",51,63,2013,8387,7933,454,5.4
"51063",51,63,2014,8301,7915,386,4.7
"51063",51,63,2015,8292,7962,330,4
"51063",51,63,2016,8178,7842,336,4.1
"51063",51,63,2017,8093,7794,299,3.7
"51065",51,65,1990,6395,6214,181,2.8
"51065",51,65,1991,6789,6431,358,5.3
"51065",51,65,1992,7160,6771,389,5.4
"51065",51,65,1993,7320,7052,268,3.7
"51065",51,65,1994,7646,7353,293,3.8
"51065",51,65,1995,8037,7794,243,3
"51065",51,65,1996,8328,8104,224,2.7
"51065",51,65,1997,8733,8530,203,2.3
"51065",51,65,1998,9330,9190,140,1.5
"51065",51,65,1999,9641,9532,109,1.1
"51065",51,65,2000,10227,10024,203,2
"51065",51,65,2001,10639,10374,265,2.5
"51065",51,65,2002,11234,10872,362,3.2
"51065",51,65,2003,11664,11263,401,3.4
"51065",51,65,2004,12041,11663,378,3.1
"51065",51,65,2005,12793,12400,393,3.1
"51065",51,65,2006,13385,13065,320,2.4
"51065",51,65,2007,13799,13473,326,2.4
"51065",51,65,2008,14162,13695,467,3.3
"51065",51,65,2009,13992,13190,802,5.7
"51065",51,65,2010,13078,12253,825,6.3
"51065",51,65,2011,13266,12494,772,5.8
"51065",51,65,2012,13178,12486,692,5.3
"51065",51,65,2013,13031,12409,622,4.8
"51065",51,65,2014,13166,12589,577,4.4
"51065",51,65,2015,13160,12664,496,3.8
"51065",51,65,2016,13162,12715,447,3.4
"51065",51,65,2017,13519,13106,413,3.1
"51067",51,67,1990,21289,20044,1245,5.8
"51067",51,67,1991,21717,19836,1881,8.7
"51067",51,67,1992,21785,20488,1297,6
"51067",51,67,1993,22081,21135,946,4.3
"51067",51,67,1994,23112,22020,1092,4.7
"51067",51,67,1995,22741,21511,1230,5.4
"51067",51,67,1996,22525,21386,1139,5.1
"51067",51,67,1997,23095,22242,853,3.7
"51067",51,67,1998,24334,23663,671,2.8
"51067",51,67,1999,25148,24132,1016,4
"51067",51,67,2000,24379,23645,734,3
"51067",51,67,2001,24933,23925,1008,4
"51067",51,67,2002,25501,24169,1332,5.2
"51067",51,67,2003,24840,23732,1108,4.5
"51067",51,67,2004,24682,23700,982,4
"51067",51,67,2005,25337,24409,928,3.7
"51067",51,67,2006,26011,25178,833,3.2
"51067",51,67,2007,26388,25509,879,3.3
"51067",51,67,2008,27094,25803,1291,4.8
"51067",51,67,2009,26808,24610,2198,8.2
"51067",51,67,2010,27622,25216,2406,8.7
"51067",51,67,2011,27679,25608,2071,7.5
"51067",51,67,2012,27427,25623,1804,6.6
"51067",51,67,2013,27210,25604,1606,5.9
"51067",51,67,2014,27163,25705,1458,5.4
"51067",51,67,2015,26444,25209,1235,4.7
"51067",51,67,2016,26330,25190,1140,4.3
"51067",51,67,2017,26196,25157,1039,4
"51069",51,69,1990,26093,24671,1422,5.4
"51069",51,69,1991,27345,25262,2083,7.6
"51069",51,69,1992,28684,26544,2140,7.5
"51069",51,69,1993,28035,26563,1472,5.3
"51069",51,69,1994,29156,27881,1275,4.4
"51069",51,69,1995,29819,28517,1302,4.4
"51069",51,69,1996,31165,29882,1283,4.1
"51069",51,69,1997,31465,30374,1091,3.5
"51069",51,69,1998,32934,32094,840,2.6
"51069",51,69,1999,32645,31971,674,2.1
"51069",51,69,2000,32922,32247,675,2.1
"51069",51,69,2001,33608,32664,944,2.8
"51069",51,69,2002,34573,33371,1202,3.5
"51069",51,69,2003,36026,34715,1311,3.6
"51069",51,69,2004,36941,35803,1138,3.1
"51069",51,69,2005,38283,37198,1085,2.8
"51069",51,69,2006,40563,39480,1083,2.7
"51069",51,69,2007,41122,39905,1217,3
"51069",51,69,2008,41455,39721,1734,4.2
"51069",51,69,2009,40902,37818,3084,7.5
"51069",51,69,2010,41981,38832,3149,7.5
"51069",51,69,2011,43199,40397,2802,6.5
"51069",51,69,2012,43479,40967,2512,5.8
"51069",51,69,2013,44138,41800,2338,5.3
"51069",51,69,2014,44475,42380,2095,4.7
"51069",51,69,2015,44612,42841,1771,4
"51069",51,69,2016,45273,43674,1599,3.5
"51069",51,69,2017,46296,44818,1478,3.2
"51071",51,71,1990,8440,7699,741,8.8
"51071",51,71,1991,8588,7686,902,10.5
"51071",51,71,1992,8519,7790,729,8.6
"51071",51,71,1993,8407,7739,668,7.9
"51071",51,71,1994,8336,7748,588,7.1
"51071",51,71,1995,8461,7845,616,7.3
"51071",51,71,1996,8295,7708,587,7.1
"51071",51,71,1997,8267,7723,544,6.6
"51071",51,71,1998,8337,7721,616,7.4
"51071",51,71,1999,8437,7923,514,6.1
"51071",51,71,2000,7800,7467,333,4.3
"51071",51,71,2001,7916,7465,451,5.7
"51071",51,71,2002,8016,7531,485,6.1
"51071",51,71,2003,8188,7745,443,5.4
"51071",51,71,2004,8154,7734,420,5.2
"51071",51,71,2005,8352,7921,431,5.2
"51071",51,71,2006,8481,8162,319,3.8
"51071",51,71,2007,8144,7778,366,4.5
"51071",51,71,2008,8373,7923,450,5.4
"51071",51,71,2009,8334,7572,762,9.1
"51071",51,71,2010,8302,7507,795,9.6
"51071",51,71,2011,8274,7613,661,8
"51071",51,71,2012,8242,7643,599,7.3
"51071",51,71,2013,8217,7643,574,7
"51071",51,71,2014,8066,7566,500,6.2
"51071",51,71,2015,7943,7531,412,5.2
"51071",51,71,2016,7931,7501,430,5.4
"51071",51,71,2017,7903,7530,373,4.7
"51073",51,73,1990,15368,14823,545,3.5
"51073",51,73,1991,15914,15205,709,4.5
"51073",51,73,1992,16109,15334,775,4.8
"51073",51,73,1993,16327,15576,751,4.6
"51073",51,73,1994,16499,15747,752,4.6
"51073",51,73,1995,16774,16169,605,3.6
"51073",51,73,1996,16917,16293,624,3.7
"51073",51,73,1997,17398,16878,520,3
"51073",51,73,1998,17885,17443,442,2.5
"51073",51,73,1999,18054,17636,418,2.3
"51073",51,73,2000,17594,17252,342,1.9
"51073",51,73,2001,18121,17675,446,2.5
"51073",51,73,2002,18590,18000,590,3.2
"51073",51,73,2003,18849,18248,601,3.2
"51073",51,73,2004,19083,18485,598,3.1
"51073",51,73,2005,19798,19183,615,3.1
"51073",51,73,2006,20348,19807,541,2.7
"51073",51,73,2007,20549,20039,510,2.5
"51073",51,73,2008,21066,20335,731,3.5
"51073",51,73,2009,20830,19578,1252,6
"51073",51,73,2010,19553,18219,1334,6.8
"51073",51,73,2011,19550,18323,1227,6.3
"51073",51,73,2012,19375,18282,1093,5.6
"51073",51,73,2013,19318,18312,1006,5.2
"51073",51,73,2014,19434,18494,940,4.8
"51073",51,73,2015,19090,18312,778,4.1
"51073",51,73,2016,19063,18359,704,3.7
"51073",51,73,2017,19304,18655,649,3.4
"51075",51,75,1990,7420,7188,232,3.1
"51075",51,75,1991,7745,7347,398,5.1
"51075",51,75,1992,7979,7505,474,5.9
"51075",51,75,1993,7997,7647,350,4.4
"51075",51,75,1994,8354,8042,312,3.7
"51075",51,75,1995,8537,8292,245,2.9
"51075",51,75,1996,8842,8634,208,2.4
"51075",51,75,1997,9053,8834,219,2.4
"51075",51,75,1998,8982,8793,189,2.1
"51075",51,75,1999,9097,8946,151,1.7
"51075",51,75,2000,8916,8759,157,1.8
"51075",51,75,2001,9128,8899,229,2.5
"51075",51,75,2002,9334,9019,315,3.4
"51075",51,75,2003,9523,9203,320,3.4
"51075",51,75,2004,9876,9543,333,3.4
"51075",51,75,2005,10343,10032,311,3
"51075",51,75,2006,10821,10552,269,2.5
"51075",51,75,2007,11126,10860,266,2.4
"51075",51,75,2008,11453,11074,379,3.3
"51075",51,75,2009,11384,10644,740,6.5
"51075",51,75,2010,10483,9733,750,7.2
"51075",51,75,2011,10374,9716,658,6.3
"51075",51,75,2012,10281,9707,574,5.6
"51075",51,75,2013,10371,9837,534,5.1
"51075",51,75,2014,10539,10033,506,4.8
"51075",51,75,2015,10616,10172,444,4.2
"51075",51,75,2016,10815,10403,412,3.8
"51075",51,75,2017,10969,10586,383,3.5
"51077",51,77,1990,8637,7815,822,9.5
"51077",51,77,1991,8660,7848,812,9.4
"51077",51,77,1992,8836,8204,632,7.2
"51077",51,77,1993,8376,7942,434,5.2
"51077",51,77,1994,8447,8072,375,4.4
"51077",51,77,1995,8502,8060,442,5.2
"51077",51,77,1996,8290,7713,577,7
"51077",51,77,1997,8119,7685,434,5.3
"51077",51,77,1998,8212,7762,450,5.5
"51077",51,77,1999,8273,7802,471,5.7
"51077",51,77,2000,8090,7678,412,5.1
"51077",51,77,2001,7940,7336,604,7.6
"51077",51,77,2002,8005,7364,641,8
"51077",51,77,2003,7910,7411,499,6.3
"51077",51,77,2004,7536,7165,371,4.9
"51077",51,77,2005,7401,7052,349,4.7
"51077",51,77,2006,7104,6711,393,5.5
"51077",51,77,2007,7121,6757,364,5.1
"51077",51,77,2008,7170,6707,463,6.5
"51077",51,77,2009,7295,6515,780,10.7
"51077",51,77,2010,7373,6455,918,12.5
"51077",51,77,2011,7206,6424,782,10.9
"51077",51,77,2012,7000,6330,670,9.6
"51077",51,77,2013,7011,6334,677,9.7
"51077",51,77,2014,7070,6521,549,7.8
"51077",51,77,2015,7045,6628,417,5.9
"51077",51,77,2016,7013,6651,362,5.2
"51077",51,77,2017,7220,6909,311,4.3
"51079",51,79,1990,5663,5498,165,2.9
"51079",51,79,1991,6118,5643,475,7.8
"51079",51,79,1992,6326,5922,404,6.4
"51079",51,79,1993,6549,6281,268,4.1
"51079",51,79,1994,6746,6484,262,3.9
"51079",51,79,1995,6736,6538,198,2.9
"51079",51,79,1996,6864,6652,212,3.1
"51079",51,79,1997,7080,6842,238,3.4
"51079",51,79,1998,7386,7280,106,1.4
"51079",51,79,1999,7715,7607,108,1.4
"51079",51,79,2000,8400,8245,155,1.8
"51079",51,79,2001,8618,8420,198,2.3
"51079",51,79,2002,8896,8581,315,3.5
"51079",51,79,2003,9110,8739,371,4.1
"51079",51,79,2004,9246,8953,293,3.2
"51079",51,79,2005,9658,9374,284,2.9
"51079",51,79,2006,10152,9915,237,2.3
"51079",51,79,2007,10420,10198,222,2.1
"51079",51,79,2008,10686,10336,350,3.3
"51079",51,79,2009,10754,10132,622,5.8
"51079",51,79,2010,9655,9007,648,6.7
"51079",51,79,2011,9792,9201,591,6
"51079",51,79,2012,9800,9256,544,5.6
"51079",51,79,2013,9685,9218,467,4.8
"51079",51,79,2014,9851,9416,435,4.4
"51079",51,79,2015,9848,9481,367,3.7
"51079",51,79,2016,9918,9590,328,3.3
"51079",51,79,2017,10170,9860,310,3
"51081",51,81,1990,4466,4203,263,5.9
"51081",51,81,1991,5225,4792,433,8.3
"51081",51,81,1992,5403,5019,384,7.1
"51081",51,81,1993,5279,4937,342,6.5
"51081",51,81,1994,5137,4847,290,5.6
"51081",51,81,1995,5458,5121,337,6.2
"51081",51,81,1996,5579,5290,289,5.2
"51081",51,81,1997,5609,5373,236,4.2
"51081",51,81,1998,5452,5250,202,3.7
"51081",51,81,1999,5416,5254,162,3
"51081",51,81,2000,4012,3876,136,3.4
"51081",51,81,2001,4097,3907,190,4.6
"51081",51,81,2002,4014,3828,186,4.6
"51081",51,81,2003,4238,4015,223,5.3
"51081",51,81,2004,3930,3673,257,6.5
"51081",51,81,2005,3931,3718,213,5.4
"51081",51,81,2006,3933,3765,168,4.3
"51081",51,81,2007,4288,4095,193,4.5
"51081",51,81,2008,4389,4147,242,5.5
"51081",51,81,2009,4401,4007,394,9
"51081",51,81,2010,4562,4124,438,9.6
"51081",51,81,2011,4581,4179,402,8.8
"51081",51,81,2012,4468,4083,385,8.6
"51081",51,81,2013,4355,4018,337,7.7
"51081",51,81,2014,4245,3969,276,6.5
"51081",51,81,2015,4172,3947,225,5.4
"51081",51,81,2016,4202,3987,215,5.1
"51081",51,81,2017,4280,4084,196,4.6
"51083",51,83,1990,18230,16813,1417,7.8
"51083",51,83,1991,18678,17043,1635,8.8
"51083",51,83,1992,19088,17485,1603,8.4
"51083",51,83,1993,18867,17536,1331,7.1
"51083",51,83,1994,18232,17027,1205,6.6
"51083",51,83,1995,18249,16869,1380,7.6
"51083",51,83,1996,18191,16130,2061,11.3
"51083",51,83,1997,18252,16191,2061,11.3
"51083",51,83,1998,17950,16644,1306,7.3
"51083",51,83,1999,18403,17242,1161,6.3
"51083",51,83,2000,16209,15392,817,5
"51083",51,83,2001,16725,15500,1225,7.3
"51083",51,83,2002,16758,15035,1723,10.3
"51083",51,83,2003,16239,14583,1656,10.2
"51083",51,83,2004,15502,14289,1213,7.8
"51083",51,83,2005,15792,14818,974,6.2
"51083",51,83,2006,15763,14834,929,5.9
"51083",51,83,2007,15403,14422,981,6.4
"51083",51,83,2008,15745,14667,1078,6.8
"51083",51,83,2009,16531,14668,1863,11.3
"51083",51,83,2010,16686,14651,2035,12.2
"51083",51,83,2011,16361,14564,1797,11
"51083",51,83,2012,16051,14528,1523,9.5
"51083",51,83,2013,15859,14409,1450,9.1
"51083",51,83,2014,15552,14337,1215,7.8
"51083",51,83,2015,15199,14232,967,6.4
"51083",51,83,2016,14846,13972,874,5.9
"51083",51,83,2017,14881,14101,780,5.2
"51085",51,85,1990,36367,35338,1029,2.8
"51085",51,85,1991,37807,36142,1665,4.4
"51085",51,85,1992,38651,36810,1841,4.8
"51085",51,85,1993,38884,37545,1339,3.4
"51085",51,85,1994,40559,39411,1148,2.8
"51085",51,85,1995,42146,41237,909,2.2
"51085",51,85,1996,42419,41493,926,2.2
"51085",51,85,1997,43903,42863,1040,2.4
"51085",51,85,1998,45785,44986,799,1.7
"51085",51,85,1999,47513,46814,699,1.5
"51085",51,85,2000,47485,46695,790,1.7
"51085",51,85,2001,48679,47455,1224,2.5
"51085",51,85,2002,50099,48448,1651,3.3
"51085",51,85,2003,50886,49232,1654,3.3
"51085",51,85,2004,52220,50582,1638,3.1
"51085",51,85,2005,53511,51917,1594,3
"51085",51,85,2006,54752,53357,1395,2.5
"51085",51,85,2007,54737,53387,1350,2.5
"51085",51,85,2008,55834,53918,1916,3.4
"51085",51,85,2009,54576,51015,3561,6.5
"51085",51,85,2010,54430,50855,3575,6.6
"51085",51,85,2011,54957,51675,3282,6
"51085",51,85,2012,55152,52111,3041,5.5
"51085",51,85,2013,55404,52602,2802,5.1
"51085",51,85,2014,55794,53244,2550,4.6
"51085",51,85,2015,56233,54052,2181,3.9
"51085",51,85,2016,57089,55068,2021,3.5
"51085",51,85,2017,58121,56179,1942,3.3
"51087",51,87,1990,126509,122735,3774,3
"51087",51,87,1991,129687,124138,5549,4.3
"51087",51,87,1992,132617,125627,6990,5.3
"51087",51,87,1993,131075,125797,5278,4
"51087",51,87,1994,134544,130128,4416,3.3
"51087",51,87,1995,134066,130121,3945,2.9
"51087",51,87,1996,136706,132690,4016,2.9
"51087",51,87,1997,137672,134129,3543,2.6
"51087",51,87,1998,137066,134167,2899,2.1
"51087",51,87,1999,138799,136128,2671,1.9
"51087",51,87,2000,145559,142902,2657,1.8
"51087",51,87,2001,147695,143342,4353,2.9
"51087",51,87,2002,148325,142853,5472,3.7
"51087",51,87,2003,149235,143680,5555,3.7
"51087",51,87,2004,152373,146955,5418,3.6
"51087",51,87,2005,156494,151154,5340,3.4
"51087",51,87,2006,159613,154985,4628,2.9
"51087",51,87,2007,162619,158125,4494,2.8
"51087",51,87,2008,166024,159993,6031,3.6
"51087",51,87,2009,164333,153042,11291,6.9
"51087",51,87,2010,167701,155452,12249,7.3
"51087",51,87,2011,170535,159037,11498,6.7
"51087",51,87,2012,172595,162158,10437,6
"51087",51,87,2013,174077,164368,9709,5.6
"51087",51,87,2014,176232,167224,9008,5.1
"51087",51,87,2015,176916,169312,7604,4.3
"51087",51,87,2016,178588,171560,7028,3.9
"51087",51,87,2017,182026,175365,6661,3.7
"51089",51,89,1990,32345,29824,2521,7.8
"51089",51,89,1991,32312,28939,3373,10.4
"51089",51,89,1992,31489,29294,2195,7
"51089",51,89,1993,30498,28741,1757,5.8
"51089",51,89,1994,30578,28197,2381,7.8
"51089",51,89,1995,30191,27629,2562,8.5
"51089",51,89,1996,29252,27160,2092,7.2
"51089",51,89,1997,28013,26899,1114,4
"51089",51,89,1998,27800,26718,1082,3.9
"51089",51,89,1999,27586,25835,1751,6.3
"51089",51,89,2000,28865,27447,1418,4.9
"51089",51,89,2001,28546,26848,1698,5.9
"51089",51,89,2002,28242,25380,2862,10.1
"51089",51,89,2003,27996,25188,2808,10
"51089",51,89,2004,26140,23659,2481,9.5
"51089",51,89,2005,25472,23772,1700,6.7
"51089",51,89,2006,25107,23903,1204,4.8
"51089",51,89,2007,25752,24336,1416,5.5
"51089",51,89,2008,25396,23358,2038,8
"51089",51,89,2009,25592,22092,3500,13.7
"51089",51,89,2010,24007,20467,3540,14.7
"51089",51,89,2011,22821,19949,2872,12.6
"51089",51,89,2012,22753,20351,2402,10.6
"51089",51,89,2013,23405,21274,2131,9.1
"51089",51,89,2014,22923,21159,1764,7.7
"51089",51,89,2015,22353,20920,1433,6.4
"51089",51,89,2016,22112,20865,1247,5.6
"51089",51,89,2017,22541,21420,1121,5
"51091",51,91,1990,1354,1296,58,4.3
"51091",51,91,1991,1388,1313,75,5.4
"51091",51,91,1992,1329,1269,60,4.5
"51091",51,91,1993,1341,1276,65,4.8
"51091",51,91,1994,1340,1279,61,4.6
"51091",51,91,1995,1346,1231,115,8.5
"51091",51,91,1996,1310,1194,116,8.9
"51091",51,91,1997,1305,1218,87,6.7
"51091",51,91,1998,1263,1220,43,3.4
"51091",51,91,1999,1263,1230,33,2.6
"51091",51,91,2000,1172,1138,34,2.9
"51091",51,91,2001,1137,1101,36,3.2
"51091",51,91,2002,1122,1078,44,3.9
"51091",51,91,2003,1182,1132,50,4.2
"51091",51,91,2004,1189,1147,42,3.5
"51091",51,91,2005,1184,1142,42,3.5
"51091",51,91,2006,1130,1094,36,3.2
"51091",51,91,2007,1127,1089,38,3.4
"51091",51,91,2008,1143,1085,58,5.1
"51091",51,91,2009,1161,1074,87,7.5
"51091",51,91,2010,1445,1355,90,6.2
"51091",51,91,2011,1460,1378,82,5.6
"51091",51,91,2012,1461,1390,71,4.9
"51091",51,91,2013,1419,1358,61,4.3
"51091",51,91,2014,1419,1364,55,3.9
"51091",51,91,2015,1339,1292,47,3.5
"51091",51,91,2016,1305,1264,41,3.1
"51091",51,91,2017,1244,1201,43,3.5
"51093",51,93,1990,13049,12370,679,5.2
"51093",51,93,1991,13557,12727,830,6.1
"51093",51,93,1992,13840,12828,1012,7.3
"51093",51,93,1993,13745,12853,892,6.5
"51093",51,93,1994,13940,13091,849,6.1
"51093",51,93,1995,14275,13554,721,5.1
"51093",51,93,1996,14440,13703,737,5.1
"51093",51,93,1997,14668,14028,640,4.4
"51093",51,93,1998,15050,14578,472,3.1
"51093",51,93,1999,15146,14746,400,2.6
"51093",51,93,2000,14908,14583,325,2.2
"51093",51,93,2001,15397,14985,412,2.7
"51093",51,93,2002,15846,15292,554,3.5
"51093",51,93,2003,16250,15668,582,3.6
"51093",51,93,2004,16608,16025,583,3.5
"51093",51,93,2005,17369,16725,644,3.7
"51093",51,93,2006,18275,17708,567,3.1
"51093",51,93,2007,18589,18057,532,2.9
"51093",51,93,2008,19098,18397,701,3.7
"51093",51,93,2009,18840,17671,1169,6.2
"51093",51,93,2010,18800,17458,1342,7.1
"51093",51,93,2011,18880,17569,1311,6.9
"51093",51,93,2012,18766,17578,1188,6.3
"51093",51,93,2013,18857,17773,1084,5.7
"51093",51,93,2014,18972,17974,998,5.3
"51093",51,93,2015,18801,17941,860,4.6
"51093",51,93,2016,18904,18081,823,4.4
"51093",51,93,2017,19105,18359,746,3.9
"51095",51,95,1990,19028,18453,575,3
"51095",51,95,1991,19999,19322,677,3.4
"51095",51,95,1992,20514,19858,656,3.2
"51095",51,95,1993,20409,19821,588,2.9
"51095",51,95,1994,20999,20359,640,3
"51095",51,95,1995,21799,21166,633,2.9
"51095",51,95,1996,22544,21870,674,3
"51095",51,95,1997,23477,22809,668,2.8
"51095",51,95,1998,24412,23926,486,2
"51095",51,95,1999,25120,24632,488,1.9
"51095",51,95,2000,23292,22831,461,2
"51095",51,95,2001,24268,23651,617,2.5
"51095",51,95,2002,25386,24546,840,3.3
"51095",51,95,2003,26182,25309,873,3.3
"51095",51,95,2004,27307,26372,935,3.4
"51095",51,95,2005,28790,27878,912,3.2
"51095",51,95,2006,30328,29515,813,2.7
"51095",51,95,2007,31343,30571,772,2.5
"51095",51,95,2008,32414,31386,1028,3.2
"51095",51,95,2009,32172,30447,1725,5.4
"51095",51,95,2010,32243,30205,2038,6.3
"51095",51,95,2011,32605,30618,1987,6.1
"51095",51,95,2012,32988,31101,1887,5.7
"51095",51,95,2013,33696,31896,1800,5.3
"51095",51,95,2014,34611,32906,1705,4.9
"51095",51,95,2015,34291,32805,1486,4.3
"51095",51,95,2016,34812,33451,1361,3.9
"51095",51,95,2017,35352,34080,1272,3.6
"51097",51,97,1990,3117,2970,147,4.7
"51097",51,97,1991,3361,3165,196,5.8
"51097",51,97,1992,3349,3118,231,6.9
"51097",51,97,1993,3078,2849,229,7.4
"51097",51,97,1994,3140,2958,182,5.8
"51097",51,97,1995,3231,3073,158,4.9
"51097",51,97,1996,2986,2827,159,5.3
"51097",51,97,1997,3100,2957,143,4.6
"51097",51,97,1998,2914,2823,91,3.1
"51097",51,97,1999,2913,2822,91,3.1
"51097",51,97,2000,3161,3079,82,2.6
"51097",51,97,2001,3156,3052,104,3.3
"51097",51,97,2002,3143,3004,139,4.4
"51097",51,97,2003,3125,2983,142,4.5
"51097",51,97,2004,3206,3082,124,3.9
"51097",51,97,2005,3263,3134,129,4
"51097",51,97,2006,3334,3221,113,3.4
"51097",51,97,2007,3330,3214,116,3.5
"51097",51,97,2008,3349,3196,153,4.6
"51097",51,97,2009,3263,3002,261,8
"51097",51,97,2010,3592,3302,290,8.1
"51097",51,97,2011,3664,3394,270,7.4
"51097",51,97,2012,3673,3430,243,6.6
"51097",51,97,2013,3638,3416,222,6.1
"51097",51,97,2014,3644,3433,211,5.8
"51097",51,97,2015,3631,3456,175,4.8
"51097",51,97,2016,3655,3501,154,4.2
"51097",51,97,2017,3766,3630,136,3.6
"51099",51,99,1990,6992,6726,266,3.8
"51099",51,99,1991,7295,6825,470,6.4
"51099",51,99,1992,7540,6931,609,8.1
"51099",51,99,1993,7575,7153,422,5.6
"51099",51,99,1994,8024,7704,320,4
"51099",51,99,1995,8226,7864,362,4.4
"51099",51,99,1996,8035,7702,333,4.1
"51099",51,99,1997,8200,7926,274,3.3
"51099",51,99,1998,8382,8175,207,2.5
"51099",51,99,1999,8653,8488,165,1.9
"51099",51,99,2000,8407,8243,164,2
"51099",51,99,2001,8722,8508,214,2.5
"51099",51,99,2002,8813,8536,277,3.1
"51099",51,99,2003,9016,8723,293,3.2
"51099",51,99,2004,9151,8860,291,3.2
"51099",51,99,2005,9461,9140,321,3.4
"51099",51,99,2006,9484,9162,322,3.4
"51099",51,99,2007,9352,9023,329,3.5
"51099",51,99,2008,9650,9160,490,5.1
"51099",51,99,2009,10252,9476,776,7.6
"51099",51,99,2010,11413,10573,840,7.4
"51099",51,99,2011,11721,10904,817,7
"51099",51,99,2012,11735,10974,761,6.5
"51099",51,99,2013,11975,11281,694,5.8
"51099",51,99,2014,12080,11428,652,5.4
"51099",51,99,2015,12053,11479,574,4.8
"51099",51,99,2016,12303,11772,531,4.3
"51099",51,99,2017,12359,11869,490,4
"51101",51,101,1990,5831,5649,182,3.1
"51101",51,101,1991,6432,6110,322,5
"51101",51,101,1992,6553,6214,339,5.2
"51101",51,101,1993,6149,5876,273,4.4
"51101",51,101,1994,6406,6115,291,4.5
"51101",51,101,1995,6572,6338,234,3.6
"51101",51,101,1996,6206,5927,279,4.5
"51101",51,101,1997,6440,6161,279,4.3
"51101",51,101,1998,6246,6055,191,3.1
"51101",51,101,1999,6275,6125,150,2.4
"51101",51,101,2000,7029,6896,133,1.9
"51101",51,101,2001,7214,7002,212,2.9
"51101",51,101,2002,7343,7075,268,3.6
"51101",51,101,2003,7462,7191,271,3.6
"51101",51,101,2004,7604,7341,263,3.5
"51101",51,101,2005,7911,7633,278,3.5
"51101",51,101,2006,8290,8062,228,2.8
"51101",51,101,2007,8461,8232,229,2.7
"51101",51,101,2008,8761,8434,327,3.7
"51101",51,101,2009,8662,8055,607,7
"51101",51,101,2010,8656,8011,645,7.5
"51101",51,101,2011,8703,8104,599,6.9
"51101",51,101,2012,8686,8137,549,6.3
"51101",51,101,2013,8699,8208,491,5.6
"51101",51,101,2014,8752,8299,453,5.2
"51101",51,101,2015,8704,8336,368,4.2
"51101",51,101,2016,8738,8403,335,3.8
"51101",51,101,2017,8856,8548,308,3.5
"51103",51,103,1990,5040,4479,561,11.1
"51103",51,103,1991,5221,4591,630,12.1
"51103",51,103,1992,5467,4630,837,15.3
"51103",51,103,1993,5333,4522,811,15.2
"51103",51,103,1994,5296,4542,754,14.2
"51103",51,103,1995,5271,4538,733,13.9
"51103",51,103,1996,5237,4477,760,14.5
"51103",51,103,1997,5190,4529,661,12.7
"51103",51,103,1998,5060,4529,531,10.5
"51103",51,103,1999,5159,4662,497,9.6
"51103",51,103,2000,4851,4566,285,5.9
"51103",51,103,2001,4938,4633,305,6.2
"51103",51,103,2002,5168,4836,332,6.4
"51103",51,103,2003,5232,4942,290,5.5
"51103",51,103,2004,5102,4809,293,5.7
"51103",51,103,2005,5210,4915,295,5.7
"51103",51,103,2006,5184,4954,230,4.4
"51103",51,103,2007,5318,5086,232,4.4
"51103",51,103,2008,5542,5226,316,5.7
"51103",51,103,2009,5654,5130,524,9.3
"51103",51,103,2010,5570,5024,546,9.8
"51103",51,103,2011,5590,5072,518,9.3
"51103",51,103,2012,5522,5082,440,8
"51103",51,103,2013,5401,4995,406,7.5
"51103",51,103,2014,5348,4938,410,7.7
"51103",51,103,2015,5130,4791,339,6.6
"51103",51,103,2016,5103,4813,290,5.7
"51103",51,103,2017,5153,4870,283,5.5
"51105",51,105,1990,9120,8252,868,9.5
"51105",51,105,1991,9711,8690,1021,10.5
"51105",51,105,1992,10100,8633,1467,14.5
"51105",51,105,1993,10056,8930,1126,11.2
"51105",51,105,1994,10393,9309,1084,10.4
"51105",51,105,1995,10907,9629,1278,11.7
"51105",51,105,1996,10908,9612,1296,11.9
"51105",51,105,1997,10277,9345,932,9.1
"51105",51,105,1998,9850,9065,785,8
"51105",51,105,1999,9557,8711,846,8.9
"51105",51,105,2000,8830,8456,374,4.2
"51105",51,105,2001,9056,8605,451,5
"51105",51,105,2002,9504,8958,546,5.7
"51105",51,105,2003,9627,9048,579,6
"51105",51,105,2004,9299,8773,526,5.7
"51105",51,105,2005,9229,8762,467,5.1
"51105",51,105,2006,9277,8873,404,4.4
"51105",51,105,2007,9585,9186,399,4.2
"51105",51,105,2008,9788,9268,520,5.3
"51105",51,105,2009,10125,9395,730,7.2
"51105",51,105,2010,10127,9325,802,7.9
"51105",51,105,2011,10229,9451,778,7.6
"51105",51,105,2012,9794,8985,809,8.3
"51105",51,105,2013,9305,8488,817,8.8
"51105",51,105,2014,8840,8115,725,8.2
"51105",51,105,2015,8572,7952,620,7.2
"51105",51,105,2016,8434,7856,578,6.9
"51105",51,105,2017,8245,7788,457,5.5
"51107",51,107,1990,52572,51702,870,1.7
"51107",51,107,1991,54617,52728,1889,3.5
"51107",51,107,1992,56955,54629,2326,4.1
"51107",51,107,1993,60042,58010,2032,3.4
"51107",51,107,1994,64705,62649,2056,3.2
"51107",51,107,1995,68602,66679,1923,2.8
"51107",51,107,1996,71351,69642,1709,2.4
"51107",51,107,1997,75891,74419,1472,1.9
"51107",51,107,1998,83090,82053,1037,1.2
"51107",51,107,1999,90500,89503,997,1.1
"51107",51,107,2000,100070,98642,1428,1.4
"51107",51,107,2001,109398,106665,2733,2.5
"51107",51,107,2002,116388,112030,4358,3.7
"51107",51,107,2003,124224,120279,3945,3.2
"51107",51,107,2004,135147,131510,3637,2.7
"51107",51,107,2005,147280,143676,3604,2.4
"51107",51,107,2006,156992,153601,3391,2.2
"51107",51,107,2007,163971,160532,3439,2.1
"51107",51,107,2008,173148,168299,4849,2.8
"51107",51,107,2009,174290,166112,8178,4.7
"51107",51,107,2010,175439,166487,8952,5.1
"51107",51,107,2011,181515,173042,8473,4.7
"51107",51,107,2012,186073,177798,8275,4.4
"51107",51,107,2013,191048,182680,8368,4.4
"51107",51,107,2014,195972,187625,8347,4.3
"51107",51,107,2015,200054,192918,7136,3.6
"51107",51,107,2016,206982,200306,6676,3.2
"51107",51,107,2017,211626,205188,6438,3
"51109",51,109,1990,10420,9842,578,5.5
"51109",51,109,1991,10512,9557,955,9.1
"51109",51,109,1992,10937,9773,1164,10.6
"51109",51,109,1993,10694,9746,948,8.9
"51109",51,109,1994,10277,9432,845,8.2
"51109",51,109,1995,10080,9093,987,9.8
"51109",51,109,1996,9373,8542,831,8.9
"51109",51,109,1997,9381,8703,678,7.2
"51109",51,109,1998,9338,8904,434,4.6
"51109",51,109,1999,9651,9315,336,3.5
"51109",51,109,2000,12886,12578,308,2.4
"51109",51,109,2001,13180,12769,411,3.1
"51109",51,109,2002,13603,13007,596,4.4
"51109",51,109,2003,13935,13343,592,4.2
"51109",51,109,2004,14350,13796,554,3.9
"51109",51,109,2005,15101,14548,553,3.7
"51109",51,109,2006,15800,15308,492,3.1
"51109",51,109,2007,16152,15683,469,2.9
"51109",51,109,2008,16793,16088,705,4.2
"51109",51,109,2009,16665,15358,1307,7.8
"51109",51,109,2010,17858,16513,1345,7.5
"51109",51,109,2011,17943,16717,1226,6.8
"51109",51,109,2012,17965,16845,1120,6.2
"51109",51,109,2013,18051,17027,1024,5.7
"51109",51,109,2014,18448,17509,939,5.1
"51109",51,109,2015,18790,17993,797,4.2
"51109",51,109,2016,18542,17826,716,3.9
"51109",51,109,2017,19087,18420,667,3.5
"51111",51,111,1990,5552,5116,436,7.9
"51111",51,111,1991,5528,4477,1051,19
"51111",51,111,1992,5232,4592,640,12.2
"51111",51,111,1993,5006,4550,456,9.1
"51111",51,111,1994,4987,4514,473,9.5
"51111",51,111,1995,4969,4335,634,12.8
"51111",51,111,1996,5087,4582,505,9.9
"51111",51,111,1997,4872,4414,458,9.4
"51111",51,111,1998,4583,4309,274,6
"51111",51,111,1999,4779,4550,229,4.8
"51111",51,111,2000,5374,5187,187,3.5
"51111",51,111,2001,5399,5155,244,4.5
"51111",51,111,2002,5466,5159,307,5.6
"51111",51,111,2003,5587,5274,313,5.6
"51111",51,111,2004,5419,5147,272,5
"51111",51,111,2005,5577,5281,296,5.3
"51111",51,111,2006,5572,5324,248,4.5
"51111",51,111,2007,5508,5258,250,4.5
"51111",51,111,2008,5501,5175,326,5.9
"51111",51,111,2009,5616,5095,521,9.3
"51111",51,111,2010,5547,5020,527,9.5
"51111",51,111,2011,5511,5039,472,8.6
"51111",51,111,2012,5385,4978,407,7.6
"51111",51,111,2013,5326,4950,376,7.1
"51111",51,111,2014,5341,5025,316,5.9
"51111",51,111,2015,5284,5014,270,5.1
"51111",51,111,2016,5245,5001,244,4.7
"51111",51,111,2017,5198,4971,227,4.4
"51113",51,113,1990,5773,5611,162,2.8
"51113",51,113,1991,6313,6002,311,4.9
"51113",51,113,1992,6629,6296,333,5
"51113",51,113,1993,6304,6080,224,3.6
"51113",51,113,1994,6729,6485,244,3.6
"51113",51,113,1995,7104,6881,223,3.1
"51113",51,113,1996,7224,6948,276,3.8
"51113",51,113,1997,7638,7408,230,3
"51113",51,113,1998,8253,8095,158,1.9
"51113",51,113,1999,8747,8595,152,1.7
"51113",51,113,2000,6560,6443,117,1.8
"51113",51,113,2001,6791,6640,151,2.2
"51113",51,113,2002,6987,6686,301,4.3
"51113",51,113,2003,7131,6855,276,3.9
"51113",51,113,2004,7004,6790,214,3.1
"51113",51,113,2005,7172,6949,223,3.1
"51113",51,113,2006,7274,7080,194,2.7
"51113",51,113,2007,7352,7156,196,2.7
"51113",51,113,2008,7404,7127,277,3.7
"51113",51,113,2009,7429,6973,456,6.1
"51113",51,113,2010,7169,6717,452,6.3
"51113",51,113,2011,7223,6844,379,5.2
"51113",51,113,2012,7261,6912,349,4.8
"51113",51,113,2013,7224,6902,322,4.5
"51113",51,113,2014,7245,6952,293,4
"51113",51,113,2015,7224,6978,246,3.4
"51113",51,113,2016,7162,6936,226,3.2
"51113",51,113,2017,7290,7075,215,2.9
"51115",51,115,1990,4189,4053,136,3.2
"51115",51,115,1991,4279,4112,167,3.9
"51115",51,115,1992,4283,4091,192,4.5
"51115",51,115,1993,4278,4097,181,4.2
"51115",51,115,1994,4396,4200,196,4.5
"51115",51,115,1995,4401,4240,161,3.7
"51115",51,115,1996,4464,4314,150,3.4
"51115",51,115,1997,4557,4402,155,3.4
"51115",51,115,1998,4610,4488,122,2.6
"51115",51,115,1999,4647,4545,102,2.2
"51115",51,115,2000,4259,4165,94,2.2
"51115",51,115,2001,4356,4226,130,3
"51115",51,115,2002,4424,4247,177,4
"51115",51,115,2003,4341,4202,139,3.2
"51115",51,115,2004,4300,4167,133,3.1
"51115",51,115,2005,4396,4263,133,3
"51115",51,115,2006,4454,4337,117,2.6
"51115",51,115,2007,4427,4314,113,2.6
"51115",51,115,2008,4500,4340,160,3.6
"51115",51,115,2009,4335,4096,239,5.5
"51115",51,115,2010,4224,3956,268,6.3
"51115",51,115,2011,4244,3967,277,6.5
"51115",51,115,2012,4176,3938,238,5.7
"51115",51,115,2013,4163,3952,211,5.1
"51115",51,115,2014,4125,3933,192,4.7
"51115",51,115,2015,4072,3901,171,4.2
"51115",51,115,2016,4033,3870,163,4
"51115",51,115,2017,4093,3938,155,3.8
"51117",51,117,1990,14397,13562,835,5.8
"51117",51,117,1991,14960,13566,1394,9.3
"51117",51,117,1992,15049,13680,1369,9.1
"51117",51,117,1993,14879,13967,912,6.1
"51117",51,117,1994,15167,14252,915,6
"51117",51,117,1995,15285,14215,1070,7
"51117",51,117,1996,15143,13827,1316,8.7
"51117",51,117,1997,14998,14121,877,5.8
"51117",51,117,1998,14894,14219,675,4.5
"51117",51,117,1999,15040,14238,802,5.3
"51117",51,117,2000,14247,13765,482,3.4
"51117",51,117,2001,14174,13344,830,5.9
"51117",51,117,2002,14088,12646,1442,10.2
"51117",51,117,2003,13610,12334,1276,9.4
"51117",51,117,2004,13015,12121,894,6.9
"51117",51,117,2005,13193,12376,817,6.2
"51117",51,117,2006,13121,12424,697,5.3
"51117",51,117,2007,13192,12525,667,5.1
"51117",51,117,2008,13466,12585,881,6.5
"51117",51,117,2009,14067,12533,1534,10.9
"51117",51,117,2010,14158,12552,1606,11.3
"51117",51,117,2011,14059,12599,1460,10.4
"51117",51,117,2012,13540,12263,1277,9.4
"51117",51,117,2013,12780,11588,1192,9.3
"51117",51,117,2014,12628,11651,977,7.7
"51117",51,117,2015,12514,11748,766,6.1
"51117",51,117,2016,12444,11738,706,5.7
"51117",51,117,2017,12150,11512,638,5.3
"51119",51,119,1990,4075,3940,135,3.3
"51119",51,119,1991,4208,4043,165,3.9
"51119",51,119,1992,4296,4081,215,5
"51119",51,119,1993,4250,4045,205,4.8
"51119",51,119,1994,4383,4154,229,5.2
"51119",51,119,1995,4657,4474,183,3.9
"51119",51,119,1996,4561,4399,162,3.6
"51119",51,119,1997,4755,4611,144,3
"51119",51,119,1998,4840,4736,104,2.1
"51119",51,119,1999,5098,4990,108,2.1
"51119",51,119,2000,4545,4449,96,2.1
"51119",51,119,2001,4632,4508,124,2.7
"51119",51,119,2002,4738,4581,157,3.3
"51119",51,119,2003,4837,4667,170,3.5
"51119",51,119,2004,4860,4692,168,3.5
"51119",51,119,2005,5031,4852,179,3.6
"51119",51,119,2006,5059,4897,162,3.2
"51119",51,119,2007,5041,4890,151,3
"51119",51,119,2008,5132,4936,196,3.8
"51119",51,119,2009,5185,4840,345,6.7
"51119",51,119,2010,5160,4789,371,7.2
"51119",51,119,2011,5138,4805,333,6.5
"51119",51,119,2012,5136,4824,312,6.1
"51119",51,119,2013,5113,4830,283,5.5
"51119",51,119,2014,5027,4773,254,5.1
"51119",51,119,2015,4980,4769,211,4.2
"51119",51,119,2016,5021,4827,194,3.9
"51119",51,119,2017,5194,5017,177,3.4
"51121",51,121,1990,37410,34587,2823,7.5
"51121",51,121,1991,37427,34632,2795,7.5
"51121",51,121,1992,36955,34952,2003,5.4
"51121",51,121,1993,36998,34976,2022,5.5
"51121",51,121,1994,36937,35521,1416,3.8
"51121",51,121,1995,37032,35835,1197,3.2
"51121",51,121,1996,36977,35641,1336,3.6
"51121",51,121,1997,36845,35937,908,2.5
"51121",51,121,1998,36948,36232,716,1.9
"51121",51,121,1999,37763,37075,688,1.8
"51121",51,121,2000,40823,39784,1039,2.5
"51121",51,121,2001,40953,39594,1359,3.3
"51121",51,121,2002,41353,39695,1658,4
"51121",51,121,2003,42529,40907,1622,3.8
"51121",51,121,2004,42396,40808,1588,3.7
"51121",51,121,2005,43120,41566,1554,3.6
"51121",51,121,2006,43558,42200,1358,3.1
"51121",51,121,2007,44293,42874,1419,3.2
"51121",51,121,2008,45879,44009,1870,4.1
"51121",51,121,2009,45447,42285,3162,7
"51121",51,121,2010,47497,44140,3357,7.1
"51121",51,121,2011,48374,45309,3065,6.3
"51121",51,121,2012,49165,46242,2923,5.9
"51121",51,121,2013,49663,46856,2807,5.7
"51121",51,121,2014,49774,47228,2546,5.1
"51121",51,121,2015,49724,47573,2151,4.3
"51121",51,121,2016,49659,47585,2074,4.2
"51121",51,121,2017,49863,47952,1911,3.8
"51125",51,125,1990,6081,5820,261,4.3
"51125",51,125,1991,6186,5778,408,6.6
"51125",51,125,1992,6912,6392,520,7.5
"51125",51,125,1993,6540,6211,329,5
"51125",51,125,1994,6675,6405,270,4
"51125",51,125,1995,6828,6574,254,3.7
"51125",51,125,1996,6736,6454,282,4.2
"51125",51,125,1997,7029,6759,270,3.8
"51125",51,125,1998,6989,6788,201,2.9
"51125",51,125,1999,7233,7077,156,2.2
"51125",51,125,2000,7033,6869,164,2.3
"51125",51,125,2001,7120,6885,235,3.3
"51125",51,125,2002,7102,6843,259,3.6
"51125",51,125,2003,7144,6883,261,3.7
"51125",51,125,2004,7221,6955,266,3.7
"51125",51,125,2005,7424,7182,242,3.3
"51125",51,125,2006,7715,7500,215,2.8
"51125",51,125,2007,7904,7692,212,2.7
"51125",51,125,2008,8077,7788,289,3.6
"51125",51,125,2009,8040,7526,514,6.4
"51125",51,125,2010,7574,7034,540,7.1
"51125",51,125,2011,7604,7123,481,6.3
"51125",51,125,2012,7465,7030,435,5.8
"51125",51,125,2013,7358,6952,406,5.5
"51125",51,125,2014,7392,7027,365,4.9
"51125",51,125,2015,7266,6970,296,4.1
"51125",51,125,2016,7225,6962,263,3.6
"51125",51,125,2017,7354,7097,257,3.5
"51127",51,127,1990,5669,5478,191,3.4
"51127",51,127,1991,5872,5571,301,5.1
"51127",51,127,1992,5932,5601,331,5.6
"51127",51,127,1993,5937,5645,292,4.9
"51127",51,127,1994,6082,5820,262,4.3
"51127",51,127,1995,6240,6046,194,3.1
"51127",51,127,1996,6295,6092,203,3.2
"51127",51,127,1997,6679,6496,183,2.7
"51127",51,127,1998,6780,6606,174,2.6
"51127",51,127,1999,6938,6805,133,1.9
"51127",51,127,2000,7300,7165,135,1.8
"51127",51,127,2001,7536,7309,227,3
"51127",51,127,2002,7718,7437,281,3.6
"51127",51,127,2003,8017,7721,296,3.7
"51127",51,127,2004,8371,8080,291,3.5
"51127",51,127,2005,8789,8503,286,3.3
"51127",51,127,2006,9267,9009,258,2.8
"51127",51,127,2007,9415,9159,256,2.7
"51127",51,127,2008,9927,9572,355,3.6
"51127",51,127,2009,9874,9187,687,7
"51127",51,127,2010,10294,9550,744,7.2
"51127",51,127,2011,10439,9770,669,6.4
"51127",51,127,2012,10615,10023,592,5.6
"51127",51,127,2013,10783,10239,544,5
"51127",51,127,2014,11076,10574,502,4.5
"51127",51,127,2015,11213,10785,428,3.8
"51127",51,127,2016,11656,11257,399,3.4
"51127",51,127,2017,11857,11475,382,3.2
"51131",51,131,1990,5703,5394,309,5.4
"51131",51,131,1991,5936,5386,550,9.3
"51131",51,131,1992,5827,5287,540,9.3
"51131",51,131,1993,5680,5252,428,7.5
"51131",51,131,1994,5560,5192,368,6.6
"51131",51,131,1995,5724,5213,511,8.9
"51131",51,131,1996,5458,5009,449,8.2
"51131",51,131,1997,5211,4873,338,6.5
"51131",51,131,1998,5142,4864,278,5.4
"51131",51,131,1999,5276,5041,235,4.5
"51131",51,131,2000,5603,5453,150,2.7
"51131",51,131,2001,5669,5460,209,3.7
"51131",51,131,2002,5876,5576,300,5.1
"51131",51,131,2003,5935,5646,289,4.9
"51131",51,131,2004,5902,5621,281,4.8
"51131",51,131,2005,5914,5608,306,5.2
"51131",51,131,2006,5865,5604,261,4.5
"51131",51,131,2007,5959,5717,242,4.1
"51131",51,131,2008,6112,5780,332,5.4
"51131",51,131,2009,6382,5893,489,7.7
"51131",51,131,2010,6335,5799,536,8.5
"51131",51,131,2011,6364,5799,565,8.9
"51131",51,131,2012,6198,5624,574,9.3
"51131",51,131,2013,6035,5485,550,9.1
"51131",51,131,2014,6082,5621,461,7.6
"51131",51,131,2015,6098,5725,373,6.1
"51131",51,131,2016,5869,5525,344,5.9
"51131",51,131,2017,5403,5087,316,5.8
"51133",51,133,1990,4924,4428,496,10.1
"51133",51,133,1991,5174,4618,556,10.7
"51133",51,133,1992,5459,4724,735,13.5
"51133",51,133,1993,5374,4624,750,14
"51133",51,133,1994,5361,4661,700,13.1
"51133",51,133,1995,5268,4599,669,12.7
"51133",51,133,1996,5228,4552,676,12.9
"51133",51,133,1997,5279,4682,597,11.3
"51133",51,133,1998,5150,4692,458,8.9
"51133",51,133,1999,5315,4908,407,7.7
"51133",51,133,2000,5441,5192,249,4.6
"51133",51,133,2001,5501,5222,279,5.1
"51133",51,133,2002,5577,5243,334,6
"51133",51,133,2003,5630,5314,316,5.6
"51133",51,133,2004,5927,5625,302,5.1
"51133",51,133,2005,6037,5743,294,4.9
"51133",51,133,2006,5971,5719,252,4.2
"51133",51,133,2007,5947,5689,258,4.3
"51133",51,133,2008,5911,5574,337,5.7
"51133",51,133,2009,6114,5583,531,8.7
"51133",51,133,2010,6150,5617,533,8.7
"51133",51,133,2011,6031,5489,542,9
"51133",51,133,2012,5893,5412,481,8.2
"51133",51,133,2013,5690,5269,421,7.4
"51133",51,133,2014,5640,5241,399,7.1
"51133",51,133,2015,5464,5130,334,6.1
"51133",51,133,2016,5442,5142,300,5.5
"51133",51,133,2017,5364,5072,292,5.4
"51135",51,135,1990,6607,6315,292,4.4
"51135",51,135,1991,6733,6250,483,7.2
"51135",51,135,1992,6662,6218,444,6.7
"51135",51,135,1993,6386,5963,423,6.6
"51135",51,135,1994,6330,5882,448,7.1
"51135",51,135,1995,6565,6195,370,5.6
"51135",51,135,1996,6302,5900,402,6.4
"51135",51,135,1997,6269,5834,435,6.9
"51135",51,135,1998,6398,6158,240,3.8
"51135",51,135,1999,6743,6560,183,2.7
"51135",51,135,2000,6172,5991,181,2.9
"51135",51,135,2001,6265,6015,250,4
"51135",51,135,2002,6351,6071,280,4.4
"51135",51,135,2003,6416,6131,285,4.4
"51135",51,135,2004,6266,5983,283,4.5
"51135",51,135,2005,6345,6053,292,4.6
"51135",51,135,2006,6427,6160,267,4.2
"51135",51,135,2007,6577,6322,255,3.9
"51135",51,135,2008,6588,6228,360,5.5
"51135",51,135,2009,6639,6107,532,8
"51135",51,135,2010,6859,6338,521,7.6
"51135",51,135,2011,6893,6400,493,7.2
"51135",51,135,2012,6879,6441,438,6.4
"51135",51,135,2013,7072,6645,427,6
"51135",51,135,2014,7078,6699,379,5.4
"51135",51,135,2015,7129,6806,323,4.5
"51135",51,135,2016,7024,6742,282,4
"51135",51,135,2017,6985,6708,277,4
"51137",51,137,1990,10840,10262,578,5.3
"51137",51,137,1991,11083,10141,942,8.5
"51137",51,137,1992,10944,10048,896,8.2
"51137",51,137,1993,11037,10441,596,5.4
"51137",51,137,1994,10762,10262,500,4.6
"51137",51,137,1995,10740,10224,516,4.8
"51137",51,137,1996,10835,10248,587,5.4
"51137",51,137,1997,10806,10351,455,4.2
"51137",51,137,1998,11059,10762,297,2.7
"51137",51,137,1999,11028,10753,275,2.5
"51137",51,137,2000,12737,12474,263,2.1
"51137",51,137,2001,12932,12583,349,2.7
"51137",51,137,2002,13287,12688,599,4.5
"51137",51,137,2003,13726,13176,550,4
"51137",51,137,2004,14093,13611,482,3.4
"51137",51,137,2005,14651,14179,472,3.2
"51137",51,137,2006,15043,14582,461,3.1
"51137",51,137,2007,15396,14903,493,3.2
"51137",51,137,2008,15677,14960,717,4.6
"51137",51,137,2009,15836,14614,1222,7.7
"51137",51,137,2010,15456,14178,1278,8.3
"51137",51,137,2011,15788,14606,1182,7.5
"51137",51,137,2012,15878,14817,1061,6.7
"51137",51,137,2013,16114,15161,953,5.9
"51137",51,137,2014,16180,15321,859,5.3
"51137",51,137,2015,16053,15315,738,4.6
"51137",51,137,2016,16340,15669,671,4.1
"51137",51,137,2017,16539,15903,636,3.8
"51139",51,139,1990,11300,9794,1506,13.3
"51139",51,139,1991,11563,10075,1488,12.9
"51139",51,139,1992,11907,10612,1295,10.9
"51139",51,139,1993,11667,10791,876,7.5
"51139",51,139,1994,11749,10927,822,7
"51139",51,139,1995,11956,11059,897,7.5
"51139",51,139,1996,11649,10816,833,7.2
"51139",51,139,1997,11632,10966,666,5.7
"51139",51,139,1998,11708,11132,576,4.9
"51139",51,139,1999,11966,11492,474,4
"51139",51,139,2000,11786,11474,312,2.6
"51139",51,139,2001,12164,11754,410,3.4
"51139",51,139,2002,12294,11535,759,6.2
"51139",51,139,2003,11882,11050,832,7
"51139",51,139,2004,11332,10696,636,5.6
"51139",51,139,2005,11433,10843,590,5.2
"51139",51,139,2006,11178,10651,527,4.7
"51139",51,139,2007,11328,10755,573,5.1
"51139",51,139,2008,11779,10969,810,6.9
"51139",51,139,2009,12070,10651,1419,11.8
"51139",51,139,2010,12336,10900,1436,11.6
"51139",51,139,2011,12491,11106,1385,11.1
"51139",51,139,2012,12202,10957,1245,10.2
"51139",51,139,2013,11944,10841,1103,9.2
"51139",51,139,2014,11830,10874,956,8.1
"51139",51,139,2015,11642,10840,802,6.9
"51139",51,139,2016,11579,10929,650,5.6
"51139",51,139,2017,11640,11023,617,5.3
"51141",51,141,1990,9451,9006,445,4.7
"51141",51,141,1991,9524,8815,709,7.4
"51141",51,141,1992,9392,8939,453,4.8
"51141",51,141,1993,9127,8779,348,3.8
"51141",51,141,1994,9047,8649,398,4.4
"51141",51,141,1995,9203,8606,597,6.5
"51141",51,141,1996,9076,8619,457,5
"51141",51,141,1997,9002,8674,328,3.6
"51141",51,141,1998,9100,8712,388,4.3
"51141",51,141,1999,8983,8494,489,5.4
"51141",51,141,2000,9509,9193,316,3.3
"51141",51,141,2001,9591,9084,507,5.3
"51141",51,141,2002,9601,8790,811,8.4
"51141",51,141,2003,9758,9010,748,7.7
"51141",51,141,2004,9023,8318,705,7.8
"51141",51,141,2005,8779,8195,584,6.7
"51141",51,141,2006,8808,8397,411,4.7
"51141",51,141,2007,9049,8682,367,4.1
"51141",51,141,2008,9140,8549,591,6.5
"51141",51,141,2009,9249,8221,1028,11.1
"51141",51,141,2010,8321,7265,1056,12.7
"51141",51,141,2011,8047,7178,869,10.8
"51141",51,141,2012,7985,7256,729,9.1
"51141",51,141,2013,7802,7154,648,8.3
"51141",51,141,2014,7724,7205,519,6.7
"51141",51,141,2015,7638,7224,414,5.4
"51141",51,141,2016,7942,7553,389,4.9
"51141",51,141,2017,7429,7094,335,4.5
"51143",51,143,1990,30413,27907,2506,8.2
"51143",51,143,1991,30697,27708,2989,9.7
"51143",51,143,1992,30990,28541,2449,7.9
"51143",51,143,1993,30522,28765,1757,5.8
"51143",51,143,1994,31367,29186,2181,7
"51143",51,143,1995,31895,29170,2725,8.5
"51143",51,143,1996,31861,29743,2118,6.6
"51143",51,143,1997,31531,29793,1738,5.5
"51143",51,143,1998,30913,29321,1592,5.1
"51143",51,143,1999,31410,29596,1814,5.8
"51143",51,143,2000,31960,30895,1065,3.3
"51143",51,143,2001,32501,30592,1909,5.9
"51143",51,143,2002,32838,30524,2314,7
"51143",51,143,2003,32612,30478,2134,6.5
"51143",51,143,2004,31626,29615,2011,6.4
"51143",51,143,2005,31788,29753,2035,6.4
"51143",51,143,2006,31044,29335,1709,5.5
"51143",51,143,2007,30955,29185,1770,5.7
"51143",51,143,2008,31711,29605,2106,6.6
"51143",51,143,2009,31800,28432,3368,10.6
"51143",51,143,2010,30911,27543,3368,10.9
"51143",51,143,2011,31169,28329,2840,9.1
"51143",51,143,2012,30740,28350,2390,7.8
"51143",51,143,2013,30444,28299,2145,7
"51143",51,143,2014,30257,28329,1928,6.4
"51143",51,143,2015,30069,28472,1597,5.3
"51143",51,143,2016,29657,28234,1423,4.8
"51143",51,143,2017,29542,28201,1341,4.5
"51145",51,145,1990,7557,7318,239,3.2
"51145",51,145,1991,8001,7620,381,4.8
"51145",51,145,1992,8290,7912,378,4.6
"51145",51,145,1993,8512,8203,309,3.6
"51145",51,145,1994,9026,8730,296,3.3
"51145",51,145,1995,9496,9247,249,2.6
"51145",51,145,1996,9990,9758,232,2.3
"51145",51,145,1997,10472,10198,274,2.6
"51145",51,145,1998,10641,10446,195,1.8
"51145",51,145,1999,11141,10965,176,1.6
"51145",51,145,2000,11250,11045,205,1.8
"51145",51,145,2001,11561,11269,292,2.5
"51145",51,145,2002,12114,11732,382,3.2
"51145",51,145,2003,12468,12073,395,3.2
"51145",51,145,2004,12938,12554,384,3
"51145",51,145,2005,13506,13118,388,2.9
"51145",51,145,2006,14216,13845,371,2.6
"51145",51,145,2007,14287,13950,337,2.4
"51145",51,145,2008,14573,14084,489,3.4
"51145",51,145,2009,14164,13273,891,6.3
"51145",51,145,2010,13510,12557,953,7.1
"51145",51,145,2011,13555,12708,847,6.2
"51145",51,145,2012,13559,12794,765,5.6
"51145",51,145,2013,13561,12871,690,5.1
"51145",51,145,2014,13662,13040,622,4.6
"51145",51,145,2015,13388,12855,533,4
"51145",51,145,2016,13617,13130,487,3.6
"51145",51,145,2017,13858,13394,464,3.3
"51147",51,147,1990,7746,7113,633,8.2
"51147",51,147,1991,8303,7424,879,10.6
"51147",51,147,1992,8727,7826,901,10.3
"51147",51,147,1993,8535,7794,741,8.7
"51147",51,147,1994,8327,7940,387,4.6
"51147",51,147,1995,8539,8084,455,5.3
"51147",51,147,1996,8372,7875,497,5.9
"51147",51,147,1997,8476,7791,685,8.1
"51147",51,147,1998,8117,7733,384,4.7
"51147",51,147,1999,8167,7881,286,3.5
"51147",51,147,2000,8133,7859,274,3.4
"51147",51,147,2001,8232,7885,347,4.2
"51147",51,147,2002,8266,7779,487,5.9
"51147",51,147,2003,8456,7973,483,5.7
"51147",51,147,2004,8290,7815,475,5.7
"51147",51,147,2005,8532,8041,491,5.8
"51147",51,147,2006,8892,8462,430,4.8
"51147",51,147,2007,9053,8637,416,4.6
"51147",51,147,2008,9646,9115,531,5.5
"51147",51,147,2009,9992,9104,888,8.9
"51147",51,147,2010,10279,9284,995,9.7
"51147",51,147,2011,10386,9450,936,9
"51147",51,147,2012,10285,9411,874,8.5
"51147",51,147,2013,9990,9151,839,8.4
"51147",51,147,2014,10026,9257,769,7.7
"51147",51,147,2015,10057,9428,629,6.3
"51147",51,147,2016,10140,9595,545,5.4
"51147",51,147,2017,10306,9792,514,5
"51149",51,149,1990,11968,11509,459,3.8
"51149",51,149,1991,11453,10883,570,5
"51149",51,149,1992,12031,11273,758,6.3
"51149",51,149,1993,12019,11488,531,4.4
"51149",51,149,1994,12051,11529,522,4.3
"51149",51,149,1995,12055,11579,476,3.9
"51149",51,149,1996,12528,12076,452,3.6
"51149",51,149,1997,12598,12203,395,3.1
"51149",51,149,1998,11851,11491,360,3
"51149",51,149,1999,12099,11755,344,2.8
"51149",51,149,2000,13224,12884,340,2.6
"51149",51,149,2001,13593,13117,476,3.5
"51149",51,149,2002,14114,13568,546,3.9
"51149",51,149,2003,14546,13939,607,4.2
"51149",51,149,2004,14704,14157,547,3.7
"51149",51,149,2005,15026,14442,584,3.9
"51149",51,149,2006,14854,14349,505,3.4
"51149",51,149,2007,14693,14219,474,3.2
"51149",51,149,2008,14985,14346,639,4.3
"51149",51,149,2009,15052,14009,1043,6.9
"51149",51,149,2010,13962,12838,1124,8.1
"51149",51,149,2011,14530,13396,1134,7.8
"51149",51,149,2012,14664,13577,1087,7.4
"51149",51,149,2013,14741,13709,1032,7
"51149",51,149,2014,14764,13829,935,6.3
"51149",51,149,2015,14871,14067,804,5.4
"51149",51,149,2016,14910,14179,731,4.9
"51149",51,149,2017,15149,14477,672,4.4
"51153",51,153,1990,117965,115203,2762,2.3
"51153",51,153,1991,121379,116505,4874,4
"51153",51,153,1992,124687,118864,5823,4.7
"51153",51,153,1993,125475,120989,4486,3.6
"51153",51,153,1994,128899,124640,4259,3.3
"51153",51,153,1995,129613,125387,4226,3.3
"51153",51,153,1996,129273,125610,3663,2.8
"51153",51,153,1997,131575,128147,3428,2.6
"51153",51,153,1998,136689,133954,2735,2
"51153",51,153,1999,142289,139606,2683,1.9
"51153",51,153,2000,153614,150881,2733,1.8
"51153",51,153,2001,160696,156730,3966,2.5
"51153",51,153,2002,166146,160457,5689,3.4
"51153",51,153,2003,170707,164902,5805,3.4
"51153",51,153,2004,179226,173907,5319,3
"51153",51,153,2005,189649,184445,5204,2.7
"51153",51,153,2006,197085,192301,4784,2.4
"51153",51,153,2007,200311,195368,4943,2.5
"51153",51,153,2008,206086,199300,6786,3.3
"51153",51,153,2009,208417,197060,11357,5.4
"51153",51,153,2010,218394,205097,13297,6.1
"51153",51,153,2011,225195,212446,12749,5.7
"51153",51,153,2012,228830,216748,12082,5.3
"51153",51,153,2013,231105,219058,12047,5.2
"51153",51,153,2014,231813,220441,11372,4.9
"51153",51,153,2015,231347,221783,9564,4.1
"51153",51,153,2016,234607,225977,8630,3.7
"51153",51,153,2017,239833,231667,8166,3.4
"51155",51,155,1990,18329,15828,2501,13.6
"51155",51,155,1991,18010,15738,2272,12.6
"51155",51,155,1992,17563,15843,1720,9.8
"51155",51,155,1993,17508,15775,1733,9.9
"51155",51,155,1994,17004,15822,1182,7
"51155",51,155,1995,17021,15963,1058,6.2
"51155",51,155,1996,17474,15800,1674,9.6
"51155",51,155,1997,16814,15931,883,5.3
"51155",51,155,1998,16558,15890,668,4
"51155",51,155,1999,16978,16233,745,4.4
"51155",51,155,2000,17403,16607,796,4.6
"51155",51,155,2001,17737,16475,1262,7.1
"51155",51,155,2002,17566,16452,1114,6.3
"51155",51,155,2003,18041,16939,1102,6.1
"51155",51,155,2004,18041,16958,1083,6
"51155",51,155,2005,17995,17179,816,4.5
"51155",51,155,2006,18087,17377,710,3.9
"51155",51,155,2007,17706,16730,976,5.5
"51155",51,155,2008,18145,16987,1158,6.4
"51155",51,155,2009,18123,16147,1976,10.9
"51155",51,155,2010,16975,15091,1884,11.1
"51155",51,155,2011,16880,15413,1467,8.7
"51155",51,155,2012,16887,15631,1256,7.4
"51155",51,155,2013,16858,15578,1280,7.6
"51155",51,155,2014,16458,15451,1007,6.1
"51155",51,155,2015,16309,15483,826,5.1
"51155",51,155,2016,16249,15272,977,6
"51155",51,155,2017,16260,15390,870,5.4
"51157",51,157,1990,3613,3403,210,5.8
"51157",51,157,1991,4150,3793,357,8.6
"51157",51,157,1992,4169,3851,318,7.6
"51157",51,157,1993,4009,3840,169,4.2
"51157",51,157,1994,3984,3783,201,5
"51157",51,157,1995,3991,3795,196,4.9
"51157",51,157,1996,4000,3851,149,3.7
"51157",51,157,1997,4336,4076,260,6
"51157",51,157,1998,4158,4037,121,2.9
"51157",51,157,1999,3991,3912,79,2
"51157",51,157,2000,3753,3683,70,1.9
"51157",51,157,2001,3740,3651,89,2.4
"51157",51,157,2002,3728,3601,127,3.4
"51157",51,157,2003,3945,3825,120,3
"51157",51,157,2004,4049,3941,108,2.7
"51157",51,157,2005,4112,4004,108,2.6
"51157",51,157,2006,4265,4164,101,2.4
"51157",51,157,2007,4314,4206,108,2.5
"51157",51,157,2008,4281,4132,149,3.5
"51157",51,157,2009,4229,3983,246,5.8
"51157",51,157,2010,4025,3771,254,6.3
"51157",51,157,2011,4003,3778,225,5.6
"51157",51,157,2012,3963,3748,215,5.4
"51157",51,157,2013,3916,3715,201,5.1
"51157",51,157,2014,3797,3615,182,4.8
"51157",51,157,2015,3734,3579,155,4.2
"51157",51,157,2016,3706,3574,132,3.6
"51157",51,157,2017,3745,3615,130,3.5
"51159",51,159,1990,3500,3257,243,6.9
"51159",51,159,1991,3647,3370,277,7.6
"51159",51,159,1992,3813,3440,373,9.8
"51159",51,159,1993,3749,3431,318,8.5
"51159",51,159,1994,4046,3762,284,7
"51159",51,159,1995,4012,3761,251,6.3
"51159",51,159,1996,3945,3638,307,7.8
"51159",51,159,1997,3912,3672,240,6.1
"51159",51,159,1998,3954,3765,189,4.8
"51159",51,159,1999,4036,3854,182,4.5
"51159",51,159,2000,3427,3277,150,4.4
"51159",51,159,2001,3442,3299,143,4.2
"51159",51,159,2002,3508,3308,200,5.7
"51159",51,159,2003,3564,3341,223,6.3
"51159",51,159,2004,3464,3279,185,5.3
"51159",51,159,2005,3482,3317,165,4.7
"51159",51,159,2006,3496,3326,170,4.9
"51159",51,159,2007,3500,3348,152,4.3
"51159",51,159,2008,3881,3686,195,5
"51159",51,159,2009,4089,3773,316,7.7
"51159",51,159,2010,4366,4058,308,7.1
"51159",51,159,2011,4267,3982,285,6.7
"51159",51,159,2012,3926,3675,251,6.4
"51159",51,159,2013,3939,3695,244,6.2
"51159",51,159,2014,3972,3755,217,5.5
"51159",51,159,2015,3900,3722,178,4.6
"51159",51,159,2016,3903,3757,146,3.7
"51159",51,159,2017,3893,3746,147,3.8
"51161",51,161,1990,45169,43845,1324,2.9
"51161",51,161,1991,46331,44455,1876,4
"51161",51,161,1992,47405,45477,1928,4.1
"51161",51,161,1993,47750,45855,1895,4
"51161",51,161,1994,48572,47200,1372,2.8
"51161",51,161,1995,49001,47929,1072,2.2
"51161",51,161,1996,48667,47585,1082,2.2
"51161",51,161,1997,47909,46804,1105,2.3
"51161",51,161,1998,48460,47667,793,1.6
"51161",51,161,1999,47875,47244,631,1.3
"51161",51,161,2000,46009,45205,804,1.7
"51161",51,161,2001,46496,45353,1143,2.5
"51161",51,161,2002,47125,45587,1538,3.3
"51161",51,161,2003,46141,44587,1554,3.4
"51161",51,161,2004,45699,44184,1515,3.3
"51161",51,161,2005,46636,45233,1403,3
"51161",51,161,2006,48751,47481,1270,2.6
"51161",51,161,2007,48977,47743,1234,2.5
"51161",51,161,2008,49795,48208,1587,3.2
"51161",51,161,2009,48506,45655,2851,5.9
"51161",51,161,2010,49258,46137,3121,6.3
"51161",51,161,2011,49724,46896,2828,5.7
"51161",51,161,2012,49569,46975,2594,5.2
"51161",51,161,2013,49826,47327,2499,5
"51161",51,161,2014,49979,47689,2290,4.6
"51161",51,161,2015,49070,47142,1928,3.9
"51161",51,161,2016,49064,47293,1771,3.6
"51161",51,161,2017,49144,47449,1695,3.4
"51163",51,163,1990,9514,8962,552,5.8
"51163",51,163,1991,10205,9373,832,8.2
"51163",51,163,1992,10091,9127,964,9.6
"51163",51,163,1993,9776,9019,757,7.7
"51163",51,163,1994,9701,9141,560,5.8
"51163",51,163,1995,9667,9185,482,5
"51163",51,163,1996,9765,9328,437,4.5
"51163",51,163,1997,9880,9564,316,3.2
"51163",51,163,1998,9686,9472,214,2.2
"51163",51,163,1999,10241,10029,212,2.1
"51163",51,163,2000,10674,10442,232,2.2
"51163",51,163,2001,10881,10560,321,3
"51163",51,163,2002,11029,10644,385,3.5
"51163",51,163,2003,11197,10779,418,3.7
"51163",51,163,2004,10884,10521,363,3.3
"51163",51,163,2005,11233,10881,352,3.1
"51163",51,163,2006,11238,10928,310,2.8
"51163",51,163,2007,11240,10912,328,2.9
"51163",51,163,2008,11504,11030,474,4.1
"51163",51,163,2009,11671,10918,753,6.5
"51163",51,163,2010,11142,10303,839,7.5
"51163",51,163,2011,11010,10263,747,6.8
"51163",51,163,2012,10768,10112,656,6.1
"51163",51,163,2013,10416,9811,605,5.8
"51163",51,163,2014,10299,9749,550,5.3
"51163",51,163,2015,10321,9835,486,4.7
"51163",51,163,2016,10447,9986,461,4.4
"51163",51,163,2017,10588,10155,433,4.1
"51165",51,165,1990,32380,30729,1651,5.1
"51165",51,165,1991,33639,31651,1988,5.9
"51165",51,165,1992,35349,33525,1824,5.2
"51165",51,165,1993,35505,34219,1286,3.6
"51165",51,165,1994,36137,35067,1070,3
"51165",51,165,1995,36869,35739,1130,3.1
"51165",51,165,1996,36413,35438,975,2.7
"51165",51,165,1997,36682,36045,637,1.7
"51165",51,165,1998,36565,36088,477,1.3
"51165",51,165,1999,37456,36985,471,1.3
"51165",51,165,2000,36123,35508,615,1.7
"51165",51,165,2001,36893,35996,897,2.4
"51165",51,165,2002,37652,36334,1318,3.5
"51165",51,165,2003,38991,37751,1240,3.2
"51165",51,165,2004,39649,38419,1230,3.1
"51165",51,165,2005,40244,39032,1212,3
"51165",51,165,2006,42116,41097,1019,2.4
"51165",51,165,2007,41530,40497,1033,2.5
"51165",51,165,2008,42270,40857,1413,3.3
"51165",51,165,2009,41705,39260,2445,5.9
"51165",51,165,2010,40373,37656,2717,6.7
"51165",51,165,2011,41314,38822,2492,6
"51165",51,165,2012,40874,38557,2317,5.7
"51165",51,165,2013,40622,38560,2062,5.1
"51165",51,165,2014,40378,38483,1895,4.7
"51165",51,165,2015,40108,38457,1651,4.1
"51165",51,165,2016,40499,39062,1437,3.5
"51165",51,165,2017,40837,39501,1336,3.3
"51167",51,167,1990,11949,10572,1377,11.5
"51167",51,167,1991,12683,11022,1661,13.1
"51167",51,167,1992,12710,11096,1614,12.7
"51167",51,167,1993,13112,11690,1422,10.8
"51167",51,167,1994,13749,11937,1812,13.2
"51167",51,167,1995,14179,12615,1564,11
"51167",51,167,1996,14230,12610,1620,11.4
"51167",51,167,1997,14138,12712,1426,10.1
"51167",51,167,1998,14084,12798,1286,9.1
"51167",51,167,1999,14109,12951,1158,8.2
"51167",51,167,2000,11865,11248,617,5.2
"51167",51,167,2001,11903,11139,764,6.4
"51167",51,167,2002,12140,11369,771,6.4
"51167",51,167,2003,12281,11519,762,6.2
"51167",51,167,2004,11521,10840,681,5.9
"51167",51,167,2005,11955,11265,690,5.8
"51167",51,167,2006,11812,11099,713,6
"51167",51,167,2007,11772,11165,607,5.2
"51167",51,167,2008,11877,11194,683,5.8
"51167",51,167,2009,12397,11095,1302,10.5
"51167",51,167,2010,12081,10844,1237,10.2
"51167",51,167,2011,11942,10809,1133,9.5
"51167",51,167,2012,11782,10762,1020,8.7
"51167",51,167,2013,11603,10619,984,8.5
"51167",51,167,2014,11277,10386,891,7.9
"51167",51,167,2015,11423,10673,750,6.6
"51167",51,167,2016,11230,10497,733,6.5
"51167",51,167,2017,11056,10447,609,5.5
"51169",51,169,1990,9716,8940,776,8
"51169",51,169,1991,9897,9011,886,9
"51169",51,169,1992,10235,9344,891,8.7
"51169",51,169,1993,10141,9309,832,8.2
"51169",51,169,1994,10231,9337,894,8.7
"51169",51,169,1995,10328,9399,929,9
"51169",51,169,1996,9868,9131,737,7.5
"51169",51,169,1997,9602,8943,659,6.9
"51169",51,169,1998,9517,8778,739,7.8
"51169",51,169,1999,9261,8656,605,6.5
"51169",51,169,2000,9771,9394,377,3.9
"51169",51,169,2001,9767,9314,453,4.6
"51169",51,169,2002,9816,9292,524,5.3
"51169",51,169,2003,9861,9322,539,5.5
"51169",51,169,2004,9715,9161,554,5.7
"51169",51,169,2005,9769,9255,514,5.3
"51169",51,169,2006,9924,9434,490,4.9
"51169",51,169,2007,9804,9350,454,4.6
"51169",51,169,2008,10102,9555,547,5.4
"51169",51,169,2009,9861,8919,942,9.6
"51169",51,169,2010,10072,9219,853,8.5
"51169",51,169,2011,10156,9411,745,7.3
"51169",51,169,2012,10087,9326,761,7.5
"51169",51,169,2013,10003,9305,698,7
"51169",51,169,2014,9784,9211,573,5.9
"51169",51,169,2015,9500,9010,490,5.2
"51169",51,169,2016,9412,8947,465,4.9
"51169",51,169,2017,9393,9009,384,4.1
"51171",51,171,1990,16619,15827,792,4.8
"51171",51,171,1991,17345,16262,1083,6.2
"51171",51,171,1992,17760,16640,1120,6.3
"51171",51,171,1993,17319,16607,712,4.1
"51171",51,171,1994,17719,17081,638,3.6
"51171",51,171,1995,17973,16930,1043,5.8
"51171",51,171,1996,17334,16467,867,5
"51171",51,171,1997,17193,16628,565,3.3
"51171",51,171,1998,17310,16841,469,2.7
"51171",51,171,1999,17574,17081,493,2.8
"51171",51,171,2000,18513,18179,334,1.8
"51171",51,171,2001,18787,18327,460,2.4
"51171",51,171,2002,19057,18460,597,3.1
"51171",51,171,2003,19133,18387,746,3.9
"51171",51,171,2004,19018,18378,640,3.4
"51171",51,171,2005,19521,18920,601,3.1
"51171",51,171,2006,19786,19188,598,3
"51171",51,171,2007,20009,19372,637,3.2
"51171",51,171,2008,20290,19346,944,4.7
"51171",51,171,2009,20232,18576,1656,8.2
"51171",51,171,2010,20831,19117,1714,8.2
"51171",51,171,2011,21084,19597,1487,7.1
"51171",51,171,2012,20834,19508,1326,6.4
"51171",51,171,2013,20940,19764,1176,5.6
"51171",51,171,2014,21222,20159,1063,5
"51171",51,171,2015,21034,20135,899,4.3
"51171",51,171,2016,20797,20007,790,3.8
"51171",51,171,2017,21027,20282,745,3.5
"51173",51,173,1990,16449,14825,1624,9.9
"51173",51,173,1991,17211,15497,1714,10
"51173",51,173,1992,18343,15924,2419,13.2
"51173",51,173,1993,17913,15775,2138,11.9
"51173",51,173,1994,17469,15663,1806,10.3
"51173",51,173,1995,17621,15900,1721,9.8
"51173",51,173,1996,16820,14992,1828,10.9
"51173",51,173,1997,16529,15183,1346,8.1
"51173",51,173,1998,16525,15622,903,5.5
"51173",51,173,1999,16558,15558,1000,6
"51173",51,173,2000,15862,15171,691,4.4
"51173",51,173,2001,15565,14570,995,6.4
"51173",51,173,2002,15475,14223,1252,8.1
"51173",51,173,2003,15772,14576,1196,7.6
"51173",51,173,2004,15375,14564,811,5.3
"51173",51,173,2005,15589,14862,727,4.7
"51173",51,173,2006,15339,14620,719,4.7
"51173",51,173,2007,15065,14244,821,5.4
"51173",51,173,2008,15128,14207,921,6.1
"51173",51,173,2009,15153,13472,1681,11.1
"51173",51,173,2010,13707,12046,1661,12.1
"51173",51,173,2011,13750,12250,1500,10.9
"51173",51,173,2012,13516,12221,1295,9.6
"51173",51,173,2013,13405,12189,1216,9.1
"51173",51,173,2014,13448,12381,1067,7.9
"51173",51,173,2015,13460,12582,878,6.5
"51173",51,173,2016,13659,12859,800,5.9
"51173",51,173,2017,13117,12411,706,5.4
"51175",51,175,1990,7808,7415,393,5
"51175",51,175,1991,7662,7248,414,5.4
"51175",51,175,1992,7886,7363,523,6.6
"51175",51,175,1993,7489,7074,415,5.5
"51175",51,175,1994,7620,7217,403,5.3
"51175",51,175,1995,7710,7376,334,4.3
"51175",51,175,1996,7500,7124,376,5
"51175",51,175,1997,7655,7342,313,4.1
"51175",51,175,1998,7718,7479,239,3.1
"51175",51,175,1999,8536,8260,276,3.2
"51175",51,175,2000,7489,7281,208,2.8
"51175",51,175,2001,7411,7171,240,3.2
"51175",51,175,2002,7436,7124,312,4.2
"51175",51,175,2003,7566,7234,332,4.4
"51175",51,175,2004,7420,7099,321,4.3
"51175",51,175,2005,7523,7207,316,4.2
"51175",51,175,2006,7588,7308,280,3.7
"51175",51,175,2007,7673,7397,276,3.6
"51175",51,175,2008,8112,7722,390,4.8
"51175",51,175,2009,8095,7450,645,8
"51175",51,175,2010,9495,8679,816,8.6
"51175",51,175,2011,9441,8715,726,7.7
"51175",51,175,2012,9494,8898,596,6.3
"51175",51,175,2013,9241,8724,517,5.6
"51175",51,175,2014,9124,8676,448,4.9
"51175",51,175,2015,9196,8827,369,4
"51175",51,175,2016,9024,8666,358,4
"51175",51,175,2017,8845,8512,333,3.8
"51177",51,177,1990,31523,30294,1229,3.9
"51177",51,177,1991,32967,31007,1960,5.9
"51177",51,177,1992,34788,32675,2113,6.1
"51177",51,177,1993,34320,32740,1580,4.6
"51177",51,177,1994,36286,34945,1341,3.7
"51177",51,177,1995,37436,36120,1316,3.5
"51177",51,177,1996,39738,38463,1275,3.2
"51177",51,177,1997,40843,39709,1134,2.8
"51177",51,177,1998,42461,41710,751,1.8
"51177",51,177,1999,44530,43834,696,1.6
"51177",51,177,2000,48522,47689,833,1.7
"51177",51,177,2001,50930,49855,1075,2.1
"51177",51,177,2002,53322,51777,1545,2.9
"51177",51,177,2003,55468,53773,1695,3.1
"51177",51,177,2004,58122,56431,1691,2.9
"51177",51,177,2005,61880,60198,1682,2.7
"51177",51,177,2006,64312,62735,1577,2.5
"51177",51,177,2007,64669,63030,1639,2.5
"51177",51,177,2008,66228,63968,2260,3.4
"51177",51,177,2009,64917,61268,3649,5.6
"51177",51,177,2010,63357,58922,4435,7
"51177",51,177,2011,64277,59971,4306,6.7
"51177",51,177,2012,64141,60232,3909,6.1
"51177",51,177,2013,64155,60426,3729,5.8
"51177",51,177,2014,64117,60640,3477,5.4
"51177",51,177,2015,63800,60840,2960,4.6
"51177",51,177,2016,64849,62173,2676,4.1
"51177",51,177,2017,66131,63665,2466,3.7
"51179",51,179,1990,32349,31305,1044,3.2
"51179",51,179,1991,34615,32881,1734,5
"51179",51,179,1992,36144,34235,1909,5.3
"51179",51,179,1993,37392,36130,1262,3.4
"51179",51,179,1994,39238,38034,1204,3.1
"51179",51,179,1995,40629,39374,1255,3.1
"51179",51,179,1996,42155,41020,1135,2.7
"51179",51,179,1997,43187,42291,896,2.1
"51179",51,179,1998,44550,43848,702,1.6
"51179",51,179,1999,46699,46004,695,1.5
"51179",51,179,2000,48423,47600,823,1.7
"51179",51,179,2001,50738,49613,1125,2.2
"51179",51,179,2002,53202,51592,1610,3
"51179",51,179,2003,55344,53623,1721,3.1
"51179",51,179,2004,58475,56801,1674,2.9
"51179",51,179,2005,61558,59870,1688,2.7
"51179",51,179,2006,63634,62051,1583,2.5
"51179",51,179,2007,64503,62816,1687,2.6
"51179",51,179,2008,66129,63852,2277,3.4
"51179",51,179,2009,65512,61927,3585,5.5
"51179",51,179,2010,63904,59748,4156,6.5
"51179",51,179,2011,65148,61126,4022,6.2
"51179",51,179,2012,65515,61724,3791,5.8
"51179",51,179,2013,66087,62345,3742,5.7
"51179",51,179,2014,66681,63121,3560,5.3
"51179",51,179,2015,66649,63674,2975,4.5
"51179",51,179,2016,68194,65497,2697,4
"51179",51,179,2017,69689,67165,2524,3.6
"51181",51,181,1990,3137,2933,204,6.5
"51181",51,181,1991,3250,2950,300,9.2
"51181",51,181,1992,3255,2830,425,13.1
"51181",51,181,1993,3070,2722,348,11.3
"51181",51,181,1994,2860,2521,339,11.9
"51181",51,181,1995,2717,2460,257,9.5
"51181",51,181,1996,2688,2408,280,10.4
"51181",51,181,1997,2648,2421,227,8.6
"51181",51,181,1998,2483,2285,198,8
"51181",51,181,1999,2405,2221,184,7.7
"51181",51,181,2000,3396,3297,99,2.9
"51181",51,181,2001,3457,3342,115,3.3
"51181",51,181,2002,3558,3397,161,4.5
"51181",51,181,2003,3549,3386,163,4.6
"51181",51,181,2004,3536,3386,150,4.2
"51181",51,181,2005,3638,3462,176,4.8
"51181",51,181,2006,3707,3580,127,3.4
"51181",51,181,2007,3730,3603,127,3.4
"51181",51,181,2008,3815,3645,170,4.5
"51181",51,181,2009,3719,3441,278,7.5
"51181",51,181,2010,3694,3363,331,9
"51181",51,181,2011,3760,3442,318,8.5
"51181",51,181,2012,3690,3402,288,7.8
"51181",51,181,2013,3633,3368,265,7.3
"51181",51,181,2014,3664,3436,228,6.2
"51181",51,181,2015,3716,3528,188,5.1
"51181",51,181,2016,3652,3458,194,5.3
"51181",51,181,2017,3708,3540,168,4.5
"51183",51,183,1990,4841,4560,281,5.8
"51183",51,183,1991,4916,4405,511,10.4
"51183",51,183,1992,5051,4496,555,11
"51183",51,183,1993,4960,4544,416,8.4
"51183",51,183,1994,4971,4600,371,7.5
"51183",51,183,1995,5056,4739,317,6.3
"51183",51,183,1996,5066,4684,382,7.5
"51183",51,183,1997,5564,5262,302,5.4
"51183",51,183,1998,5747,5517,230,4
"51183",51,183,1999,6277,6094,183,2.9
"51183",51,183,2000,4532,4364,168,3.7
"51183",51,183,2001,4471,4259,212,4.7
"51183",51,183,2002,4385,4130,255,5.8
"51183",51,183,2003,4473,4163,310,6.9
"51183",51,183,2004,4409,4142,267,6.1
"51183",51,183,2005,4408,4148,260,5.9
"51183",51,183,2006,4476,4273,203,4.5
"51183",51,183,2007,4464,4264,200,4.5
"51183",51,183,2008,4503,4241,262,5.8
"51183",51,183,2009,4441,3991,450,10.1
"51183",51,183,2010,4281,3792,489,11.4
"51183",51,183,2011,4381,3922,459,10.5
"51183",51,183,2012,4277,3861,416,9.7
"51183",51,183,2013,4185,3797,388,9.3
"51183",51,183,2014,4108,3787,321,7.8
"51183",51,183,2015,4073,3794,279,6.8
"51183",51,183,2016,3943,3693,250,6.3
"51183",51,183,2017,3917,3684,233,5.9
"51185",51,185,1990,18917,17140,1777,9.4
"51185",51,185,1991,19933,17551,2382,12
"51185",51,185,1992,21046,18176,2870,13.6
"51185",51,185,1993,20627,17905,2722,13.2
"51185",51,185,1994,20988,18076,2912,13.9
"51185",51,185,1995,20175,18096,2079,10.3
"51185",51,185,1996,19848,17930,1918,9.7
"51185",51,185,1997,20061,18311,1750,8.7
"51185",51,185,1998,19714,18018,1696,8.6
"51185",51,185,1999,19524,18153,1371,7
"51185",51,185,2000,18999,18022,977,5.1
"51185",51,185,2001,19384,18426,958,4.9
"51185",51,185,2002,20101,18936,1165,5.8
"51185",51,185,2003,19904,18826,1078,5.4
"51185",51,185,2004,19269,18346,923,4.8
"51185",51,185,2005,19489,18598,891,4.6
"51185",51,185,2006,19985,19186,799,4
"51185",51,185,2007,20298,19384,914,4.5
"51185",51,185,2008,20752,19839,913,4.4
"51185",51,185,2009,21483,19864,1619,7.5
"51185",51,185,2010,18394,16779,1615,8.8
"51185",51,185,2011,18195,16749,1446,7.9
"51185",51,185,2012,17974,16489,1485,8.3
"51185",51,185,2013,17673,16146,1527,8.6
"51185",51,185,2014,17225,15821,1404,8.2
"51185",51,185,2015,16612,15382,1230,7.4
"51185",51,185,2016,15937,14731,1206,7.6
"51185",51,185,2017,15866,14927,939,5.9
"51187",51,187,1990,14113,13082,1031,7.3
"51187",51,187,1991,14702,13269,1433,9.7
"51187",51,187,1992,15094,13485,1609,10.7
"51187",51,187,1993,14598,13596,1002,6.9
"51187",51,187,1994,14818,13952,866,5.8
"51187",51,187,1995,14911,14057,854,5.7
"51187",51,187,1996,14818,14062,756,5.1
"51187",51,187,1997,14644,14018,626,4.3
"51187",51,187,1998,14716,14291,425,2.9
"51187",51,187,1999,15065,14668,397,2.6
"51187",51,187,2000,16584,16245,339,2
"51187",51,187,2001,16800,16328,472,2.8
"51187",51,187,2002,17082,16400,682,4
"51187",51,187,2003,17309,16613,696,4
"51187",51,187,2004,17704,17098,606,3.4
"51187",51,187,2005,18604,18034,570,3.1
"51187",51,187,2006,19146,18604,542,2.8
"51187",51,187,2007,19438,18846,592,3
"51187",51,187,2008,20070,19187,883,4.4
"51187",51,187,2009,19746,18257,1489,7.5
"51187",51,187,2010,20103,18480,1623,8.1
"51187",51,187,2011,20119,18629,1490,7.4
"51187",51,187,2012,20060,18716,1344,6.7
"51187",51,187,2013,20087,18854,1233,6.1
"51187",51,187,2014,19916,18791,1125,5.6
"51187",51,187,2015,19619,18684,935,4.8
"51187",51,187,2016,19671,18867,804,4.1
"51187",51,187,2017,20033,19290,743,3.7
"51191",51,191,1990,23871,21920,1951,8.2
"51191",51,191,1991,24273,22518,1755,7.2
"51191",51,191,1992,25645,23629,2016,7.9
"51191",51,191,1993,25356,23628,1728,6.8
"51191",51,191,1994,25592,23844,1748,6.8
"51191",51,191,1995,26356,24429,1927,7.3
"51191",51,191,1996,26280,24229,2051,7.8
"51191",51,191,1997,25390,23890,1500,5.9
"51191",51,191,1998,25090,23823,1267,5
"51191",51,191,1999,24868,23743,1125,4.5
"51191",51,191,2000,25140,24240,900,3.6
"51191",51,191,2001,25534,24241,1293,5.1
"51191",51,191,2002,25931,24351,1580,6.1
"51191",51,191,2003,25976,24569,1407,5.4
"51191",51,191,2004,25579,24326,1253,4.9
"51191",51,191,2005,25934,24759,1175,4.5
"51191",51,191,2006,26377,25278,1099,4.2
"51191",51,191,2007,26738,25524,1214,4.5
"51191",51,191,2008,27513,26160,1353,4.9
"51191",51,191,2009,26996,24701,2295,8.5
"51191",51,191,2010,27416,25239,2177,7.9
"51191",51,191,2011,27899,25914,1985,7.1
"51191",51,191,2012,27772,25902,1870,6.7
"51191",51,191,2013,27839,26066,1773,6.4
"51191",51,191,2014,27619,26024,1595,5.8
"51191",51,191,2015,26978,25683,1295,4.8
"51191",51,191,2016,26809,25588,1221,4.6
"51191",51,191,2017,26908,25804,1104,4.1
"51193",51,193,1990,7358,6740,618,8.4
"51193",51,193,1991,7711,6924,787,10.2
"51193",51,193,1992,7968,6993,975,12.2
"51193",51,193,1993,7499,6654,845,11.3
"51193",51,193,1994,7448,6723,725,9.7
"51193",51,193,1995,7412,6735,677,9.1
"51193",51,193,1996,7475,6756,719,9.6
"51193",51,193,1997,7485,6916,569,7.6
"51193",51,193,1998,7298,6892,406,5.6
"51193",51,193,1999,7343,6967,376,5.1
"51193",51,193,2000,7686,7411,275,3.6
"51193",51,193,2001,7676,7361,315,4.1
"51193",51,193,2002,7875,7500,375,4.8
"51193",51,193,2003,8061,7672,389,4.8
"51193",51,193,2004,7836,7465,371,4.7
"51193",51,193,2005,8114,7742,372,4.6
"51193",51,193,2006,8259,7933,326,3.9
"51193",51,193,2007,8313,7964,349,4.2
"51193",51,193,2008,8875,8428,447,5
"51193",51,193,2009,9133,8438,695,7.6
"51193",51,193,2010,9178,8436,742,8.1
"51193",51,193,2011,9402,8695,707,7.5
"51193",51,193,2012,9152,8487,665,7.3
"51193",51,193,2013,9100,8475,625,6.9
"51193",51,193,2014,9012,8428,584,6.5
"51193",51,193,2015,8920,8439,481,5.4
"51193",51,193,2016,8966,8551,415,4.6
"51193",51,193,2017,9004,8581,423,4.7
"51195",51,195,1990,15570,13870,1700,10.9
"51195",51,195,1991,16234,14065,2169,13.4
"51195",51,195,1992,16625,14060,2565,15.4
"51195",51,195,1993,16265,14122,2143,13.2
"51195",51,195,1994,16003,13967,2036,12.7
"51195",51,195,1995,16300,13509,2791,17.1
"51195",51,195,1996,15222,12793,2429,16
"51195",51,195,1997,14944,13169,1775,11.9
"51195",51,195,1998,14784,13269,1515,10.2
"51195",51,195,1999,14812,13478,1334,9
"51195",51,195,2000,16152,15467,685,4.2
"51195",51,195,2001,16387,15614,773,4.7
"51195",51,195,2002,16917,15915,1002,5.9
"51195",51,195,2003,17258,16263,995,5.8
"51195",51,195,2004,16837,15944,893,5.3
"51195",51,195,2005,17238,16413,825,4.8
"51195",51,195,2006,17279,16497,782,4.5
"51195",51,195,2007,17456,16769,687,3.9
"51195",51,195,2008,18108,17273,835,4.6
"51195",51,195,2009,19412,18129,1283,6.6
"51195",51,195,2010,16977,15561,1416,8.3
"51195",51,195,2011,17257,15933,1324,7.7
"51195",51,195,2012,16013,14583,1430,8.9
"51195",51,195,2013,15100,13538,1562,10.3
"51195",51,195,2014,14435,13063,1372,9.5
"51195",51,195,2015,13783,12641,1142,8.3
"51195",51,195,2016,13190,12062,1128,8.6
"51195",51,195,2017,12986,12106,880,6.8
"51197",51,197,1990,13433,12131,1302,9.7
"51197",51,197,1991,13993,12641,1352,9.7
"51197",51,197,1992,14292,12823,1469,10.3
"51197",51,197,1993,14555,13330,1225,8.4
"51197",51,197,1994,14719,13794,925,6.3
"51197",51,197,1995,14975,13988,987,6.6
"51197",51,197,1996,15291,13927,1364,8.9
"51197",51,197,1997,14874,13878,996,6.7
"51197",51,197,1998,14125,13514,611,4.3
"51197",51,197,1999,14276,13695,581,4.1
"51197",51,197,2000,14162,13546,616,4.3
"51197",51,197,2001,14318,13340,978,6.8
"51197",51,197,2002,14333,13432,901,6.3
"51197",51,197,2003,14728,13949,779,5.3
"51197",51,197,2004,14484,13779,705,4.9
"51197",51,197,2005,14965,14312,653,4.4
"51197",51,197,2006,14984,14366,618,4.1
"51197",51,197,2007,15475,14784,691,4.5
"51197",51,197,2008,16175,15312,863,5.3
"51197",51,197,2009,16396,14680,1716,10.5
"51197",51,197,2010,14277,12687,1590,11.1
"51197",51,197,2011,14385,13062,1323,9.2
"51197",51,197,2012,14125,13031,1094,7.7
"51197",51,197,2013,14001,12909,1092,7.8
"51197",51,197,2014,13790,12900,890,6.5
"51197",51,197,2015,13642,12901,741,5.4
"51197",51,197,2016,13641,12856,785,5.8
"51197",51,197,2017,13646,12935,711,5.2
"51199",51,199,1990,20704,19980,724,3.5
"51199",51,199,1991,22100,21256,844,3.8
"51199",51,199,1992,23155,22215,940,4.1
"51199",51,199,1993,24219,23311,908,3.7
"51199",51,199,1994,25488,24521,967,3.8
"51199",51,199,1995,26118,25359,759,2.9
"51199",51,199,1996,27074,26252,822,3
"51199",51,199,1997,28146,27404,742,2.6
"51199",51,199,1998,28431,27873,558,2
"51199",51,199,1999,28782,28206,576,2
"51199",51,199,2000,26860,26332,528,2
"51199",51,199,2001,27967,27271,696,2.5
"51199",51,199,2002,28920,28027,893,3.1
"51199",51,199,2003,29158,28235,923,3.2
"51199",51,199,2004,29502,28589,913,3.1
"51199",51,199,2005,30554,29620,934,3.1
"51199",51,199,2006,31071,30232,839,2.7
"51199",51,199,2007,31002,30233,769,2.5
"51199",51,199,2008,31323,30292,1031,3.3
"51199",51,199,2009,30435,28820,1615,5.3
"51199",51,199,2010,31289,29377,1912,6.1
"51199",51,199,2011,31907,29945,1962,6.1
"51199",51,199,2012,31718,29883,1835,5.8
"51199",51,199,2013,31835,30123,1712,5.4
"51199",51,199,2014,31832,30235,1597,5
"51199",51,199,2015,31991,30618,1373,4.3
"51199",51,199,2016,32066,30808,1258,3.9
"51199",51,199,2017,32591,31430,1161,3.6
"51510",51,510,1990,73894,71827,2067,2.8
"51510",51,510,1991,75367,71718,3649,4.8
"51510",51,510,1992,77524,72691,4833,6.2
"51510",51,510,1993,75793,71192,4601,6.1
"51510",51,510,1994,75218,71836,3382,4.5
"51510",51,510,1995,75460,72118,3342,4.4
"51510",51,510,1996,72769,69836,2933,4
"51510",51,510,1997,72914,70641,2273,3.1
"51510",51,510,1998,72298,70669,1629,2.3
"51510",51,510,1999,74455,72803,1652,2.2
"51510",51,510,2000,80943,79495,1448,1.8
"51510",51,510,2001,81631,79416,2215,2.7
"51510",51,510,2002,83146,80282,2864,3.4
"51510",51,510,2003,82495,80019,2476,3
"51510",51,510,2004,83784,81478,2306,2.8
"51510",51,510,2005,84746,82535,2211,2.6
"51510",51,510,2006,86832,84891,1941,2.2
"51510",51,510,2007,89476,87484,1992,2.2
"51510",51,510,2008,93221,90650,2571,2.8
"51510",51,510,2009,94424,89890,4534,4.8
"51510",51,510,2010,90361,85915,4446,4.9
"51510",51,510,2011,92505,88377,4128,4.5
"51510",51,510,2012,93257,89443,3814,4.1
"51510",51,510,2013,93676,89882,3794,4.1
"51510",51,510,2014,93538,89936,3602,3.9
"51510",51,510,2015,94154,91055,3099,3.3
"51510",51,510,2016,96239,93416,2823,2.9
"51510",51,510,2017,98590,95761,2829,2.9
"51520",51,520,1990,8904,8194,710,8
"51520",51,520,1991,8753,8141,612,7
"51520",51,520,1992,8797,8121,676,7.7
"51520",51,520,1993,8804,8229,575,6.5
"51520",51,520,1994,8757,8213,544,6.2
"51520",51,520,1995,8885,8415,470,5.3
"51520",51,520,1996,8454,7979,475,5.6
"51520",51,520,1997,8279,7869,410,5
"51520",51,520,1998,7927,7575,352,4.4
"51520",51,520,1999,7665,7390,275,3.6
"51520",51,520,2000,7512,7273,239,3.2
"51520",51,520,2001,7585,7268,317,4.2
"51520",51,520,2002,7573,7195,378,5
"51520",51,520,2003,7837,7350,487,6.2
"51520",51,520,2004,7713,7230,483,6.3
"51520",51,520,2005,7737,7312,425,5.5
"51520",51,520,2006,7937,7550,387,4.9
"51520",51,520,2007,7966,7557,409,5.1
"51520",51,520,2008,8091,7625,466,5.8
"51520",51,520,2009,8125,7315,810,10
"51520",51,520,2010,7977,7274,703,8.8
"51520",51,520,2011,8098,7426,672,8.3
"51520",51,520,2012,8003,7419,584,7.3
"51520",51,520,2013,7823,7277,546,7
"51520",51,520,2014,7721,7227,494,6.4
"51520",51,520,2015,7513,7110,403,5.4
"51520",51,520,2016,7438,7057,381,5.1
"51520",51,520,2017,7471,7130,341,4.6
"51530",51,530,1990,3413,3104,309,9.1
"51530",51,530,1991,3631,3239,392,10.8
"51530",51,530,1992,3398,3017,381,11.2
"51530",51,530,1993,3445,3015,430,12.5
"51530",51,530,1994,3232,3037,195,6
"51530",51,530,1995,3239,3052,187,5.8
"51530",51,530,1996,3111,2920,191,6.1
"51530",51,530,1997,3132,2993,139,4.4
"51530",51,530,1998,3318,3229,89,2.7
"51530",51,530,1999,3380,3291,89,2.6
"51530",51,530,2000,3226,3152,74,2.3
"51530",51,530,2001,3293,3180,113,3.4
"51530",51,530,2002,3331,3179,152,4.6
"51530",51,530,2003,3380,3228,152,4.5
"51530",51,530,2004,3353,3214,139,4.1
"51530",51,530,2005,3392,3263,129,3.8
"51530",51,530,2006,3389,3273,116,3.4
"51530",51,530,2007,3376,3255,121,3.6
"51530",51,530,2008,3450,3274,176,5.1
"51530",51,530,2009,3449,3155,294,8.5
"51530",51,530,2010,3248,2925,323,9.9
"51530",51,530,2011,3240,2944,296,9.1
"51530",51,530,2012,3263,3005,258,7.9
"51530",51,530,2013,3313,3088,225,6.8
"51530",51,530,2014,3306,3114,192,5.8
"51530",51,530,2015,3293,3126,167,5.1
"51530",51,530,2016,3271,3103,168,5.1
"51530",51,530,2017,3316,3171,145,4.4
"51540",51,540,1990,20675,20147,528,2.6
"51540",51,540,1991,20541,19588,953,4.6
"51540",51,540,1992,20190,19229,961,4.8
"51540",51,540,1993,20147,19487,660,3.3
"51540",51,540,1994,20041,19384,657,3.3
"51540",51,540,1995,20128,19593,535,2.7
"51540",51,540,1996,18678,18082,596,3.2
"51540",51,540,1997,18626,18149,477,2.6
"51540",51,540,1998,18278,17962,316,1.7
"51540",51,540,1999,18182,17864,318,1.7
"51540",51,540,2000,19378,18803,575,3
"51540",51,540,2001,19097,18408,689,3.6
"51540",51,540,2002,19644,18879,765,3.9
"51540",51,540,2003,19398,18591,807,4.2
"51540",51,540,2004,19583,18769,814,4.2
"51540",51,540,2005,19797,19039,758,3.8
"51540",51,540,2006,20407,19744,663,3.2
"51540",51,540,2007,21246,20596,650,3.1
"51540",51,540,2008,21730,20884,846,3.9
"51540",51,540,2009,21718,20317,1401,6.5
"51540",51,540,2010,23203,21790,1413,6.1
"51540",51,540,2011,23247,21947,1300,5.6
"51540",51,540,2012,23430,22230,1200,5.1
"51540",51,540,2013,23398,22302,1096,4.7
"51540",51,540,2014,24220,23170,1050,4.3
"51540",51,540,2015,24644,23734,910,3.7
"51540",51,540,2016,24842,23995,847,3.4
"51540",51,540,2017,25558,24767,791,3.1
"51550",51,550,1990,80153,76720,3433,4.3
"51550",51,550,1991,84966,80324,4642,5.5
"51550",51,550,1992,87887,83014,4873,5.5
"51550",51,550,1993,89729,85565,4164,4.6
"51550",51,550,1994,94590,89850,4740,5
"51550",51,550,1995,97629,93736,3893,4
"51550",51,550,1996,99234,95365,3869,3.9
"51550",51,550,1997,102437,98577,3860,3.8
"51550",51,550,1998,105004,102208,2796,2.7
"51550",51,550,1999,106288,103558,2730,2.6
"51550",51,550,2000,97963,95714,2249,2.3
"51550",51,550,2001,101138,98156,2982,2.9
"51550",51,550,2002,103352,99526,3826,3.7
"51550",51,550,2003,105117,101059,4058,3.9
"51550",51,550,2004,107580,103541,4039,3.8
"51550",51,550,2005,111678,107638,4040,3.6
"51550",51,550,2006,114199,110468,3731,3.3
"51550",51,550,2007,114338,110894,3444,3
"51550",51,550,2008,116579,112090,4489,3.9
"51550",51,550,2009,114934,107619,7315,6.4
"51550",51,550,2010,113319,105173,8146,7.2
"51550",51,550,2011,114650,106720,7930,6.9
"51550",51,550,2012,115188,107798,7390,6.4
"51550",51,550,2013,116337,109455,6882,5.9
"51550",51,550,2014,117267,111068,6199,5.3
"51550",51,550,2015,116309,111025,5284,4.5
"51550",51,550,2016,117770,112689,5081,4.3
"51550",51,550,2017,119577,114953,4624,3.9
"51570",51,570,1990,8606,8248,358,4.2
"51570",51,570,1991,8723,8251,472,5.4
"51570",51,570,1992,8980,8326,654,7.3
"51570",51,570,1993,8744,8263,481,5.5
"51570",51,570,1994,8896,8472,424,4.8
"51570",51,570,1995,9028,8626,402,4.5
"51570",51,570,1996,8694,8337,357,4.1
"51570",51,570,1997,8755,8419,336,3.8
"51570",51,570,1998,8521,8281,240,2.8
"51570",51,570,1999,8409,8201,208,2.5
"51570",51,570,2000,8617,8422,195,2.3
"51570",51,570,2001,8679,8402,277,3.2
"51570",51,570,2002,8770,8389,381,4.3
"51570",51,570,2003,8753,8359,394,4.5
"51570",51,570,2004,8899,8535,364,4.1
"51570",51,570,2005,9059,8684,375,4.1
"51570",51,570,2006,9134,8838,296,3.2
"51570",51,570,2007,9205,8906,299,3.2
"51570",51,570,2008,9324,8911,413,4.4
"51570",51,570,2009,9160,8440,720,7.9
"51570",51,570,2010,8533,7828,705,8.3
"51570",51,570,2011,8560,7915,645,7.5
"51570",51,570,2012,8617,8018,599,7
"51570",51,570,2013,8661,8098,563,6.5
"51570",51,570,2014,8703,8198,505,5.8
"51570",51,570,2015,8665,8256,409,4.7
"51570",51,570,2016,8700,8306,394,4.5
"51570",51,570,2017,8849,8488,361,4.1
"51580",51,580,1990,3259,2932,327,10
"51580",51,580,1991,3432,2991,441,12.8
"51580",51,580,1992,3088,2648,440,14.2
"51580",51,580,1993,3321,2982,339,10.2
"51580",51,580,1994,3294,2904,390,11.8
"51580",51,580,1995,3352,3025,327,9.8
"51580",51,580,1996,3454,3174,280,8.1
"51580",51,580,1997,3481,3182,299,8.6
"51580",51,580,1998,3408,3215,193,5.7
"51580",51,580,1999,3315,3068,247,7.5
"51580",51,580,2000,2901,2785,116,4
"51580",51,580,2001,2980,2837,143,4.8
"51580",51,580,2002,3066,2874,192,6.3
"51580",51,580,2003,3065,2896,169,5.5
"51580",51,580,2004,2865,2702,163,5.7
"51580",51,580,2005,2837,2674,163,5.7
"51580",51,580,2006,2790,2589,201,7.2
"51580",51,580,2007,2704,2545,159,5.9
"51580",51,580,2008,2675,2492,183,6.8
"51580",51,580,2009,2742,2466,276,10.1
"51580",51,580,2010,2689,2403,286,10.6
"51580",51,580,2011,2663,2413,250,9.4
"51580",51,580,2012,2644,2407,237,9
"51580",51,580,2013,2561,2346,215,8.4
"51580",51,580,2014,2488,2289,199,8
"51580",51,580,2015,2418,2272,146,6
"51580",51,580,2016,2379,2238,141,5.9
"51580",51,580,2017,2379,2230,149,6.3
"51590",51,590,1990,26149,23699,2450,9.4
"51590",51,590,1991,27200,23546,3654,13.4
"51590",51,590,1992,27172,24171,3001,11
"51590",51,590,1993,26943,24646,2297,8.5
"51590",51,590,1994,27267,24931,2336,8.6
"51590",51,590,1995,27147,24917,2230,8.2
"51590",51,590,1996,25634,23448,2186,8.5
"51590",51,590,1997,25292,23487,1805,7.1
"51590",51,590,1998,25396,23875,1521,6
"51590",51,590,1999,25213,23571,1642,6.5
"51590",51,590,2000,21392,20448,944,4.4
"51590",51,590,2001,21448,19949,1499,7
"51590",51,590,2002,21686,19811,1875,8.6
"51590",51,590,2003,21747,19687,2060,9.5
"51590",51,590,2004,20837,18862,1975,9.5
"51590",51,590,2005,20921,18793,2128,10.2
"51590",51,590,2006,20172,18405,1767,8.8
"51590",51,590,2007,19709,18250,1459,7.4
"51590",51,590,2008,20157,18301,1856,9.2
"51590",51,590,2009,20102,17388,2714,13.5
"51590",51,590,2010,20099,17390,2709,13.5
"51590",51,590,2011,20279,17918,2361,11.6
"51590",51,590,2012,19971,17906,2065,10.3
"51590",51,590,2013,19805,17864,1941,9.8
"51590",51,590,2014,19600,17893,1707,8.7
"51590",51,590,2015,19117,17735,1382,7.2
"51590",51,590,2016,19083,17915,1168,6.1
"51590",51,590,2017,19140,17989,1151,6
"51595",51,595,1990,2443,2282,161,6.6
"51595",51,595,1991,2673,2389,284,10.6
"51595",51,595,1992,2593,2336,257,9.9
"51595",51,595,1993,2345,2144,201,8.6
"51595",51,595,1994,2523,2344,179,7.1
"51595",51,595,1995,2685,2477,208,7.7
"51595",51,595,1996,2477,2320,157,6.3
"51595",51,595,1997,2500,2351,149,6
"51595",51,595,1998,2623,2513,110,4.2
"51595",51,595,1999,2500,2384,116,4.6
"51595",51,595,2000,2366,2292,74,3.1
"51595",51,595,2001,2407,2305,102,4.2
"51595",51,595,2002,2399,2276,123,5.1
"51595",51,595,2003,2558,2380,178,7
"51595",51,595,2004,2466,2286,180,7.3
"51595",51,595,2005,2433,2293,140,5.8
"51595",51,595,2006,2503,2364,139,5.6
"51595",51,595,2007,2456,2305,151,6.1
"51595",51,595,2008,2519,2333,186,7.4
"51595",51,595,2009,2535,2228,307,12.1
"51595",51,595,2010,2570,2251,319,12.4
"51595",51,595,2011,2557,2280,277,10.8
"51595",51,595,2012,2471,2210,261,10.6
"51595",51,595,2013,2382,2148,234,9.8
"51595",51,595,2014,2313,2123,190,8.2
"51595",51,595,2015,2245,2089,156,6.9
"51595",51,595,2016,2242,2096,146,6.5
"51595",51,595,2017,2278,2153,125,5.5
"51600",51,600,1990,12262,12065,197,1.6
"51600",51,600,1991,12313,12036,277,2.2
"51600",51,600,1992,12558,12280,278,2.2
"51600",51,600,1993,12511,12213,298,2.4
"51600",51,600,1994,12383,12202,181,1.5
"51600",51,600,1995,12425,12247,178,1.4
"51600",51,600,1996,11803,11621,182,1.5
"51600",51,600,1997,11922,11751,171,1.4
"51600",51,600,1998,12308,12151,157,1.3
"51600",51,600,1999,12315,12206,109,.9
"51600",51,600,2000,12507,12336,171,1.4
"51600",51,600,2001,12540,12337,203,1.6
"51600",51,600,2002,12338,12066,272,2.2
"51600",51,600,2003,12398,12060,338,2.7
"51600",51,600,2004,12513,12169,344,2.7
"51600",51,600,2005,12777,12434,343,2.7
"51600",51,600,2006,13230,12903,327,2.5
"51600",51,600,2007,13902,13550,352,2.5
"51600",51,600,2008,14413,13951,462,3.2
"51600",51,600,2009,14525,13722,803,5.5
"51600",51,600,2010,12663,11974,689,5.4
"51600",51,600,2011,12712,12087,625,4.9
"51600",51,600,2012,12933,12376,557,4.3
"51600",51,600,2013,13109,12563,546,4.2
"51600",51,600,2014,13243,12696,547,4.1
"51600",51,600,2015,12799,12351,448,3.5
"51600",51,600,2016,12952,12553,399,3.1
"51600",51,600,2017,13251,12864,387,2.9
"51610",51,610,1990,5874,5780,94,1.6
"51610",51,610,1991,5872,5642,230,3.9
"51610",51,610,1992,5869,5555,314,5.4
"51610",51,610,1993,5669,5421,248,4.4
"51610",51,610,1994,5726,5575,151,2.6
"51610",51,610,1995,5850,5595,255,4.4
"51610",51,610,1996,5767,5530,237,4.1
"51610",51,610,1997,5792,5592,200,3.5
"51610",51,610,1998,5727,5600,127,2.2
"51610",51,610,1999,5826,5751,75,1.3
"51610",51,610,2000,6156,6056,100,1.6
"51610",51,610,2001,6221,6053,168,2.7
"51610",51,610,2002,6203,5992,211,3.4
"51610",51,610,2003,6081,5883,198,3.3
"51610",51,610,2004,6157,5952,205,3.3
"51610",51,610,2005,6428,6210,218,3.4
"51610",51,610,2006,6509,6320,189,2.9
"51610",51,610,2007,6661,6456,205,3.1
"51610",51,610,2008,6917,6639,278,4
"51610",51,610,2009,7259,6758,501,6.9
"51610",51,610,2010,7382,7022,360,4.9
"51610",51,610,2011,7517,7198,319,4.2
"51610",51,610,2012,7728,7419,309,4
"51610",51,610,2013,7840,7534,306,3.9
"51610",51,610,2014,7789,7507,282,3.6
"51610",51,610,2015,7844,7605,239,3
"51610",51,610,2016,7968,7748,220,2.8
"51610",51,610,2017,8160,7941,219,2.7
"51620",51,620,1990,3475,3316,159,4.6
"51620",51,620,1991,3712,3490,222,6
"51620",51,620,1992,3774,3547,227,6
"51620",51,620,1993,3829,3564,265,6.9
"51620",51,620,1994,3729,3507,222,6
"51620",51,620,1995,3777,3578,199,5.3
"51620",51,620,1996,3759,3545,214,5.7
"51620",51,620,1997,3836,3655,181,4.7
"51620",51,620,1998,3760,3615,145,3.9
"51620",51,620,1999,3969,3795,174,4.4
"51620",51,620,2000,3569,3456,113,3.2
"51620",51,620,2001,3549,3393,156,4.4
"51620",51,620,2002,3535,3364,171,4.8
"51620",51,620,2003,3666,3486,180,4.9
"51620",51,620,2004,3643,3458,185,5.1
"51620",51,620,2005,3725,3531,194,5.2
"51620",51,620,2006,3798,3617,181,4.8
"51620",51,620,2007,3924,3743,181,4.6
"51620",51,620,2008,3951,3704,247,6.3
"51620",51,620,2009,3945,3546,399,10.1
"51620",51,620,2010,3708,3241,467,12.6
"51620",51,620,2011,3672,3255,417,11.4
"51620",51,620,2012,3729,3357,372,10
"51620",51,620,2013,3694,3351,343,9.3
"51620",51,620,2014,3614,3330,284,7.9
"51620",51,620,2015,3608,3366,242,6.7
"51620",51,620,2016,3532,3316,216,6.1
"51620",51,620,2017,3484,3291,193,5.5
"51630",51,630,1990,10396,9896,500,4.8
"51630",51,630,1991,10798,9923,875,8.1
"51630",51,630,1992,10622,9674,948,8.9
"51630",51,630,1993,10956,10296,660,6
"51630",51,630,1994,11024,10502,522,4.7
"51630",51,630,1995,11338,10856,482,4.3
"51630",51,630,1996,10324,9883,441,4.3
"51630",51,630,1997,10556,10164,392,3.7
"51630",51,630,1998,9633,9289,344,3.6
"51630",51,630,1999,9543,9264,279,2.9
"51630",51,630,2000,10325,10086,239,2.3
"51630",51,630,2001,10578,10200,378,3.6
"51630",51,630,2002,10712,10127,585,5.5
"51630",51,630,2003,10598,10042,556,5.2
"51630",51,630,2004,11045,10503,542,4.9
"51630",51,630,2005,11225,10722,503,4.5
"51630",51,630,2006,11645,11180,465,4
"51630",51,630,2007,12429,11872,557,4.5
"51630",51,630,2008,12965,12183,782,6
"51630",51,630,2009,12984,11768,1216,9.4
"51630",51,630,2010,12423,11304,1119,9
"51630",51,630,2011,13068,12022,1046,8
"51630",51,630,2012,13600,12641,959,7.1
"51630",51,630,2013,13762,12872,890,6.5
"51630",51,630,2014,13671,12834,837,6.1
"51630",51,630,2015,13367,12652,715,5.3
"51630",51,630,2016,13540,12886,654,4.8
"51630",51,630,2017,13823,13222,601,4.3
"51640",51,640,1990,3520,3225,295,8.4
"51640",51,640,1991,3499,3219,280,8
"51640",51,640,1992,3516,3290,226,6.4
"51640",51,640,1993,3339,3196,143,4.3
"51640",51,640,1994,3424,3289,135,3.9
"51640",51,640,1995,3418,3285,133,3.9
"51640",51,640,1996,3473,3313,160,4.6
"51640",51,640,1997,3405,3301,104,3.1
"51640",51,640,1998,3277,3169,108,3.3
"51640",51,640,1999,3236,3093,143,4.4
"51640",51,640,2000,3305,3189,116,3.5
"51640",51,640,2001,3186,2994,192,6
"51640",51,640,2002,3268,3005,263,8
"51640",51,640,2003,3264,3055,209,6.4
"51640",51,640,2004,3138,2960,178,5.7
"51640",51,640,2005,3110,2950,160,5.1
"51640",51,640,2006,3035,2849,186,6.1
"51640",51,640,2007,3124,2948,176,5.6
"51640",51,640,2008,3130,2939,191,6.1
"51640",51,640,2009,3234,2921,313,9.7
"51640",51,640,2010,3172,2825,347,10.9
"51640",51,640,2011,3105,2784,321,10.3
"51640",51,640,2012,3058,2787,271,8.9
"51640",51,640,2013,3019,2759,260,8.6
"51640",51,640,2014,2994,2773,221,7.4
"51640",51,640,2015,2946,2784,162,5.5
"51640",51,640,2016,2899,2754,145,5
"51640",51,640,2017,2879,2749,130,4.5
"51650",51,650,1990,64936,61480,3456,5.3
"51650",51,650,1991,66963,62923,4040,6
"51650",51,650,1992,67557,62826,4731,7
"51650",51,650,1993,67027,62739,4288,6.4
"51650",51,650,1994,67170,63029,4141,6.2
"51650",51,650,1995,66873,63189,3684,5.5
"51650",51,650,1996,65706,62364,3342,5.1
"51650",51,650,1997,66850,63525,3325,5
"51650",51,650,1998,66200,63748,2452,3.7
"51650",51,650,1999,66364,63731,2633,4
"51650",51,650,2000,64335,62586,1749,2.7
"51650",51,650,2001,64976,62699,2277,3.5
"51650",51,650,2002,65854,62648,3206,4.9
"51650",51,650,2003,65721,62500,3221,4.9
"51650",51,650,2004,65417,62275,3142,4.8
"51650",51,650,2005,66763,63746,3017,4.5
"51650",51,650,2006,67151,64648,2503,3.7
"51650",51,650,2007,68492,66052,2440,3.6
"51650",51,650,2008,69260,65979,3281,4.7
"51650",51,650,2009,67306,62042,5264,7.8
"51650",51,650,2010,66666,60687,5979,9
"51650",51,650,2011,66445,60507,5938,8.9
"51650",51,650,2012,65983,60542,5441,8.2
"51650",51,650,2013,65846,60905,4941,7.5
"51650",51,650,2014,65586,61146,4440,6.8
"51650",51,650,2015,64261,60397,3864,6
"51650",51,650,2016,63882,60206,3676,5.8
"51650",51,650,2017,64727,61435,3292,5.1
"51660",51,660,1990,16075,15080,995,6.2
"51660",51,660,1991,16495,15622,873,5.3
"51660",51,660,1992,16978,16373,605,3.6
"51660",51,660,1993,17516,16982,534,3
"51660",51,660,1994,17671,17267,404,2.3
"51660",51,660,1995,18022,17601,421,2.3
"51660",51,660,1996,17587,17142,445,2.5
"51660",51,660,1997,17747,17430,317,1.8
"51660",51,660,1998,18053,17805,248,1.4
"51660",51,660,1999,18640,18402,238,1.3
"51660",51,660,2000,19658,19206,452,2.3
"51660",51,660,2001,19992,19436,556,2.8
"51660",51,660,2002,20386,19632,754,3.7
"51660",51,660,2003,20967,20148,819,3.9
"51660",51,660,2004,21083,20247,836,4
"51660",51,660,2005,20953,20146,807,3.9
"51660",51,660,2006,21715,21062,653,3
"51660",51,660,2007,22762,22100,662,2.9
"51660",51,660,2008,22980,22023,957,4.2
"51660",51,660,2009,23048,21497,1551,6.7
"51660",51,660,2010,23165,21250,1915,8.3
"51660",51,660,2011,23788,21933,1855,7.8
"51660",51,660,2012,24127,22350,1777,7.4
"51660",51,660,2013,24034,22408,1626,6.8
"51660",51,660,2014,24216,22737,1479,6.1
"51660",51,660,2015,23883,22615,1268,5.3
"51660",51,660,2016,24197,23017,1180,4.9
"51660",51,660,2017,24559,23462,1097,4.5
"51670",51,670,1990,11527,10813,714,6.2
"51670",51,670,1991,11581,10539,1042,9
"51670",51,670,1992,11434,10223,1211,10.6
"51670",51,670,1993,11320,10439,881,7.8
"51670",51,670,1994,10967,10175,792,7.2
"51670",51,670,1995,10880,10219,661,6.1
"51670",51,670,1996,10539,9892,647,6.1
"51670",51,670,1997,10564,9993,571,5.4
"51670",51,670,1998,10812,10345,467,4.3
"51670",51,670,1999,10669,10233,436,4.1
"51670",51,670,2000,9873,9590,283,2.9
"51670",51,670,2001,9973,9509,464,4.7
"51670",51,670,2002,10108,9481,627,6.2
"51670",51,670,2003,10021,9385,636,6.3
"51670",51,670,2004,10015,9449,566,5.7
"51670",51,670,2005,10276,9683,593,5.8
"51670",51,670,2006,10294,9811,483,4.7
"51670",51,670,2007,10437,9950,487,4.7
"51670",51,670,2008,10658,10022,636,6
"51670",51,670,2009,10553,9454,1099,10.4
"51670",51,670,2010,9864,8721,1143,11.6
"51670",51,670,2011,9911,8791,1120,11.3
"51670",51,670,2012,9742,8762,980,10.1
"51670",51,670,2013,9657,8714,943,9.8
"51670",51,670,2014,9658,8788,870,9
"51670",51,670,2015,9620,8891,729,7.6
"51670",51,670,2016,9765,9122,643,6.6
"51670",51,670,2017,9931,9326,605,6.1
"51678",51,678,1990,2904,2671,233,8
"51678",51,678,1991,3003,2797,206,6.9
"51678",51,678,1992,2830,2677,153,5.4
"51678",51,678,1993,2764,2626,138,5
"51678",51,678,1994,2811,2708,103,3.7
"51678",51,678,1995,2798,2721,77,2.8
"51678",51,678,1996,2803,2723,80,2.9
"51678",51,678,1997,2840,2785,55,1.9
"51678",51,678,1998,2889,2837,52,1.8
"51678",51,678,1999,3013,2969,44,1.5
"51678",51,678,2000,2243,2163,80,3.6
"51678",51,678,2001,2317,2225,92,4
"51678",51,678,2002,2362,2230,132,5.6
"51678",51,678,2003,2328,2199,129,5.5
"51678",51,678,2004,2276,2148,128,5.6
"51678",51,678,2005,2316,2195,121,5.2
"51678",51,678,2006,2291,2183,108,4.7
"51678",51,678,2007,2367,2258,109,4.6
"51678",51,678,2008,2423,2267,156,6.4
"51678",51,678,2009,2479,2239,240,9.7
"51678",51,678,2010,2300,2086,214,9.3
"51678",51,678,2011,2293,2083,210,9.2
"51678",51,678,2012,2284,2084,200,8.8
"51678",51,678,2013,2252,2060,192,8.5
"51678",51,678,2014,2273,2096,177,7.8
"51678",51,678,2015,2252,2098,154,6.8
"51678",51,678,2016,2262,2122,140,6.2
"51678",51,678,2017,2265,2137,128,5.7
"51680",51,680,1990,32172,30311,1861,5.8
"51680",51,680,1991,32473,30370,2103,6.5
"51680",51,680,1992,32575,30442,2133,6.5
"51680",51,680,1993,32199,30638,1561,4.8
"51680",51,680,1994,32077,30647,1430,4.5
"51680",51,680,1995,32099,30858,1241,3.9
"51680",51,680,1996,30227,29073,1154,3.8
"51680",51,680,1997,29960,28716,1244,4.2
"51680",51,680,1998,29507,28715,792,2.7
"51680",51,680,1999,29665,29036,629,2.1
"51680",51,680,2000,30784,30034,750,2.4
"51680",51,680,2001,30018,28770,1248,4.2
"51680",51,680,2002,30328,28540,1788,5.9
"51680",51,680,2003,30693,28974,1719,5.6
"51680",51,680,2004,30584,29000,1584,5.2
"51680",51,680,2005,31249,29817,1432,4.6
"51680",51,680,2006,31925,30750,1175,3.7
"51680",51,680,2007,33610,32350,1260,3.7
"51680",51,680,2008,35129,33451,1678,4.8
"51680",51,680,2009,34844,32040,2804,8
"51680",51,680,2010,35841,32798,3043,8.5
"51680",51,680,2011,35762,32878,2884,8.1
"51680",51,680,2012,35600,32940,2660,7.5
"51680",51,680,2013,35746,33209,2537,7.1
"51680",51,680,2014,36000,33696,2304,6.4
"51680",51,680,2015,35627,33633,1994,5.6
"51680",51,680,2016,35470,33608,1862,5.2
"51680",51,680,2017,35820,34043,1777,5
"51683",51,683,1990,16517,16117,400,2.4
"51683",51,683,1991,17227,16359,868,5
"51683",51,683,1992,17876,16829,1047,5.9
"51683",51,683,1993,17979,17243,736,4.1
"51683",51,683,1994,18571,17883,688,3.7
"51683",51,683,1995,18653,17983,670,3.6
"51683",51,683,1996,18880,18222,658,3.5
"51683",51,683,1997,19122,18581,541,2.8
"51683",51,683,1998,18233,17888,345,1.9
"51683",51,683,1999,18816,18512,304,1.6
"51683",51,683,2000,19275,18949,326,1.7
"51683",51,683,2001,19644,19022,622,3.2
"51683",51,683,2002,19862,19002,860,4.3
"51683",51,683,2003,19748,19069,679,3.4
"51683",51,683,2004,20146,19513,633,3.1
"51683",51,683,2005,20522,19929,593,2.9
"51683",51,683,2006,20267,19732,535,2.6
"51683",51,683,2007,19776,19200,576,2.9
"51683",51,683,2008,20076,19231,845,4.2
"51683",51,683,2009,20468,18972,1496,7.3
"51683",51,683,2010,20972,19503,1469,7
"51683",51,683,2011,21403,20099,1304,6.1
"51683",51,683,2012,21926,20699,1227,5.6
"51683",51,683,2013,22238,21039,1199,5.4
"51683",51,683,2014,22115,21004,1111,5
"51683",51,683,2015,21593,20696,897,4.2
"51683",51,683,2016,21564,20778,786,3.6
"51683",51,683,2017,22051,21302,749,3.4
"51685",51,685,1990,3844,3763,81,2.1
"51685",51,685,1991,3921,3754,167,4.3
"51685",51,685,1992,3890,3740,150,3.9
"51685",51,685,1993,3929,3838,91,2.3
"51685",51,685,1994,4047,3924,123,3
"51685",51,685,1995,4035,3944,91,2.3
"51685",51,685,1996,4515,4342,173,3.8
"51685",51,685,1997,4514,4426,88,1.9
"51685",51,685,1998,4164,4093,71,1.7
"51685",51,685,1999,4263,4209,54,1.3
"51685",51,685,2000,5790,5709,81,1.4
"51685",51,685,2001,5995,5886,109,1.8
"51685",51,685,2002,6015,5848,167,2.8
"51685",51,685,2003,5969,5810,159,2.7
"51685",51,685,2004,6306,6130,176,2.8
"51685",51,685,2005,6519,6354,165,2.5
"51685",51,685,2006,6622,6467,155,2.3
"51685",51,685,2007,6562,6395,167,2.5
"51685",51,685,2008,6631,6383,248,3.7
"51685",51,685,2009,6870,6455,415,6
"51685",51,685,2010,8066,7563,503,6.2
"51685",51,685,2011,8634,8151,483,5.6
"51685",51,685,2012,8754,8291,463,5.3
"51685",51,685,2013,8804,8356,448,5.1
"51685",51,685,2014,8161,7770,391,4.8
"51685",51,685,2015,8333,7984,349,4.2
"51685",51,685,2016,8468,8156,312,3.7
"51685",51,685,2017,8644,8354,290,3.4
"51690",51,690,1990,8282,7479,803,9.7
"51690",51,690,1991,8384,7253,1131,13.5
"51690",51,690,1992,7890,7231,659,8.4
"51690",51,690,1993,7670,7088,582,7.6
"51690",51,690,1994,7765,7010,755,9.7
"51690",51,690,1995,7558,6869,689,9.1
"51690",51,690,1996,7391,6767,624,8.4
"51690",51,690,1997,7068,6701,367,5.2
"51690",51,690,1998,6824,6458,366,5.4
"51690",51,690,1999,6830,6151,679,9.9
"51690",51,690,2000,6748,6211,537,8
"51690",51,690,2001,6617,6098,519,7.8
"51690",51,690,2002,6508,5688,820,12.6
"51690",51,690,2003,6318,5651,667,10.6
"51690",51,690,2004,6023,5279,744,12.4
"51690",51,690,2005,5947,5345,602,10.1
"51690",51,690,2006,5838,5410,428,7.3
"51690",51,690,2007,5919,5432,487,8.2
"51690",51,690,2008,5930,5222,708,11.9
"51690",51,690,2009,6208,5011,1197,19.3
"51690",51,690,2010,6136,5066,1070,17.4
"51690",51,690,2011,5902,5005,897,15.2
"51690",51,690,2012,5746,5010,736,12.8
"51690",51,690,2013,5700,5059,641,11.2
"51690",51,690,2014,5545,4994,551,9.9
"51690",51,690,2015,5357,4886,471,8.8
"51690",51,690,2016,5156,4788,368,7.1
"51690",51,690,2017,5235,4879,356,6.8
"51700",51,700,1990,81038,76831,4207,5.2
"51700",51,700,1991,82997,78052,4945,6
"51700",51,700,1992,85652,79798,5854,6.8
"51700",51,700,1993,82976,77620,5356,6.5
"51700",51,700,1994,84235,78881,5354,6.4
"51700",51,700,1995,84093,79357,4736,5.6
"51700",51,700,1996,82156,77747,4409,5.4
"51700",51,700,1997,82110,77964,4146,5
"51700",51,700,1998,84190,80804,3386,4
"51700",51,700,1999,84368,81028,3340,4
"51700",51,700,2000,82885,80710,2175,2.6
"51700",51,700,2001,84162,81164,2998,3.6
"51700",51,700,2002,85247,81335,3912,4.6
"51700",51,700,2003,85598,81532,4066,4.8
"51700",51,700,2004,85745,81820,3925,4.6
"51700",51,700,2005,86290,82389,3901,4.5
"51700",51,700,2006,86219,83110,3109,3.6
"51700",51,700,2007,87554,84430,3124,3.6
"51700",51,700,2008,89322,85187,4135,4.6
"51700",51,700,2009,94427,87426,7001,7.4
"51700",51,700,2010,90664,83104,7560,8.3
"51700",51,700,2011,90697,83305,7392,8.2
"51700",51,700,2012,90033,83286,6747,7.5
"51700",51,700,2013,90473,84337,6136,6.8
"51700",51,700,2014,90707,85007,5700,6.3
"51700",51,700,2015,88807,83972,4835,5.4
"51700",51,700,2016,88720,84128,4592,5.2
"51700",51,700,2017,90074,85883,4191,4.7
"51710",51,710,1990,98488,93821,4667,4.7
"51710",51,710,1991,96837,90845,5992,6.2
"51710",51,710,1992,97657,90654,7003,7.2
"51710",51,710,1993,92009,85736,6273,6.8
"51710",51,710,1994,90671,84275,6396,7.1
"51710",51,710,1995,87680,82051,5629,6.4
"51710",51,710,1996,86105,80241,5864,6.8
"51710",51,710,1997,85712,79975,5737,6.7
"51710",51,710,1998,84583,80133,4450,5.3
"51710",51,710,1999,83551,79262,4289,5.1
"51710",51,710,2000,92995,89931,3064,3.3
"51710",51,710,2001,94794,90698,4096,4.3
"51710",51,710,2002,98076,93011,5065,5.2
"51710",51,710,2003,97219,92073,5146,5.3
"51710",51,710,2004,96978,91903,5075,5.2
"51710",51,710,2005,96113,91215,4898,5.1
"51710",51,710,2006,95709,91598,4111,4.3
"51710",51,710,2007,99742,95656,4086,4.1
"51710",51,710,2008,100847,95534,5313,5.3
"51710",51,710,2009,98751,90318,8433,8.5
"51710",51,710,2010,112449,102606,9843,8.8
"51710",51,710,2011,112932,103527,9405,8.3
"51710",51,710,2012,112848,104251,8597,7.6
"51710",51,710,2013,112762,104905,7857,7
"51710",51,710,2014,112049,104890,7159,6.4
"51710",51,710,2015,110521,104347,6174,5.6
"51710",51,710,2016,110198,104320,5878,5.3
"51710",51,710,2017,111699,106502,5197,4.7
"51720",51,720,1990,1641,1483,158,9.6
"51720",51,720,1991,1667,1500,167,10
"51720",51,720,1992,1697,1548,149,8.8
"51720",51,720,1993,1628,1485,143,8.8
"51720",51,720,1994,1663,1512,151,9.1
"51720",51,720,1995,1667,1461,206,12.4
"51720",51,720,1996,1548,1376,172,11.1
"51720",51,720,1997,1548,1416,132,8.5
"51720",51,720,1998,1476,1371,105,7.1
"51720",51,720,1999,1448,1339,109,7.5
"51720",51,720,2000,1488,1427,61,4.1
"51720",51,720,2001,1524,1454,70,4.6
"51720",51,720,2002,1581,1503,78,4.9
"51720",51,720,2003,1610,1523,87,5.4
"51720",51,720,2004,1535,1450,85,5.5
"51720",51,720,2005,1524,1439,85,5.6
"51720",51,720,2006,1514,1435,79,5.2
"51720",51,720,2007,1565,1501,64,4.1
"51720",51,720,2008,1620,1536,84,5.2
"51720",51,720,2009,1724,1614,110,6.4
"51720",51,720,2010,2079,1928,151,7.3
"51720",51,720,2011,2113,1966,147,7
"51720",51,720,2012,1994,1841,153,7.7
"51720",51,720,2013,1871,1715,156,8.3
"51720",51,720,2014,1807,1667,140,7.7
"51720",51,720,2015,1733,1612,121,7
"51720",51,720,2016,1659,1544,115,6.9
"51720",51,720,2017,1628,1538,90,5.5
"51730",51,730,1990,18238,16926,1312,7.2
"51730",51,730,1991,18417,16521,1896,10.3
"51730",51,730,1992,17811,15683,2128,11.9
"51730",51,730,1993,18373,16609,1764,9.6
"51730",51,730,1994,17873,16167,1706,9.5
"51730",51,730,1995,17847,16473,1374,7.7
"51730",51,730,1996,15973,14523,1450,9.1
"51730",51,730,1997,15968,14674,1294,8.1
"51730",51,730,1998,15901,14978,923,5.8
"51730",51,730,1999,15618,14805,813,5.2
"51730",51,730,2000,13917,13440,477,3.4
"51730",51,730,2001,14018,13242,776,5.5
"51730",51,730,2002,14076,13021,1055,7.5
"51730",51,730,2003,14121,12900,1221,8.6
"51730",51,730,2004,13945,12848,1097,7.9
"51730",51,730,2005,13965,12930,1035,7.4
"51730",51,730,2006,13888,13012,876,6.3
"51730",51,730,2007,14087,13206,881,6.3
"51730",51,730,2008,14288,13246,1042,7.3
"51730",51,730,2009,14460,12533,1927,13.3
"51730",51,730,2010,13877,11939,1938,14
"51730",51,730,2011,13714,11950,1764,12.9
"51730",51,730,2012,13623,11995,1628,12
"51730",51,730,2013,13777,12169,1608,11.7
"51730",51,730,2014,13796,12314,1482,10.7
"51730",51,730,2015,13502,12262,1240,9.2
"51730",51,730,2016,13191,12147,1044,7.9
"51730",51,730,2017,13392,12414,978,7.3
"51735",51,735,1990,5880,5651,229,3.9
"51735",51,735,1991,5917,5718,199,3.4
"51735",51,735,1992,5800,5591,209,3.6
"51735",51,735,1993,5944,5752,192,3.2
"51735",51,735,1994,5915,5722,193,3.3
"51735",51,735,1995,6097,5916,181,3
"51735",51,735,1996,5948,5767,181,3
"51735",51,735,1997,5970,5792,178,3
"51735",51,735,1998,6065,5931,134,2.2
"51735",51,735,1999,6117,5983,134,2.2
"51735",51,735,2000,5832,5724,108,1.9
"51735",51,735,2001,5883,5743,140,2.4
"51735",51,735,2002,5978,5813,165,2.8
"51735",51,735,2003,6027,5836,191,3.2
"51735",51,735,2004,5985,5801,184,3.1
"51735",51,735,2005,6161,5983,178,2.9
"51735",51,735,2006,6299,6150,149,2.4
"51735",51,735,2007,6327,6183,144,2.3
"51735",51,735,2008,6402,6207,195,3
"51735",51,735,2009,6197,5876,321,5.2
"51735",51,735,2010,6395,6007,388,6.1
"51735",51,735,2011,6369,6005,364,5.7
"51735",51,735,2012,6361,6017,344,5.4
"51735",51,735,2013,6346,6031,315,5
"51735",51,735,2014,6298,6011,287,4.6
"51735",51,735,2015,6200,5960,240,3.9
"51735",51,735,2016,6158,5940,218,3.5
"51735",51,735,2017,6247,6029,218,3.5
"51740",51,740,1990,47133,44009,3124,6.6
"51740",51,740,1991,47969,44333,3636,7.6
"51740",51,740,1992,48217,44176,4041,8.4
"51740",51,740,1993,47006,43421,3585,7.6
"51740",51,740,1994,47472,43301,4171,8.8
"51740",51,740,1995,46111,42825,3286,7.1
"51740",51,740,1996,45640,42186,3454,7.6
"51740",51,740,1997,45342,41960,3382,7.5
"51740",51,740,1998,44967,42540,2427,5.4
"51740",51,740,1999,44225,42031,2194,5
"51740",51,740,2000,42953,41486,1467,3.4
"51740",51,740,2001,43530,41611,1919,4.4
"51740",51,740,2002,43884,41552,2332,5.3
"51740",51,740,2003,43557,41195,2362,5.4
"51740",51,740,2004,43692,41271,2421,5.5
"51740",51,740,2005,44821,42403,2418,5.4
"51740",51,740,2006,45779,43744,2035,4.4
"51740",51,740,2007,46428,44483,1945,4.2
"51740",51,740,2008,46504,44108,2396,5.2
"51740",51,740,2009,45167,41325,3842,8.5
"51740",51,740,2010,45461,41102,4359,9.6
"51740",51,740,2011,45777,41496,4281,9.4
"51740",51,740,2012,45724,41698,4026,8.8
"51740",51,740,2013,45482,41776,3706,8.1
"51740",51,740,2014,45095,41801,3294,7.3
"51740",51,740,2015,44252,41493,2759,6.2
"51740",51,740,2016,44007,41276,2731,6.2
"51740",51,740,2017,44552,42134,2418,5.4
"51750",51,750,1990,7230,6381,849,11.7
"51750",51,750,1991,7103,6447,656,9.2
"51750",51,750,1992,7162,6680,482,6.7
"51750",51,750,1993,6918,6455,463,6.7
"51750",51,750,1994,6848,6502,346,5.1
"51750",51,750,1995,6826,6559,267,3.9
"51750",51,750,1996,6432,6143,289,4.5
"51750",51,750,1997,6403,6194,209,3.3
"51750",51,750,1998,6443,6270,173,2.7
"51750",51,750,1999,6634,6451,183,2.8
"51750",51,750,2000,7470,7227,243,3.3
"51750",51,750,2001,7439,7130,309,4.2
"51750",51,750,2002,7358,6972,386,5.2
"51750",51,750,2003,7322,6938,384,5.2
"51750",51,750,2004,7234,6849,385,5.3
"51750",51,750,2005,7228,6899,329,4.6
"51750",51,750,2006,7239,6961,278,3.8
"51750",51,750,2007,7757,7443,314,4
"51750",51,750,2008,7994,7570,424,5.3
"51750",51,750,2009,7922,7215,707,8.9
"51750",51,750,2010,7787,7060,727,9.3
"51750",51,750,2011,8082,7401,681,8.4
"51750",51,750,2012,8109,7465,644,7.9
"51750",51,750,2013,8338,7709,629,7.5
"51750",51,750,2014,8468,7896,572,6.8
"51750",51,750,2015,8291,7822,469,5.7
"51750",51,750,2016,8247,7796,451,5.5
"51750",51,750,2017,8285,7867,418,5
"51760",51,760,1990,104210,98296,5914,5.7
"51760",51,760,1991,104814,96682,8132,7.8
"51760",51,760,1992,103928,94459,9469,9.1
"51760",51,760,1993,101435,94604,6831,6.7
"51760",51,760,1994,101156,95096,6060,6
"51760",51,760,1995,100497,95089,5408,5.4
"51760",51,760,1996,94994,89744,5250,5.5
"51760",51,760,1997,95291,90677,4614,4.8
"51760",51,760,1998,94477,90813,3664,3.9
"51760",51,760,1999,93603,90403,3200,3.4
"51760",51,760,2000,95424,92887,2537,2.7
"51760",51,760,2001,96231,92218,4013,4.2
"51760",51,760,2002,96296,90760,5536,5.7
"51760",51,760,2003,95032,89532,5500,5.8
"51760",51,760,2004,94900,89426,5474,5.8
"51760",51,760,2005,95504,90382,5122,5.4
"51760",51,760,2006,95448,90997,4451,4.7
"51760",51,760,2007,98875,94548,4327,4.4
"51760",51,760,2008,101506,95650,5856,5.8
"51760",51,760,2009,101096,91416,9680,9.6
"51760",51,760,2010,106456,96347,10109,9.5
"51760",51,760,2011,107647,98520,9127,8.5
"51760",51,760,2012,109323,101135,8188,7.5
"51760",51,760,2013,110462,102949,7513,6.8
"51760",51,760,2014,112378,105455,6923,6.2
"51760",51,760,2015,112703,106819,5884,5.2
"51760",51,760,2016,114501,109128,5373,4.7
"51760",51,760,2017,116588,111499,5089,4.4
"51770",51,770,1990,48953,46674,2279,4.7
"51770",51,770,1991,50452,47094,3358,6.7
"51770",51,770,1992,51134,47530,3604,7
"51770",51,770,1993,50872,47879,2993,5.9
"51770",51,770,1994,50666,48393,2273,4.5
"51770",51,770,1995,50980,49143,1837,3.6
"51770",51,770,1996,50152,48227,1925,3.8
"51770",51,770,1997,49474,47435,2039,4.1
"51770",51,770,1998,49597,48158,1439,2.9
"51770",51,770,1999,48810,47564,1246,2.6
"51770",51,770,2000,46705,45553,1152,2.5
"51770",51,770,2001,47125,45457,1668,3.5
"51770",51,770,2002,47115,44769,2346,5
"51770",51,770,2003,45618,43252,2366,5.2
"51770",51,770,2004,44680,42604,2076,4.6
"51770",51,770,2005,45225,43312,1913,4.2
"51770",51,770,2006,45481,43761,1720,3.8
"51770",51,770,2007,46289,44547,1742,3.8
"51770",51,770,2008,47072,44936,2136,4.5
"51770",51,770,2009,47264,43194,4070,8.6
"51770",51,770,2010,49317,45022,4295,8.7
"51770",51,770,2011,49488,45492,3996,8.1
"51770",51,770,2012,49653,46074,3579,7.2
"51770",51,770,2013,49779,46460,3319,6.7
"51770",51,770,2014,50088,47144,2944,5.9
"51770",51,770,2015,48902,46508,2394,4.9
"51770",51,770,2016,48866,46743,2123,4.3
"51770",51,770,2017,48976,46910,2066,4.2
"51775",51,775,1990,12805,12392,413,3.2
"51775",51,775,1991,13304,12582,722,5.4
"51775",51,775,1992,13329,12653,676,5.1
"51775",51,775,1993,13325,12843,482,3.6
"51775",51,775,1994,13592,13197,395,2.9
"51775",51,775,1995,13749,13399,350,2.5
"51775",51,775,1996,14059,13717,342,2.4
"51775",51,775,1997,13902,13493,409,2.9
"51775",51,775,1998,13754,13418,336,2.4
"51775",51,775,1999,13422,13208,214,1.6
"51775",51,775,2000,12975,12724,251,1.9
"51775",51,775,2001,13005,12633,372,2.9
"51775",51,775,2002,13234,12724,510,3.9
"51775",51,775,2003,12782,12284,498,3.9
"51775",51,775,2004,12479,12045,434,3.5
"51775",51,775,2005,12722,12314,408,3.2
"51775",51,775,2006,13073,12680,393,3
"51775",51,775,2007,13370,12975,395,3
"51775",51,775,2008,13649,13151,498,3.6
"51775",51,775,2009,13289,12441,848,6.4
"51775",51,775,2010,12789,11910,879,6.9
"51775",51,775,2011,12834,12017,817,6.4
"51775",51,775,2012,12915,12148,767,5.9
"51775",51,775,2013,13049,12289,760,5.8
"51775",51,775,2014,13120,12441,679,5.2
"51775",51,775,2015,12765,12201,564,4.4
"51775",51,775,2016,12874,12361,513,4
"51775",51,775,2017,12907,12413,494,3.8
"51790",51,790,1990,11846,11331,515,4.3
"51790",51,790,1991,11691,11093,598,5.1
"51790",51,790,1992,11562,10902,660,5.7
"51790",51,790,1993,11425,10902,523,4.6
"51790",51,790,1994,11333,10739,594,5.2
"51790",51,790,1995,11317,10737,580,5.1
"51790",51,790,1996,10543,10034,509,4.8
"51790",51,790,1997,10722,10358,364,3.4
"51790",51,790,1998,11451,11182,269,2.3
"51790",51,790,1999,11494,11235,259,2.3
"51790",51,790,2000,11645,11393,252,2.2
"51790",51,790,2001,11622,11284,338,2.9
"51790",51,790,2002,11750,11296,454,3.9
"51790",51,790,2003,11380,10942,438,3.8
"51790",51,790,2004,10980,10599,381,3.5
"51790",51,790,2005,11231,10864,367,3.3
"51790",51,790,2006,11241,10893,348,3.1
"51790",51,790,2007,11609,11251,358,3.1
"51790",51,790,2008,11872,11364,508,4.3
"51790",51,790,2009,11891,11029,862,7.2
"51790",51,790,2010,11846,10920,926,7.8
"51790",51,790,2011,12005,11154,851,7.1
"51790",51,790,2012,11825,11066,759,6.4
"51790",51,790,2013,11954,11259,695,5.8
"51790",51,790,2014,12040,11418,622,5.2
"51790",51,790,2015,11809,11295,514,4.4
"51790",51,790,2016,11775,11310,465,3.9
"51790",51,790,2017,11848,11415,433,3.7
"51800",51,800,1990,25182,23602,1580,6.3
"51800",51,800,1991,25618,24005,1613,6.3
"51800",51,800,1992,25940,23945,1995,7.7
"51800",51,800,1993,25746,23989,1757,6.8
"51800",51,800,1994,26296,24403,1893,7.2
"51800",51,800,1995,27064,25357,1707,6.3
"51800",51,800,1996,27916,26239,1677,6
"51800",51,800,1997,29165,27579,1586,5.4
"51800",51,800,1998,29959,28812,1147,3.8
"51800",51,800,1999,30736,29686,1050,3.4
"51800",51,800,2000,29326,28586,740,2.5
"51800",51,800,2001,31024,30055,969,3.1
"51800",51,800,2002,33002,31575,1427,4.3
"51800",51,800,2003,34539,33049,1490,4.3
"51800",51,800,2004,35979,34462,1517,4.2
"51800",51,800,2005,37792,36284,1508,4
"51800",51,800,2006,39342,37958,1384,3.5
"51800",51,800,2007,39794,38487,1307,3.3
"51800",51,800,2008,40871,39201,1670,4.1
"51800",51,800,2009,40575,37854,2721,6.7
"51800",51,800,2010,41753,38581,3172,7.6
"51800",51,800,2011,41913,38790,3123,7.5
"51800",51,800,2012,41803,38869,2934,7
"51800",51,800,2013,41983,39325,2658,6.3
"51800",51,800,2014,42366,39919,2447,5.8
"51800",51,800,2015,42290,40190,2100,5
"51800",51,800,2016,42900,40872,2028,4.7
"51800",51,800,2017,43492,41684,1808,4.2
"51810",51,810,1990,191985,184421,7564,3.9
"51810",51,810,1991,199943,190390,9553,4.8
"51810",51,810,1992,205487,194794,10693,5.2
"51810",51,810,1993,205530,196234,9296,4.5
"51810",51,810,1994,207761,197885,9876,4.8
"51810",51,810,1995,209088,200125,8963,4.3
"51810",51,810,1996,207601,199018,8583,4.1
"51810",51,810,1997,210428,202298,8130,3.9
"51810",51,810,1998,211520,205686,5834,2.8
"51810",51,810,1999,211899,206331,5568,2.6
"51810",51,810,2000,205898,201294,4604,2.2
"51810",51,810,2001,210475,204339,6136,2.9
"51810",51,810,2002,213845,206207,7638,3.6
"51810",51,810,2003,215308,207436,7872,3.7
"51810",51,810,2004,216704,209047,7657,3.5
"51810",51,810,2005,220002,212602,7400,3.4
"51810",51,810,2006,221582,215051,6531,2.9
"51810",51,810,2007,222978,216854,6124,2.7
"51810",51,810,2008,225849,217654,8195,3.6
"51810",51,810,2009,219738,206585,13153,6
"51810",51,810,2010,226894,212145,14749,6.5
"51810",51,810,2011,229211,215118,14093,6.1
"51810",51,810,2012,229035,215892,13143,5.7
"51810",51,810,2013,231008,218514,12494,5.4
"51810",51,810,2014,231758,220297,11461,4.9
"51810",51,810,2015,228767,218950,9817,4.3
"51810",51,810,2016,228883,219727,9156,4
"51810",51,810,2017,232521,224148,8373,3.6
"51820",51,820,1990,9125,8735,390,4.3
"51820",51,820,1991,9309,8595,714,7.7
"51820",51,820,1992,9227,8431,796,8.6
"51820",51,820,1993,9033,8396,637,7.1
"51820",51,820,1994,8827,8334,493,5.6
"51820",51,820,1995,8779,8332,447,5.1
"51820",51,820,1996,8539,8151,388,4.5
"51820",51,820,1997,8793,8416,377,4.3
"51820",51,820,1998,9065,8805,260,2.9
"51820",51,820,1999,9257,8997,260,2.8
"51820",51,820,2000,9149,8912,237,2.6
"51820",51,820,2001,9352,9005,347,3.7
"51820",51,820,2002,9559,9104,455,4.8
"51820",51,820,2003,9673,9233,440,4.5
"51820",51,820,2004,9510,9140,370,3.9
"51820",51,820,2005,9827,9450,377,3.8
"51820",51,820,2006,9877,9559,318,3.2
"51820",51,820,2007,10090,9742,348,3.4
"51820",51,820,2008,10427,9916,511,4.9
"51820",51,820,2009,10699,9786,913,8.5
"51820",51,820,2010,10170,9255,915,9
"51820",51,820,2011,10176,9355,821,8.1
"51820",51,820,2012,10041,9335,706,7
"51820",51,820,2013,10028,9420,608,6.1
"51820",51,820,2014,10070,9530,540,5.4
"51820",51,820,2015,10010,9531,479,4.8
"51820",51,820,2016,10177,9751,426,4.2
"51820",51,820,2017,10272,9853,419,4.1
"51830",51,830,1990,5828,5307,521,8.9
"51830",51,830,1991,5937,5357,580,9.8
"51830",51,830,1992,5985,5216,769,12.8
"51830",51,830,1993,6012,5366,646,10.7
"51830",51,830,1994,6161,5513,648,10.5
"51830",51,830,1995,6219,5730,489,7.9
"51830",51,830,1996,5722,5247,475,8.3
"51830",51,830,1997,5827,5409,418,7.2
"51830",51,830,1998,6080,5743,337,5.5
"51830",51,830,1999,6130,5782,348,5.7
"51830",51,830,2000,4607,4404,203,4.4
"51830",51,830,2001,4673,4406,267,5.7
"51830",51,830,2002,4636,4298,338,7.3
"51830",51,830,2003,4589,4220,369,8
"51830",51,830,2004,4600,4243,357,7.8
"51830",51,830,2005,4773,4426,347,7.3
"51830",51,830,2006,4811,4525,286,5.9
"51830",51,830,2007,5112,4825,287,5.6
"51830",51,830,2008,5331,4874,457,8.6
"51830",51,830,2009,5543,4721,822,14.8
"51830",51,830,2010,6516,5856,660,10.1
"51830",51,830,2011,6745,6138,607,9
"51830",51,830,2012,6845,6274,571,8.3
"51830",51,830,2013,6877,6349,528,7.7
"51830",51,830,2014,6637,6149,488,7.4
"51830",51,830,2015,6657,6235,422,6.3
"51830",51,830,2016,6704,6329,375,5.6
"51830",51,830,2017,6820,6460,360,5.3
"51840",51,840,1990,12597,11803,794,6.3
"51840",51,840,1991,12959,11747,1212,9.4
"51840",51,840,1992,12938,11689,1249,9.7
"51840",51,840,1993,12980,12189,791,6.1
"51840",51,840,1994,13262,12529,733,5.5
"51840",51,840,1995,13486,12823,663,4.9
"51840",51,840,1996,12808,12212,596,4.7
"51840",51,840,1997,13016,12408,608,4.7
"51840",51,840,1998,13252,12858,394,3
"51840",51,840,1999,12977,12654,323,2.5
"51840",51,840,2000,12913,12624,289,2.2
"51840",51,840,2001,13083,12663,420,3.2
"51840",51,840,2002,13248,12722,526,4
"51840",51,840,2003,13330,12839,491,3.7
"51840",51,840,2004,13595,13145,450,3.3
"51840",51,840,2005,13740,13311,429,3.1
"51840",51,840,2006,14212,13793,419,2.9
"51840",51,840,2007,14328,13868,460,3.2
"51840",51,840,2008,14354,13701,653,4.5
"51840",51,840,2009,14218,13067,1151,8.1
"51840",51,840,2010,13688,12551,1137,8.3
"51840",51,840,2011,14078,13032,1046,7.4
"51840",51,840,2012,14246,13294,952,6.7
"51840",51,840,2013,14359,13524,835,5.8
"51840",51,840,2014,14432,13690,742,5.1
"51840",51,840,2015,14199,13576,623,4.4
"51840",51,840,2016,14305,13727,578,4
"51840",51,840,2017,14570,14043,527,3.6
"53001",53,1,1990,7784,6933,851,10.9
"53001",53,1,1991,8001,6977,1024,12.8
"53001",53,1,1992,8066,6902,1164,14.4
"53001",53,1,1993,8405,7122,1283,15.3
"53001",53,1,1994,8285,7237,1048,12.6
"53001",53,1,1995,8763,7736,1027,11.7
"53001",53,1,1996,8774,7779,995,11.3
"53001",53,1,1997,8969,8076,893,10
"53001",53,1,1998,9367,8409,958,10.2
"53001",53,1,1999,8915,7962,953,10.7
"53001",53,1,2000,8079,7404,675,8.4
"53001",53,1,2001,8080,7342,738,9.1
"53001",53,1,2002,8166,7418,748,9.2
"53001",53,1,2003,8172,7450,722,8.8
"53001",53,1,2004,8168,7512,656,8
"53001",53,1,2005,8176,7596,580,7.1
"53001",53,1,2006,8063,7512,551,6.8
"53001",53,1,2007,8021,7495,526,6.6
"53001",53,1,2008,8117,7583,534,6.6
"53001",53,1,2009,8320,7570,750,9
"53001",53,1,2010,8440,7555,885,10.5
"53001",53,1,2011,8257,7425,832,10.1
"53001",53,1,2012,8230,7482,748,9.1
"53001",53,1,2013,8376,7674,702,8.4
"53001",53,1,2014,8552,7941,611,7.1
"53001",53,1,2015,8618,8018,600,7
"53001",53,1,2016,8714,8158,556,6.4
"53001",53,1,2017,8918,8404,514,5.8
"53003",53,3,1990,9447,8941,506,5.4
"53003",53,3,1991,9494,8890,604,6.4
"53003",53,3,1992,9936,9397,539,5.4
"53003",53,3,1993,10253,9718,535,5.2
"53003",53,3,1994,10875,10443,432,4
"53003",53,3,1995,11398,10878,520,4.6
"53003",53,3,1996,11904,11399,505,4.2
"53003",53,3,1997,12422,11977,445,3.6
"53003",53,3,1998,12936,12433,503,3.9
"53003",53,3,1999,12820,12381,439,3.4
"53003",53,3,2000,9676,9134,542,5.6
"53003",53,3,2001,9805,9232,573,5.8
"53003",53,3,2002,10172,9458,714,7
"53003",53,3,2003,9928,9186,742,7.5
"53003",53,3,2004,10177,9508,669,6.6
"53003",53,3,2005,10517,9858,659,6.3
"53003",53,3,2006,10232,9758,474,4.6
"53003",53,3,2007,10264,9733,531,5.2
"53003",53,3,2008,10403,9709,694,6.7
"53003",53,3,2009,10387,9391,996,9.6
"53003",53,3,2010,10333,9361,972,9.4
"53003",53,3,2011,10051,9158,893,8.9
"53003",53,3,2012,9763,9003,760,7.8
"53003",53,3,2013,9793,9144,649,6.6
"53003",53,3,2014,9707,9186,521,5.4
"53003",53,3,2015,9679,9212,467,4.8
"53003",53,3,2016,9964,9473,491,4.9
"53003",53,3,2017,10262,9833,429,4.2
"53005",53,5,1990,61336,57395,3941,6.4
"53005",53,5,1991,62143,57725,4418,7.1
"53005",53,5,1992,64837,60014,4823,7.4
"53005",53,5,1993,68348,63606,4742,6.9
"53005",53,5,1994,72181,68005,4176,5.8
"53005",53,5,1995,72823,67077,5746,7.9
"53005",53,5,1996,72255,66533,5722,7.9
"53005",53,5,1997,72687,67943,4744,6.5
"53005",53,5,1998,74055,69338,4717,6.4
"53005",53,5,1999,75019,70789,4230,5.6
"53005",53,5,2000,76225,72039,4186,5.5
"53005",53,5,2001,76504,71859,4645,6.1
"53005",53,5,2002,79974,74913,5061,6.3
"53005",53,5,2003,82206,76515,5691,6.9
"53005",53,5,2004,84452,79307,5145,6.1
"53005",53,5,2005,85027,79916,5111,6
"53005",53,5,2006,83218,78060,5158,6.2
"53005",53,5,2007,86073,81368,4705,5.5
"53005",53,5,2008,88789,83988,4801,5.4
"53005",53,5,2009,92828,86121,6707,7.2
"53005",53,5,2010,94253,86846,7407,7.9
"53005",53,5,2011,92903,85275,7628,8.2
"53005",53,5,2012,92041,83467,8574,9.3
"53005",53,5,2013,90301,82246,8055,8.9
"53005",53,5,2014,89907,83182,6725,7.5
"53005",53,5,2015,91760,85591,6169,6.7
"53005",53,5,2016,94291,88412,5879,6.2
"53005",53,5,2017,97430,92070,5360,5.5
"53007",53,7,1990,31764,28928,2836,8.9
"53007",53,7,1991,31698,28273,3425,10.8
"53007",53,7,1992,32290,28613,3677,11.4
"53007",53,7,1993,32986,29488,3498,10.6
"53007",53,7,1994,34149,30979,3170,9.3
"53007",53,7,1995,34069,30453,3616,10.6
"53007",53,7,1996,35229,31692,3537,10
"53007",53,7,1997,35525,32732,2793,7.9
"53007",53,7,1998,36832,33755,3077,8.4
"53007",53,7,1999,36065,32905,3160,8.8
"53007",53,7,2000,36622,33993,2629,7.2
"53007",53,7,2001,34823,31844,2979,8.6
"53007",53,7,2002,35643,32523,3120,8.8
"53007",53,7,2003,36734,33621,3113,8.5
"53007",53,7,2004,38460,35737,2723,7.1
"53007",53,7,2005,39450,37014,2436,6.2
"53007",53,7,2006,39463,37252,2211,5.6
"53007",53,7,2007,40622,38390,2232,5.5
"53007",53,7,2008,40871,38445,2426,5.9
"53007",53,7,2009,42120,38717,3403,8.1
"53007",53,7,2010,42102,38353,3749,8.9
"53007",53,7,2011,41402,37911,3491,8.4
"53007",53,7,2012,41395,38084,3311,8
"53007",53,7,2013,40399,37461,2938,7.3
"53007",53,7,2014,41171,38639,2532,6.1
"53007",53,7,2015,42636,40246,2390,5.6
"53007",53,7,2016,43289,40840,2449,5.7
"53007",53,7,2017,44518,42349,2169,4.9
"53009",53,9,1990,23210,21524,1686,7.3
"53009",53,9,1991,22949,21112,1837,8
"53009",53,9,1992,23253,21200,2053,8.8
"53009",53,9,1993,23555,21224,2331,9.9
"53009",53,9,1994,23485,20856,2629,11.2
"53009",53,9,1995,24522,22311,2211,9
"53009",53,9,1996,24787,22541,2246,9.1
"53009",53,9,1997,25166,23202,1964,7.8
"53009",53,9,1998,25515,23584,1931,7.6
"53009",53,9,1999,26584,24643,1941,7.3
"53009",53,9,2000,25933,23955,1978,7.6
"53009",53,9,2001,25620,23496,2124,8.3
"53009",53,9,2002,26463,24143,2320,8.8
"53009",53,9,2003,27035,24693,2342,8.7
"53009",53,9,2004,28224,26163,2061,7.3
"53009",53,9,2005,29526,27521,2005,6.8
"53009",53,9,2006,29619,27739,1880,6.3
"53009",53,9,2007,30007,28041,1966,6.6
"53009",53,9,2008,30083,27811,2272,7.6
"53009",53,9,2009,30374,27306,3068,10.1
"53009",53,9,2010,29621,26352,3269,11
"53009",53,9,2011,28488,25371,3117,10.9
"53009",53,9,2012,28153,25210,2943,10.5
"53009",53,9,2013,27336,24710,2626,9.6
"53009",53,9,2014,26738,24493,2245,8.4
"53009",53,9,2015,26809,24621,2188,8.2
"53009",53,9,2016,27313,25259,2054,7.5
"53009",53,9,2017,27927,26023,1904,6.8
"53011",53,11,1990,128576,122317,6259,4.9
"53011",53,11,1991,128103,119895,8208,6.4
"53011",53,11,1992,131295,122125,9170,7
"53011",53,11,1993,135682,127895,7787,5.7
"53011",53,11,1994,142864,136143,6721,4.7
"53011",53,11,1995,153519,146903,6616,4.3
"53011",53,11,1996,164969,158175,6794,4.1
"53011",53,11,1997,176972,170822,6150,3.5
"53011",53,11,1998,185669,177643,8026,4.3
"53011",53,11,1999,188637,181075,7562,4
"53011",53,11,2000,179672,170175,9497,5.3
"53011",53,11,2001,179908,167007,12901,7.2
"53011",53,11,2002,185358,168119,17239,9.3
"53011",53,11,2003,187492,169407,18085,9.6
"53011",53,11,2004,195607,180734,14873,7.6
"53011",53,11,2005,202656,189108,13548,6.7
"53011",53,11,2006,205896,192980,12916,6.3
"53011",53,11,2007,209985,196792,13193,6.3
"53011",53,11,2008,215138,198972,16166,7.5
"53011",53,11,2009,219478,190185,29293,13.3
"53011",53,11,2010,216620,188628,27992,12.9
"53011",53,11,2011,211482,186816,24666,11.7
"53011",53,11,2012,209404,189704,19700,9.4
"53011",53,11,2013,208351,190701,17650,8.5
"53011",53,11,2014,209309,194621,14688,7
"53011",53,11,2015,214351,200483,13868,6.5
"53011",53,11,2016,220790,207514,13276,6
"53011",53,11,2017,227382,215782,11600,5.1
"53013",53,13,1990,1496,1302,194,13
"53013",53,13,1991,1357,1170,187,13.8
"53013",53,13,1992,1415,1207,208,14.7
"53013",53,13,1993,1521,1290,231,15.2
"53013",53,13,1994,1544,1353,191,12.4
"53013",53,13,1995,1507,1304,203,13.5
"53013",53,13,1996,1436,1223,213,14.8
"53013",53,13,1997,1488,1321,167,11.2
"53013",53,13,1998,1551,1379,172,11.1
"53013",53,13,1999,1572,1388,184,11.7
"53013",53,13,2000,1788,1631,157,8.8
"53013",53,13,2001,1684,1521,163,9.7
"53013",53,13,2002,1668,1496,172,10.3
"53013",53,13,2003,1660,1500,160,9.6
"53013",53,13,2004,1645,1508,137,8.3
"53013",53,13,2005,1636,1503,133,8.1
"53013",53,13,2006,1506,1366,140,9.3
"53013",53,13,2007,1531,1417,114,7.4
"53013",53,13,2008,1565,1447,118,7.5
"53013",53,13,2009,1600,1424,176,11
"53013",53,13,2010,1959,1774,185,9.4
"53013",53,13,2011,1854,1680,174,9.4
"53013",53,13,2012,1821,1670,151,8.3
"53013",53,13,2013,1768,1626,142,8
"53013",53,13,2014,1740,1616,124,7.1
"53013",53,13,2015,1695,1583,112,6.6
"53013",53,13,2016,1719,1608,111,6.5
"53013",53,13,2017,1766,1667,99,5.6
"53015",53,15,1990,38256,35526,2730,7.1
"53015",53,15,1991,38600,35368,3232,8.4
"53015",53,15,1992,37991,33930,4061,10.7
"53015",53,15,1993,38508,34331,4177,10.8
"53015",53,15,1994,39322,35738,3584,9.1
"53015",53,15,1995,40895,37635,3260,8
"53015",53,15,1996,41718,38342,3376,8.1
"53015",53,15,1997,42332,39365,2967,7
"53015",53,15,1998,43881,40637,3244,7.4
"53015",53,15,1999,43823,40694,3129,7.1
"53015",53,15,2000,43311,40260,3051,7
"53015",53,15,2001,42179,38000,4179,9.9
"53015",53,15,2002,42346,37775,4571,10.8
"53015",53,15,2003,42455,38201,4254,10
"53015",53,15,2004,42763,39058,3705,8.7
"53015",53,15,2005,42978,39717,3261,7.6
"53015",53,15,2006,42952,39906,3046,7.1
"53015",53,15,2007,43809,40721,3088,7
"53015",53,15,2008,44370,40522,3848,8.7
"53015",53,15,2009,45014,38954,6060,13.5
"53015",53,15,2010,46432,40435,5997,12.9
"53015",53,15,2011,44774,39434,5340,11.9
"53015",53,15,2012,44553,39791,4762,10.7
"53015",53,15,2013,43324,39074,4250,9.8
"53015",53,15,2014,43617,40102,3515,8.1
"53015",53,15,2015,44124,40697,3427,7.8
"53015",53,15,2016,44844,41668,3176,7.1
"53015",53,15,2017,46010,43224,2786,6.1
"53017",53,17,1990,16040,14747,1293,8.1
"53017",53,17,1991,16322,14906,1416,8.7
"53017",53,17,1992,16766,15285,1481,8.8
"53017",53,17,1993,17488,16050,1438,8.2
"53017",53,17,1994,18387,16969,1418,7.7
"53017",53,17,1995,18439,16977,1462,7.9
"53017",53,17,1996,19126,17631,1495,7.8
"53017",53,17,1997,19572,18332,1240,6.3
"53017",53,17,1998,20408,19058,1350,6.6
"53017",53,17,1999,20089,18697,1392,6.9
"53017",53,17,2000,18109,16884,1225,6.8
"53017",53,17,2001,17211,15885,1326,7.7
"53017",53,17,2002,17691,16338,1353,7.6
"53017",53,17,2003,18374,16956,1418,7.7
"53017",53,17,2004,19379,18122,1257,6.5
"53017",53,17,2005,19966,18824,1142,5.7
"53017",53,17,2006,20129,19037,1092,5.4
"53017",53,17,2007,20956,19853,1103,5.3
"53017",53,17,2008,21187,19988,1199,5.7
"53017",53,17,2009,22170,20394,1776,8
"53017",53,17,2010,19876,17945,1931,9.7
"53017",53,17,2011,19281,17473,1808,9.4
"53017",53,17,2012,19262,17512,1750,9.1
"53017",53,17,2013,18914,17348,1566,8.3
"53017",53,17,2014,19328,17954,1374,7.1
"53017",53,17,2015,19776,18503,1273,6.4
"53017",53,17,2016,20536,19136,1400,6.8
"53017",53,17,2017,21012,19812,1200,5.7
"53019",53,19,1990,2824,2481,343,12.1
"53019",53,19,1991,2755,2401,354,12.8
"53019",53,19,1992,2843,2429,414,14.6
"53019",53,19,1993,2824,2390,434,15.4
"53019",53,19,1994,2926,2520,406,13.9
"53019",53,19,1995,2944,2534,410,13.9
"53019",53,19,1996,2909,2533,376,12.9
"53019",53,19,1997,2876,2578,298,10.4
"53019",53,19,1998,2808,2498,310,11
"53019",53,19,1999,2730,2425,305,11.2
"53019",53,19,2000,2994,2681,313,10.5
"53019",53,19,2001,2858,2519,339,11.9
"53019",53,19,2002,2948,2632,316,10.7
"53019",53,19,2003,2923,2525,398,13.6
"53019",53,19,2004,2988,2662,326,10.9
"53019",53,19,2005,3009,2721,288,9.6
"53019",53,19,2006,2946,2650,296,10
"53019",53,19,2007,2975,2711,264,8.9
"53019",53,19,2008,2998,2716,282,9.4
"53019",53,19,2009,3083,2673,410,13.3
"53019",53,19,2010,2645,2181,464,17.5
"53019",53,19,2011,2528,2088,440,17.4
"53019",53,19,2012,2444,2061,383,15.7
"53019",53,19,2013,2485,2150,335,13.5
"53019",53,19,2014,2452,2173,279,11.4
"53019",53,19,2015,2477,2223,254,10.3
"53019",53,19,2016,2491,2237,254,10.2
"53019",53,19,2017,2539,2259,280,11
"53021",53,21,1990,19183,17124,2059,10.7
"53021",53,21,1991,19844,17431,2413,12.2
"53021",53,21,1992,20530,18159,2371,11.5
"53021",53,21,1993,21741,19226,2515,11.6
"53021",53,21,1994,22499,20413,2086,9.3
"53021",53,21,1995,22910,20565,2345,10.2
"53021",53,21,1996,22948,20335,2613,11.4
"53021",53,21,1997,22822,20678,2144,9.4
"53021",53,21,1998,23554,21285,2269,9.6
"53021",53,21,1999,23876,21587,2289,9.6
"53021",53,21,2000,23054,21221,1833,8
"53021",53,21,2001,23247,21286,1961,8.4
"53021",53,21,2002,24536,22408,2128,8.7
"53021",53,21,2003,26162,23843,2319,8.9
"53021",53,21,2004,27950,25811,2139,7.7
"53021",53,21,2005,29279,27118,2161,7.4
"53021",53,21,2006,30005,27719,2286,7.6
"53021",53,21,2007,32463,30208,2255,6.9
"53021",53,21,2008,34124,31888,2236,6.6
"53021",53,21,2009,36752,33671,3081,8.4
"53021",53,21,2010,38254,34884,3370,8.8
"53021",53,21,2011,38700,35199,3501,9
"53021",53,21,2012,39167,35366,3801,9.7
"53021",53,21,2013,38399,34773,3626,9.4
"53021",53,21,2014,38056,34886,3170,8.3
"53021",53,21,2015,38981,36002,2979,7.6
"53021",53,21,2016,39844,36916,2928,7.3
"53021",53,21,2017,40873,38294,2579,6.3
"53023",53,23,1990,1067,1033,34,3.2
"53023",53,23,1991,1027,1000,27,2.6
"53023",53,23,1992,1050,1014,36,3.4
"53023",53,23,1993,1096,1028,68,6.2
"53023",53,23,1994,1048,991,57,5.4
"53023",53,23,1995,1038,989,49,4.7
"53023",53,23,1996,1103,1058,45,4.1
"53023",53,23,1997,1101,1061,40,3.6
"53023",53,23,1998,1115,1072,43,3.9
"53023",53,23,1999,1129,1086,43,3.8
"53023",53,23,2000,1037,983,54,5.2
"53023",53,23,2001,1052,995,57,5.4
"53023",53,23,2002,1061,993,68,6.4
"53023",53,23,2003,1080,1006,74,6.9
"53023",53,23,2004,1087,1025,62,5.7
"53023",53,23,2005,1081,1019,62,5.7
"53023",53,23,2006,1043,983,60,5.8
"53023",53,23,2007,1018,963,55,5.4
"53023",53,23,2008,1021,971,50,4.9
"53023",53,23,2009,1028,953,75,7.3
"53023",53,23,2010,1061,973,88,8.3
"53023",53,23,2011,1030,952,78,7.6
"53023",53,23,2012,1020,942,78,7.6
"53023",53,23,2013,986,913,73,7.4
"53023",53,23,2014,960,897,63,6.6
"53023",53,23,2015,930,872,58,6.2
"53023",53,23,2016,919,866,53,5.8
"53023",53,23,2017,916,866,50,5.5
"53025",53,25,1990,27333,24852,2481,9.1
"53025",53,25,1991,28647,25663,2984,10.4
"53025",53,25,1992,29928,26563,3365,11.2
"53025",53,25,1993,31251,27754,3497,11.2
"53025",53,25,1994,33136,29679,3457,10.4
"53025",53,25,1995,34100,30599,3501,10.3
"53025",53,25,1996,35754,32239,3515,9.8
"53025",53,25,1997,37169,34020,3149,8.5
"53025",53,25,1998,38836,35442,3394,8.7
"53025",53,25,1999,39500,35749,3751,9.5
"53025",53,25,2000,35775,32702,3073,8.6
"53025",53,25,2001,35186,31874,3312,9.4
"53025",53,25,2002,36076,32615,3461,9.6
"53025",53,25,2003,36677,33238,3439,9.4
"53025",53,25,2004,37422,34279,3143,8.4
"53025",53,25,2005,38364,35447,2917,7.6
"53025",53,25,2006,38924,36151,2773,7.1
"53025",53,25,2007,40534,37905,2629,6.5
"53025",53,25,2008,40948,38144,2804,6.8
"53025",53,25,2009,42357,38150,4207,9.9
"53025",53,25,2010,43212,38522,4690,10.9
"53025",53,25,2011,42786,38460,4326,10.1
"53025",53,25,2012,43914,39740,4174,9.5
"53025",53,25,2013,44014,40206,3808,8.7
"53025",53,25,2014,44845,41513,3332,7.4
"53025",53,25,2015,44711,41432,3279,7.3
"53025",53,25,2016,44567,41422,3145,7.1
"53025",53,25,2017,45310,42475,2835,6.3
"53027",53,27,1990,27575,24855,2720,9.9
"53027",53,27,1991,27211,23940,3271,12
"53027",53,27,1992,27952,24501,3451,12.3
"53027",53,27,1993,28026,23790,4236,15.1
"53027",53,27,1994,27679,23934,3745,13.5
"53027",53,27,1995,28206,24993,3213,11.4
"53027",53,27,1996,27985,24893,3092,11
"53027",53,27,1997,28498,25857,2641,9.3
"53027",53,27,1998,28000,25318,2682,9.6
"53027",53,27,1999,27359,25050,2309,8.4
"53027",53,27,2000,29367,26987,2380,8.1
"53027",53,27,2001,28393,25649,2744,9.7
"53027",53,27,2002,28968,26201,2767,9.6
"53027",53,27,2003,29680,26867,2813,9.5
"53027",53,27,2004,30907,28286,2621,8.5
"53027",53,27,2005,31229,28761,2468,7.9
"53027",53,27,2006,31044,28686,2358,7.6
"53027",53,27,2007,31481,28996,2485,7.9
"53027",53,27,2008,31893,29267,2626,8.2
"53027",53,27,2009,31602,27416,4186,13.2
"53027",53,27,2010,31046,26723,4323,13.9
"53027",53,27,2011,29705,25667,4038,13.6
"53027",53,27,2012,28876,25129,3747,13
"53027",53,27,2013,28125,24791,3334,11.9
"53027",53,27,2014,27202,24451,2751,10.1
"53027",53,27,2015,26928,24474,2454,9.1
"53027",53,27,2016,27238,24993,2245,8.2
"53027",53,27,2017,27971,25993,1978,7.1
"53029",53,29,1990,23040,22225,815,3.5
"53029",53,29,1991,22885,21843,1042,4.6
"53029",53,29,1992,24022,22593,1429,5.9
"53029",53,29,1993,24073,22786,1287,5.3
"53029",53,29,1994,24844,23472,1372,5.5
"53029",53,29,1995,25793,24561,1232,4.8
"53029",53,29,1996,26545,25324,1221,4.6
"53029",53,29,1997,28423,27450,973,3.4
"53029",53,29,1998,29937,28938,999,3.3
"53029",53,29,1999,31034,29843,1191,3.8
"53029",53,29,2000,29034,27422,1612,5.6
"53029",53,29,2001,28729,26886,1843,6.4
"53029",53,29,2002,30155,27909,2246,7.4
"53029",53,29,2003,30516,28187,2329,7.6
"53029",53,29,2004,31509,29299,2210,7
"53029",53,29,2005,31726,29751,1975,6.2
"53029",53,29,2006,32363,30548,1815,5.6
"53029",53,29,2007,32973,31150,1823,5.5
"53029",53,29,2008,33072,31144,1928,5.8
"53029",53,29,2009,33017,30058,2959,9
"53029",53,29,2010,33812,30665,3147,9.3
"53029",53,29,2011,32640,29678,2962,9.1
"53029",53,29,2012,32528,29879,2649,8.1
"53029",53,29,2013,31776,29413,2363,7.4
"53029",53,29,2014,31725,29630,2095,6.6
"53029",53,29,2015,31767,29814,1953,6.1
"53029",53,29,2016,32737,30827,1910,5.8
"53029",53,29,2017,34259,32475,1784,5.2
"53031",53,31,1990,8418,7977,441,5.2
"53031",53,31,1991,8211,7654,557,6.8
"53031",53,31,1992,8591,7817,774,9
"53031",53,31,1993,9306,8540,766,8.2
"53031",53,31,1994,9389,8501,888,9.5
"53031",53,31,1995,9943,9178,765,7.7
"53031",53,31,1996,10069,9292,777,7.7
"53031",53,31,1997,10126,9444,682,6.7
"53031",53,31,1998,10270,9611,659,6.4
"53031",53,31,1999,11431,10759,672,5.9
"53031",53,31,2000,11692,10992,700,6
"53031",53,31,2001,11928,11125,803,6.7
"53031",53,31,2002,12356,11381,975,7.9
"53031",53,31,2003,12816,11858,958,7.5
"53031",53,31,2004,13409,12556,853,6.4
"53031",53,31,2005,13598,12798,800,5.9
"53031",53,31,2006,13603,12861,742,5.5
"53031",53,31,2007,13696,12968,728,5.3
"53031",53,31,2008,13716,12906,810,5.9
"53031",53,31,2009,13171,11995,1176,8.9
"53031",53,31,2010,12750,11436,1314,10.3
"53031",53,31,2011,12072,10810,1262,10.5
"53031",53,31,2012,11930,10740,1190,10
"53031",53,31,2013,11424,10351,1073,9.4
"53031",53,31,2014,11196,10299,897,8
"53031",53,31,2015,11200,10397,803,7.2
"53031",53,31,2016,11507,10703,804,7
"53031",53,31,2017,12021,11285,736,6.1
"53033",53,33,1990,857056,826082,30974,3.6
"53033",53,33,1991,861929,823004,38925,4.5
"53033",53,33,1992,893454,842280,51174,5.7
"53033",53,33,1993,900329,847891,52438,5.8
"53033",53,33,1994,893847,850994,42853,4.8
"53033",53,33,1995,902205,859147,43058,4.8
"53033",53,33,1996,926544,885479,41065,4.4
"53033",53,33,1997,958429,923616,34813,3.6
"53033",53,33,1998,974897,942774,32123,3.3
"53033",53,33,1999,979108,946876,32232,3.3
"53033",53,33,2000,988130,951669,36461,3.7
"53033",53,33,2001,992822,945223,47599,4.8
"53033",53,33,2002,983366,922965,60401,6.1
"53033",53,33,2003,987258,926821,60437,6.1
"53033",53,33,2004,993258,943793,49465,5
"53033",53,33,2005,1011681,967430,44251,4.4
"53033",53,33,2006,1043636,1004810,38826,3.7
"53033",53,33,2007,1067240,1033216,34024,3.2
"53033",53,33,2008,1090567,1048196,42371,3.9
"53033",53,33,2009,1113894,1024328,89566,8
"53033",53,33,2010,1105830,1006061,99769,9
"53033",53,33,2011,1108889,1021048,87841,7.9
"53033",53,33,2012,1122834,1051837,70997,6.3
"53033",53,33,2013,1137369,1079695,57674,5.1
"53033",53,33,2014,1158195,1103941,54254,4.7
"53033",53,33,2015,1178040,1127580,50460,4.3
"53033",53,33,2016,1204361,1156940,47421,3.9
"53033",53,33,2017,1230208,1184708,45500,3.7
"53035",53,35,1990,84866,81258,3608,4.3
"53035",53,35,1991,86160,81715,4445,5.2
"53035",53,35,1992,88021,82664,5357,6.1
"53035",53,35,1993,88952,82965,5987,6.7
"53035",53,35,1994,89984,83992,5992,6.7
"53035",53,35,1995,90890,84483,6407,7
"53035",53,35,1996,95069,89070,5999,6.3
"53035",53,35,1997,95176,90028,5148,5.4
"53035",53,35,1998,94647,89911,4736,5
"53035",53,35,1999,99009,94047,4962,5
"53035",53,35,2000,106205,100257,5948,5.6
"53035",53,35,2001,104775,98130,6645,6.3
"53035",53,35,2002,110392,102875,7517,6.8
"53035",53,35,2003,113544,105865,7679,6.8
"53035",53,35,2004,118477,111484,6993,5.9
"53035",53,35,2005,120999,114535,6464,5.3
"53035",53,35,2006,121958,115759,6199,5.1
"53035",53,35,2007,123028,116967,6061,4.9
"53035",53,35,2008,124802,118172,6630,5.3
"53035",53,35,2009,125529,115796,9733,7.8
"53035",53,35,2010,120592,110230,10362,8.6
"53035",53,35,2011,117324,107470,9854,8.4
"53035",53,35,2012,116110,106945,9165,7.9
"53035",53,35,2013,113691,105488,8203,7.2
"53035",53,35,2014,113577,106632,6945,6.1
"53035",53,35,2015,115357,108912,6445,5.6
"53035",53,35,2016,118179,111669,6510,5.5
"53035",53,35,2017,121104,115166,5938,4.9
"53037",53,37,1990,12723,11690,1033,8.1
"53037",53,37,1991,12883,11607,1276,9.9
"53037",53,37,1992,13553,11819,1734,12.8
"53037",53,37,1993,13744,12296,1448,10.5
"53037",53,37,1994,14401,13066,1335,9.3
"53037",53,37,1995,15418,14007,1411,9.2
"53037",53,37,1996,15453,14198,1255,8.1
"53037",53,37,1997,15537,14611,926,6
"53037",53,37,1998,15548,14650,898,5.8
"53037",53,37,1999,15543,14665,878,5.6
"53037",53,37,2000,17298,16244,1054,6.1
"53037",53,37,2001,17044,15853,1191,7
"53037",53,37,2002,17902,16593,1309,7.3
"53037",53,37,2003,18502,17075,1427,7.7
"53037",53,37,2004,18823,17499,1324,7
"53037",53,37,2005,19119,17929,1190,6.2
"53037",53,37,2006,19466,18357,1109,5.7
"53037",53,37,2007,20360,19265,1095,5.4
"53037",53,37,2008,20952,19635,1317,6.3
"53037",53,37,2009,20924,19014,1910,9.1
"53037",53,37,2010,21306,19221,2085,9.8
"53037",53,37,2011,20765,18841,1924,9.3
"53037",53,37,2012,20583,18773,1810,8.8
"53037",53,37,2013,20207,18636,1571,7.8
"53037",53,37,2014,20200,18801,1399,6.9
"53037",53,37,2015,20847,19544,1303,6.3
"53037",53,37,2016,21533,20265,1268,5.9
"53037",53,37,2017,22228,21048,1180,5.3
"53039",53,39,1990,7966,6990,976,12.3
"53039",53,39,1991,7834,6791,1043,13.3
"53039",53,39,1992,8076,6945,1131,14
"53039",53,39,1993,8207,6992,1215,14.8
"53039",53,39,1994,8425,7352,1073,12.7
"53039",53,39,1995,8855,7762,1093,12.3
"53039",53,39,1996,8992,7949,1043,11.6
"53039",53,39,1997,9375,8411,964,10.3
"53039",53,39,1998,9219,8274,945,10.3
"53039",53,39,1999,9087,8212,875,9.6
"53039",53,39,2000,9320,8542,778,8.3
"53039",53,39,2001,9177,8092,1085,11.8
"53039",53,39,2002,9501,8407,1094,11.5
"53039",53,39,2003,9417,8292,1125,11.9
"53039",53,39,2004,9470,8578,892,9.4
"53039",53,39,2005,9373,8607,766,8.2
"53039",53,39,2006,9517,8785,732,7.7
"53039",53,39,2007,9756,9028,728,7.5
"53039",53,39,2008,10173,9356,817,8
"53039",53,39,2009,10904,9772,1132,10.4
"53039",53,39,2010,10328,9069,1259,12.2
"53039",53,39,2011,10157,8958,1199,11.8
"53039",53,39,2012,9939,8921,1018,10.2
"53039",53,39,2013,9722,8805,917,9.4
"53039",53,39,2014,9586,8844,742,7.7
"53039",53,39,2015,9458,8775,683,7.2
"53039",53,39,2016,9642,8993,649,6.7
"53039",53,39,2017,10051,9465,586,5.8
"53041",53,41,1990,26490,24271,2219,8.4
"53041",53,41,1991,26213,23416,2797,10.7
"53041",53,41,1992,27374,24322,3052,11.1
"53041",53,41,1993,27741,24709,3032,10.9
"53041",53,41,1994,28733,26030,2703,9.4
"53041",53,41,1995,30064,27328,2736,9.1
"53041",53,41,1996,30994,28113,2881,9.3
"53041",53,41,1997,32439,29954,2485,7.7
"53041",53,41,1998,31258,28540,2718,8.7
"53041",53,41,1999,31387,28696,2691,8.6
"53041",53,41,2000,29888,27462,2426,8.1
"53041",53,41,2001,28852,26233,2619,9.1
"53041",53,41,2002,29495,26731,2764,9.4
"53041",53,41,2003,30107,27250,2857,9.5
"53041",53,41,2004,30759,28150,2609,8.5
"53041",53,41,2005,30631,28174,2457,8
"53041",53,41,2006,31197,28853,2344,7.5
"53041",53,41,2007,31212,28762,2450,7.8
"53041",53,41,2008,31519,28767,2752,8.7
"53041",53,41,2009,31789,27561,4228,13.3
"53041",53,41,2010,33962,29503,4459,13.1
"53041",53,41,2011,32542,28390,4152,12.8
"53041",53,41,2012,32233,28372,3861,12
"53041",53,41,2013,31352,28046,3306,10.5
"53041",53,41,2014,30544,27780,2764,9
"53041",53,41,2015,31232,28588,2644,8.5
"53041",53,41,2016,31915,29452,2463,7.7
"53041",53,41,2017,33151,30948,2203,6.6
"53043",53,43,1990,4180,4015,165,3.9
"53043",53,43,1991,4102,3916,186,4.5
"53043",53,43,1992,4259,4034,225,5.3
"53043",53,43,1993,4469,4194,275,6.2
"53043",53,43,1994,4480,4199,281,6.3
"53043",53,43,1995,4745,4441,304,6.4
"53043",53,43,1996,5062,4792,270,5.3
"53043",53,43,1997,5042,4809,233,4.6
"53043",53,43,1998,5138,4880,258,5
"53043",53,43,1999,4913,4662,251,5.1
"53043",53,43,2000,4620,4377,243,5.3
"53043",53,43,2001,4519,4243,276,6.1
"53043",53,43,2002,4594,4273,321,7
"53043",53,43,2003,4680,4349,331,7.1
"53043",53,43,2004,4808,4482,326,6.8
"53043",53,43,2005,4725,4425,300,6.3
"53043",53,43,2006,4663,4377,286,6.1
"53043",53,43,2007,4704,4429,275,5.8
"53043",53,43,2008,4829,4548,281,5.8
"53043",53,43,2009,4858,4443,415,8.5
"53043",53,43,2010,5327,4880,447,8.4
"53043",53,43,2011,5298,4868,430,8.1
"53043",53,43,2012,5245,4863,382,7.3
"53043",53,43,2013,5090,4742,348,6.8
"53043",53,43,2014,5037,4747,290,5.8
"53043",53,43,2015,4877,4590,287,5.9
"53043",53,43,2016,4891,4621,270,5.5
"53043",53,43,2017,4955,4710,245,4.9
"53045",53,45,1990,15960,14994,966,6.1
"53045",53,45,1991,15842,14558,1284,8.1
"53045",53,45,1992,15954,14589,1365,8.6
"53045",53,45,1993,16739,15153,1586,9.5
"53045",53,45,1994,17360,15743,1617,9.3
"53045",53,45,1995,18609,17044,1565,8.4
"53045",53,45,1996,19438,17898,1540,7.9
"53045",53,45,1997,20484,19107,1377,6.7
"53045",53,45,1998,20770,19443,1327,6.4
"53045",53,45,1999,20337,19030,1307,6.4
"53045",53,45,2000,21017,19535,1482,7.1
"53045",53,45,2001,20475,18818,1657,8.1
"53045",53,45,2002,21634,19804,1830,8.5
"53045",53,45,2003,22654,20691,1963,8.7
"53045",53,45,2004,23622,21832,1790,7.6
"53045",53,45,2005,24024,22395,1629,6.8
"53045",53,45,2006,24647,23085,1562,6.3
"53045",53,45,2007,25189,23543,1646,6.5
"53045",53,45,2008,25523,23609,1914,7.5
"53045",53,45,2009,25549,22795,2754,10.8
"53045",53,45,2010,24941,21963,2978,11.9
"53045",53,45,2011,23792,21005,2787,11.7
"53045",53,45,2012,23551,20983,2568,10.9
"53045",53,45,2013,23363,21030,2333,10
"53045",53,45,2014,23134,21203,1931,8.3
"53045",53,45,2015,23021,21208,1813,7.9
"53045",53,45,2016,23501,21746,1755,7.5
"53045",53,45,2017,23843,22272,1571,6.6
"53047",53,47,1990,19057,17158,1899,10
"53047",53,47,1991,20120,17812,2308,11.5
"53047",53,47,1992,20893,18443,2450,11.7
"53047",53,47,1993,21915,19311,2604,11.9
"53047",53,47,1994,22675,20264,2411,10.6
"53047",53,47,1995,23220,20654,2566,11.1
"53047",53,47,1996,23591,21058,2533,10.7
"53047",53,47,1997,24016,21792,2224,9.3
"53047",53,47,1998,24140,21685,2455,10.2
"53047",53,47,1999,22446,20231,2215,9.9
"53047",53,47,2000,20644,18769,1875,9.1
"53047",53,47,2001,18842,16860,1982,10.5
"53047",53,47,2002,18649,16749,1900,10.2
"53047",53,47,2003,19764,17882,1882,9.5
"53047",53,47,2004,20311,18665,1646,8.1
"53047",53,47,2005,20706,19169,1537,7.4
"53047",53,47,2006,20654,19173,1481,7.2
"53047",53,47,2007,20642,19194,1448,7
"53047",53,47,2008,21389,19915,1474,6.9
"53047",53,47,2009,22152,20019,2133,9.6
"53047",53,47,2010,22347,19950,2397,10.7
"53047",53,47,2011,21338,19145,2193,10.3
"53047",53,47,2012,21146,19140,2006,9.5
"53047",53,47,2013,21002,19197,1805,8.6
"53047",53,47,2014,21316,19796,1520,7.1
"53047",53,47,2015,21239,19756,1483,7
"53047",53,47,2016,21406,19997,1409,6.6
"53047",53,47,2017,20930,19492,1438,6.9
"53049",53,49,1990,7558,6916,642,8.5
"53049",53,49,1991,7768,6980,788,10.1
"53049",53,49,1992,7835,6984,851,10.9
"53049",53,49,1993,7984,7030,954,11.9
"53049",53,49,1994,8067,7102,965,12
"53049",53,49,1995,8372,7513,859,10.3
"53049",53,49,1996,8388,7557,831,9.9
"53049",53,49,1997,8893,8099,794,8.9
"53049",53,49,1998,8549,7734,815,9.5
"53049",53,49,1999,8142,7433,709,8.7
"53049",53,49,2000,8611,7937,674,7.8
"53049",53,49,2001,8492,7738,754,8.9
"53049",53,49,2002,8649,7843,806,9.3
"53049",53,49,2003,9015,8181,834,9.3
"53049",53,49,2004,9267,8550,717,7.7
"53049",53,49,2005,9095,8420,675,7.4
"53049",53,49,2006,9161,8515,646,7.1
"53049",53,49,2007,9293,8591,702,7.6
"53049",53,49,2008,9216,8469,747,8.1
"53049",53,49,2009,9299,8109,1190,12.8
"53049",53,49,2010,8789,7557,1232,14
"53049",53,49,2011,8220,7114,1106,13.5
"53049",53,49,2012,8193,7206,987,12
"53049",53,49,2013,7996,7096,900,11.3
"53049",53,49,2014,7857,7081,776,9.9
"53049",53,49,2015,8101,7368,733,9
"53049",53,49,2016,8289,7629,660,8
"53049",53,49,2017,8410,7818,592,7
"53051",53,51,1990,3499,2984,515,14.7
"53051",53,51,1991,3438,2944,494,14.4
"53051",53,51,1992,3658,3127,531,14.5
"53051",53,51,1993,3814,3281,533,14
"53051",53,51,1994,3813,3312,501,13.1
"53051",53,51,1995,4049,3478,571,14.1
"53051",53,51,1996,4156,3516,640,15.4
"53051",53,51,1997,4300,3750,550,12.8
"53051",53,51,1998,4340,3834,506,11.7
"53051",53,51,1999,4417,3966,451,10.2
"53051",53,51,2000,4628,4238,390,8.4
"53051",53,51,2001,4642,4203,439,9.5
"53051",53,51,2002,4660,4203,457,9.8
"53051",53,51,2003,4804,4300,504,10.5
"53051",53,51,2004,5011,4557,454,9.1
"53051",53,51,2005,5067,4640,427,8.4
"53051",53,51,2006,5115,4705,410,8
"53051",53,51,2007,5290,4874,416,7.9
"53051",53,51,2008,5525,5022,503,9.1
"53051",53,51,2009,5573,4762,811,14.6
"53051",53,51,2010,5148,4359,789,15.3
"53051",53,51,2011,4862,4181,681,14
"53051",53,51,2012,4813,4199,614,12.8
"53051",53,51,2013,4682,4125,557,11.9
"53051",53,51,2014,4581,4123,458,10
"53051",53,51,2015,4602,4155,447,9.7
"53051",53,51,2016,4660,4249,411,8.8
"53051",53,51,2017,4734,4381,353,7.5
"53053",53,53,1990,277634,263924,13710,4.9
"53053",53,53,1991,277407,259640,17767,6.4
"53053",53,53,1992,286417,264846,21571,7.5
"53053",53,53,1993,295567,273386,22181,7.5
"53053",53,53,1994,306291,284246,22045,7.2
"53053",53,53,1995,318314,297459,20855,6.6
"53053",53,53,1996,323944,304960,18984,5.9
"53053",53,53,1997,336130,321142,14988,4.5
"53053",53,53,1998,345346,330375,14971,4.3
"53053",53,53,1999,349193,333096,16097,4.6
"53053",53,53,2000,340655,321727,18928,5.6
"53053",53,53,2001,333309,310416,22893,6.9
"53053",53,53,2002,343525,315545,27980,8.1
"53053",53,53,2003,348837,320120,28717,8.2
"53053",53,53,2004,360651,334881,25770,7.1
"53053",53,53,2005,369155,346469,22686,6.1
"53053",53,53,2006,373684,352910,20774,5.6
"53053",53,53,2007,387377,366760,20617,5.3
"53053",53,53,2008,394631,370735,23896,6.1
"53053",53,53,2009,397744,359010,38734,9.7
"53053",53,53,2010,395844,354576,41268,10.4
"53053",53,53,2011,386867,347772,39095,10.1
"53053",53,53,2012,386969,350908,36061,9.3
"53053",53,53,2013,384278,352223,32055,8.3
"53053",53,53,2014,385485,358486,26999,7
"53053",53,53,2015,392345,366996,25349,6.5
"53053",53,53,2016,404636,380551,24085,6
"53053",53,53,2017,417219,394842,22377,5.4
"53055",53,55,1990,5107,4955,152,3
"53055",53,55,1991,5322,5128,194,3.6
"53055",53,55,1992,5364,5033,331,6.2
"53055",53,55,1993,5394,4985,409,7.6
"53055",53,55,1994,5443,5060,383,7
"53055",53,55,1995,5662,5269,393,6.9
"53055",53,55,1996,5675,5294,381,6.7
"53055",53,55,1997,5883,5562,321,5.5
"53055",53,55,1998,6152,5888,264,4.3
"53055",53,55,1999,6808,6555,253,3.7
"53055",53,55,2000,7499,7168,331,4.4
"53055",53,55,2001,7424,7046,378,5.1
"53055",53,55,2002,7559,7111,448,5.9
"53055",53,55,2003,7825,7371,454,5.8
"53055",53,55,2004,8229,7827,402,4.9
"53055",53,55,2005,8223,7845,378,4.6
"53055",53,55,2006,8222,7884,338,4.1
"53055",53,55,2007,8486,8160,326,3.8
"53055",53,55,2008,8770,8423,347,4
"53055",53,55,2009,8503,7934,569,6.7
"53055",53,55,2010,8449,7831,618,7.3
"53055",53,55,2011,8063,7479,584,7.2
"53055",53,55,2012,8105,7584,521,6.4
"53055",53,55,2013,7788,7323,465,6
"53055",53,55,2014,7692,7308,384,5
"53055",53,55,2015,7721,7346,375,4.9
"53055",53,55,2016,7874,7511,363,4.6
"53055",53,55,2017,8235,7911,324,3.9
"53057",53,57,1990,39549,36733,2816,7.1
"53057",53,57,1991,40636,37126,3510,8.6
"53057",53,57,1992,42093,37748,4345,10.3
"53057",53,57,1993,43748,38872,4876,11.1
"53057",53,57,1994,47771,42962,4809,10.1
"53057",53,57,1995,49565,44920,4645,9.4
"53057",53,57,1996,47723,43399,4324,9.1
"53057",53,57,1997,49042,45595,3447,7
"53057",53,57,1998,49611,46235,3376,6.8
"53057",53,57,1999,52771,49404,3367,6.4
"53057",53,57,2000,52076,48718,3358,6.4
"53057",53,57,2001,50935,47105,3830,7.5
"53057",53,57,2002,52144,47785,4359,8.4
"53057",53,57,2003,53300,48926,4374,8.2
"53057",53,57,2004,55123,51212,3911,7.1
"53057",53,57,2005,56282,52784,3498,6.2
"53057",53,57,2006,56494,53316,3178,5.6
"53057",53,57,2007,57934,54870,3064,5.3
"53057",53,57,2008,58791,55231,3560,6.1
"53057",53,57,2009,58592,52625,5967,10.2
"53057",53,57,2010,59114,52658,6456,10.9
"53057",53,57,2011,57143,51131,6012,10.5
"53057",53,57,2012,57112,51599,5513,9.7
"53057",53,57,2013,56754,51876,4878,8.6
"53057",53,57,2014,56490,52399,4091,7.2
"53057",53,57,2015,56713,52843,3870,6.8
"53057",53,57,2016,57965,54231,3734,6.4
"53057",53,57,2017,59436,56167,3269,5.5
"53059",53,59,1990,3947,3532,415,10.5
"53059",53,59,1991,4004,3489,515,12.9
"53059",53,59,1992,3784,3091,693,18.3
"53059",53,59,1993,4100,3502,598,14.6
"53059",53,59,1994,3999,3533,466,11.7
"53059",53,59,1995,4151,3700,451,10.9
"53059",53,59,1996,4019,3593,426,10.6
"53059",53,59,1997,4189,3777,412,9.8
"53059",53,59,1998,4396,3974,422,9.6
"53059",53,59,1999,4260,3895,365,8.6
"53059",53,59,2000,4824,4497,327,6.8
"53059",53,59,2001,4870,4303,567,11.6
"53059",53,59,2002,4718,4243,475,10.1
"53059",53,59,2003,4738,4255,483,10.2
"53059",53,59,2004,4940,4511,429,8.7
"53059",53,59,2005,5033,4633,400,7.9
"53059",53,59,2006,5086,4696,390,7.7
"53059",53,59,2007,5059,4682,377,7.5
"53059",53,59,2008,5157,4690,467,9.1
"53059",53,59,2009,5117,4448,669,13.1
"53059",53,59,2010,5179,4514,665,12.8
"53059",53,59,2011,5083,4463,620,12.2
"53059",53,59,2012,5033,4502,531,10.6
"53059",53,59,2013,4998,4501,497,9.9
"53059",53,59,2014,4947,4540,407,8.2
"53059",53,59,2015,4950,4580,370,7.5
"53059",53,59,2016,5076,4726,350,6.9
"53059",53,59,2017,5218,4896,322,6.2
"53061",53,61,1990,249722,239417,10305,4.1
"53061",53,61,1991,255630,242367,13263,5.2
"53061",53,61,1992,269062,252230,16832,6.3
"53061",53,61,1993,275269,257732,17537,6.4
"53061",53,61,1994,278102,262524,15578,5.6
"53061",53,61,1995,282245,267320,14925,5.3
"53061",53,61,1996,292811,278697,14114,4.8
"53061",53,61,1997,310353,298863,11490,3.7
"53061",53,61,1998,322005,311168,10837,3.4
"53061",53,61,1999,329780,316441,13339,4
"53061",53,61,2000,323911,310635,13276,4.1
"53061",53,61,2001,329236,312771,16465,5
"53061",53,61,2002,332439,308928,23511,7.1
"53061",53,61,2003,335106,311461,23645,7.1
"53061",53,61,2004,337515,318653,18862,5.6
"53061",53,61,2005,346207,329649,16558,4.8
"53061",53,61,2006,358027,343319,14708,4.1
"53061",53,61,2007,363266,350475,12791,3.5
"53061",53,61,2008,373004,355995,17009,4.6
"53061",53,61,2009,381983,345897,36086,9.4
"53061",53,61,2010,386587,345332,41255,10.7
"53061",53,61,2011,384100,347747,36353,9.5
"53061",53,61,2012,385500,356761,28739,7.5
"53061",53,61,2013,388729,366189,22540,5.8
"53061",53,61,2014,395565,374903,20662,5.2
"53061",53,61,2015,401650,382890,18760,4.7
"53061",53,61,2016,412294,394461,17833,4.3
"53061",53,61,2017,421369,403989,17380,4.1
"53063",53,63,1990,173569,163488,10081,5.8
"53063",53,63,1991,175989,164831,11158,6.3
"53063",53,63,1992,180122,167774,12348,6.9
"53063",53,63,1993,184774,173734,11040,6
"53063",53,63,1994,192417,181864,10553,5.5
"53063",53,63,1995,200396,188950,11446,5.7
"53063",53,63,1996,205464,194307,11157,5.4
"53063",53,63,1997,210104,200530,9574,4.6
"53063",53,63,1998,215528,205599,9929,4.6
"53063",53,63,1999,221051,209374,11677,5.3
"53063",53,63,2000,211671,199489,12182,5.8
"53063",53,63,2001,209491,194929,14562,7
"53063",53,63,2002,210686,194342,16344,7.8
"53063",53,63,2003,213702,197460,16242,7.6
"53063",53,63,2004,219136,204452,14684,6.7
"53063",53,63,2005,224140,210833,13307,5.9
"53063",53,63,2006,227128,214779,12349,5.4
"53063",53,63,2007,233681,221245,12436,5.3
"53063",53,63,2008,239320,225045,14275,6
"53063",53,63,2009,240002,217765,22237,9.3
"53063",53,63,2010,238125,214109,24016,10.1
"53063",53,63,2011,230795,208508,22287,9.7
"53063",53,63,2012,230421,209506,20915,9.1
"53063",53,63,2013,227420,208842,18578,8.2
"53063",53,63,2014,225474,209773,15701,7
"53063",53,63,2015,227903,212951,14952,6.6
"53063",53,63,2016,234478,220390,14088,6
"53063",53,63,2017,240421,227426,12995,5.4
"53065",53,65,1990,13457,12282,1175,8.7
"53065",53,65,1991,13915,12548,1367,9.8
"53065",53,65,1992,14667,12999,1668,11.4
"53065",53,65,1993,15444,13874,1570,10.2
"53065",53,65,1994,16438,14851,1587,9.7
"53065",53,65,1995,16843,15148,1695,10.1
"53065",53,65,1996,17269,15516,1753,10.2
"53065",53,65,1997,17711,16110,1601,9
"53065",53,65,1998,18051,16488,1563,8.7
"53065",53,65,1999,17707,16157,1550,8.8
"53065",53,65,2000,17582,16168,1414,8
"53065",53,65,2001,17115,15461,1654,9.7
"53065",53,65,2002,17399,15635,1764,10.1
"53065",53,65,2003,17601,15892,1709,9.7
"53065",53,65,2004,18026,16512,1514,8.4
"53065",53,65,2005,18006,16564,1442,8
"53065",53,65,2006,18169,16778,1391,7.7
"53065",53,65,2007,18631,17145,1486,8
"53065",53,65,2008,18887,17290,1597,8.5
"53065",53,65,2009,18977,16502,2475,13
"53065",53,65,2010,19104,16603,2501,13.1
"53065",53,65,2011,18296,16036,2260,12.4
"53065",53,65,2012,18222,16079,2143,11.8
"53065",53,65,2013,17734,15819,1915,10.8
"53065",53,65,2014,17400,15781,1619,9.3
"53065",53,65,2015,17451,15886,1565,9
"53065",53,65,2016,17882,16428,1454,8.1
"53065",53,65,2017,18284,16956,1328,7.3
"53067",53,67,1990,81191,77048,4143,5.1
"53067",53,67,1991,82687,77676,5011,6.1
"53067",53,67,1992,85744,80007,5737,6.7
"53067",53,67,1993,88197,82052,6145,7
"53067",53,67,1994,90697,84498,6199,6.8
"53067",53,67,1995,95128,88870,6258,6.6
"53067",53,67,1996,98266,92196,6070,6.2
"53067",53,67,1997,101455,96324,5131,5.1
"53067",53,67,1998,105101,100196,4905,4.7
"53067",53,67,1999,106852,101933,4919,4.6
"53067",53,67,2000,108427,102916,5511,5.1
"53067",53,67,2001,106819,100329,6490,6.1
"53067",53,67,2002,111009,103746,7263,6.5
"53067",53,67,2003,115052,107554,7498,6.5
"53067",53,67,2004,119267,112249,7018,5.9
"53067",53,67,2005,121951,115486,6465,5.3
"53067",53,67,2006,123916,117699,6217,5
"53067",53,67,2007,128000,121724,6276,4.9
"53067",53,67,2008,131686,124618,7068,5.4
"53067",53,67,2009,131896,121431,10465,7.9
"53067",53,67,2010,126948,115550,11398,9
"53067",53,67,2011,123314,112238,11076,9
"53067",53,67,2012,123207,112813,10394,8.4
"53067",53,67,2013,122799,113494,9305,7.6
"53067",53,67,2014,123392,115391,8001,6.5
"53067",53,67,2015,125764,118204,7560,6
"53067",53,67,2016,129787,122547,7240,5.6
"53067",53,67,2017,134847,128150,6697,5
"53069",53,69,1990,1535,1439,96,6.3
"53069",53,69,1991,1513,1424,89,5.9
"53069",53,69,1992,1552,1442,110,7.1
"53069",53,69,1993,1651,1523,128,7.8
"53069",53,69,1994,1667,1500,167,10
"53069",53,69,1995,1690,1575,115,6.8
"53069",53,69,1996,1738,1626,112,6.4
"53069",53,69,1997,1885,1775,110,5.8
"53069",53,69,1998,1972,1850,122,6.2
"53069",53,69,1999,1997,1865,132,6.6
"53069",53,69,2000,1662,1539,123,7.4
"53069",53,69,2001,1575,1438,137,8.7
"53069",53,69,2002,1547,1389,158,10.2
"53069",53,69,2003,1580,1424,156,9.9
"53069",53,69,2004,1606,1478,128,8
"53069",53,69,2005,1630,1505,125,7.7
"53069",53,69,2006,1623,1506,117,7.2
"53069",53,69,2007,1667,1544,123,7.4
"53069",53,69,2008,1773,1637,136,7.7
"53069",53,69,2009,1625,1390,235,14.5
"53069",53,69,2010,1472,1247,225,15.3
"53069",53,69,2011,1429,1224,205,14.3
"53069",53,69,2012,1376,1201,175,12.7
"53069",53,69,2013,1294,1139,155,12
"53069",53,69,2014,1276,1153,123,9.6
"53069",53,69,2015,1294,1177,117,9
"53069",53,69,2016,1288,1178,110,8.5
"53069",53,69,2017,1307,1214,93,7.1
"53071",53,71,1990,23859,22185,1674,7
"53071",53,71,1991,23617,21708,1909,8.1
"53071",53,71,1992,24440,22466,1974,8.1
"53071",53,71,1993,24844,23157,1687,6.8
"53071",53,71,1994,25434,23873,1561,6.1
"53071",53,71,1995,26276,24582,1694,6.4
"53071",53,71,1996,26600,24718,1882,7.1
"53071",53,71,1997,27275,25559,1716,6.3
"53071",53,71,1998,27698,25890,1808,6.5
"53071",53,71,1999,27689,25815,1874,6.8
"53071",53,71,2000,27223,25503,1720,6.3
"53071",53,71,2001,27136,25265,1871,6.9
"53071",53,71,2002,28118,26152,1966,7
"53071",53,71,2003,28710,26675,2035,7.1
"53071",53,71,2004,29223,27374,1849,6.3
"53071",53,71,2005,28983,27229,1754,6.1
"53071",53,71,2006,28717,27028,1689,5.9
"53071",53,71,2007,29172,27603,1569,5.4
"53071",53,71,2008,30445,28862,1583,5.2
"53071",53,71,2009,31127,29002,2125,6.8
"53071",53,71,2010,30530,28085,2445,8
"53071",53,71,2011,29623,27252,2371,8
"53071",53,71,2012,29564,27361,2203,7.5
"53071",53,71,2013,28421,26403,2018,7.1
"53071",53,71,2014,28460,26710,1750,6.1
"53071",53,71,2015,28054,26395,1659,5.9
"53071",53,71,2016,28715,27178,1537,5.4
"53071",53,71,2017,29304,27861,1443,4.9
"53073",53,73,1990,68105,64411,3694,5.4
"53073",53,73,1991,69561,64838,4723,6.8
"53073",53,73,1992,72942,67303,5639,7.7
"53073",53,73,1993,74735,68951,5784,7.7
"53073",53,73,1994,75410,69287,6123,8.1
"53073",53,73,1995,79592,73508,6084,7.6
"53073",53,73,1996,80035,74383,5652,7.1
"53073",53,73,1997,80714,76001,4713,5.8
"53073",53,73,1998,82094,77556,4538,5.5
"53073",53,73,1999,86046,81556,4490,5.2
"53073",53,73,2000,88217,83181,5036,5.7
"53073",53,73,2001,87105,81122,5983,6.9
"53073",53,73,2002,90836,84489,6347,7
"53073",53,73,2003,94539,88113,6426,6.8
"53073",53,73,2004,99224,93295,5929,6
"53073",53,73,2005,102524,97125,5399,5.3
"53073",53,73,2006,102885,97820,5065,4.9
"53073",53,73,2007,106348,101371,4977,4.7
"53073",53,73,2008,108750,102979,5771,5.3
"53073",53,73,2009,108027,98816,9211,8.5
"53073",53,73,2010,104359,94467,9892,9.5
"53073",53,73,2011,102742,93482,9260,9
"53073",53,73,2012,103136,94735,8401,8.1
"53073",53,73,2013,102157,94564,7593,7.4
"53073",53,73,2014,101316,94670,6646,6.6
"53073",53,73,2015,104285,98036,6249,6
"53073",53,73,2016,107124,100951,6173,5.8
"53073",53,73,2017,110074,104560,5514,5
"53075",53,75,1990,17524,17238,286,1.6
"53075",53,75,1991,17349,17028,321,1.9
"53075",53,75,1992,17272,16864,408,2.4
"53075",53,75,1993,17796,17383,413,2.3
"53075",53,75,1994,18111,17713,398,2.2
"53075",53,75,1995,18418,18004,414,2.2
"53075",53,75,1996,19202,18788,414,2.2
"53075",53,75,1997,19599,19253,346,1.8
"53075",53,75,1998,19901,19521,380,1.9
"53075",53,75,1999,19806,19441,365,1.8
"53075",53,75,2000,19280,18482,798,4.1
"53075",53,75,2001,18442,17587,855,4.6
"53075",53,75,2002,18992,18063,929,4.9
"53075",53,75,2003,19332,18377,955,4.9
"53075",53,75,2004,20107,19193,914,4.5
"53075",53,75,2005,20371,19453,918,4.5
"53075",53,75,2006,20338,19456,882,4.3
"53075",53,75,2007,20298,19433,865,4.3
"53075",53,75,2008,21253,20331,922,4.3
"53075",53,75,2009,21833,20585,1248,5.7
"53075",53,75,2010,22489,20977,1512,6.7
"53075",53,75,2011,22511,21051,1460,6.5
"53075",53,75,2012,22415,20940,1475,6.6
"53075",53,75,2013,22211,20876,1335,6
"53075",53,75,2014,22153,20998,1155,5.2
"53075",53,75,2015,22754,21641,1113,4.9
"53075",53,75,2016,23110,21965,1145,5
"53075",53,75,2017,23465,22426,1039,4.4
"53077",53,77,1990,103424,91722,11702,11.3
"53077",53,77,1991,102819,89532,13287,12.9
"53077",53,77,1992,108512,93722,14790,13.6
"53077",53,77,1993,111798,95791,16007,14.3
"53077",53,77,1994,113297,98734,14563,12.9
"53077",53,77,1995,115764,100368,15396,13.3
"53077",53,77,1996,116929,102121,14808,12.7
"53077",53,77,1997,117572,105991,11581,9.9
"53077",53,77,1998,119397,107422,11975,10
"53077",53,77,1999,116615,104823,11792,10.1
"53077",53,77,2000,113583,103976,9607,8.5
"53077",53,77,2001,109066,98190,10876,10
"53077",53,77,2002,111441,100568,10873,9.8
"53077",53,77,2003,113431,102478,10953,9.7
"53077",53,77,2004,116105,106008,10097,8.7
"53077",53,77,2005,117560,108427,9133,7.8
"53077",53,77,2006,118626,109807,8819,7.4
"53077",53,77,2007,120128,111716,8412,7
"53077",53,77,2008,123322,114285,9037,7.3
"53077",53,77,2009,126001,114665,11336,9
"53077",53,77,2010,122140,109168,12972,10.6
"53077",53,77,2011,120326,107392,12934,10.7
"53077",53,77,2012,121082,108267,12815,10.6
"53077",53,77,2013,119049,107154,11895,10
"53077",53,77,2014,119487,109113,10374,8.7
"53077",53,77,2015,121810,111910,9900,8.1
"53077",53,77,2016,125834,116419,9415,7.5
"53077",53,77,2017,126814,118212,8602,6.8
"54001",54,1,1990,6021,5261,760,12.6
"54001",54,1,1991,6263,5149,1114,17.8
"54001",54,1,1992,6205,5137,1068,17.2
"54001",54,1,1993,6259,5388,871,13.9
"54001",54,1,1994,6438,5696,742,11.5
"54001",54,1,1995,6361,5495,866,13.6
"54001",54,1,1996,6401,5536,865,13.5
"54001",54,1,1997,6179,5492,687,11.1
"54001",54,1,1998,6132,5420,712,11.6
"54001",54,1,1999,6109,5452,657,10.8
"54001",54,1,2000,6666,6138,528,7.9
"54001",54,1,2001,6755,6314,441,6.5
"54001",54,1,2002,6792,6298,494,7.3
"54001",54,1,2003,6670,6188,482,7.2
"54001",54,1,2004,6525,6105,420,6.4
"54001",54,1,2005,6549,6146,403,6.2
"54001",54,1,2006,6740,6353,387,5.7
"54001",54,1,2007,6733,6366,367,5.5
"54001",54,1,2008,6723,6394,329,4.9
"54001",54,1,2009,6876,6277,599,8.7
"54001",54,1,2010,6870,6180,690,10
"54001",54,1,2011,6777,6142,635,9.4
"54001",54,1,2012,6728,6168,560,8.3
"54001",54,1,2013,6708,6230,478,7.1
"54001",54,1,2014,6819,6359,460,6.7
"54001",54,1,2015,6883,6373,510,7.4
"54001",54,1,2016,6952,6479,473,6.8
"54001",54,1,2017,6927,6526,401,5.8
"54003",54,3,1990,29606,27715,1891,6.4
"54003",54,3,1991,30567,27571,2996,9.8
"54003",54,3,1992,30627,27700,2927,9.6
"54003",54,3,1993,30704,28246,2458,8
"54003",54,3,1994,30927,29031,1896,6.1
"54003",54,3,1995,31993,30094,1899,5.9
"54003",54,3,1996,32388,30640,1748,5.4
"54003",54,3,1997,33222,31712,1510,4.5
"54003",54,3,1998,34213,32890,1323,3.9
"54003",54,3,1999,35201,33939,1262,3.6
"54003",54,3,2000,39612,38182,1430,3.6
"54003",54,3,2001,40550,39014,1536,3.8
"54003",54,3,2002,40631,38721,1910,4.7
"54003",54,3,2003,40419,38540,1879,4.6
"54003",54,3,2004,41670,39878,1792,4.3
"54003",54,3,2005,43568,41847,1721,4
"54003",54,3,2006,45306,43394,1912,4.2
"54003",54,3,2007,45993,44102,1891,4.1
"54003",54,3,2008,46459,44256,2203,4.7
"54003",54,3,2009,46564,42615,3949,8.5
"54003",54,3,2010,51020,46642,4378,8.6
"54003",54,3,2011,51211,47258,3953,7.7
"54003",54,3,2012,52263,48774,3489,6.7
"54003",54,3,2013,52548,49590,2958,5.6
"54003",54,3,2014,52512,49628,2884,5.5
"54003",54,3,2015,53787,51146,2641,4.9
"54003",54,3,2016,54018,51881,2137,4
"54003",54,3,2017,54471,52462,2009,3.7
"54005",54,5,1990,8484,7688,796,9.4
"54005",54,5,1991,8883,7706,1177,13.3
"54005",54,5,1992,9219,7789,1430,15.5
"54005",54,5,1993,8616,7068,1548,18
"54005",54,5,1994,8362,7205,1157,13.8
"54005",54,5,1995,8421,7534,887,10.5
"54005",54,5,1996,8427,7603,824,9.8
"54005",54,5,1997,8282,7547,735,8.9
"54005",54,5,1998,8127,7303,824,10.1
"54005",54,5,1999,8034,7157,877,10.9
"54005",54,5,2000,9810,9146,664,6.8
"54005",54,5,2001,9712,9215,497,5.1
"54005",54,5,2002,9796,9051,745,7.6
"54005",54,5,2003,9406,8815,591,6.3
"54005",54,5,2004,9288,8825,463,5
"54005",54,5,2005,9294,8865,429,4.6
"54005",54,5,2006,9422,8976,446,4.7
"54005",54,5,2007,9453,9007,446,4.7
"54005",54,5,2008,9422,9054,368,3.9
"54005",54,5,2009,9381,8653,728,7.8
"54005",54,5,2010,8812,8035,777,8.8
"54005",54,5,2011,8680,7980,700,8.1
"54005",54,5,2012,8921,7994,927,10.4
"54005",54,5,2013,8653,7826,827,9.6
"54005",54,5,2014,8420,7637,783,9.3
"54005",54,5,2015,8166,7371,795,9.7
"54005",54,5,2016,7978,7252,726,9.1
"54005",54,5,2017,7692,7209,483,6.3
"54007",54,7,1990,4989,4320,669,13.4
"54007",54,7,1991,5126,4027,1099,21.4
"54007",54,7,1992,5119,4062,1057,20.6
"54007",54,7,1993,4899,4078,821,16.8
"54007",54,7,1994,4910,4143,767,15.6
"54007",54,7,1995,5187,4493,694,13.4
"54007",54,7,1996,5447,4798,649,11.9
"54007",54,7,1997,5163,4588,575,11.1
"54007",54,7,1998,5172,4616,556,10.8
"54007",54,7,1999,5274,4716,558,10.6
"54007",54,7,2000,5853,5423,430,7.3
"54007",54,7,2001,5779,5412,367,6.4
"54007",54,7,2002,5917,5467,450,7.6
"54007",54,7,2003,5937,5495,442,7.4
"54007",54,7,2004,5834,5487,347,5.9
"54007",54,7,2005,5863,5512,351,6
"54007",54,7,2006,5954,5625,329,5.5
"54007",54,7,2007,6019,5689,330,5.5
"54007",54,7,2008,5918,5613,305,5.2
"54007",54,7,2009,5945,5455,490,8.2
"54007",54,7,2010,5686,5056,630,11.1
"54007",54,7,2011,5497,4885,612,11.1
"54007",54,7,2012,5411,4826,585,10.8
"54007",54,7,2013,5331,4783,548,10.3
"54007",54,7,2014,5224,4729,495,9.5
"54007",54,7,2015,5449,4962,487,8.9
"54007",54,7,2016,5485,5004,481,8.8
"54007",54,7,2017,5366,4971,395,7.4
"54009",54,9,1990,11975,11220,755,6.3
"54009",54,9,1991,11984,10858,1126,9.4
"54009",54,9,1992,11883,10491,1392,11.7
"54009",54,9,1993,11529,10406,1123,9.7
"54009",54,9,1994,11524,10545,979,8.5
"54009",54,9,1995,11332,10640,692,6.1
"54009",54,9,1996,11302,10623,679,6
"54009",54,9,1997,11206,10309,897,8
"54009",54,9,1998,11391,10737,654,5.7
"54009",54,9,1999,11386,10692,694,6.1
"54009",54,9,2000,11811,11267,544,4.6
"54009",54,9,2001,11716,11146,570,4.9
"54009",54,9,2002,11494,10813,681,5.9
"54009",54,9,2003,11317,10601,716,6.3
"54009",54,9,2004,11163,10339,824,7.4
"54009",54,9,2005,11095,10286,809,7.3
"54009",54,9,2006,10974,10162,812,7.4
"54009",54,9,2007,10948,10298,650,5.9
"54009",54,9,2008,11143,10506,637,5.7
"54009",54,9,2009,11132,9907,1225,11
"54009",54,9,2010,10917,9672,1245,11.4
"54009",54,9,2011,10713,9667,1046,9.8
"54009",54,9,2012,10649,9718,931,8.7
"54009",54,9,2013,10372,9572,800,7.7
"54009",54,9,2014,10101,9366,735,7.3
"54009",54,9,2015,10064,9325,739,7.3
"54009",54,9,2016,9967,9265,702,7
"54009",54,9,2017,9850,9252,598,6.1
"54011",54,11,1990,43004,40173,2831,6.6
"54011",54,11,1991,43606,39612,3994,9.2
"54011",54,11,1992,43548,39345,4203,9.7
"54011",54,11,1993,42633,39051,3582,8.4
"54011",54,11,1994,42792,39449,3343,7.8
"54011",54,11,1995,42446,39987,2459,5.8
"54011",54,11,1996,43161,40499,2662,6.2
"54011",54,11,1997,42933,40521,2412,5.6
"54011",54,11,1998,42379,40187,2192,5.2
"54011",54,11,1999,42798,40636,2162,5.1
"54011",54,11,2000,44806,42660,2146,4.8
"54011",54,11,2001,44477,42366,2111,4.7
"54011",54,11,2002,44051,41730,2321,5.3
"54011",54,11,2003,44073,41860,2213,5
"54011",54,11,2004,43994,41900,2094,4.8
"54011",54,11,2005,44041,42054,1987,4.5
"54011",54,11,2006,44611,42568,2043,4.6
"54011",54,11,2007,45655,43794,1861,4.1
"54011",54,11,2008,45433,43680,1753,3.9
"54011",54,11,2009,44709,41714,2995,6.7
"54011",54,11,2010,43292,40164,3128,7.2
"54011",54,11,2011,42919,39853,3066,7.1
"54011",54,11,2012,43037,40228,2809,6.5
"54011",54,11,2013,42399,39956,2443,5.8
"54011",54,11,2014,42108,39789,2319,5.5
"54011",54,11,2015,41187,38945,2242,5.4
"54011",54,11,2016,41161,39183,1978,4.8
"54011",54,11,2017,41479,39599,1880,4.5
"54013",54,13,1990,3038,2527,511,16.8
"54013",54,13,1991,3051,2419,632,20.7
"54013",54,13,1992,3096,2467,629,20.3
"54013",54,13,1993,3047,2453,594,19.5
"54013",54,13,1994,2952,2302,650,22
"54013",54,13,1995,2749,2114,635,23.1
"54013",54,13,1996,2614,2111,503,19.2
"54013",54,13,1997,2507,2068,439,17.5
"54013",54,13,1998,2539,2138,401,15.8
"54013",54,13,1999,2637,2178,459,17.4
"54013",54,13,2000,2935,2632,303,10.3
"54013",54,13,2001,2884,2593,291,10.1
"54013",54,13,2002,2909,2591,318,10.9
"54013",54,13,2003,2906,2572,334,11.5
"54013",54,13,2004,2806,2546,260,9.3
"54013",54,13,2005,2675,2445,230,8.6
"54013",54,13,2006,2718,2521,197,7.2
"54013",54,13,2007,2754,2560,194,7
"54013",54,13,2008,2790,2599,191,6.8
"54013",54,13,2009,2849,2485,364,12.8
"54013",54,13,2010,2906,2499,407,14
"54013",54,13,2011,2867,2504,363,12.7
"54013",54,13,2012,2843,2527,316,11.1
"54013",54,13,2013,2880,2588,292,10.1
"54013",54,13,2014,2902,2619,283,9.8
"54013",54,13,2015,2756,2412,344,12.5
"54013",54,13,2016,2618,2282,336,12.8
"54013",54,13,2017,2478,2219,259,10.5
"54015",54,15,1990,2938,2461,477,16.2
"54015",54,15,1991,3066,2474,592,19.3
"54015",54,15,1992,3115,2518,597,19.2
"54015",54,15,1993,3168,2603,565,17.8
"54015",54,15,1994,3339,2824,515,15.4
"54015",54,15,1995,3462,2976,486,14
"54015",54,15,1996,3718,3219,499,13.4
"54015",54,15,1997,4008,3525,483,12.1
"54015",54,15,1998,4071,3625,446,11
"54015",54,15,1999,4233,3777,456,10.8
"54015",54,15,2000,3643,3335,308,8.5
"54015",54,15,2001,3606,3348,258,7.2
"54015",54,15,2002,3674,3300,374,10.2
"54015",54,15,2003,3511,3188,323,9.2
"54015",54,15,2004,3489,3228,261,7.5
"54015",54,15,2005,3484,3213,271,7.8
"54015",54,15,2006,3487,3247,240,6.9
"54015",54,15,2007,3500,3255,245,7
"54015",54,15,2008,3506,3286,220,6.3
"54015",54,15,2009,3556,3159,397,11.2
"54015",54,15,2010,3647,3131,516,14.1
"54015",54,15,2011,3573,3132,441,12.3
"54015",54,15,2012,3530,3105,425,12
"54015",54,15,2013,3481,3063,418,12
"54015",54,15,2014,3317,2955,362,10.9
"54015",54,15,2015,3264,2899,365,11.2
"54015",54,15,2016,3254,2917,337,10.4
"54015",54,15,2017,3175,2903,272,8.6
"54017",54,17,1990,2718,2514,204,7.5
"54017",54,17,1991,2768,2567,201,7.3
"54017",54,17,1992,2851,2566,285,10
"54017",54,17,1993,2909,2608,301,10.3
"54017",54,17,1994,3000,2732,268,8.9
"54017",54,17,1995,3025,2774,251,8.3
"54017",54,17,1996,3098,2869,229,7.4
"54017",54,17,1997,3257,3054,203,6.2
"54017",54,17,1998,3331,3073,258,7.7
"54017",54,17,1999,3286,3093,193,5.9
"54017",54,17,2000,2910,2740,170,5.8
"54017",54,17,2001,2928,2770,158,5.4
"54017",54,17,2002,2917,2724,193,6.6
"54017",54,17,2003,2874,2704,170,5.9
"54017",54,17,2004,2812,2672,140,5
"54017",54,17,2005,2858,2720,138,4.8
"54017",54,17,2006,2882,2731,151,5.2
"54017",54,17,2007,2823,2685,138,4.9
"54017",54,17,2008,2816,2677,139,4.9
"54017",54,17,2009,2860,2638,222,7.8
"54017",54,17,2010,3315,3078,237,7.1
"54017",54,17,2011,3325,3088,237,7.1
"54017",54,17,2012,3405,3190,215,6.3
"54017",54,17,2013,3517,3329,188,5.3
"54017",54,17,2014,3632,3450,182,5
"54017",54,17,2015,3634,3433,201,5.5
"54017",54,17,2016,3776,3581,195,5.2
"54017",54,17,2017,3894,3732,162,4.2
"54019",54,19,1990,16857,14967,1890,11.2
"54019",54,19,1991,17244,14870,2374,13.8
"54019",54,19,1992,17271,14739,2532,14.7
"54019",54,19,1993,17590,15110,2480,14.1
"54019",54,19,1994,17760,15518,2242,12.6
"54019",54,19,1995,17868,15944,1924,10.8
"54019",54,19,1996,18239,16482,1757,9.6
"54019",54,19,1997,18038,16376,1662,9.2
"54019",54,19,1998,17755,16119,1636,9.2
"54019",54,19,1999,17412,15662,1750,10.1
"54019",54,19,2000,18508,17188,1320,7.1
"54019",54,19,2001,18459,17330,1129,6.1
"54019",54,19,2002,18452,17102,1350,7.3
"54019",54,19,2003,17819,16508,1311,7.4
"54019",54,19,2004,17668,16582,1086,6.1
"54019",54,19,2005,17747,16717,1030,5.8
"54019",54,19,2006,18034,17016,1018,5.6
"54019",54,19,2007,18141,17154,987,5.4
"54019",54,19,2008,18124,17284,840,4.6
"54019",54,19,2009,18118,16590,1528,8.4
"54019",54,19,2010,17567,15817,1750,10
"54019",54,19,2011,17734,16146,1588,9
"54019",54,19,2012,17576,16054,1522,8.7
"54019",54,19,2013,16983,15521,1462,8.6
"54019",54,19,2014,16596,15206,1390,8.4
"54019",54,19,2015,16240,14844,1396,8.6
"54019",54,19,2016,15952,14688,1264,7.9
"54019",54,19,2017,15757,14750,1007,6.4
"54021",54,21,1990,2798,2492,306,10.9
"54021",54,21,1991,2837,2492,345,12.2
"54021",54,21,1992,2810,2449,361,12.8
"54021",54,21,1993,2804,2501,303,10.8
"54021",54,21,1994,2830,2567,263,9.3
"54021",54,21,1995,2672,2385,287,10.7
"54021",54,21,1996,2798,2543,255,9.1
"54021",54,21,1997,2690,2494,196,7.3
"54021",54,21,1998,2737,2524,213,7.8
"54021",54,21,1999,2653,2403,250,9.4
"54021",54,21,2000,2785,2583,202,7.3
"54021",54,21,2001,2932,2773,159,5.4
"54021",54,21,2002,2950,2748,202,6.8
"54021",54,21,2003,2992,2802,190,6.4
"54021",54,21,2004,2974,2833,141,4.7
"54021",54,21,2005,3048,2906,142,4.7
"54021",54,21,2006,3107,2961,146,4.7
"54021",54,21,2007,3106,2980,126,4.1
"54021",54,21,2008,3135,3016,119,3.8
"54021",54,21,2009,3218,3006,212,6.6
"54021",54,21,2010,2775,2528,247,8.9
"54021",54,21,2011,2815,2586,229,8.1
"54021",54,21,2012,2771,2555,216,7.8
"54021",54,21,2013,2751,2568,183,6.7
"54021",54,21,2014,2741,2562,179,6.5
"54021",54,21,2015,2699,2488,211,7.8
"54021",54,21,2016,2536,2327,209,8.2
"54021",54,21,2017,2435,2261,174,7.1
"54023",54,23,1990,5388,5012,376,7
"54023",54,23,1991,5418,4889,529,9.8
"54023",54,23,1992,5288,4743,545,10.3
"54023",54,23,1993,5013,4545,468,9.3
"54023",54,23,1994,4843,4318,525,10.8
"54023",54,23,1995,4841,4344,497,10.3
"54023",54,23,1996,4805,4299,506,10.5
"54023",54,23,1997,4778,4267,511,10.7
"54023",54,23,1998,4515,4076,439,9.7
"54023",54,23,1999,4433,4061,372,8.4
"54023",54,23,2000,5474,5183,291,5.3
"54023",54,23,2001,5736,5486,250,4.4
"54023",54,23,2002,5390,5046,344,6.4
"54023",54,23,2003,5233,4836,397,7.6
"54023",54,23,2004,4871,4545,326,6.7
"54023",54,23,2005,4935,4624,311,6.3
"54023",54,23,2006,5131,4822,309,6
"54023",54,23,2007,5310,5032,278,5.2
"54023",54,23,2008,5252,4975,277,5.3
"54023",54,23,2009,5092,4586,506,9.9
"54023",54,23,2010,6124,5525,599,9.8
"54023",54,23,2011,6190,5634,556,9
"54023",54,23,2012,6171,5627,544,8.8
"54023",54,23,2013,5995,5505,490,8.2
"54023",54,23,2014,5807,5359,448,7.7
"54023",54,23,2015,5751,5314,437,7.6
"54023",54,23,2016,5949,5595,354,6
"54023",54,23,2017,5873,5543,330,5.6
"54025",54,25,1990,15525,13661,1864,12
"54025",54,25,1991,15553,13356,2197,14.1
"54025",54,25,1992,15069,13210,1859,12.3
"54025",54,25,1993,15353,13268,2085,13.6
"54025",54,25,1994,15692,13291,2401,15.3
"54025",54,25,1995,15140,13619,1521,10
"54025",54,25,1996,15098,13801,1297,8.6
"54025",54,25,1997,15277,14029,1248,8.2
"54025",54,25,1998,14913,13737,1176,7.9
"54025",54,25,1999,15515,14267,1248,8
"54025",54,25,2000,15129,14137,992,6.6
"54025",54,25,2001,15149,14276,873,5.8
"54025",54,25,2002,15122,14114,1008,6.7
"54025",54,25,2003,14937,13990,947,6.3
"54025",54,25,2004,14877,14016,861,5.8
"54025",54,25,2005,15042,14121,921,6.1
"54025",54,25,2006,15628,14663,965,6.2
"54025",54,25,2007,15614,14669,945,6.1
"54025",54,25,2008,15088,14254,834,5.5
"54025",54,25,2009,14851,13467,1384,9.3
"54025",54,25,2010,15430,14080,1350,8.7
"54025",54,25,2011,15567,14268,1299,8.3
"54025",54,25,2012,15490,14254,1236,8
"54025",54,25,2013,15465,14314,1151,7.4
"54025",54,25,2014,15127,14080,1047,6.9
"54025",54,25,2015,15324,14318,1006,6.6
"54025",54,25,2016,15665,14820,845,5.4
"54025",54,25,2017,15723,14963,760,4.8
"54027",54,27,1990,7460,6768,692,9.3
"54027",54,27,1991,7691,6731,960,12.5
"54027",54,27,1992,7601,6786,815,10.7
"54027",54,27,1993,7631,6962,669,8.8
"54027",54,27,1994,7540,7198,342,4.5
"54027",54,27,1995,7669,7359,310,4
"54027",54,27,1996,8073,7699,374,4.6
"54027",54,27,1997,8413,7930,483,5.7
"54027",54,27,1998,8742,8214,528,6
"54027",54,27,1999,8724,8310,414,4.7
"54027",54,27,2000,9351,9046,305,3.3
"54027",54,27,2001,9331,8989,342,3.7
"54027",54,27,2002,9110,8682,428,4.7
"54027",54,27,2003,9154,8690,464,5.1
"54027",54,27,2004,9274,8846,428,4.6
"54027",54,27,2005,9403,9013,390,4.1
"54027",54,27,2006,9817,9427,390,4
"54027",54,27,2007,9693,9343,350,3.6
"54027",54,27,2008,9456,9050,406,4.3
"54027",54,27,2009,9290,8532,758,8.2
"54027",54,27,2010,9765,8877,888,9.1
"54027",54,27,2011,9800,8934,866,8.8
"54027",54,27,2012,9736,8963,773,7.9
"54027",54,27,2013,9572,8901,671,7
"54027",54,27,2014,9407,8809,598,6.4
"54027",54,27,2015,9603,9064,539,5.6
"54027",54,27,2016,9883,9453,430,4.4
"54027",54,27,2017,10144,9745,399,3.9
"54029",54,29,1990,15799,14902,897,5.7
"54029",54,29,1991,15903,14513,1390,8.7
"54029",54,29,1992,15744,14041,1703,10.8
"54029",54,29,1993,15199,13809,1390,9.1
"54029",54,29,1994,15277,13968,1309,8.6
"54029",54,29,1995,14959,14043,916,6.1
"54029",54,29,1996,15157,14182,975,6.4
"54029",54,29,1997,14783,13745,1038,7
"54029",54,29,1998,15118,14285,833,5.5
"54029",54,29,1999,15115,14181,934,6.2
"54029",54,29,2000,15702,14983,719,4.6
"54029",54,29,2001,15448,14781,667,4.3
"54029",54,29,2002,15119,14316,803,5.3
"54029",54,29,2003,14819,13945,874,5.9
"54029",54,29,2004,14705,13586,1119,7.6
"54029",54,29,2005,14695,13604,1091,7.4
"54029",54,29,2006,14572,13462,1110,7.6
"54029",54,29,2007,14419,13589,830,5.8
"54029",54,29,2008,14723,13863,860,5.8
"54029",54,29,2009,14598,12957,1641,11.2
"54029",54,29,2010,14174,12456,1718,12.1
"54029",54,29,2011,13894,12420,1474,10.6
"54029",54,29,2012,13753,12476,1277,9.3
"54029",54,29,2013,13397,12309,1088,8.1
"54029",54,29,2014,13127,12071,1056,8
"54029",54,29,2015,12965,11953,1012,7.8
"54029",54,29,2016,12841,11942,899,7
"54029",54,29,2017,12687,11914,773,6.1
"54031",54,31,1990,5406,5099,307,5.7
"54031",54,31,1991,5367,4906,461,8.6
"54031",54,31,1992,5577,5199,378,6.8
"54031",54,31,1993,6497,6184,313,4.8
"54031",54,31,1994,6736,6425,311,4.6
"54031",54,31,1995,6864,6561,303,4.4
"54031",54,31,1996,6843,6564,279,4.1
"54031",54,31,1997,6893,6620,273,4
"54031",54,31,1998,6880,6591,289,4.2
"54031",54,31,1999,7293,7011,282,3.9
"54031",54,31,2000,6685,6429,256,3.8
"54031",54,31,2001,6859,6610,249,3.6
"54031",54,31,2002,6974,6687,287,4.1
"54031",54,31,2003,6938,6627,311,4.5
"54031",54,31,2004,6817,6542,275,4
"54031",54,31,2005,6982,6715,267,3.8
"54031",54,31,2006,7266,6980,286,3.9
"54031",54,31,2007,7222,6918,304,4.2
"54031",54,31,2008,6873,6559,314,4.6
"54031",54,31,2009,6750,6147,603,8.9
"54031",54,31,2010,5710,5048,662,11.6
"54031",54,31,2011,5693,5095,598,10.5
"54031",54,31,2012,5570,4979,591,10.6
"54031",54,31,2013,5452,4935,517,9.5
"54031",54,31,2014,5348,4895,453,8.5
"54031",54,31,2015,5456,5048,408,7.5
"54031",54,31,2016,5710,5385,325,5.7
"54031",54,31,2017,5828,5539,289,5
"54033",54,33,1990,29891,27301,2590,8.7
"54033",54,33,1991,30875,27649,3226,10.4
"54033",54,33,1992,31253,27758,3495,11.2
"54033",54,33,1993,31157,27936,3221,10.3
"54033",54,33,1994,31910,29255,2655,8.3
"54033",54,33,1995,32262,29480,2782,8.6
"54033",54,33,1996,33492,30822,2670,8
"54033",54,33,1997,34421,31946,2475,7.2
"54033",54,33,1998,34298,31857,2441,7.1
"54033",54,33,1999,34433,32086,2347,6.8
"54033",54,33,2000,31348,29545,1803,5.8
"54033",54,33,2001,31082,29474,1608,5.2
"54033",54,33,2002,30788,28971,1817,5.9
"54033",54,33,2003,30493,28696,1797,5.9
"54033",54,33,2004,30368,28762,1606,5.3
"54033",54,33,2005,30438,28999,1439,4.7
"54033",54,33,2006,30786,29338,1448,4.7
"54033",54,33,2007,30762,29452,1310,4.3
"54033",54,33,2008,31062,29847,1215,3.9
"54033",54,33,2009,31478,29434,2044,6.5
"54033",54,33,2010,31254,28872,2382,7.6
"54033",54,33,2011,31381,29143,2238,7.1
"54033",54,33,2012,31407,29358,2049,6.5
"54033",54,33,2013,31778,30013,1765,5.6
"54033",54,33,2014,31780,30068,1712,5.4
"54033",54,33,2015,31771,29765,2006,6.3
"54033",54,33,2016,32307,30421,1886,5.8
"54033",54,33,2017,32872,31278,1594,4.8
"54035",54,35,1990,11350,10301,1049,9.2
"54035",54,35,1991,13004,11733,1271,9.8
"54035",54,35,1992,12797,11206,1591,12.4
"54035",54,35,1993,11977,10437,1540,12.9
"54035",54,35,1994,12268,11181,1087,8.9
"54035",54,35,1995,12577,11558,1019,8.1
"54035",54,35,1996,12602,11644,958,7.6
"54035",54,35,1997,12710,11843,867,6.8
"54035",54,35,1998,12918,12000,918,7.1
"54035",54,35,1999,12723,11786,937,7.4
"54035",54,35,2000,12733,11981,752,5.9
"54035",54,35,2001,12649,11970,679,5.4
"54035",54,35,2002,12253,11463,790,6.4
"54035",54,35,2003,11776,10811,965,8.2
"54035",54,35,2004,11585,10861,724,6.2
"54035",54,35,2005,11587,10902,685,5.9
"54035",54,35,2006,11824,11204,620,5.2
"54035",54,35,2007,12055,11470,585,4.9
"54035",54,35,2008,11979,11373,606,5.1
"54035",54,35,2009,11722,10391,1331,11.4
"54035",54,35,2010,12313,10911,1402,11.4
"54035",54,35,2011,12018,10783,1235,10.3
"54035",54,35,2012,12015,10988,1027,8.5
"54035",54,35,2013,12024,11197,827,6.9
"54035",54,35,2014,11826,11036,790,6.7
"54035",54,35,2015,11882,11024,858,7.2
"54035",54,35,2016,11990,11213,777,6.5
"54035",54,35,2017,11930,11247,683,5.7
"54037",54,37,1990,18803,17742,1061,5.6
"54037",54,37,1991,19352,17442,1910,9.9
"54037",54,37,1992,19372,17501,1871,9.7
"54037",54,37,1993,19012,17861,1151,6.1
"54037",54,37,1994,19270,18340,930,4.8
"54037",54,37,1995,19706,18851,855,4.3
"54037",54,37,1996,19836,19030,806,4.1
"54037",54,37,1997,20280,19562,718,3.5
"54037",54,37,1998,20984,20332,652,3.1
"54037",54,37,1999,21467,20864,603,2.8
"54037",54,37,2000,23354,22566,788,3.4
"54037",54,37,2001,23304,22556,748,3.2
"54037",54,37,2002,23249,22338,911,3.9
"54037",54,37,2003,23149,22278,871,3.8
"54037",54,37,2004,23523,22729,794,3.4
"54037",54,37,2005,24044,23247,797,3.3
"54037",54,37,2006,24802,23959,843,3.4
"54037",54,37,2007,25251,24439,812,3.2
"54037",54,37,2008,24918,23971,947,3.8
"54037",54,37,2009,24647,23019,1628,6.6
"54037",54,37,2010,26869,25077,1792,6.7
"54037",54,37,2011,27221,25523,1698,6.2
"54037",54,37,2012,27507,26019,1488,5.4
"54037",54,37,2013,27404,26092,1312,4.8
"54037",54,37,2014,26881,25626,1255,4.7
"54037",54,37,2015,27688,26548,1140,4.1
"54037",54,37,2016,28521,27562,959,3.4
"54037",54,37,2017,28661,27759,902,3.1
"54039",54,39,1990,96595,90577,6018,6.2
"54039",54,39,1991,98410,90755,7655,7.8
"54039",54,39,1992,99203,90595,8608,8.7
"54039",54,39,1993,101385,93293,8092,8
"54039",54,39,1994,101919,95243,6676,6.6
"54039",54,39,1995,102042,96207,5835,5.7
"54039",54,39,1996,103637,98002,5635,5.4
"54039",54,39,1997,104121,99047,5074,4.9
"54039",54,39,1998,103977,99109,4868,4.7
"54039",54,39,1999,105902,101002,4900,4.6
"54039",54,39,2000,97313,92508,4805,4.9
"54039",54,39,2001,96760,92351,4409,4.6
"54039",54,39,2002,94366,89369,4997,5.3
"54039",54,39,2003,91509,86590,4919,5.4
"54039",54,39,2004,90926,86585,4341,4.8
"54039",54,39,2005,90679,86270,4409,4.9
"54039",54,39,2006,91497,87484,4013,4.4
"54039",54,39,2007,92044,88360,3684,4
"54039",54,39,2008,92747,89483,3264,3.5
"54039",54,39,2009,92520,86739,5781,6.2
"54039",54,39,2010,92603,85765,6838,7.4
"54039",54,39,2011,91673,85161,6512,7.1
"54039",54,39,2012,91341,85308,6033,6.6
"54039",54,39,2013,89397,84118,5279,5.9
"54039",54,39,2014,88618,83393,5225,5.9
"54039",54,39,2015,86005,80842,5163,6
"54039",54,39,2016,85190,80542,4648,5.5
"54039",54,39,2017,84245,80029,4216,5
"54041",54,41,1990,7132,6349,783,11
"54041",54,41,1991,7432,6470,962,12.9
"54041",54,41,1992,7330,6349,981,13.4
"54041",54,41,1993,7281,6338,943,13
"54041",54,41,1994,7088,6249,839,11.8
"54041",54,41,1995,7108,6288,820,11.5
"54041",54,41,1996,7094,6409,685,9.7
"54041",54,41,1997,7058,6432,626,8.9
"54041",54,41,1998,6921,6340,581,8.4
"54041",54,41,1999,7116,6543,573,8.1
"54041",54,41,2000,7465,7030,435,5.8
"54041",54,41,2001,7417,7017,400,5.4
"54041",54,41,2002,7363,6874,489,6.6
"54041",54,41,2003,7206,6693,513,7.1
"54041",54,41,2004,7137,6759,378,5.3
"54041",54,41,2005,7238,6876,362,5
"54041",54,41,2006,7362,6983,379,5.1
"54041",54,41,2007,7374,6997,377,5.1
"54041",54,41,2008,7453,7141,312,4.2
"54041",54,41,2009,7707,7143,564,7.3
"54041",54,41,2010,6990,6376,614,8.8
"54041",54,41,2011,7171,6636,535,7.5
"54041",54,41,2012,7381,6861,520,7
"54041",54,41,2013,7359,6887,472,6.4
"54041",54,41,2014,7173,6717,456,6.4
"54041",54,41,2015,6962,6387,575,8.3
"54041",54,41,2016,6820,6240,580,8.5
"54041",54,41,2017,6508,6078,430,6.6
"54043",54,43,1990,6990,6000,990,14.2
"54043",54,43,1991,7105,5923,1182,16.6
"54043",54,43,1992,7273,6092,1181,16.2
"54043",54,43,1993,7081,6011,1070,15.1
"54043",54,43,1994,7143,6200,943,13.2
"54043",54,43,1995,6934,6028,906,13.1
"54043",54,43,1996,7133,6257,876,12.3
"54043",54,43,1997,6934,6161,773,11.1
"54043",54,43,1998,6907,6121,786,11.4
"54043",54,43,1999,6982,6171,811,11.6
"54043",54,43,2000,8136,7540,596,7.3
"54043",54,43,2001,8156,7618,538,6.6
"54043",54,43,2002,8155,7482,673,8.3
"54043",54,43,2003,7878,7285,593,7.5
"54043",54,43,2004,7810,7321,489,6.3
"54043",54,43,2005,7837,7334,503,6.4
"54043",54,43,2006,7961,7475,486,6.1
"54043",54,43,2007,8018,7582,436,5.4
"54043",54,43,2008,8092,7713,379,4.7
"54043",54,43,2009,8158,7371,787,9.6
"54043",54,43,2010,7873,6948,925,11.7
"54043",54,43,2011,7678,6860,818,10.7
"54043",54,43,2012,7706,6910,796,10.3
"54043",54,43,2013,7548,6823,725,9.6
"54043",54,43,2014,7519,6796,723,9.6
"54043",54,43,2015,7338,6622,716,9.8
"54043",54,43,2016,7280,6659,621,8.5
"54043",54,43,2017,7214,6723,491,6.8
"54045",54,45,1990,14395,12764,1631,11.3
"54045",54,45,1991,14625,12748,1877,12.8
"54045",54,45,1992,14763,12719,2044,13.8
"54045",54,45,1993,15043,12686,2357,15.7
"54045",54,45,1994,14671,12690,1981,13.5
"54045",54,45,1995,14473,12706,1767,12.2
"54045",54,45,1996,14074,12533,1541,10.9
"54045",54,45,1997,14003,12681,1322,9.4
"54045",54,45,1998,14042,12513,1529,10.9
"54045",54,45,1999,13181,11600,1581,12
"54045",54,45,2000,13734,12704,1030,7.5
"54045",54,45,2001,13601,12838,763,5.6
"54045",54,45,2002,13299,12305,994,7.5
"54045",54,45,2003,12772,11819,953,7.5
"54045",54,45,2004,12681,11974,707,5.6
"54045",54,45,2005,12708,12082,626,4.9
"54045",54,45,2006,12894,12265,629,4.9
"54045",54,45,2007,12888,12212,676,5.2
"54045",54,45,2008,13186,12638,548,4.2
"54045",54,45,2009,13388,12308,1080,8.1
"54045",54,45,2010,12687,11404,1283,10.1
"54045",54,45,2011,12913,11764,1149,8.9
"54045",54,45,2012,12904,11646,1258,9.7
"54045",54,45,2013,12378,11163,1215,9.8
"54045",54,45,2014,11891,10636,1255,10.6
"54045",54,45,2015,11469,10181,1288,11.2
"54045",54,45,2016,11143,10007,1136,10.2
"54045",54,45,2017,10757,9950,807,7.5
"54047",54,47,1990,8831,7671,1160,13.1
"54047",54,47,1991,8982,7358,1624,18.1
"54047",54,47,1992,8732,7334,1398,16
"54047",54,47,1993,8433,7199,1234,14.6
"54047",54,47,1994,8208,7070,1138,13.9
"54047",54,47,1995,8122,7110,1012,12.5
"54047",54,47,1996,8075,7048,1027,12.7
"54047",54,47,1997,7627,6810,817,10.7
"54047",54,47,1998,7452,6579,873,11.7
"54047",54,47,1999,7469,6410,1059,14.2
"54047",54,47,2000,7091,6361,730,10.3
"54047",54,47,2001,7036,6490,546,7.8
"54047",54,47,2002,7018,6335,683,9.7
"54047",54,47,2003,6804,6003,801,11.8
"54047",54,47,2004,6406,5777,629,9.8
"54047",54,47,2005,6384,5856,528,8.3
"54047",54,47,2006,6948,6413,535,7.7
"54047",54,47,2007,6944,6429,515,7.4
"54047",54,47,2008,7193,6768,425,5.9
"54047",54,47,2009,7463,6603,860,11.5
"54047",54,47,2010,6362,5521,841,13.2
"54047",54,47,2011,6671,5875,796,11.9
"54047",54,47,2012,6599,5802,797,12.1
"54047",54,47,2013,6192,5406,786,12.7
"54047",54,47,2014,5771,5014,757,13.1
"54047",54,47,2015,5331,4650,681,12.8
"54047",54,47,2016,5077,4460,617,12.2
"54047",54,47,2017,4997,4574,423,8.5
"54049",54,49,1990,23873,21744,2129,8.9
"54049",54,49,1991,24038,21447,2591,10.8
"54049",54,49,1992,24695,21030,3665,14.8
"54049",54,49,1993,24281,20400,3881,16
"54049",54,49,1994,23924,21269,2655,11.1
"54049",54,49,1995,24174,22048,2126,8.8
"54049",54,49,1996,24348,21765,2583,10.6
"54049",54,49,1997,24246,21924,2322,9.6
"54049",54,49,1998,23610,21760,1850,7.8
"54049",54,49,1999,24033,22156,1877,7.8
"54049",54,49,2000,26009,24504,1505,5.8
"54049",54,49,2001,26328,25007,1321,5
"54049",54,49,2002,25596,24051,1545,6
"54049",54,49,2003,25128,23688,1440,5.7
"54049",54,49,2004,25097,23850,1247,5
"54049",54,49,2005,25772,24595,1177,4.6
"54049",54,49,2006,26160,24990,1170,4.5
"54049",54,49,2007,26269,25156,1113,4.2
"54049",54,49,2008,26484,25534,950,3.6
"54049",54,49,2009,26502,24936,1566,5.9
"54049",54,49,2010,26641,24703,1938,7.3
"54049",54,49,2011,26740,24902,1838,6.9
"54049",54,49,2012,26833,25103,1730,6.4
"54049",54,49,2013,26745,25157,1588,5.9
"54049",54,49,2014,26419,24833,1586,6
"54049",54,49,2015,25958,24174,1784,6.9
"54049",54,49,2016,25640,23963,1677,6.5
"54049",54,49,2017,25559,24226,1333,5.2
"54051",54,51,1990,16057,14860,1197,7.5
"54051",54,51,1991,16430,14720,1710,10.4
"54051",54,51,1992,16318,14345,1973,12.1
"54051",54,51,1993,16529,14546,1983,12
"54051",54,51,1994,16274,14792,1482,9.1
"54051",54,51,1995,16041,14824,1217,7.6
"54051",54,51,1996,16083,15025,1058,6.6
"54051",54,51,1997,16341,15145,1196,7.3
"54051",54,51,1998,15916,14941,975,6.1
"54051",54,51,1999,16124,15116,1008,6.3
"54051",54,51,2000,15896,14986,910,5.7
"54051",54,51,2001,15846,14922,924,5.8
"54051",54,51,2002,15397,14370,1027,6.7
"54051",54,51,2003,14903,13938,965,6.5
"54051",54,51,2004,14938,14026,912,6.1
"54051",54,51,2005,15048,14174,874,5.8
"54051",54,51,2006,15014,14155,859,5.7
"54051",54,51,2007,14867,14081,786,5.3
"54051",54,51,2008,14818,14061,757,5.1
"54051",54,51,2009,14905,13600,1305,8.8
"54051",54,51,2010,14680,13261,1419,9.7
"54051",54,51,2011,14338,13056,1282,8.9
"54051",54,51,2012,14325,13170,1155,8.1
"54051",54,51,2013,14300,13257,1043,7.3
"54051",54,51,2014,14241,13150,1091,7.7
"54051",54,51,2015,14018,12829,1189,8.5
"54051",54,51,2016,14048,12929,1119,8
"54051",54,51,2017,13841,13009,832,6
"54053",54,53,1990,10027,9122,905,9
"54053",54,53,1991,10035,8651,1384,13.8
"54053",54,53,1992,10125,8472,1653,16.3
"54053",54,53,1993,9693,8238,1455,15
"54053",54,53,1994,9586,8486,1100,11.5
"54053",54,53,1995,9774,8644,1130,11.6
"54053",54,53,1996,9489,8424,1065,11.2
"54053",54,53,1997,9104,8082,1022,11.2
"54053",54,53,1998,8942,7851,1091,12.2
"54053",54,53,1999,9026,7854,1172,13
"54053",54,53,2000,10579,9727,852,8.1
"54053",54,53,2001,10446,9694,752,7.2
"54053",54,53,2002,10547,9661,886,8.4
"54053",54,53,2003,10357,9364,993,9.6
"54053",54,53,2004,10141,9329,812,8
"54053",54,53,2005,10096,9305,791,7.8
"54053",54,53,2006,10478,9747,731,7
"54053",54,53,2007,10357,9643,714,6.9
"54053",54,53,2008,10135,9425,710,7
"54053",54,53,2009,10279,9073,1206,11.7
"54053",54,53,2010,11282,9980,1302,11.5
"54053",54,53,2011,11051,9846,1205,10.9
"54053",54,53,2012,10902,9826,1076,9.9
"54053",54,53,2013,10566,9575,991,9.4
"54053",54,53,2014,10127,9169,958,9.5
"54053",54,53,2015,9944,9095,849,8.5
"54053",54,53,2016,10016,9303,713,7.1
"54053",54,53,2017,9985,9316,669,6.7
"54055",54,55,1990,28534,26212,2322,8.1
"54055",54,55,1991,28393,25786,2607,9.2
"54055",54,55,1992,28049,25188,2861,10.2
"54055",54,55,1993,27935,25501,2434,8.7
"54055",54,55,1994,28038,26042,1996,7.1
"54055",54,55,1995,27701,26126,1575,5.7
"54055",54,55,1996,27828,26353,1475,5.3
"54055",54,55,1997,28082,26555,1527,5.4
"54055",54,55,1998,28031,26549,1482,5.3
"54055",54,55,1999,28232,26888,1344,4.8
"54055",54,55,2000,25664,24360,1304,5.1
"54055",54,55,2001,25736,24484,1252,4.9
"54055",54,55,2002,25512,24086,1426,5.6
"54055",54,55,2003,24798,23236,1562,6.3
"54055",54,55,2004,23937,22586,1351,5.6
"54055",54,55,2005,23764,22563,1201,5.1
"54055",54,55,2006,24324,23122,1202,4.9
"54055",54,55,2007,24823,23780,1043,4.2
"54055",54,55,2008,25128,24113,1015,4
"54055",54,55,2009,25342,23686,1656,6.5
"54055",54,55,2010,24076,22035,2041,8.5
"54055",54,55,2011,23732,21694,2038,8.6
"54055",54,55,2012,23431,21470,1961,8.4
"54055",54,55,2013,23129,21359,1770,7.7
"54055",54,55,2014,22214,20513,1701,7.7
"54055",54,55,2015,21914,20322,1592,7.3
"54055",54,55,2016,21660,20212,1448,6.7
"54055",54,55,2017,21365,20119,1246,5.8
"54057",54,57,1990,11776,10982,794,6.7
"54057",54,57,1991,11790,10788,1002,8.5
"54057",54,57,1992,11529,10405,1124,9.7
"54057",54,57,1993,11280,10451,829,7.3
"54057",54,57,1994,11392,10646,746,6.5
"54057",54,57,1995,11604,10877,727,6.3
"54057",54,57,1996,11657,10953,704,6
"54057",54,57,1997,11769,11182,587,5
"54057",54,57,1998,12076,11244,832,6.9
"54057",54,57,1999,12444,11579,865,7
"54057",54,57,2000,12983,12279,704,5.4
"54057",54,57,2001,13010,12315,695,5.3
"54057",54,57,2002,12928,12072,856,6.6
"54057",54,57,2003,13104,12260,844,6.4
"54057",54,57,2004,13218,12448,770,5.8
"54057",54,57,2005,13385,12670,715,5.3
"54057",54,57,2006,13448,12767,681,5.1
"54057",54,57,2007,13397,12766,631,4.7
"54057",54,57,2008,13567,12948,619,4.6
"54057",54,57,2009,13815,12806,1009,7.3
"54057",54,57,2010,12362,11208,1154,9.3
"54057",54,57,2011,12183,11106,1077,8.8
"54057",54,57,2012,12095,11071,1024,8.5
"54057",54,57,2013,11895,10963,932,7.8
"54057",54,57,2014,11782,10845,937,8
"54057",54,57,2015,11594,10742,852,7.3
"54057",54,57,2016,11894,11186,708,6
"54057",54,57,2017,11914,11272,642,5.4
"54059",54,59,1990,9837,8772,1065,10.8
"54059",54,59,1991,10211,8834,1377,13.5
"54059",54,59,1992,10528,9194,1334,12.7
"54059",54,59,1993,10569,9123,1446,13.7
"54059",54,59,1994,10288,8892,1396,13.6
"54059",54,59,1995,10020,8649,1371,13.7
"54059",54,59,1996,9853,8459,1394,14.1
"54059",54,59,1997,9136,7981,1155,12.6
"54059",54,59,1998,8750,7571,1179,13.5
"54059",54,59,1999,8503,7255,1248,14.7
"54059",54,59,2000,9079,8370,709,7.8
"54059",54,59,2001,9013,8443,570,6.3
"54059",54,59,2002,8725,7972,753,8.6
"54059",54,59,2003,8186,7429,757,9.2
"54059",54,59,2004,7940,7406,534,6.7
"54059",54,59,2005,8134,7663,471,5.8
"54059",54,59,2006,8590,8118,472,5.5
"54059",54,59,2007,8806,8305,501,5.7
"54059",54,59,2008,9051,8667,384,4.2
"54059",54,59,2009,8937,8143,794,8.9
"54059",54,59,2010,9168,8266,902,9.8
"54059",54,59,2011,9201,8410,791,8.6
"54059",54,59,2012,8988,8115,873,9.7
"54059",54,59,2013,8480,7533,947,11.2
"54059",54,59,2014,7710,6783,927,12
"54059",54,59,2015,7229,6278,951,13.2
"54059",54,59,2016,6740,5894,846,12.6
"54059",54,59,2017,6755,6171,584,8.6
"54061",54,61,1990,36711,34323,2388,6.5
"54061",54,61,1991,36973,34338,2635,7.1
"54061",54,61,1992,37836,34816,3020,8
"54061",54,61,1993,38745,35520,3225,8.3
"54061",54,61,1994,38740,36839,1901,4.9
"54061",54,61,1995,38083,36436,1647,4.3
"54061",54,61,1996,38794,36802,1992,5.1
"54061",54,61,1997,38286,36525,1761,4.6
"54061",54,61,1998,37732,36402,1330,3.5
"54061",54,61,1999,38622,37342,1280,3.3
"54061",54,61,2000,41250,39462,1788,4.3
"54061",54,61,2001,41934,40360,1574,3.8
"54061",54,61,2002,41728,39901,1827,4.4
"54061",54,61,2003,42500,40653,1847,4.3
"54061",54,61,2004,43167,41523,1644,3.8
"54061",54,61,2005,44216,42591,1625,3.7
"54061",54,61,2006,45922,44330,1592,3.5
"54061",54,61,2007,47423,45933,1490,3.1
"54061",54,61,2008,48617,47266,1351,2.8
"54061",54,61,2009,49875,47679,2196,4.4
"54061",54,61,2010,48354,45653,2701,5.6
"54061",54,61,2011,48549,45850,2699,5.6
"54061",54,61,2012,49695,47114,2581,5.2
"54061",54,61,2013,50023,47763,2260,4.5
"54061",54,61,2014,50271,48042,2229,4.4
"54061",54,61,2015,50337,47964,2373,4.7
"54061",54,61,2016,51218,49004,2214,4.3
"54061",54,61,2017,52106,50172,1934,3.7
"54063",54,63,1990,5113,4637,476,9.3
"54063",54,63,1991,5135,4517,618,12
"54063",54,63,1992,4924,4467,457,9.3
"54063",54,63,1993,4970,4531,439,8.8
"54063",54,63,1994,5081,4631,450,8.9
"54063",54,63,1995,5063,4711,352,7
"54063",54,63,1996,5081,4779,302,5.9
"54063",54,63,1997,5238,4940,298,5.7
"54063",54,63,1998,5154,4870,284,5.5
"54063",54,63,1999,5329,5104,225,4.2
"54063",54,63,2000,5831,5544,287,4.9
"54063",54,63,2001,5843,5584,259,4.4
"54063",54,63,2002,5842,5550,292,5
"54063",54,63,2003,5759,5476,283,4.9
"54063",54,63,2004,5763,5517,246,4.3
"54063",54,63,2005,5720,5453,267,4.7
"54063",54,63,2006,5944,5617,327,5.5
"54063",54,63,2007,5954,5675,279,4.7
"54063",54,63,2008,5870,5607,263,4.5
"54063",54,63,2009,5829,5407,422,7.2
"54063",54,63,2010,5764,5303,461,8
"54063",54,63,2011,5781,5322,459,7.9
"54063",54,63,2012,5733,5318,415,7.2
"54063",54,63,2013,5677,5320,357,6.3
"54063",54,63,2014,5559,5233,326,5.9
"54063",54,63,2015,5735,5415,320,5.6
"54063",54,63,2016,5972,5700,272,4.6
"54063",54,63,2017,6029,5772,257,4.3
"54065",54,65,1990,5709,5438,271,4.7
"54065",54,65,1991,5851,5364,487,8.3
"54065",54,65,1992,5833,5371,462,7.9
"54065",54,65,1993,5844,5460,384,6.6
"54065",54,65,1994,5825,5516,309,5.3
"54065",54,65,1995,5889,5548,341,5.8
"54065",54,65,1996,6199,5863,336,5.4
"54065",54,65,1997,5929,5622,307,5.2
"54065",54,65,1998,6015,5809,206,3.4
"54065",54,65,1999,6153,5998,155,2.5
"54065",54,65,2000,7286,7002,284,3.9
"54065",54,65,2001,7339,7048,291,4
"54065",54,65,2002,7116,6801,315,4.4
"54065",54,65,2003,6870,6555,315,4.6
"54065",54,65,2004,6856,6568,288,4.2
"54065",54,65,2005,7029,6703,326,4.6
"54065",54,65,2006,7122,6786,336,4.7
"54065",54,65,2007,7084,6750,334,4.7
"54065",54,65,2008,6979,6610,369,5.3
"54065",54,65,2009,6883,6277,606,8.8
"54065",54,65,2010,7677,6975,702,9.1
"54065",54,65,2011,7588,6958,630,8.3
"54065",54,65,2012,7589,7033,556,7.3
"54065",54,65,2013,7439,6978,461,6.2
"54065",54,65,2014,7397,6956,441,6
"54065",54,65,2015,7455,7045,410,5.5
"54065",54,65,2016,7645,7310,335,4.4
"54065",54,65,2017,7715,7409,306,4
"54067",54,67,1990,10301,8963,1338,13
"54067",54,67,1991,10593,8938,1655,15.6
"54067",54,67,1992,10526,8883,1643,15.6
"54067",54,67,1993,10523,8830,1693,16.1
"54067",54,67,1994,10541,9146,1395,13.2
"54067",54,67,1995,10242,9213,1029,10
"54067",54,67,1996,10574,9430,1144,10.8
"54067",54,67,1997,10680,9583,1097,10.3
"54067",54,67,1998,10474,9538,936,8.9
"54067",54,67,1999,10909,9870,1039,9.5
"54067",54,67,2000,11074,10319,755,6.8
"54067",54,67,2001,10898,10285,613,5.6
"54067",54,67,2002,10741,9966,775,7.2
"54067",54,67,2003,10421,9657,764,7.3
"54067",54,67,2004,10319,9766,553,5.4
"54067",54,67,2005,10397,9823,574,5.5
"54067",54,67,2006,10662,10091,571,5.4
"54067",54,67,2007,10793,10255,538,5
"54067",54,67,2008,10668,10176,492,4.6
"54067",54,67,2009,10697,9772,925,8.6
"54067",54,67,2010,10937,9841,1096,10
"54067",54,67,2011,10952,9954,998,9.1
"54067",54,67,2012,10832,9827,1005,9.3
"54067",54,67,2013,10373,9379,994,9.6
"54067",54,67,2014,10053,9134,919,9.1
"54067",54,67,2015,9911,9013,898,9.1
"54067",54,67,2016,9574,8731,843,8.8
"54067",54,67,2017,9351,8690,661,7.1
"54069",54,69,1990,24248,22955,1293,5.3
"54069",54,69,1991,24360,22670,1690,6.9
"54069",54,69,1992,24107,22063,2044,8.5
"54069",54,69,1993,24172,22235,1937,8
"54069",54,69,1994,24425,22590,1835,7.5
"54069",54,69,1995,24153,22931,1222,5.1
"54069",54,69,1996,24446,23319,1127,4.6
"54069",54,69,1997,24979,23576,1403,5.6
"54069",54,69,1998,24298,23219,1079,4.4
"54069",54,69,1999,24397,23419,978,4
"54069",54,69,2000,22465,21460,1005,4.5
"54069",54,69,2001,22071,21124,947,4.3
"54069",54,69,2002,21439,20333,1106,5.2
"54069",54,69,2003,20670,19546,1124,5.4
"54069",54,69,2004,20739,19685,1054,5.1
"54069",54,69,2005,20967,19946,1021,4.9
"54069",54,69,2006,20981,19976,1005,4.8
"54069",54,69,2007,21089,20200,889,4.2
"54069",54,69,2008,21154,20272,882,4.2
"54069",54,69,2009,21306,19693,1613,7.6
"54069",54,69,2010,21826,20093,1733,7.9
"54069",54,69,2011,21324,19763,1561,7.3
"54069",54,69,2012,21355,19994,1361,6.4
"54069",54,69,2013,21330,20120,1210,5.7
"54069",54,69,2014,20970,19799,1171,5.6
"54069",54,69,2015,20609,19451,1158,5.6
"54069",54,69,2016,20603,19461,1142,5.5
"54069",54,69,2017,20565,19582,983,4.8
"54071",54,71,1990,3665,3454,211,5.8
"54071",54,71,1991,3654,3404,250,6.8
"54071",54,71,1992,3619,3441,178,4.9
"54071",54,71,1993,3662,3493,169,4.6
"54071",54,71,1994,3725,3538,187,5
"54071",54,71,1995,3797,3614,183,4.8
"54071",54,71,1996,3705,3553,152,4.1
"54071",54,71,1997,3803,3665,138,3.6
"54071",54,71,1998,3777,3639,138,3.7
"54071",54,71,1999,3971,3791,180,4.5
"54071",54,71,2000,3967,3655,312,7.9
"54071",54,71,2001,3755,3579,176,4.7
"54071",54,71,2002,3791,3616,175,4.6
"54071",54,71,2003,3840,3665,175,4.6
"54071",54,71,2004,3748,3607,141,3.8
"54071",54,71,2005,3664,3524,140,3.8
"54071",54,71,2006,3850,3687,163,4.2
"54071",54,71,2007,3807,3666,141,3.7
"54071",54,71,2008,3715,3555,160,4.3
"54071",54,71,2009,3562,3293,269,7.6
"54071",54,71,2010,3658,3343,315,8.6
"54071",54,71,2011,3648,3385,263,7.2
"54071",54,71,2012,3636,3389,247,6.8
"54071",54,71,2013,3579,3384,195,5.4
"54071",54,71,2014,3477,3307,170,4.9
"54071",54,71,2015,3565,3399,166,4.7
"54071",54,71,2016,3649,3508,141,3.9
"54071",54,71,2017,3672,3538,134,3.6
"54073",54,73,1990,3227,2899,328,10.2
"54073",54,73,1991,3165,2726,439,13.9
"54073",54,73,1992,3324,2903,421,12.7
"54073",54,73,1993,3242,2775,467,14.4
"54073",54,73,1994,3109,2767,342,11
"54073",54,73,1995,3067,2749,318,10.4
"54073",54,73,1996,3109,2819,290,9.3
"54073",54,73,1997,3298,3034,264,8
"54073",54,73,1998,3301,2936,365,11.1
"54073",54,73,1999,2827,2584,243,8.6
"54073",54,73,2000,3326,3133,193,5.8
"54073",54,73,2001,3344,3155,189,5.7
"54073",54,73,2002,3337,3104,233,7
"54073",54,73,2003,3290,3040,250,7.6
"54073",54,73,2004,3223,3027,196,6.1
"54073",54,73,2005,3189,2988,201,6.3
"54073",54,73,2006,3177,2999,178,5.6
"54073",54,73,2007,3163,2982,181,5.7
"54073",54,73,2008,3145,2961,184,5.9
"54073",54,73,2009,3221,2893,328,10.2
"54073",54,73,2010,2937,2627,310,10.6
"54073",54,73,2011,2918,2633,285,9.8
"54073",54,73,2012,2878,2627,251,8.7
"54073",54,73,2013,2893,2682,211,7.3
"54073",54,73,2014,2973,2761,212,7.1
"54073",54,73,2015,2977,2724,253,8.5
"54073",54,73,2016,2950,2709,241,8.2
"54073",54,73,2017,2856,2657,199,7
"54075",54,75,1990,4198,3640,558,13.3
"54075",54,75,1991,4160,3466,694,16.7
"54075",54,75,1992,4108,3522,586,14.3
"54075",54,75,1993,4133,3638,495,12
"54075",54,75,1994,4288,3720,568,13.2
"54075",54,75,1995,4273,3522,751,17.6
"54075",54,75,1996,4241,3696,545,12.9
"54075",54,75,1997,4235,3868,367,8.7
"54075",54,75,1998,4267,3894,373,8.7
"54075",54,75,1999,4278,3914,364,8.5
"54075",54,75,2000,4037,3766,271,6.7
"54075",54,75,2001,4003,3739,264,6.6
"54075",54,75,2002,3996,3720,276,6.9
"54075",54,75,2003,4021,3750,271,6.7
"54075",54,75,2004,3835,3598,237,6.2
"54075",54,75,2005,3750,3510,240,6.4
"54075",54,75,2006,3818,3522,296,7.8
"54075",54,75,2007,3747,3474,273,7.3
"54075",54,75,2008,3606,3350,256,7.1
"54075",54,75,2009,3602,3174,428,11.9
"54075",54,75,2010,3800,3363,437,11.5
"54075",54,75,2011,3684,3275,409,11.1
"54075",54,75,2012,3623,3255,368,10.2
"54075",54,75,2013,3595,3287,308,8.6
"54075",54,75,2014,3536,3229,307,8.7
"54075",54,75,2015,3582,3290,292,8.2
"54075",54,75,2016,3722,3475,247,6.6
"54075",54,75,2017,3742,3519,223,6
"54077",54,77,1990,12168,10944,1224,10.1
"54077",54,77,1991,12265,10868,1397,11.4
"54077",54,77,1992,12564,10986,1578,12.6
"54077",54,77,1993,12749,11236,1513,11.9
"54077",54,77,1994,12855,11683,1172,9.1
"54077",54,77,1995,12640,11578,1062,8.4
"54077",54,77,1996,12892,11662,1230,9.5
"54077",54,77,1997,12732,11629,1103,8.7
"54077",54,77,1998,12476,11609,867,6.9
"54077",54,77,1999,12762,11982,780,6.1
"54077",54,77,2000,13394,12650,744,5.6
"54077",54,77,2001,13547,12867,680,5
"54077",54,77,2002,13651,12804,847,6.2
"54077",54,77,2003,13783,12917,866,6.3
"54077",54,77,2004,13934,13189,745,5.3
"54077",54,77,2005,14293,13610,683,4.8
"54077",54,77,2006,14906,14230,676,4.5
"54077",54,77,2007,14859,14218,641,4.3
"54077",54,77,2008,15122,14527,595,3.9
"54077",54,77,2009,15420,14335,1085,7
"54077",54,77,2010,14935,13687,1248,8.4
"54077",54,77,2011,14635,13519,1116,7.6
"54077",54,77,2012,14778,13735,1043,7.1
"54077",54,77,2013,14631,13675,956,6.5
"54077",54,77,2014,14462,13590,872,6
"54077",54,77,2015,14601,13689,912,6.2
"54077",54,77,2016,14833,13982,851,5.7
"54077",54,77,2017,15074,14326,748,5
"54079",54,79,1990,20076,18665,1411,7
"54079",54,79,1991,21095,19258,1837,8.7
"54079",54,79,1992,21678,19662,2016,9.3
"54079",54,79,1993,22627,20841,1786,7.9
"54079",54,79,1994,23512,21958,1554,6.6
"54079",54,79,1995,23991,22670,1321,5.5
"54079",54,79,1996,24810,23489,1321,5.3
"54079",54,79,1997,25544,24352,1192,4.7
"54079",54,79,1998,26236,25013,1223,4.7
"54079",54,79,1999,27397,26147,1250,4.6
"54079",54,79,2000,26217,24958,1259,4.8
"54079",54,79,2001,26243,25146,1097,4.2
"54079",54,79,2002,26113,24815,1298,5
"54079",54,79,2003,25740,24436,1304,5.1
"54079",54,79,2004,26080,24865,1215,4.7
"54079",54,79,2005,26468,25260,1208,4.6
"54079",54,79,2006,27138,26023,1115,4.1
"54079",54,79,2007,27468,26446,1022,3.7
"54079",54,79,2008,27977,27059,918,3.3
"54079",54,79,2009,27921,26229,1692,6.1
"54079",54,79,2010,26390,24389,2001,7.6
"54079",54,79,2011,26290,24366,1924,7.3
"54079",54,79,2012,26373,24679,1694,6.4
"54079",54,79,2013,25958,24485,1473,5.7
"54079",54,79,2014,25886,24445,1441,5.6
"54079",54,79,2015,25470,24042,1428,5.6
"54079",54,79,2016,25743,24486,1257,4.9
"54079",54,79,2017,26006,24783,1223,4.7
"54081",54,81,1990,29177,26600,2577,8.8
"54081",54,81,1991,30256,26907,3349,11.1
"54081",54,81,1992,30455,26642,3813,12.5
"54081",54,81,1993,31157,27135,4022,12.9
"54081",54,81,1994,31231,28162,3069,9.8
"54081",54,81,1995,32499,29811,2688,8.3
"54081",54,81,1996,34150,31331,2819,8.3
"54081",54,81,1997,34095,31508,2587,7.6
"54081",54,81,1998,34454,31911,2543,7.4
"54081",54,81,1999,34799,32295,2504,7.2
"54081",54,81,2000,32720,30713,2007,6.1
"54081",54,81,2001,33068,31438,1630,4.9
"54081",54,81,2002,32381,30493,1888,5.8
"54081",54,81,2003,31173,29152,2021,6.5
"54081",54,81,2004,31401,29736,1665,5.3
"54081",54,81,2005,32166,30644,1522,4.7
"54081",54,81,2006,32787,31297,1490,4.5
"54081",54,81,2007,32751,31296,1455,4.4
"54081",54,81,2008,32804,31500,1304,4
"54081",54,81,2009,32854,30491,2363,7.2
"54081",54,81,2010,32470,29824,2646,8.1
"54081",54,81,2011,33020,30644,2376,7.2
"54081",54,81,2012,32843,30456,2387,7.3
"54081",54,81,2013,31791,29478,2313,7.3
"54081",54,81,2014,31198,28953,2245,7.2
"54081",54,81,2015,30272,28032,2240,7.4
"54081",54,81,2016,29896,27808,2088,7
"54081",54,81,2017,29526,27942,1584,5.4
"54083",54,83,1990,12226,10465,1761,14.4
"54083",54,83,1991,12544,10711,1833,14.6
"54083",54,83,1992,12503,10884,1619,12.9
"54083",54,83,1993,12654,11175,1479,11.7
"54083",54,83,1994,12896,11557,1339,10.4
"54083",54,83,1995,13096,11630,1466,11.2
"54083",54,83,1996,13232,11725,1507,11.4
"54083",54,83,1997,13087,11915,1172,9
"54083",54,83,1998,13139,11962,1177,9
"54083",54,83,1999,13590,12589,1001,7.4
"54083",54,83,2000,12841,12067,774,6
"54083",54,83,2001,12902,12170,732,5.7
"54083",54,83,2002,12717,11871,846,6.7
"54083",54,83,2003,12525,11718,807,6.4
"54083",54,83,2004,12541,11852,689,5.5
"54083",54,83,2005,12839,12167,672,5.2
"54083",54,83,2006,13132,12463,669,5.1
"54083",54,83,2007,13086,12420,666,5.1
"54083",54,83,2008,12807,12112,695,5.4
"54083",54,83,2009,12712,11586,1126,8.9
"54083",54,83,2010,12208,10927,1281,10.5
"54083",54,83,2011,12083,10906,1177,9.7
"54083",54,83,2012,12078,11023,1055,8.7
"54083",54,83,2013,11921,11061,860,7.2
"54083",54,83,2014,11801,10945,856,7.3
"54083",54,83,2015,11870,11036,834,7
"54083",54,83,2016,12190,11461,729,6
"54083",54,83,2017,12099,11448,651,5.4
"54085",54,85,1990,4456,3827,629,14.1
"54085",54,85,1991,4480,3836,644,14.4
"54085",54,85,1992,4458,3809,649,14.6
"54085",54,85,1993,4424,3720,704,15.9
"54085",54,85,1994,4436,3767,669,15.1
"54085",54,85,1995,4291,3717,574,13.4
"54085",54,85,1996,4346,3754,592,13.6
"54085",54,85,1997,4229,3755,474,11.2
"54085",54,85,1998,4119,3661,458,11.1
"54085",54,85,1999,4305,3893,412,9.6
"54085",54,85,2000,4611,4322,289,6.3
"54085",54,85,2001,4587,4287,300,6.5
"54085",54,85,2002,4548,4223,325,7.1
"54085",54,85,2003,4464,4113,351,7.9
"54085",54,85,2004,4452,4157,295,6.6
"54085",54,85,2005,4591,4323,268,5.8
"54085",54,85,2006,4745,4507,238,5
"54085",54,85,2007,4628,4391,237,5.1
"54085",54,85,2008,4545,4294,251,5.5
"54085",54,85,2009,4404,3994,410,9.3
"54085",54,85,2010,4295,3878,417,9.7
"54085",54,85,2011,4310,3918,392,9.1
"54085",54,85,2012,4382,4059,323,7.4
"54085",54,85,2013,4555,4276,279,6.1
"54085",54,85,2014,4591,4305,286,6.2
"54085",54,85,2015,4483,4169,314,7
"54085",54,85,2016,4558,4260,298,6.5
"54085",54,85,2017,4419,4177,242,5.5
"54087",54,87,1990,5917,5011,906,15.3
"54087",54,87,1991,5989,4989,1000,16.7
"54087",54,87,1992,6071,5028,1043,17.2
"54087",54,87,1993,6006,5112,894,14.9
"54087",54,87,1994,6127,5309,818,13.4
"54087",54,87,1995,6170,5304,866,14
"54087",54,87,1996,6208,5488,720,11.6
"54087",54,87,1997,6344,5630,714,11.3
"54087",54,87,1998,6310,5598,712,11.3
"54087",54,87,1999,6188,5438,750,12.1
"54087",54,87,2000,6209,5649,560,9
"54087",54,87,2001,6006,5424,582,9.7
"54087",54,87,2002,5697,5186,511,9
"54087",54,87,2003,5476,4995,481,8.8
"54087",54,87,2004,5409,4988,421,7.8
"54087",54,87,2005,5413,5012,401,7.4
"54087",54,87,2006,5529,5182,347,6.3
"54087",54,87,2007,5595,5235,360,6.4
"54087",54,87,2008,5540,5183,357,6.4
"54087",54,87,2009,5562,4897,665,12
"54087",54,87,2010,5510,4759,751,13.6
"54087",54,87,2011,5412,4712,700,12.9
"54087",54,87,2012,5326,4720,606,11.4
"54087",54,87,2013,5358,4803,555,10.4
"54087",54,87,2014,5283,4752,531,10.1
"54087",54,87,2015,5210,4610,600,11.5
"54087",54,87,2016,5195,4660,535,10.3
"54087",54,87,2017,5117,4680,437,8.5
"54089",54,89,1990,4673,4221,452,9.7
"54089",54,89,1991,4803,4264,539,11.2
"54089",54,89,1992,4591,3954,637,13.9
"54089",54,89,1993,4341,3851,490,11.3
"54089",54,89,1994,4370,3837,533,12.2
"54089",54,89,1995,4410,3906,504,11.4
"54089",54,89,1996,4335,3903,432,10
"54089",54,89,1997,4294,3918,376,8.8
"54089",54,89,1998,4337,3927,410,9.5
"54089",54,89,1999,4337,3947,390,9
"54089",54,89,2000,4827,4472,355,7.4
"54089",54,89,2001,4760,4450,310,6.5
"54089",54,89,2002,4792,4444,348,7.3
"54089",54,89,2003,4689,4357,332,7.1
"54089",54,89,2004,4699,4403,296,6.3
"54089",54,89,2005,4683,4389,294,6.3
"54089",54,89,2006,4739,4440,299,6.3
"54089",54,89,2007,4754,4469,285,6
"54089",54,89,2008,4654,4420,234,5
"54089",54,89,2009,4652,4286,366,7.9
"54089",54,89,2010,4783,4330,453,9.5
"54089",54,89,2011,4693,4258,435,9.3
"54089",54,89,2012,4637,4226,411,8.9
"54089",54,89,2013,4550,4203,347,7.6
"54089",54,89,2014,4480,4159,321,7.2
"54089",54,89,2015,4509,4191,318,7.1
"54089",54,89,2016,4564,4285,279,6.1
"54089",54,89,2017,4537,4283,254,5.6
"54091",54,91,1990,6132,5520,612,10
"54091",54,91,1991,6358,5581,777,12.2
"54091",54,91,1992,6306,5558,748,11.9
"54091",54,91,1993,6478,5581,897,13.8
"54091",54,91,1994,6430,5833,597,9.3
"54091",54,91,1995,6561,5940,621,9.5
"54091",54,91,1996,6897,6183,714,10.4
"54091",54,91,1997,6987,6428,559,8
"54091",54,91,1998,6941,6401,540,7.8
"54091",54,91,1999,7037,6494,543,7.7
"54091",54,91,2000,6977,6595,382,5.5
"54091",54,91,2001,7003,6634,369,5.3
"54091",54,91,2002,6942,6537,405,5.8
"54091",54,91,2003,6883,6481,402,5.8
"54091",54,91,2004,6809,6477,332,4.9
"54091",54,91,2005,6931,6571,360,5.2
"54091",54,91,2006,6987,6617,370,5.3
"54091",54,91,2007,6946,6608,338,4.9
"54091",54,91,2008,6969,6661,308,4.4
"54091",54,91,2009,7138,6632,506,7.1
"54091",54,91,2010,7446,6872,574,7.7
"54091",54,91,2011,7430,6878,552,7.4
"54091",54,91,2012,7562,7045,517,6.8
"54091",54,91,2013,7758,7320,438,5.6
"54091",54,91,2014,7737,7325,412,5.3
"54091",54,91,2015,7720,7257,463,6
"54091",54,91,2016,7809,7369,440,5.6
"54091",54,91,2017,7839,7458,381,4.9
"54093",54,93,1990,3512,3085,427,12.2
"54093",54,93,1991,3621,3148,473,13.1
"54093",54,93,1992,3607,3112,495,13.7
"54093",54,93,1993,3635,3122,513,14.1
"54093",54,93,1994,3843,3344,499,13
"54093",54,93,1995,3819,3385,434,11.4
"54093",54,93,1996,3876,3370,506,13.1
"54093",54,93,1997,3739,3293,446,11.9
"54093",54,93,1998,3538,3147,391,11.1
"54093",54,93,1999,3443,3132,311,9
"54093",54,93,2000,3330,3119,211,6.3
"54093",54,93,2001,3271,3086,185,5.7
"54093",54,93,2002,3264,3008,256,7.8
"54093",54,93,2003,3092,2864,228,7.4
"54093",54,93,2004,3066,2866,200,6.5
"54093",54,93,2005,3026,2836,190,6.3
"54093",54,93,2006,3060,2871,189,6.2
"54093",54,93,2007,2994,2812,182,6.1
"54093",54,93,2008,2922,2734,188,6.4
"54093",54,93,2009,2882,2556,326,11.3
"54093",54,93,2010,3301,2937,364,11
"54093",54,93,2011,3225,2922,303,9.4
"54093",54,93,2012,3192,2934,258,8.1
"54093",54,93,2013,3272,3049,223,6.8
"54093",54,93,2014,3358,3144,214,6.4
"54093",54,93,2015,3415,3206,209,6.1
"54093",54,93,2016,3471,3284,187,5.4
"54093",54,93,2017,3396,3222,174,5.1
"54095",54,95,1990,4159,3746,413,9.9
"54095",54,95,1991,4119,3704,415,10.1
"54095",54,95,1992,4042,3615,427,10.6
"54095",54,95,1993,4044,3638,406,10
"54095",54,95,1994,4019,3700,319,7.9
"54095",54,95,1995,4114,3766,348,8.5
"54095",54,95,1996,4238,3926,312,7.4
"54095",54,95,1997,4165,3883,282,6.8
"54095",54,95,1998,4085,3739,346,8.5
"54095",54,95,1999,4244,3934,310,7.3
"54095",54,95,2000,3841,3613,228,5.9
"54095",54,95,2001,3789,3569,220,5.8
"54095",54,95,2002,3790,3533,257,6.8
"54095",54,95,2003,3674,3403,271,7.4
"54095",54,95,2004,3582,3321,261,7.3
"54095",54,95,2005,3595,3333,262,7.3
"54095",54,95,2006,3663,3401,262,7.2
"54095",54,95,2007,3675,3447,228,6.2
"54095",54,95,2008,3620,3393,227,6.3
"54095",54,95,2009,3631,3251,380,10.5
"54095",54,95,2010,3551,3145,406,11.4
"54095",54,95,2011,3601,3222,379,10.5
"54095",54,95,2012,3661,3325,336,9.2
"54095",54,95,2013,3632,3315,317,8.7
"54095",54,95,2014,3603,3274,329,9.1
"54095",54,95,2015,3647,3305,342,9.4
"54095",54,95,2016,3543,3228,315,8.9
"54095",54,95,2017,3442,3194,248,7.2
"54097",54,97,1990,9818,8763,1055,10.7
"54097",54,97,1991,10179,8623,1556,15.3
"54097",54,97,1992,9763,8458,1305,13.4
"54097",54,97,1993,9767,8614,1153,11.8
"54097",54,97,1994,9843,8889,954,9.7
"54097",54,97,1995,10173,8857,1316,12.9
"54097",54,97,1996,10127,9151,976,9.6
"54097",54,97,1997,10115,9330,785,7.8
"54097",54,97,1998,10525,9779,746,7.1
"54097",54,97,1999,10383,9612,771,7.4
"54097",54,97,2000,10381,9760,621,6
"54097",54,97,2001,10884,10323,561,5.2
"54097",54,97,2002,10692,10010,682,6.4
"54097",54,97,2003,10528,9858,670,6.4
"54097",54,97,2004,10489,9920,569,5.4
"54097",54,97,2005,10649,10131,518,4.9
"54097",54,97,2006,10793,10282,511,4.7
"54097",54,97,2007,10830,10353,477,4.4
"54097",54,97,2008,10730,10275,455,4.2
"54097",54,97,2009,10749,9851,898,8.4
"54097",54,97,2010,10369,9409,960,9.3
"54097",54,97,2011,10239,9351,888,8.7
"54097",54,97,2012,9986,9206,780,7.8
"54097",54,97,2013,9610,8927,683,7.1
"54097",54,97,2014,9539,8894,645,6.8
"54097",54,97,2015,9637,8862,775,8
"54097",54,97,2016,9793,9055,738,7.5
"54097",54,97,2017,9521,8948,573,6
"54099",54,99,1990,16517,15134,1383,8.4
"54099",54,99,1991,16891,15005,1886,11.2
"54099",54,99,1992,16833,14963,1870,11.1
"54099",54,99,1993,16631,14980,1651,9.9
"54099",54,99,1994,16641,15105,1536,9.2
"54099",54,99,1995,16605,15368,1237,7.4
"54099",54,99,1996,16796,15585,1211,7.2
"54099",54,99,1997,16794,15696,1098,6.5
"54099",54,99,1998,16764,15672,1092,6.5
"54099",54,99,1999,16930,15896,1034,6.1
"54099",54,99,2000,17686,16758,928,5.2
"54099",54,99,2001,17699,16736,963,5.4
"54099",54,99,2002,17532,16423,1109,6.3
"54099",54,99,2003,17563,16538,1025,5.8
"54099",54,99,2004,17555,16623,932,5.3
"54099",54,99,2005,17577,16659,918,5.2
"54099",54,99,2006,17666,16706,960,5.4
"54099",54,99,2007,17752,16920,832,4.7
"54099",54,99,2008,17608,16780,828,4.7
"54099",54,99,2009,17306,15941,1365,7.9
"54099",54,99,2010,16938,15493,1445,8.5
"54099",54,99,2011,16504,15157,1347,8.2
"54099",54,99,2012,16389,15143,1246,7.6
"54099",54,99,2013,16041,14931,1110,6.9
"54099",54,99,2014,15848,14758,1090,6.9
"54099",54,99,2015,15531,14425,1106,7.1
"54099",54,99,2016,15511,14488,1023,6.6
"54099",54,99,2017,15556,14651,905,5.8
"54101",54,101,1990,3407,2756,651,19.1
"54101",54,101,1991,3357,2716,641,19.1
"54101",54,101,1992,3294,2660,634,19.2
"54101",54,101,1993,3208,2632,576,18
"54101",54,101,1994,3198,2678,520,16.3
"54101",54,101,1995,3093,2685,408,13.2
"54101",54,101,1996,3072,2740,332,10.8
"54101",54,101,1997,3091,2758,333,10.8
"54101",54,101,1998,2999,2728,271,9
"54101",54,101,1999,3061,2770,291,9.5
"54101",54,101,2000,3261,3023,238,7.3
"54101",54,101,2001,3184,2971,213,6.7
"54101",54,101,2002,3276,3056,220,6.7
"54101",54,101,2003,3345,3124,221,6.6
"54101",54,101,2004,3350,3162,188,5.6
"54101",54,101,2005,3291,3099,192,5.8
"54101",54,101,2006,3425,3228,197,5.8
"54101",54,101,2007,3373,3182,191,5.7
"54101",54,101,2008,3294,3112,182,5.5
"54101",54,101,2009,3257,2917,340,10.4
"54101",54,101,2010,3739,3360,379,10.1
"54101",54,101,2011,3632,3289,343,9.4
"54101",54,101,2012,3604,3218,386,10.7
"54101",54,101,2013,3515,3153,362,10.3
"54101",54,101,2014,3438,3142,296,8.6
"54101",54,101,2015,3463,3201,262,7.6
"54101",54,101,2016,3485,3195,290,8.3
"54101",54,101,2017,3362,3154,208,6.2
"54103",54,103,1990,7768,6913,855,11
"54103",54,103,1991,7848,6831,1017,13
"54103",54,103,1992,7693,6628,1065,13.8
"54103",54,103,1993,7630,6588,1042,13.7
"54103",54,103,1994,7356,6574,782,10.6
"54103",54,103,1995,7504,6656,848,11.3
"54103",54,103,1996,7611,6854,757,9.9
"54103",54,103,1997,7433,6767,666,9
"54103",54,103,1998,7349,6588,761,10.4
"54103",54,103,1999,7772,6950,822,10.6
"54103",54,103,2000,7117,6548,569,8
"54103",54,103,2001,6867,6321,546,8
"54103",54,103,2002,6812,6261,551,8.1
"54103",54,103,2003,6588,6049,539,8.2
"54103",54,103,2004,6600,6029,571,8.7
"54103",54,103,2005,6540,5925,615,9.4
"54103",54,103,2006,6346,5827,519,8.2
"54103",54,103,2007,6311,5878,433,6.9
"54103",54,103,2008,6270,5819,451,7.2
"54103",54,103,2009,6305,5569,736,11.7
"54103",54,103,2010,7016,6193,823,11.7
"54103",54,103,2011,7043,6297,746,10.6
"54103",54,103,2012,7262,6582,680,9.4
"54103",54,103,2013,7282,6620,662,9.1
"54103",54,103,2014,7259,6512,747,10.3
"54103",54,103,2015,7144,6428,716,10
"54103",54,103,2016,7192,6528,664,9.2
"54103",54,103,2017,7057,6550,507,7.2
"54105",54,105,1990,2350,1939,411,17.5
"54105",54,105,1991,2009,1591,418,20.8
"54105",54,105,1992,2054,1724,330,16.1
"54105",54,105,1993,2030,1702,328,16.2
"54105",54,105,1994,1967,1689,278,14.1
"54105",54,105,1995,2088,1753,335,16
"54105",54,105,1996,2027,1692,335,16.5
"54105",54,105,1997,1939,1660,279,14.4
"54105",54,105,1998,1900,1622,278,14.6
"54105",54,105,1999,1965,1679,286,14.6
"54105",54,105,2000,2563,2383,180,7
"54105",54,105,2001,2555,2391,164,6.4
"54105",54,105,2002,2543,2340,203,8
"54105",54,105,2003,2549,2309,240,9.4
"54105",54,105,2004,2487,2312,175,7
"54105",54,105,2005,2505,2319,186,7.4
"54105",54,105,2006,2545,2391,154,6.1
"54105",54,105,2007,2489,2341,148,5.9
"54105",54,105,2008,2463,2314,149,6
"54105",54,105,2009,2434,2139,295,12.1
"54105",54,105,2010,2292,2005,287,12.5
"54105",54,105,2011,2278,2015,263,11.5
"54105",54,105,2012,2297,2045,252,11
"54105",54,105,2013,2318,2083,235,10.1
"54105",54,105,2014,2263,2044,219,9.7
"54105",54,105,2015,2251,2018,233,10.4
"54105",54,105,2016,2229,2033,196,8.8
"54105",54,105,2017,2196,2023,173,7.9
"54107",54,107,1990,41966,39019,2947,7
"54107",54,107,1991,42660,38902,3758,8.8
"54107",54,107,1992,42994,38867,4127,9.6
"54107",54,107,1993,42923,39163,3760,8.8
"54107",54,107,1994,42880,39764,3116,7.3
"54107",54,107,1995,43483,40288,3195,7.3
"54107",54,107,1996,43704,41077,2627,6
"54107",54,107,1997,43718,41363,2355,5.4
"54107",54,107,1998,43733,40955,2778,6.4
"54107",54,107,1999,43721,41420,2301,5.3
"54107",54,107,2000,42188,40263,1925,4.6
"54107",54,107,2001,42264,40285,1979,4.7
"54107",54,107,2002,42016,39645,2371,5.6
"54107",54,107,2003,41838,39316,2522,6
"54107",54,107,2004,41109,38876,2233,5.4
"54107",54,107,2005,40944,38707,2237,5.5
"54107",54,107,2006,41183,39152,2031,4.9
"54107",54,107,2007,41151,39229,1922,4.7
"54107",54,107,2008,41121,39179,1942,4.7
"54107",54,107,2009,40962,37470,3492,8.5
"54107",54,107,2010,39348,35850,3498,8.9
"54107",54,107,2011,38647,35451,3196,8.3
"54107",54,107,2012,38543,35739,2804,7.3
"54107",54,107,2013,38447,36064,2383,6.2
"54107",54,107,2014,37785,35532,2253,6
"54107",54,107,2015,36981,34648,2333,6.3
"54107",54,107,2016,36777,34663,2114,5.7
"54107",54,107,2017,36269,34292,1977,5.5
"54109",54,109,1990,8577,7541,1036,12.1
"54109",54,109,1991,8377,7306,1071,12.8
"54109",54,109,1992,8719,7327,1392,16
"54109",54,109,1993,8718,7153,1565,18
"54109",54,109,1994,8274,7212,1062,12.8
"54109",54,109,1995,7936,7075,861,10.8
"54109",54,109,1996,8178,7323,855,10.5
"54109",54,109,1997,8300,7542,758,9.1
"54109",54,109,1998,8385,7608,777,9.3
"54109",54,109,1999,8193,7338,855,10.4
"54109",54,109,2000,8610,7948,662,7.7
"54109",54,109,2001,8606,8088,518,6
"54109",54,109,2002,8757,8174,583,6.7
"54109",54,109,2003,8209,7570,639,7.8
"54109",54,109,2004,7986,7487,499,6.2
"54109",54,109,2005,8154,7718,436,5.3
"54109",54,109,2006,8314,7850,464,5.6
"54109",54,109,2007,8204,7700,504,6.1
"54109",54,109,2008,8031,7653,378,4.7
"54109",54,109,2009,8217,7398,819,10
"54109",54,109,2010,8414,7540,874,10.4
"54109",54,109,2011,8313,7581,732,8.8
"54109",54,109,2012,8379,7610,769,9.2
"54109",54,109,2013,8288,7522,766,9.2
"54109",54,109,2014,7947,7190,757,9.5
"54109",54,109,2015,7727,6982,745,9.6
"54109",54,109,2016,7410,6655,755,10.2
"54109",54,109,2017,6998,6508,490,7
"55001",55,1,1990,6119,5786,333,5.4
"55001",55,1,1991,6393,5986,407,6.4
"55001",55,1,1992,6842,6384,458,6.7
"55001",55,1,1993,7026,6615,411,5.8
"55001",55,1,1994,6866,6465,401,5.8
"55001",55,1,1995,7083,6721,362,5.1
"55001",55,1,1996,7368,7002,366,5
"55001",55,1,1997,7814,7422,392,5
"55001",55,1,1998,8215,7857,358,4.4
"55001",55,1,1999,7976,7670,306,3.8
"55001",55,1,2000,8859,8454,405,4.6
"55001",55,1,2001,9077,8606,471,5.2
"55001",55,1,2002,9197,8659,538,5.8
"55001",55,1,2003,9285,8735,550,5.9
"55001",55,1,2004,9482,8828,654,6.9
"55001",55,1,2005,9678,9007,671,6.9
"55001",55,1,2006,9904,9244,660,6.7
"55001",55,1,2007,10105,9439,666,6.6
"55001",55,1,2008,10053,9349,704,7
"55001",55,1,2009,9989,8937,1052,10.5
"55001",55,1,2010,9137,8005,1132,12.4
"55001",55,1,2011,9062,7993,1069,11.8
"55001",55,1,2012,8984,8002,982,10.9
"55001",55,1,2013,8728,7779,949,10.9
"55001",55,1,2014,8399,7657,742,8.8
"55001",55,1,2015,8335,7730,605,7.3
"55001",55,1,2016,8311,7813,498,6
"55001",55,1,2017,8316,7893,423,5.1
"55003",55,3,1990,7549,6950,599,7.9
"55003",55,3,1991,7538,6833,705,9.4
"55003",55,3,1992,7774,7131,643,8.3
"55003",55,3,1993,8027,7350,677,8.4
"55003",55,3,1994,8257,7575,682,8.3
"55003",55,3,1995,8054,7516,538,6.7
"55003",55,3,1996,8256,7680,576,7
"55003",55,3,1997,8332,7778,554,6.6
"55003",55,3,1998,8084,7456,628,7.8
"55003",55,3,1999,7821,7225,596,7.6
"55003",55,3,2000,8875,8386,489,5.5
"55003",55,3,2001,9115,8566,549,6
"55003",55,3,2002,9265,8578,687,7.4
"55003",55,3,2003,9266,8600,666,7.2
"55003",55,3,2004,9287,8731,556,6
"55003",55,3,2005,9256,8713,543,5.9
"55003",55,3,2006,9251,8689,562,6.1
"55003",55,3,2007,9059,8515,544,6
"55003",55,3,2008,8983,8443,540,6
"55003",55,3,2009,9136,8225,911,10
"55003",55,3,2010,8411,7478,933,11.1
"55003",55,3,2011,8310,7465,845,10.2
"55003",55,3,2012,8237,7473,764,9.3
"55003",55,3,2013,8163,7416,747,9.2
"55003",55,3,2014,8055,7452,603,7.5
"55003",55,3,2015,7929,7434,495,6.2
"55003",55,3,2016,7983,7552,431,5.4
"55003",55,3,2017,8021,7655,366,4.6
"55005",55,5,1990,20791,19529,1262,6.1
"55005",55,5,1991,21541,20074,1467,6.8
"55005",55,5,1992,21880,20429,1451,6.6
"55005",55,5,1993,23255,21617,1638,7
"55005",55,5,1994,23455,22021,1434,6.1
"55005",55,5,1995,23682,22517,1165,4.9
"55005",55,5,1996,24307,23177,1130,4.6
"55005",55,5,1997,24669,23525,1144,4.6
"55005",55,5,1998,24563,23512,1051,4.3
"55005",55,5,1999,23733,22786,947,4
"55005",55,5,2000,24862,23851,1011,4.1
"55005",55,5,2001,25246,24020,1226,4.9
"55005",55,5,2002,25464,24080,1384,5.4
"55005",55,5,2003,25968,24388,1580,6.1
"55005",55,5,2004,25624,24196,1428,5.6
"55005",55,5,2005,25439,24113,1326,5.2
"55005",55,5,2006,25551,24139,1412,5.5
"55005",55,5,2007,25035,23556,1479,5.9
"55005",55,5,2008,25085,23646,1439,5.7
"55005",55,5,2009,25143,22880,2263,9
"55005",55,5,2010,23791,21586,2205,9.3
"55005",55,5,2011,23752,21737,2015,8.5
"55005",55,5,2012,23711,21839,1872,7.9
"55005",55,5,2013,23646,21873,1773,7.5
"55005",55,5,2014,24080,22691,1389,5.8
"55005",55,5,2015,24478,23258,1220,5
"55005",55,5,2016,24437,23332,1105,4.5
"55005",55,5,2017,24821,23946,875,3.5
"55007",55,7,1990,6637,6129,508,7.7
"55007",55,7,1991,6633,6068,565,8.5
"55007",55,7,1992,6846,6325,521,7.6
"55007",55,7,1993,7160,6601,559,7.8
"55007",55,7,1994,7493,6916,577,7.7
"55007",55,7,1995,7435,6928,507,6.8
"55007",55,7,1996,7604,7136,468,6.2
"55007",55,7,1997,7785,7279,506,6.5
"55007",55,7,1998,7496,7002,494,6.6
"55007",55,7,1999,7343,6914,429,5.8
"55007",55,7,2000,7690,7267,423,5.5
"55007",55,7,2001,7935,7478,457,5.8
"55007",55,7,2002,8021,7509,512,6.4
"55007",55,7,2003,8087,7553,534,6.6
"55007",55,7,2004,8226,7701,525,6.4
"55007",55,7,2005,8202,7705,497,6.1
"55007",55,7,2006,8268,7738,530,6.4
"55007",55,7,2007,8168,7629,539,6.6
"55007",55,7,2008,8047,7508,539,6.7
"55007",55,7,2009,8030,7297,733,9.1
"55007",55,7,2010,7688,6836,852,11.1
"55007",55,7,2011,7747,6912,835,10.8
"55007",55,7,2012,7796,6955,841,10.8
"55007",55,7,2013,7760,6907,853,11
"55007",55,7,2014,7545,6822,723,9.6
"55007",55,7,2015,7535,6909,626,8.3
"55007",55,7,2016,7560,7042,518,6.9
"55007",55,7,2017,7546,7149,397,5.3
"55009",55,9,1990,106092,102006,4086,3.9
"55009",55,9,1991,108655,103420,5235,4.8
"55009",55,9,1992,113925,109029,4896,4.3
"55009",55,9,1993,117972,112834,5138,4.4
"55009",55,9,1994,122771,117757,5014,4.1
"55009",55,9,1995,127437,123272,4165,3.3
"55009",55,9,1996,131411,127342,4069,3.1
"55009",55,9,1997,133184,129083,4101,3.1
"55009",55,9,1998,133389,129765,3624,2.7
"55009",55,9,1999,135432,132228,3204,2.4
"55009",55,9,2000,130602,126762,3840,2.9
"55009",55,9,2001,132025,126704,5321,4
"55009",55,9,2002,133858,127065,6793,5.1
"55009",55,9,2003,136203,128994,7209,5.3
"55009",55,9,2004,137003,130606,6397,4.7
"55009",55,9,2005,135667,129576,6091,4.5
"55009",55,9,2006,136965,130739,6226,4.5
"55009",55,9,2007,139064,132673,6391,4.6
"55009",55,9,2008,139296,132919,6377,4.6
"55009",55,9,2009,141023,130169,10854,7.7
"55009",55,9,2010,137152,126336,10816,7.9
"55009",55,9,2011,137593,127689,9904,7.2
"55009",55,9,2012,137669,128638,9031,6.6
"55009",55,9,2013,138060,129510,8550,6.2
"55009",55,9,2014,138476,131778,6698,4.8
"55009",55,9,2015,139340,133668,5672,4.1
"55009",55,9,2016,141684,136575,5109,3.6
"55009",55,9,2017,143350,139127,4223,2.9
"55011",55,11,1990,7131,6733,398,5.6
"55011",55,11,1991,7091,6600,491,6.9
"55011",55,11,1992,7220,6790,430,6
"55011",55,11,1993,7584,7207,377,5
"55011",55,11,1994,7769,7391,378,4.9
"55011",55,11,1995,7812,7486,326,4.2
"55011",55,11,1996,8013,7749,264,3.3
"55011",55,11,1997,8130,7840,290,3.6
"55011",55,11,1998,8053,7807,246,3.1
"55011",55,11,1999,7888,7652,236,3
"55011",55,11,2000,7837,7542,295,3.8
"55011",55,11,2001,8190,7816,374,4.6
"55011",55,11,2002,8227,7816,411,5
"55011",55,11,2003,8421,7983,438,5.2
"55011",55,11,2004,8102,7742,360,4.4
"55011",55,11,2005,8302,7967,335,4
"55011",55,11,2006,8522,8182,340,4
"55011",55,11,2007,8234,7874,360,4.4
"55011",55,11,2008,8137,7790,347,4.3
"55011",55,11,2009,8315,7741,574,6.9
"55011",55,11,2010,7197,6639,558,7.8
"55011",55,11,2011,6954,6474,480,6.9
"55011",55,11,2012,6639,6223,416,6.3
"55011",55,11,2013,6553,6123,430,6.6
"55011",55,11,2014,6463,6100,363,5.6
"55011",55,11,2015,6539,6219,320,4.9
"55011",55,11,2016,6596,6303,293,4.4
"55011",55,11,2017,6626,6378,248,3.7
"55013",55,13,1990,5805,5437,368,6.3
"55013",55,13,1991,5972,5512,460,7.7
"55013",55,13,1992,6009,5581,428,7.1
"55013",55,13,1993,6224,5791,433,7
"55013",55,13,1994,6790,6376,414,6.1
"55013",55,13,1995,7039,6711,328,4.7
"55013",55,13,1996,7051,6719,332,4.7
"55013",55,13,1997,7220,6873,347,4.8
"55013",55,13,1998,7123,6823,300,4.2
"55013",55,13,1999,7088,6758,330,4.7
"55013",55,13,2000,7758,7448,310,4
"55013",55,13,2001,8074,7646,428,5.3
"55013",55,13,2002,8190,7708,482,5.9
"55013",55,13,2003,8470,8000,470,5.5
"55013",55,13,2004,8437,7962,475,5.6
"55013",55,13,2005,8405,7935,470,5.6
"55013",55,13,2006,8468,7973,495,5.8
"55013",55,13,2007,8110,7554,556,6.9
"55013",55,13,2008,7902,7337,565,7.2
"55013",55,13,2009,7984,7124,860,10.8
"55013",55,13,2010,7578,6737,841,11.1
"55013",55,13,2011,7584,6804,780,10.3
"55013",55,13,2012,7540,6859,681,9
"55013",55,13,2013,7488,6852,636,8.5
"55013",55,13,2014,7372,6779,593,8
"55013",55,13,2015,7279,6769,510,7
"55013",55,13,2016,7202,6772,430,6
"55013",55,13,2017,7365,7006,359,4.9
"55015",55,15,1990,21423,20009,1414,6.6
"55015",55,15,1991,21722,20241,1481,6.8
"55015",55,15,1992,22340,21135,1205,5.4
"55015",55,15,1993,23109,21940,1169,5.1
"55015",55,15,1994,24027,22861,1166,4.9
"55015",55,15,1995,24599,23458,1141,4.6
"55015",55,15,1996,24840,24108,732,2.9
"55015",55,15,1997,25266,24460,806,3.2
"55015",55,15,1998,25251,24557,694,2.7
"55015",55,15,1999,25168,24584,584,2.3
"55015",55,15,2000,24000,23331,669,2.8
"55015",55,15,2001,24400,23408,992,4.1
"55015",55,15,2002,24840,23574,1266,5.1
"55015",55,15,2003,25346,24089,1257,5
"55015",55,15,2004,25151,24118,1033,4.1
"55015",55,15,2005,25092,24067,1025,4.1
"55015",55,15,2006,25350,24314,1036,4.1
"55015",55,15,2007,25551,24336,1215,4.8
"55015",55,15,2008,25647,24551,1096,4.3
"55015",55,15,2009,25633,23682,1951,7.6
"55015",55,15,2010,27304,25420,1884,6.9
"55015",55,15,2011,27521,25886,1635,5.9
"55015",55,15,2012,27297,25838,1459,5.3
"55015",55,15,2013,27184,25754,1430,5.3
"55015",55,15,2014,27151,26014,1137,4.2
"55015",55,15,2015,27480,26500,980,3.6
"55015",55,15,2016,27821,26931,890,3.2
"55015",55,15,2017,28041,27263,778,2.8
"55017",55,17,1990,26100,24618,1482,5.7
"55017",55,17,1991,26241,24613,1628,6.2
"55017",55,17,1992,26837,25127,1710,6.4
"55017",55,17,1993,27590,25784,1806,6.5
"55017",55,17,1994,28540,26859,1681,5.9
"55017",55,17,1995,29149,27776,1373,4.7
"55017",55,17,1996,29911,28554,1357,4.5
"55017",55,17,1997,30760,29498,1262,4.1
"55017",55,17,1998,30927,29750,1177,3.8
"55017",55,17,1999,30797,29643,1154,3.7
"55017",55,17,2000,29866,28567,1299,4.3
"55017",55,17,2001,30595,28879,1716,5.6
"55017",55,17,2002,30982,28971,2011,6.5
"55017",55,17,2003,31823,29791,2032,6.4
"55017",55,17,2004,32127,30307,1820,5.7
"55017",55,17,2005,32640,30885,1755,5.4
"55017",55,17,2006,33610,31875,1735,5.2
"55017",55,17,2007,33801,31980,1821,5.4
"55017",55,17,2008,33343,31586,1757,5.3
"55017",55,17,2009,33141,30346,2795,8.4
"55017",55,17,2010,33182,30385,2797,8.4
"55017",55,17,2011,33385,30797,2588,7.8
"55017",55,17,2012,33264,31012,2252,6.8
"55017",55,17,2013,32980,30757,2223,6.7
"55017",55,17,2014,33070,31290,1780,5.4
"55017",55,17,2015,33174,31612,1562,4.7
"55017",55,17,2016,33480,32064,1416,4.2
"55017",55,17,2017,33697,32515,1182,3.5
"55019",55,19,1990,15500,14563,937,6
"55019",55,19,1991,15590,14285,1305,8.4
"55019",55,19,1992,15435,14203,1232,8
"55019",55,19,1993,15879,14706,1173,7.4
"55019",55,19,1994,16518,15299,1219,7.4
"55019",55,19,1995,17003,15859,1144,6.7
"55019",55,19,1996,17098,16077,1021,6
"55019",55,19,1997,16816,15761,1055,6.3
"55019",55,19,1998,16809,15835,974,5.8
"55019",55,19,1999,15819,15022,797,5
"55019",55,19,2000,17468,16693,775,4.4
"55019",55,19,2001,17977,16916,1061,5.9
"55019",55,19,2002,17897,16826,1071,6
"55019",55,19,2003,18464,17326,1138,6.2
"55019",55,19,2004,17725,16725,1000,5.6
"55019",55,19,2005,17621,16650,971,5.5
"55019",55,19,2006,17805,16840,965,5.4
"55019",55,19,2007,17798,16780,1018,5.7
"55019",55,19,2008,17550,16573,977,5.6
"55019",55,19,2009,17846,16165,1681,9.4
"55019",55,19,2010,17259,15479,1780,10.3
"55019",55,19,2011,17321,15866,1455,8.4
"55019",55,19,2012,17098,15829,1269,7.4
"55019",55,19,2013,17131,15922,1209,7.1
"55019",55,19,2014,16972,16046,926,5.5
"55019",55,19,2015,17440,16678,762,4.4
"55019",55,19,2016,17595,16911,684,3.9
"55019",55,19,2017,18013,17461,552,3.1
"55021",55,21,1990,24870,23478,1392,5.6
"55021",55,21,1991,25353,23844,1509,6
"55021",55,21,1992,26018,24455,1563,6
"55021",55,21,1993,26463,24800,1663,6.3
"55021",55,21,1994,26598,24828,1770,6.7
"55021",55,21,1995,27007,25559,1448,5.4
"55021",55,21,1996,27463,26028,1435,5.2
"55021",55,21,1997,27687,26355,1332,4.8
"55021",55,21,1998,27521,26307,1214,4.4
"55021",55,21,1999,26770,25737,1033,3.9
"55021",55,21,2000,29708,28605,1103,3.7
"55021",55,21,2001,30582,29227,1355,4.4
"55021",55,21,2002,30848,29252,1596,5.2
"55021",55,21,2003,31245,29492,1753,5.6
"55021",55,21,2004,31420,29943,1477,4.7
"55021",55,21,2005,31579,30182,1397,4.4
"55021",55,21,2006,31622,30135,1487,4.7
"55021",55,21,2007,31157,29585,1572,5
"55021",55,21,2008,31061,29483,1578,5.1
"55021",55,21,2009,31128,28547,2581,8.3
"55021",55,21,2010,32090,29361,2729,8.5
"55021",55,21,2011,31790,29281,2509,7.9
"55021",55,21,2012,31328,29058,2270,7.2
"55021",55,21,2013,31235,29194,2041,6.5
"55021",55,21,2014,31201,29557,1644,5.3
"55021",55,21,2015,31366,29996,1370,4.4
"55021",55,21,2016,31689,30553,1136,3.6
"55021",55,21,2017,32023,31081,942,2.9
"55023",55,23,1990,7991,7560,431,5.4
"55023",55,23,1991,8405,7861,544,6.5
"55023",55,23,1992,8708,8156,552,6.3
"55023",55,23,1993,8996,8483,513,5.7
"55023",55,23,1994,9228,8680,548,5.9
"55023",55,23,1995,9388,8904,484,5.2
"55023",55,23,1996,9464,9026,438,4.6
"55023",55,23,1997,9767,9396,371,3.8
"55023",55,23,1998,10377,9975,402,3.9
"55023",55,23,1999,9977,9603,374,3.7
"55023",55,23,2000,9100,8758,342,3.8
"55023",55,23,2001,9282,8797,485,5.2
"55023",55,23,2002,9296,8777,519,5.6
"55023",55,23,2003,9397,8806,591,6.3
"55023",55,23,2004,9436,8930,506,5.4
"55023",55,23,2005,9554,9090,464,4.9
"55023",55,23,2006,9666,9191,475,4.9
"55023",55,23,2007,9725,9198,527,5.4
"55023",55,23,2008,9588,9016,572,6
"55023",55,23,2009,9383,8461,922,9.8
"55023",55,23,2010,8367,7489,878,10.5
"55023",55,23,2011,8456,7674,782,9.2
"55023",55,23,2012,8302,7599,703,8.5
"55023",55,23,2013,8124,7459,665,8.2
"55023",55,23,2014,7989,7425,564,7.1
"55023",55,23,2015,7910,7448,462,5.8
"55023",55,23,2016,7951,7565,386,4.9
"55023",55,23,2017,8000,7670,330,4.1
"55025",55,25,1990,217880,213475,4405,2
"55025",55,25,1991,220082,214754,5328,2.4
"55025",55,25,1992,230150,225190,4960,2.2
"55025",55,25,1993,239896,234664,5232,2.2
"55025",55,25,1994,245633,240231,5402,2.2
"55025",55,25,1995,251226,246665,4561,1.8
"55025",55,25,1996,258126,253728,4398,1.7
"55025",55,25,1997,261878,257528,4350,1.7
"55025",55,25,1998,263234,259180,4054,1.5
"55025",55,25,1999,263633,259933,3700,1.4
"55025",55,25,2000,264274,257939,6335,2.4
"55025",55,25,2001,272289,264566,7723,2.8
"55025",55,25,2002,277232,267716,9516,3.4
"55025",55,25,2003,280527,270193,10334,3.7
"55025",55,25,2004,283220,274073,9147,3.2
"55025",55,25,2005,285593,276653,8940,3.1
"55025",55,25,2006,288708,279286,9422,3.3
"55025",55,25,2007,292809,282673,10136,3.5
"55025",55,25,2008,295779,285626,10153,3.4
"55025",55,25,2009,298925,281647,17278,5.8
"55025",55,25,2010,293228,275823,17405,5.9
"55025",55,25,2011,295307,279625,15682,5.3
"55025",55,25,2012,297439,282942,14497,4.9
"55025",55,25,2013,301182,287085,14097,4.7
"55025",55,25,2014,305805,294498,11307,3.7
"55025",55,25,2015,310992,301087,9905,3.2
"55025",55,25,2016,318936,309856,9080,2.8
"55025",55,25,2017,322336,314607,7729,2.4
"55027",55,27,1990,39296,37496,1800,4.6
"55027",55,27,1991,39578,37266,2312,5.8
"55027",55,27,1992,40590,38262,2328,5.7
"55027",55,27,1993,42177,40170,2007,4.8
"55027",55,27,1994,45601,43698,1903,4.2
"55027",55,27,1995,46308,44797,1511,3.3
"55027",55,27,1996,47498,46117,1381,2.9
"55027",55,27,1997,48098,46608,1490,3.1
"55027",55,27,1998,48258,46900,1358,2.8
"55027",55,27,1999,48037,46806,1231,2.6
"55027",55,27,2000,47291,45739,1552,3.3
"55027",55,27,2001,47477,45072,2405,5.1
"55027",55,27,2002,46599,43996,2603,5.6
"55027",55,27,2003,47560,44701,2859,6
"55027",55,27,2004,47041,44535,2506,5.3
"55027",55,27,2005,46581,44305,2276,4.9
"55027",55,27,2006,47161,44807,2354,5
"55027",55,27,2007,46916,44532,2384,5.1
"55027",55,27,2008,47213,44818,2395,5.1
"55027",55,27,2009,47272,42726,4546,9.6
"55027",55,27,2010,47350,43073,4277,9
"55027",55,27,2011,47633,43911,3722,7.8
"55027",55,27,2012,47741,44327,3414,7.2
"55027",55,27,2013,47380,44129,3251,6.9
"55027",55,27,2014,47540,44988,2552,5.4
"55027",55,27,2015,47580,45483,2097,4.4
"55027",55,27,2016,48045,46299,1746,3.6
"55027",55,27,2017,48607,47188,1419,2.9
"55029",55,29,1990,14784,13799,985,6.7
"55029",55,29,1991,14561,13424,1137,7.8
"55029",55,29,1992,14721,13585,1136,7.7
"55029",55,29,1993,14641,13400,1241,8.5
"55029",55,29,1994,14956,13589,1367,9.1
"55029",55,29,1995,15051,14018,1033,6.9
"55029",55,29,1996,15638,14641,997,6.4
"55029",55,29,1997,15819,14891,928,5.9
"55029",55,29,1998,15750,14923,827,5.3
"55029",55,29,1999,15529,14838,691,4.4
"55029",55,29,2000,16397,15728,669,4.1
"55029",55,29,2001,17037,16219,818,4.8
"55029",55,29,2002,17217,16319,898,5.2
"55029",55,29,2003,17044,15770,1274,7.5
"55029",55,29,2004,16755,15732,1023,6.1
"55029",55,29,2005,16653,15734,919,5.5
"55029",55,29,2006,16660,15760,900,5.4
"55029",55,29,2007,17012,16091,921,5.4
"55029",55,29,2008,17161,16232,929,5.4
"55029",55,29,2009,17386,15848,1538,8.8
"55029",55,29,2010,15758,13985,1773,11.3
"55029",55,29,2011,15610,13741,1869,12
"55029",55,29,2012,15765,14146,1619,10.3
"55029",55,29,2013,15743,14189,1554,9.9
"55029",55,29,2014,15378,14121,1257,8.2
"55029",55,29,2015,15495,14465,1030,6.6
"55029",55,29,2016,15562,14795,767,4.9
"55029",55,29,2017,15682,15077,605,3.9
"55031",55,31,1990,19382,18270,1112,5.7
"55031",55,31,1991,20081,18648,1433,7.1
"55031",55,31,1992,20917,19287,1630,7.8
"55031",55,31,1993,21238,19680,1558,7.3
"55031",55,31,1994,21699,20118,1581,7.3
"55031",55,31,1995,22199,20893,1306,5.9
"55031",55,31,1996,22788,21566,1222,5.4
"55031",55,31,1997,23084,21901,1183,5.1
"55031",55,31,1998,23193,22091,1102,4.8
"55031",55,31,1999,22650,21692,958,4.2
"55031",55,31,2000,22673,21662,1011,4.5
"55031",55,31,2001,22594,21450,1144,5.1
"55031",55,31,2002,22815,21448,1367,6
"55031",55,31,2003,22972,21533,1439,6.3
"55031",55,31,2004,22891,21555,1336,5.8
"55031",55,31,2005,22685,21488,1197,5.3
"55031",55,31,2006,23067,21906,1161,5
"55031",55,31,2007,23176,22016,1160,5
"55031",55,31,2008,23378,22148,1230,5.3
"55031",55,31,2009,23504,21578,1926,8.2
"55031",55,31,2010,23738,21760,1978,8.3
"55031",55,31,2011,23618,21840,1778,7.5
"55031",55,31,2012,23432,21826,1606,6.9
"55031",55,31,2013,23576,22014,1562,6.6
"55031",55,31,2014,23549,22211,1338,5.7
"55031",55,31,2015,23371,22213,1158,5
"55031",55,31,2016,23655,22419,1236,5.2
"55031",55,31,2017,23776,22712,1064,4.5
"55033",55,33,1990,18198,17481,717,3.9
"55033",55,33,1991,18990,17929,1061,5.6
"55033",55,33,1992,18857,17791,1066,5.7
"55033",55,33,1993,21167,20165,1002,4.7
"55033",55,33,1994,21339,20469,870,4.1
"55033",55,33,1995,22236,21419,817,3.7
"55033",55,33,1996,22735,21992,743,3.3
"55033",55,33,1997,22708,21942,766,3.4
"55033",55,33,1998,22451,21726,725,3.2
"55033",55,33,1999,21990,21306,684,3.1
"55033",55,33,2000,22399,21610,789,3.5
"55033",55,33,2001,22821,21864,957,4.2
"55033",55,33,2002,23252,22141,1111,4.8
"55033",55,33,2003,24047,22814,1233,5.1
"55033",55,33,2004,23965,22856,1109,4.6
"55033",55,33,2005,24127,23073,1054,4.4
"55033",55,33,2006,23885,22792,1093,4.6
"55033",55,33,2007,25963,24795,1168,4.5
"55033",55,33,2008,25550,24415,1135,4.4
"55033",55,33,2009,25785,23925,1860,7.2
"55033",55,33,2010,23243,21409,1834,7.9
"55033",55,33,2011,23373,21662,1711,7.3
"55033",55,33,2012,23432,21891,1541,6.6
"55033",55,33,2013,23548,22051,1497,6.4
"55033",55,33,2014,23645,22412,1233,5.2
"55033",55,33,2015,23792,22723,1069,4.5
"55033",55,33,2016,24413,23420,993,4.1
"55033",55,33,2017,24598,23791,807,3.3
"55035",55,35,1990,44175,41950,2225,5
"55035",55,35,1991,44454,41910,2544,5.7
"55035",55,35,1992,45407,42781,2626,5.8
"55035",55,35,1993,46358,43896,2462,5.3
"55035",55,35,1994,47916,45825,2091,4.4
"55035",55,35,1995,49078,47458,1620,3.3
"55035",55,35,1996,50748,49043,1705,3.4
"55035",55,35,1997,52378,50674,1704,3.3
"55035",55,35,1998,52496,50941,1555,3
"55035",55,35,1999,52295,50878,1417,2.7
"55035",55,35,2000,52971,51220,1751,3.3
"55035",55,35,2001,53705,51548,2157,4
"55035",55,35,2002,54007,51533,2474,4.6
"55035",55,35,2003,54816,52189,2627,4.8
"55035",55,35,2004,53909,51559,2350,4.4
"55035",55,35,2005,53764,51576,2188,4.1
"55035",55,35,2006,55494,53286,2208,4
"55035",55,35,2007,57275,54873,2402,4.2
"55035",55,35,2008,56997,54637,2360,4.1
"55035",55,35,2009,56821,52959,3862,6.8
"55035",55,35,2010,57108,53138,3970,7
"55035",55,35,2011,57742,54033,3709,6.4
"55035",55,35,2012,58258,54880,3378,5.8
"55035",55,35,2013,57926,54652,3274,5.7
"55035",55,35,2014,58005,55402,2603,4.5
"55035",55,35,2015,58201,55986,2215,3.8
"55035",55,35,2016,59095,57084,2011,3.4
"55035",55,35,2017,59489,57758,1731,2.9
"55037",55,37,1990,2164,2083,81,3.7
"55037",55,37,1991,1444,1264,180,12.5
"55037",55,37,1992,1521,1352,169,11.1
"55037",55,37,1993,1568,1434,134,8.5
"55037",55,37,1994,1545,1440,105,6.8
"55037",55,37,1995,1606,1519,87,5.4
"55037",55,37,1996,1654,1547,107,6.5
"55037",55,37,1997,1734,1604,130,7.5
"55037",55,37,1998,1780,1657,123,6.9
"55037",55,37,1999,1746,1629,117,6.7
"55037",55,37,2000,2611,2499,112,4.3
"55037",55,37,2001,2648,2522,126,4.8
"55037",55,37,2002,2739,2566,173,6.3
"55037",55,37,2003,2685,2510,175,6.5
"55037",55,37,2004,2642,2473,169,6.4
"55037",55,37,2005,2558,2384,174,6.8
"55037",55,37,2006,2584,2412,172,6.7
"55037",55,37,2007,2500,2351,149,6
"55037",55,37,2008,2458,2312,146,5.9
"55037",55,37,2009,2410,2160,250,10.4
"55037",55,37,2010,2247,2014,233,10.4
"55037",55,37,2011,2211,1991,220,10
"55037",55,37,2012,2211,2027,184,8.3
"55037",55,37,2013,2196,2014,182,8.3
"55037",55,37,2014,2206,2041,165,7.5
"55037",55,37,2015,2215,2066,149,6.7
"55037",55,37,2016,2236,2105,131,5.9
"55037",55,37,2017,2309,2200,109,4.7
"55039",55,39,1990,48679,46173,2506,5.1
"55039",55,39,1991,51904,49327,2577,5
"55039",55,39,1992,52173,49871,2302,4.4
"55039",55,39,1993,52144,50052,2092,4
"55039",55,39,1994,55014,52884,2130,3.9
"55039",55,39,1995,55438,53552,1886,3.4
"55039",55,39,1996,55614,53732,1882,3.4
"55039",55,39,1997,55735,53843,1892,3.4
"55039",55,39,1998,55159,53456,1703,3.1
"55039",55,39,1999,54172,52638,1534,2.8
"55039",55,39,2000,55532,53795,1737,3.1
"55039",55,39,2001,56256,53906,2350,4.2
"55039",55,39,2002,57002,54166,2836,5
"55039",55,39,2003,57022,53946,3076,5.4
"55039",55,39,2004,56512,53847,2665,4.7
"55039",55,39,2005,55868,53301,2567,4.6
"55039",55,39,2006,56461,53797,2664,4.7
"55039",55,39,2007,56882,54193,2689,4.7
"55039",55,39,2008,56928,54198,2730,4.8
"55039",55,39,2009,56234,51171,5063,9
"55039",55,39,2010,56517,51716,4801,8.5
"55039",55,39,2011,56213,52104,4109,7.3
"55039",55,39,2012,56122,52478,3644,6.5
"55039",55,39,2013,57076,53567,3509,6.1
"55039",55,39,2014,57127,54321,2806,4.9
"55039",55,39,2015,57074,54749,2325,4.1
"55039",55,39,2016,57143,55139,2004,3.5
"55039",55,39,2017,57544,55915,1629,2.8
"55041",55,41,1990,3534,3296,238,6.7
"55041",55,41,1991,3647,3307,340,9.3
"55041",55,41,1992,4245,3928,317,7.5
"55041",55,41,1993,4371,4048,323,7.4
"55041",55,41,1994,4244,3942,302,7.1
"55041",55,41,1995,4418,4115,303,6.9
"55041",55,41,1996,4666,4416,250,5.4
"55041",55,41,1997,4662,4377,285,6.1
"55041",55,41,1998,4629,4278,351,7.6
"55041",55,41,1999,4473,4234,239,5.3
"55041",55,41,2000,4628,4356,272,5.9
"55041",55,41,2001,4928,4616,312,6.3
"55041",55,41,2002,4948,4597,351,7.1
"55041",55,41,2003,5102,4736,366,7.2
"55041",55,41,2004,5017,4701,316,6.3
"55041",55,41,2005,4949,4606,343,6.9
"55041",55,41,2006,5010,4678,332,6.6
"55041",55,41,2007,5027,4668,359,7.1
"55041",55,41,2008,4883,4542,341,7
"55041",55,41,2009,4973,4464,509,10.2
"55041",55,41,2010,4253,3755,498,11.7
"55041",55,41,2011,4187,3701,486,11.6
"55041",55,41,2012,4142,3687,455,11
"55041",55,41,2013,4081,3634,447,11
"55041",55,41,2014,4024,3675,349,8.7
"55041",55,41,2015,4000,3701,299,7.5
"55041",55,41,2016,4015,3766,249,6.2
"55041",55,41,2017,4063,3857,206,5.1
"55043",55,43,1990,25190,24015,1175,4.7
"55043",55,43,1991,27077,25619,1458,5.4
"55043",55,43,1992,25239,23869,1370,5.4
"55043",55,43,1993,25736,24488,1248,4.8
"55043",55,43,1994,25952,24627,1325,5.1
"55043",55,43,1995,25821,24575,1246,4.8
"55043",55,43,1996,25911,24271,1640,6.3
"55043",55,43,1997,25544,24178,1366,5.3
"55043",55,43,1998,24951,23943,1008,4
"55043",55,43,1999,24085,23226,859,3.6
"55043",55,43,2000,27351,26415,936,3.4
"55043",55,43,2001,28184,26875,1309,4.6
"55043",55,43,2002,28151,26785,1366,4.9
"55043",55,43,2003,28795,27306,1489,5.2
"55043",55,43,2004,27420,26163,1257,4.6
"55043",55,43,2005,26884,25715,1169,4.3
"55043",55,43,2006,27172,25956,1216,4.5
"55043",55,43,2007,28222,26865,1357,4.8
"55043",55,43,2008,28114,26756,1358,4.8
"55043",55,43,2009,28735,26582,2153,7.5
"55043",55,43,2010,27778,25663,2115,7.6
"55043",55,43,2011,27924,26027,1897,6.8
"55043",55,43,2012,27698,26042,1656,6
"55043",55,43,2013,27656,26026,1630,5.9
"55043",55,43,2014,27747,26412,1335,4.8
"55043",55,43,2015,28183,26949,1234,4.4
"55043",55,43,2016,28307,27205,1102,3.9
"55043",55,43,2017,28404,27506,898,3.2
"55045",55,45,1990,17792,17104,688,3.9
"55045",55,45,1991,17329,16318,1011,5.8
"55045",55,45,1992,18198,17383,815,4.5
"55045",55,45,1993,18189,17483,706,3.9
"55045",55,45,1994,18695,18057,638,3.4
"55045",55,45,1995,19055,18450,605,3.2
"55045",55,45,1996,18757,18104,653,3.5
"55045",55,45,1997,18921,18273,648,3.4
"55045",55,45,1998,19027,18390,637,3.3
"55045",55,45,1999,18322,17722,600,3.3
"55045",55,45,2000,19969,19318,651,3.3
"55045",55,45,2001,20085,19235,850,4.2
"55045",55,45,2002,20117,19105,1012,5
"55045",55,45,2003,20057,18967,1090,5.4
"55045",55,45,2004,19617,18732,885,4.5
"55045",55,45,2005,20008,19125,883,4.4
"55045",55,45,2006,20274,19383,891,4.4
"55045",55,45,2007,20355,19398,957,4.7
"55045",55,45,2008,20357,19400,957,4.7
"55045",55,45,2009,20333,18528,1805,8.9
"55045",55,45,2010,21275,19573,1702,8
"55045",55,45,2011,21131,19673,1458,6.9
"55045",55,45,2012,20832,19531,1301,6.2
"55045",55,45,2013,20863,19671,1192,5.7
"55045",55,45,2014,20842,19903,939,4.5
"55045",55,45,2015,21107,20303,804,3.8
"55045",55,45,2016,21285,20580,705,3.3
"55045",55,45,2017,21571,20984,587,2.7
"55047",55,47,1990,9435,8848,587,6.2
"55047",55,47,1991,10153,9461,692,6.8
"55047",55,47,1992,10126,9553,573,5.7
"55047",55,47,1993,10243,9599,644,6.3
"55047",55,47,1994,10799,10154,645,6
"55047",55,47,1995,10771,10266,505,4.7
"55047",55,47,1996,10784,10251,533,4.9
"55047",55,47,1997,10783,10237,546,5.1
"55047",55,47,1998,10690,10170,520,4.9
"55047",55,47,1999,10495,10065,430,4.1
"55047",55,47,2000,10696,10259,437,4.1
"55047",55,47,2001,10942,10352,590,5.4
"55047",55,47,2002,10903,10197,706,6.5
"55047",55,47,2003,10903,10141,762,7
"55047",55,47,2004,10624,10003,621,5.8
"55047",55,47,2005,10280,9682,598,5.8
"55047",55,47,2006,10444,9866,578,5.5
"55047",55,47,2007,10498,9927,571,5.4
"55047",55,47,2008,10400,9819,581,5.6
"55047",55,47,2009,10242,9258,984,9.6
"55047",55,47,2010,10308,9347,961,9.3
"55047",55,47,2011,10385,9534,851,8.2
"55047",55,47,2012,10314,9539,775,7.5
"55047",55,47,2013,10208,9398,810,7.9
"55047",55,47,2014,10048,9402,646,6.4
"55047",55,47,2015,10001,9460,541,5.4
"55047",55,47,2016,9798,9322,476,4.9
"55047",55,47,2017,9731,9364,367,3.8
"55049",55,49,1990,11809,11342,467,4
"55049",55,49,1991,12649,12063,586,4.6
"55049",55,49,1992,12627,12057,570,4.5
"55049",55,49,1993,12830,12277,553,4.3
"55049",55,49,1994,13375,12819,556,4.2
"55049",55,49,1995,13402,12867,535,4
"55049",55,49,1996,13480,12971,509,3.8
"55049",55,49,1997,13590,13099,491,3.6
"55049",55,49,1998,13985,13529,456,3.3
"55049",55,49,1999,13665,13251,414,3
"55049",55,49,2000,13590,13192,398,2.9
"55049",55,49,2001,13928,13427,501,3.6
"55049",55,49,2002,14044,13461,583,4.2
"55049",55,49,2003,14113,13494,619,4.4
"55049",55,49,2004,14145,13577,568,4
"55049",55,49,2005,14262,13666,596,4.2
"55049",55,49,2006,14358,13735,623,4.3
"55049",55,49,2007,14048,13412,636,4.5
"55049",55,49,2008,14069,13410,659,4.7
"55049",55,49,2009,14014,12933,1081,7.7
"55049",55,49,2010,13772,12636,1136,8.2
"55049",55,49,2011,13754,12742,1012,7.4
"55049",55,49,2012,13549,12646,903,6.7
"55049",55,49,2013,13547,12670,877,6.5
"55049",55,49,2014,13556,12862,694,5.1
"55049",55,49,2015,13702,13121,581,4.2
"55049",55,49,2016,13748,13269,479,3.5
"55049",55,49,2017,13969,13559,410,2.9
"55051",55,51,1990,2795,2623,172,6.2
"55051",55,51,1991,2851,2623,228,8
"55051",55,51,1992,3180,2908,272,8.6
"55051",55,51,1993,3302,3005,297,9
"55051",55,51,1994,3194,2942,252,7.9
"55051",55,51,1995,3168,2935,233,7.4
"55051",55,51,1996,3279,3008,271,8.3
"55051",55,51,1997,3315,3061,254,7.7
"55051",55,51,1998,3235,2981,254,7.9
"55051",55,51,1999,3267,3072,195,6
"55051",55,51,2000,3262,3030,232,7.1
"55051",55,51,2001,3273,3014,259,7.9
"55051",55,51,2002,3361,3054,307,9.1
"55051",55,51,2003,3371,3050,321,9.5
"55051",55,51,2004,3307,3008,299,9
"55051",55,51,2005,3188,2923,265,8.3
"55051",55,51,2006,3185,2924,261,8.2
"55051",55,51,2007,3065,2819,246,8
"55051",55,51,2008,3024,2784,240,7.9
"55051",55,51,2009,2989,2627,362,12.1
"55051",55,51,2010,2881,2554,327,11.4
"55051",55,51,2011,2756,2460,296,10.7
"55051",55,51,2012,2783,2492,291,10.5
"55051",55,51,2013,2728,2436,292,10.7
"55051",55,51,2014,2681,2427,254,9.5
"55051",55,51,2015,2623,2393,230,8.8
"55051",55,51,2016,2647,2451,196,7.4
"55051",55,51,2017,2626,2463,163,6.2
"55053",55,53,1990,8104,7602,502,6.2
"55053",55,53,1991,8384,7676,708,8.4
"55053",55,53,1992,8664,8030,634,7.3
"55053",55,53,1993,8997,8389,608,6.8
"55053",55,53,1994,9455,8852,603,6.4
"55053",55,53,1995,9751,9231,520,5.3
"55053",55,53,1996,10631,10121,510,4.8
"55053",55,53,1997,11310,10769,541,4.8
"55053",55,53,1998,11657,11176,481,4.1
"55053",55,53,1999,12511,12100,411,3.3
"55053",55,53,2000,9774,9311,463,4.7
"55053",55,53,2001,9795,9220,575,5.9
"55053",55,53,2002,9887,9285,602,6.1
"55053",55,53,2003,10169,9567,602,5.9
"55053",55,53,2004,9899,9349,550,5.6
"55053",55,53,2005,9816,9256,560,5.7
"55053",55,53,2006,9985,9434,551,5.5
"55053",55,53,2007,9863,9306,557,5.6
"55053",55,53,2008,9792,9233,559,5.7
"55053",55,53,2009,9981,9094,887,8.9
"55053",55,53,2010,10123,9238,885,8.7
"55053",55,53,2011,10225,9408,817,8
"55053",55,53,2012,10315,9562,753,7.3
"55053",55,53,2013,10149,9433,716,7.1
"55053",55,53,2014,10208,9610,598,5.9
"55053",55,53,2015,10354,9861,493,4.8
"55053",55,53,2016,10366,9914,452,4.4
"55053",55,53,2017,10479,10127,352,3.4
"55055",55,55,1990,37600,36138,1462,3.9
"55055",55,55,1991,37959,35849,2110,5.6
"55055",55,55,1992,37990,36057,1933,5.1
"55055",55,55,1993,39287,37402,1885,4.8
"55055",55,55,1994,40709,39037,1672,4.1
"55055",55,55,1995,41556,40194,1362,3.3
"55055",55,55,1996,42373,41224,1149,2.7
"55055",55,55,1997,42510,41256,1254,2.9
"55055",55,55,1998,42152,40997,1155,2.7
"55055",55,55,1999,42156,41113,1043,2.5
"55055",55,55,2000,43097,41802,1295,3
"55055",55,55,2001,43067,41324,1743,4
"55055",55,55,2002,42605,40546,2059,4.8
"55055",55,55,2003,43326,41087,2239,5.2
"55055",55,55,2004,43320,41149,2171,5
"55055",55,55,2005,42581,40661,1920,4.5
"55055",55,55,2006,42827,40875,1952,4.6
"55055",55,55,2007,42244,40188,2056,4.9
"55055",55,55,2008,42410,40339,2071,4.9
"55055",55,55,2009,42686,38770,3916,9.2
"55055",55,55,2010,46473,42415,4058,8.7
"55055",55,55,2011,46444,42918,3526,7.6
"55055",55,55,2012,46217,43133,3084,6.7
"55055",55,55,2013,45917,43040,2877,6.3
"55055",55,55,2014,45824,43541,2283,5
"55055",55,55,2015,45685,43752,1933,4.2
"55055",55,55,2016,45874,44095,1779,3.9
"55055",55,55,2017,45977,44516,1461,3.2
"55057",55,57,1990,10503,9774,729,6.9
"55057",55,57,1991,10656,9840,816,7.7
"55057",55,57,1992,10745,9900,845,7.9
"55057",55,57,1993,11096,10266,830,7.5
"55057",55,57,1994,11353,10540,813,7.2
"55057",55,57,1995,11035,10325,710,6.4
"55057",55,57,1996,11387,10613,774,6.8
"55057",55,57,1997,11346,10500,846,7.5
"55057",55,57,1998,10988,10256,732,6.7
"55057",55,57,1999,10615,9897,718,6.8
"55057",55,57,2000,12771,12116,655,5.1
"55057",55,57,2001,13125,12271,854,6.5
"55057",55,57,2002,13057,12097,960,7.4
"55057",55,57,2003,13157,12181,976,7.4
"55057",55,57,2004,13151,12312,839,6.4
"55057",55,57,2005,13312,12508,804,6
"55057",55,57,2006,13475,12698,777,5.8
"55057",55,57,2007,13299,12496,803,6
"55057",55,57,2008,13363,12564,799,6
"55057",55,57,2009,13554,12199,1355,10
"55057",55,57,2010,13698,12331,1367,10
"55057",55,57,2011,13713,12450,1263,9.2
"55057",55,57,2012,13584,12444,1140,8.4
"55057",55,57,2013,13481,12386,1095,8.1
"55057",55,57,2014,13387,12523,864,6.5
"55057",55,57,2015,13521,12827,694,5.1
"55057",55,57,2016,13589,12988,601,4.4
"55057",55,57,2017,13664,13207,457,3.3
"55059",55,59,1990,66291,62246,4045,6.1
"55059",55,59,1991,68538,64343,4195,6.1
"55059",55,59,1992,71052,66783,4269,6
"55059",55,59,1993,72211,68536,3675,5.1
"55059",55,59,1994,74798,71186,3612,4.8
"55059",55,59,1995,76933,73965,2968,3.9
"55059",55,59,1996,77344,74557,2787,3.6
"55059",55,59,1997,79612,76818,2794,3.5
"55059",55,59,1998,81756,79039,2717,3.3
"55059",55,59,1999,82020,79303,2717,3.3
"55059",55,59,2000,80569,77211,3358,4.2
"55059",55,59,2001,81181,76921,4260,5.2
"55059",55,59,2002,81472,76542,4930,6.1
"55059",55,59,2003,82606,77422,5184,6.3
"55059",55,59,2004,82459,77653,4806,5.8
"55059",55,59,2005,82362,77709,4653,5.6
"55059",55,59,2006,82761,78297,4464,5.4
"55059",55,59,2007,84396,80060,4336,5.1
"55059",55,59,2008,85415,80752,4663,5.5
"55059",55,59,2009,86164,77164,9000,10.4
"55059",55,59,2010,85825,77001,8824,10.3
"55059",55,59,2011,86337,78533,7804,9
"55059",55,59,2012,86975,79881,7094,8.2
"55059",55,59,2013,87092,80438,6654,7.6
"55059",55,59,2014,86935,81671,5264,6.1
"55059",55,59,2015,87548,83085,4463,5.1
"55059",55,59,2016,88793,84660,4133,4.7
"55059",55,59,2017,89921,86426,3495,3.9
"55061",55,61,1990,10027,9568,459,4.6
"55061",55,61,1991,9867,9207,660,6.7
"55061",55,61,1992,10424,9746,678,6.5
"55061",55,61,1993,10452,9895,557,5.3
"55061",55,61,1994,10611,10083,528,5
"55061",55,61,1995,10431,10018,413,4
"55061",55,61,1996,10501,10088,413,3.9
"55061",55,61,1997,10684,10291,393,3.7
"55061",55,61,1998,11080,10708,372,3.4
"55061",55,61,1999,10598,10296,302,2.8
"55061",55,61,2000,11561,11242,319,2.8
"55061",55,61,2001,11662,11203,459,3.9
"55061",55,61,2002,11814,11209,605,5.1
"55061",55,61,2003,11967,11264,703,5.9
"55061",55,61,2004,11919,11380,539,4.5
"55061",55,61,2005,11800,11271,529,4.5
"55061",55,61,2006,11837,11310,527,4.5
"55061",55,61,2007,11720,11177,543,4.6
"55061",55,61,2008,11548,11034,514,4.5
"55061",55,61,2009,11572,10666,906,7.8
"55061",55,61,2010,11178,10262,916,8.2
"55061",55,61,2011,11178,10350,828,7.4
"55061",55,61,2012,11017,10296,721,6.5
"55061",55,61,2013,10937,10239,698,6.4
"55061",55,61,2014,10843,10296,547,5
"55061",55,61,2015,10901,10455,446,4.1
"55061",55,61,2016,11075,10670,405,3.7
"55061",55,61,2017,11280,10934,346,3.1
"55063",55,63,1990,53196,51122,2074,3.9
"55063",55,63,1991,53676,51365,2311,4.3
"55063",55,63,1992,55404,52972,2432,4.4
"55063",55,63,1993,57057,54556,2501,4.4
"55063",55,63,1994,58865,56552,2313,3.9
"55063",55,63,1995,60164,57891,2273,3.8
"55063",55,63,1996,60615,58757,1858,3.1
"55063",55,63,1997,61096,59343,1753,2.9
"55063",55,63,1998,60896,59202,1694,2.8
"55063",55,63,1999,60376,58572,1804,3
"55063",55,63,2000,61123,59101,2022,3.3
"55063",55,63,2001,62020,59652,2368,3.8
"55063",55,63,2002,62409,59665,2744,4.4
"55063",55,63,2003,62356,59494,2862,4.6
"55063",55,63,2004,62297,59744,2553,4.1
"55063",55,63,2005,61433,58976,2457,4
"55063",55,63,2006,63667,61260,2407,3.8
"55063",55,63,2007,64425,61901,2524,3.9
"55063",55,63,2008,65352,62779,2573,3.9
"55063",55,63,2009,66001,61611,4390,6.7
"55063",55,63,2010,65594,61238,4356,6.6
"55063",55,63,2011,65559,61639,3920,6
"55063",55,63,2012,66417,62804,3613,5.4
"55063",55,63,2013,66776,63239,3537,5.3
"55063",55,63,2014,66710,63804,2906,4.4
"55063",55,63,2015,66668,64098,2570,3.9
"55063",55,63,2016,67813,65374,2439,3.6
"55063",55,63,2017,68207,66216,1991,2.9
"55065",55,65,1990,8382,8066,316,3.8
"55065",55,65,1991,8279,7868,411,5
"55065",55,65,1992,8396,7961,435,5.2
"55065",55,65,1993,8388,8057,331,3.9
"55065",55,65,1994,8397,8034,363,4.3
"55065",55,65,1995,8402,8064,338,4
"55065",55,65,1996,8404,8027,377,4.5
"55065",55,65,1997,8180,7878,302,3.7
"55065",55,65,1998,8127,7838,289,3.6
"55065",55,65,1999,7573,7297,276,3.6
"55065",55,65,2000,9145,8866,279,3.1
"55065",55,65,2001,9392,9021,371,4
"55065",55,65,2002,9333,8850,483,5.2
"55065",55,65,2003,9434,8950,484,5.1
"55065",55,65,2004,9025,8626,399,4.4
"55065",55,65,2005,8949,8584,365,4.1
"55065",55,65,2006,9163,8787,376,4.1
"55065",55,65,2007,9314,8928,386,4.1
"55065",55,65,2008,9098,8714,384,4.2
"55065",55,65,2009,9277,8607,670,7.2
"55065",55,65,2010,9489,8810,679,7.2
"55065",55,65,2011,9481,8875,606,6.4
"55065",55,65,2012,9399,8872,527,5.6
"55065",55,65,2013,9349,8845,504,5.4
"55065",55,65,2014,9403,9006,397,4.2
"55065",55,65,2015,9755,9397,358,3.7
"55065",55,65,2016,9880,9567,313,3.2
"55065",55,65,2017,10213,9956,257,2.5
"55067",55,67,1990,9037,8571,466,5.2
"55067",55,67,1991,8817,8267,550,6.2
"55067",55,67,1992,9232,8594,638,6.9
"55067",55,67,1993,9489,8810,679,7.2
"55067",55,67,1994,9528,8861,667,7
"55067",55,67,1995,9697,9094,603,6.2
"55067",55,67,1996,9720,9180,540,5.6
"55067",55,67,1997,9681,9122,559,5.8
"55067",55,67,1998,9496,8935,561,5.9
"55067",55,67,1999,9305,8815,490,5.3
"55067",55,67,2000,10760,10248,512,4.8
"55067",55,67,2001,11060,10372,688,6.2
"55067",55,67,2002,11267,10508,759,6.7
"55067",55,67,2003,11323,10473,850,7.5
"55067",55,67,2004,10900,10182,718,6.6
"55067",55,67,2005,10668,10034,634,5.9
"55067",55,67,2006,10857,10204,653,6
"55067",55,67,2007,10689,10031,658,6.2
"55067",55,67,2008,10675,10024,651,6.1
"55067",55,67,2009,10985,9872,1113,10.1
"55067",55,67,2010,10181,9062,1119,11
"55067",55,67,2011,10063,9044,1019,10.1
"55067",55,67,2012,9974,9047,927,9.3
"55067",55,67,2013,9815,8923,892,9.1
"55067",55,67,2014,9570,8849,721,7.5
"55067",55,67,2015,9483,8906,577,6.1
"55067",55,67,2016,9612,9115,497,5.2
"55067",55,67,2017,9726,9314,412,4.2
"55069",55,69,1990,13657,12919,738,5.4
"55069",55,69,1991,13841,12813,1028,7.4
"55069",55,69,1992,14484,13549,935,6.5
"55069",55,69,1993,14868,13946,922,6.2
"55069",55,69,1994,15015,14091,924,6.2
"55069",55,69,1995,15611,14627,984,6.3
"55069",55,69,1996,15900,15082,818,5.1
"55069",55,69,1997,16128,15265,863,5.4
"55069",55,69,1998,15494,14743,751,4.8
"55069",55,69,1999,14602,13921,681,4.7
"55069",55,69,2000,16093,15401,692,4.3
"55069",55,69,2001,16243,15408,835,5.1
"55069",55,69,2002,16242,15244,998,6.1
"55069",55,69,2003,16306,15247,1059,6.5
"55069",55,69,2004,15996,15091,905,5.7
"55069",55,69,2005,15824,14965,859,5.4
"55069",55,69,2006,15900,15018,882,5.5
"55069",55,69,2007,15570,14690,880,5.7
"55069",55,69,2008,15544,14654,890,5.7
"55069",55,69,2009,15584,13835,1749,11.2
"55069",55,69,2010,15661,13888,1773,11.3
"55069",55,69,2011,15332,13823,1509,9.8
"55069",55,69,2012,15112,13731,1381,9.1
"55069",55,69,2013,15183,13918,1265,8.3
"55069",55,69,2014,15381,14425,956,6.2
"55069",55,69,2015,15270,14507,763,5
"55069",55,69,2016,15317,14651,666,4.3
"55069",55,69,2017,15598,15039,559,3.6
"55071",55,71,1990,41548,39532,2016,4.9
"55071",55,71,1991,42108,39740,2368,5.6
"55071",55,71,1992,41611,39236,2375,5.7
"55071",55,71,1993,41936,39747,2189,5.2
"55071",55,71,1994,44875,42777,2098,4.7
"55071",55,71,1995,45450,43300,2150,4.7
"55071",55,71,1996,44756,42819,1937,4.3
"55071",55,71,1997,45021,43367,1654,3.7
"55071",55,71,1998,45827,44228,1599,3.5
"55071",55,71,1999,44588,42966,1622,3.6
"55071",55,71,2000,46826,45256,1570,3.4
"55071",55,71,2001,47248,44801,2447,5.2
"55071",55,71,2002,46286,43453,2833,6.1
"55071",55,71,2003,46459,43230,3229,7
"55071",55,71,2004,45800,43047,2753,6
"55071",55,71,2005,45215,42998,2217,4.9
"55071",55,71,2006,45407,43161,2246,4.9
"55071",55,71,2007,44712,42275,2437,5.5
"55071",55,71,2008,45202,42948,2254,5
"55071",55,71,2009,46299,41696,4603,9.9
"55071",55,71,2010,44631,40203,4428,9.9
"55071",55,71,2011,44506,40752,3754,8.4
"55071",55,71,2012,43693,40299,3394,7.8
"55071",55,71,2013,42700,39552,3148,7.4
"55071",55,71,2014,42572,40000,2572,6
"55071",55,71,2015,41934,39828,2106,5
"55071",55,71,2016,42003,40199,1804,4.3
"55071",55,71,2017,41988,40494,1494,3.6
"55073",55,73,1990,62089,59498,2591,4.2
"55073",55,73,1991,63481,60039,3442,5.4
"55073",55,73,1992,65274,61714,3560,5.5
"55073",55,73,1993,67196,63729,3467,5.2
"55073",55,73,1994,69542,65912,3630,5.2
"55073",55,73,1995,70781,67550,3231,4.6
"55073",55,73,1996,71858,68982,2876,4
"55073",55,73,1997,73710,71052,2658,3.6
"55073",55,73,1998,73829,71209,2620,3.5
"55073",55,73,1999,73316,71109,2207,3
"55073",55,73,2000,71794,69355,2439,3.4
"55073",55,73,2001,72773,69745,3028,4.2
"55073",55,73,2002,73381,69869,3512,4.8
"55073",55,73,2003,74316,70660,3656,4.9
"55073",55,73,2004,73460,70258,3202,4.4
"55073",55,73,2005,74364,71307,3057,4.1
"55073",55,73,2006,75171,71944,3227,4.3
"55073",55,73,2007,75971,72651,3320,4.4
"55073",55,73,2008,75392,71953,3439,4.6
"55073",55,73,2009,74952,68390,6562,8.8
"55073",55,73,2010,73521,66692,6829,9.3
"55073",55,73,2011,72716,66983,5733,7.9
"55073",55,73,2012,71647,66401,5246,7.3
"55073",55,73,2013,72134,67298,4836,6.7
"55073",55,73,2014,73176,69492,3684,5
"55073",55,73,2015,73511,70555,2956,4
"55073",55,73,2016,73899,71277,2622,3.5
"55073",55,73,2017,74325,72132,2193,3
"55075",55,75,1990,19193,17831,1362,7.1
"55075",55,75,1991,19495,17710,1785,9.2
"55075",55,75,1992,19703,18078,1625,8.2
"55075",55,75,1993,19864,18322,1542,7.8
"55075",55,75,1994,19929,18553,1376,6.9
"55075",55,75,1995,20158,18978,1180,5.9
"55075",55,75,1996,20468,19251,1217,5.9
"55075",55,75,1997,20973,19834,1139,5.4
"55075",55,75,1998,21504,20248,1256,5.8
"55075",55,75,1999,21198,20192,1006,4.7
"55075",55,75,2000,22405,21388,1017,4.5
"55075",55,75,2001,22637,21257,1380,6.1
"55075",55,75,2002,22868,21320,1548,6.8
"55075",55,75,2003,23390,21675,1715,7.3
"55075",55,75,2004,22884,21394,1490,6.5
"55075",55,75,2005,22349,21000,1349,6
"55075",55,75,2006,22012,20592,1420,6.5
"55075",55,75,2007,22337,20942,1395,6.2
"55075",55,75,2008,22071,20720,1351,6.1
"55075",55,75,2009,22450,19854,2596,11.6
"55075",55,75,2010,21380,19013,2367,11.1
"55075",55,75,2011,21527,19440,2087,9.7
"55075",55,75,2012,21449,19659,1790,8.3
"55075",55,75,2013,21452,19753,1699,7.9
"55075",55,75,2014,21101,19677,1424,6.7
"55075",55,75,2015,20762,19558,1204,5.8
"55075",55,75,2016,20310,19200,1110,5.5
"55075",55,75,2017,20044,19155,889,4.4
"55077",55,77,1990,5998,5600,398,6.6
"55077",55,77,1991,6139,5685,454,7.4
"55077",55,77,1992,6322,5879,443,7
"55077",55,77,1993,6549,6044,505,7.7
"55077",55,77,1994,6550,6060,490,7.5
"55077",55,77,1995,6824,6318,506,7.4
"55077",55,77,1996,7027,6570,457,6.5
"55077",55,77,1997,7191,6753,438,6.1
"55077",55,77,1998,7185,6756,429,6
"55077",55,77,1999,7008,6634,374,5.3
"55077",55,77,2000,7496,7090,406,5.4
"55077",55,77,2001,7720,7211,509,6.6
"55077",55,77,2002,7804,7227,577,7.4
"55077",55,77,2003,8013,7360,653,8.1
"55077",55,77,2004,7918,7394,524,6.6
"55077",55,77,2005,7849,7369,480,6.1
"55077",55,77,2006,7833,7364,469,6
"55077",55,77,2007,7925,7441,484,6.1
"55077",55,77,2008,7823,7325,498,6.4
"55077",55,77,2009,7786,6985,801,10.3
"55077",55,77,2010,7691,6855,836,10.9
"55077",55,77,2011,7609,6851,758,10
"55077",55,77,2012,7580,6911,669,8.8
"55077",55,77,2013,7511,6877,634,8.4
"55077",55,77,2014,7328,6803,525,7.2
"55077",55,77,2015,7504,7044,460,6.1
"55077",55,77,2016,7581,7198,383,5.1
"55077",55,77,2017,7644,7351,293,3.8
"55078",55,78,1990,1163,1056,107,9.2
"55078",55,78,1991,1505,1376,129,8.6
"55078",55,78,1992,1747,1571,176,10.1
"55078",55,78,1993,1906,1719,187,9.8
"55078",55,78,1994,1972,1794,178,9
"55078",55,78,1995,2060,1883,177,8.6
"55078",55,78,1996,2206,2023,183,8.3
"55078",55,78,1997,2393,2163,230,9.6
"55078",55,78,1998,2529,2310,219,8.7
"55078",55,78,1999,2547,2348,199,7.8
"55078",55,78,2000,1637,1488,149,9.1
"55078",55,78,2001,1684,1499,185,11
"55078",55,78,2002,1725,1509,216,12.5
"55078",55,78,2003,1718,1528,190,11.1
"55078",55,78,2004,1662,1477,185,11.1
"55078",55,78,2005,1643,1479,164,10
"55078",55,78,2006,1669,1483,186,11.1
"55078",55,78,2007,1650,1478,172,10.4
"55078",55,78,2008,1643,1468,175,10.7
"55078",55,78,2009,1640,1412,228,13.9
"55078",55,78,2010,1550,1279,271,17.5
"55078",55,78,2011,1603,1328,275,17.2
"55078",55,78,2012,1589,1330,259,16.3
"55078",55,78,2013,1573,1324,249,15.8
"55078",55,78,2014,1600,1402,198,12.4
"55078",55,78,2015,1605,1450,155,9.7
"55078",55,78,2016,1580,1460,120,7.6
"55078",55,78,2017,1588,1492,96,6
"55079",55,79,1990,475405,453338,22067,4.6
"55079",55,79,1991,469301,443605,25696,5.5
"55079",55,79,1992,474721,450445,24276,5.1
"55079",55,79,1993,478059,454029,24030,5
"55079",55,79,1994,482293,458470,23823,4.9
"55079",55,79,1995,482595,463037,19558,4.1
"55079",55,79,1996,486029,465660,20369,4.2
"55079",55,79,1997,489205,468903,20302,4.1
"55079",55,79,1998,484421,465260,19161,4
"55079",55,79,1999,478839,460114,18725,3.9
"55079",55,79,2000,474899,453896,21003,4.4
"55079",55,79,2001,473068,447127,25941,5.5
"55079",55,79,2002,468210,436967,31243,6.7
"55079",55,79,2003,466169,433157,33012,7.1
"55079",55,79,2004,458562,429695,28867,6.3
"55079",55,79,2005,451298,425389,25909,5.7
"55079",55,79,2006,454893,429034,25859,5.7
"55079",55,79,2007,469736,442497,27239,5.8
"55079",55,79,2008,469227,442645,26582,5.7
"55079",55,79,2009,467652,423498,44154,9.4
"55079",55,79,2010,476456,428841,47615,10
"55079",55,79,2011,477614,433278,44336,9.3
"55079",55,79,2012,476476,435430,41046,8.6
"55079",55,79,2013,479059,438842,40217,8.4
"55079",55,79,2014,478784,445882,32902,6.9
"55079",55,79,2015,477410,449974,27436,5.7
"55079",55,79,2016,478435,454700,23735,5
"55079",55,79,2017,478333,458982,19351,4
"55081",55,81,1990,18126,17206,920,5.1
"55081",55,81,1991,18441,17182,1259,6.8
"55081",55,81,1992,18795,17505,1290,6.9
"55081",55,81,1993,19107,17973,1134,5.9
"55081",55,81,1994,19821,18617,1204,6.1
"55081",55,81,1995,20056,19077,979,4.9
"55081",55,81,1996,20345,19420,925,4.5
"55081",55,81,1997,20135,19104,1031,5.1
"55081",55,81,1998,20026,19138,888,4.4
"55081",55,81,1999,19652,18871,781,4
"55081",55,81,2000,21559,20737,822,3.8
"55081",55,81,2001,22316,21270,1046,4.7
"55081",55,81,2002,22555,21439,1116,4.9
"55081",55,81,2003,23357,22177,1180,5.1
"55081",55,81,2004,23207,22228,979,4.2
"55081",55,81,2005,23331,22380,951,4.1
"55081",55,81,2006,23910,22884,1026,4.3
"55081",55,81,2007,24073,22963,1110,4.6
"55081",55,81,2008,24462,23321,1141,4.7
"55081",55,81,2009,24781,22890,1891,7.6
"55081",55,81,2010,23123,21282,1841,8
"55081",55,81,2011,23184,21480,1704,7.3
"55081",55,81,2012,22787,21127,1660,7.3
"55081",55,81,2013,22765,21198,1567,6.9
"55081",55,81,2014,22552,21335,1217,5.4
"55081",55,81,2015,22852,21835,1017,4.5
"55081",55,81,2016,23114,22233,881,3.8
"55081",55,81,2017,23649,22951,698,3
"55083",55,83,1990,14471,13327,1144,7.9
"55083",55,83,1991,14379,12864,1515,10.5
"55083",55,83,1992,14265,13039,1226,8.6
"55083",55,83,1993,14627,13441,1186,8.1
"55083",55,83,1994,14883,13808,1075,7.2
"55083",55,83,1995,14982,14049,933,6.2
"55083",55,83,1996,15177,14255,922,6.1
"55083",55,83,1997,15457,14582,875,5.7
"55083",55,83,1998,15806,14992,814,5.1
"55083",55,83,1999,15804,15091,713,4.5
"55083",55,83,2000,19346,18639,707,3.7
"55083",55,83,2001,19780,18704,1076,5.4
"55083",55,83,2002,19987,18729,1258,6.3
"55083",55,83,2003,20512,19064,1448,7.1
"55083",55,83,2004,20608,19297,1311,6.4
"55083",55,83,2005,20223,19064,1159,5.7
"55083",55,83,2006,20538,19286,1252,6.1
"55083",55,83,2007,20353,19086,1267,6.2
"55083",55,83,2008,20288,19005,1283,6.3
"55083",55,83,2009,20576,18253,2323,11.3
"55083",55,83,2010,21332,19042,2290,10.7
"55083",55,83,2011,21121,19092,2029,9.6
"55083",55,83,2012,20662,18928,1734,8.4
"55083",55,83,2013,20459,18881,1578,7.7
"55083",55,83,2014,20352,19091,1261,6.2
"55083",55,83,2015,20357,19308,1049,5.2
"55083",55,83,2016,20542,19635,907,4.4
"55083",55,83,2017,20793,20058,735,3.5
"55085",55,85,1990,15985,15266,719,4.5
"55085",55,85,1991,16398,15567,831,5.1
"55085",55,85,1992,17333,16472,861,5
"55085",55,85,1993,18328,17389,939,5.1
"55085",55,85,1994,18691,17710,981,5.2
"55085",55,85,1995,19773,18864,909,4.6
"55085",55,85,1996,20396,19531,865,4.2
"55085",55,85,1997,20604,19634,970,4.7
"55085",55,85,1998,20480,19512,968,4.7
"55085",55,85,1999,20435,19524,911,4.5
"55085",55,85,2000,19674,18673,1001,5.1
"55085",55,85,2001,19966,18839,1127,5.6
"55085",55,85,2002,20422,19070,1352,6.6
"55085",55,85,2003,20526,19085,1441,7
"55085",55,85,2004,20643,19392,1251,6.1
"55085",55,85,2005,20231,19062,1169,5.8
"55085",55,85,2006,20069,18897,1172,5.8
"55085",55,85,2007,19432,18232,1200,6.2
"55085",55,85,2008,19201,18022,1179,6.1
"55085",55,85,2009,18972,17130,1842,9.7
"55085",55,85,2010,19066,17123,1943,10.2
"55085",55,85,2011,18897,17117,1780,9.4
"55085",55,85,2012,19139,17474,1665,8.7
"55085",55,85,2013,18597,17003,1594,8.6
"55085",55,85,2014,18774,17509,1265,6.7
"55085",55,85,2015,18649,17574,1075,5.8
"55085",55,85,2016,18658,17753,905,4.9
"55085",55,85,2017,18434,17719,715,3.9
"55087",55,87,1990,84267,81548,2719,3.2
"55087",55,87,1991,85235,82021,3214,3.8
"55087",55,87,1992,88894,85631,3263,3.7
"55087",55,87,1993,91295,88119,3176,3.5
"55087",55,87,1994,94292,90845,3447,3.7
"55087",55,87,1995,97510,94588,2922,3
"55087",55,87,1996,100141,97214,2927,2.9
"55087",55,87,1997,101604,98605,2999,3
"55087",55,87,1998,102122,99313,2809,2.8
"55087",55,87,1999,101750,99146,2604,2.6
"55087",55,87,2000,92829,90036,2793,3
"55087",55,87,2001,93909,90030,3879,4.1
"55087",55,87,2002,94587,89461,5126,5.4
"55087",55,87,2003,95937,90515,5422,5.7
"55087",55,87,2004,95123,90514,4609,4.8
"55087",55,87,2005,94857,90578,4279,4.5
"55087",55,87,2006,95965,91517,4448,4.6
"55087",55,87,2007,97153,92643,4510,4.6
"55087",55,87,2008,97875,93307,4568,4.7
"55087",55,87,2009,99345,91091,8254,8.3
"55087",55,87,2010,100597,92455,8142,8.1
"55087",55,87,2011,100376,93284,7092,7.1
"55087",55,87,2012,100334,93887,6447,6.4
"55087",55,87,2013,100502,94373,6129,6.1
"55087",55,87,2014,101310,96489,4821,4.8
"55087",55,87,2015,102033,97992,4041,4
"55087",55,87,2016,104267,100596,3671,3.5
"55087",55,87,2017,104727,101585,3142,3
"55089",55,89,1990,41187,39886,1301,3.2
"55089",55,89,1991,41440,39808,1632,3.9
"55089",55,89,1992,43020,41377,1643,3.8
"55089",55,89,1993,43816,42497,1319,3
"55089",55,89,1994,45388,44056,1332,2.9
"55089",55,89,1995,46774,45624,1150,2.5
"55089",55,89,1996,47861,46820,1041,2.2
"55089",55,89,1997,48461,47482,979,2
"55089",55,89,1998,48766,47707,1059,2.2
"55089",55,89,1999,48958,48014,944,1.9
"55089",55,89,2000,47313,46091,1222,2.6
"55089",55,89,2001,47604,45951,1653,3.5
"55089",55,89,2002,47522,45424,2098,4.4
"55089",55,89,2003,47874,45601,2273,4.7
"55089",55,89,2004,47675,45916,1759,3.7
"55089",55,89,2005,47669,45907,1762,3.7
"55089",55,89,2006,48514,46768,1746,3.6
"55089",55,89,2007,47848,46016,1832,3.8
"55089",55,89,2008,47927,46077,1850,3.9
"55089",55,89,2009,47578,44022,3556,7.5
"55089",55,89,2010,47416,44057,3359,7.1
"55089",55,89,2011,47451,44545,2906,6.1
"55089",55,89,2012,47380,44776,2604,5.5
"55089",55,89,2013,47535,45046,2489,5.2
"55089",55,89,2014,47955,45926,2029,4.2
"55089",55,89,2015,48275,46495,1780,3.7
"55089",55,89,2016,49229,47590,1639,3.3
"55089",55,89,2017,49473,48106,1367,2.8
"55091",55,91,1990,3405,3242,163,4.8
"55091",55,91,1991,3403,3145,258,7.6
"55091",55,91,1992,3373,3153,220,6.5
"55091",55,91,1993,3499,3306,193,5.5
"55091",55,91,1994,3552,3369,183,5.2
"55091",55,91,1995,3518,3345,173,4.9
"55091",55,91,1996,3461,3294,167,4.8
"55091",55,91,1997,3493,3329,164,4.7
"55091",55,91,1998,3448,3300,148,4.3
"55091",55,91,1999,3237,3105,132,4.1
"55091",55,91,2000,3904,3762,142,3.6
"55091",55,91,2001,3980,3804,176,4.4
"55091",55,91,2002,4010,3806,204,5.1
"55091",55,91,2003,4032,3833,199,4.9
"55091",55,91,2004,3949,3746,203,5.1
"55091",55,91,2005,3965,3760,205,5.2
"55091",55,91,2006,4087,3893,194,4.7
"55091",55,91,2007,4121,3912,209,5.1
"55091",55,91,2008,4097,3902,195,4.8
"55091",55,91,2009,4134,3830,304,7.4
"55091",55,91,2010,4095,3790,305,7.4
"55091",55,91,2011,4100,3839,261,6.4
"55091",55,91,2012,4076,3844,232,5.7
"55091",55,91,2013,4031,3803,228,5.7
"55091",55,91,2014,4032,3840,192,4.8
"55091",55,91,2015,4110,3938,172,4.2
"55091",55,91,2016,4183,4024,159,3.8
"55091",55,91,2017,4260,4108,152,3.6
"55093",55,93,1990,18146,17481,665,3.7
"55093",55,93,1991,18255,17277,978,5.4
"55093",55,93,1992,18863,17789,1074,5.7
"55093",55,93,1993,19102,18232,870,4.6
"55093",55,93,1994,19575,18811,764,3.9
"55093",55,93,1995,19989,19355,634,3.2
"55093",55,93,1996,20523,19846,677,3.3
"55093",55,93,1997,20683,20059,624,3
"55093",55,93,1998,20691,20117,574,2.8
"55093",55,93,1999,20680,20152,528,2.6
"55093",55,93,2000,22725,22125,600,2.6
"55093",55,93,2001,22828,22053,775,3.4
"55093",55,93,2002,22724,21757,967,4.3
"55093",55,93,2003,23062,22023,1039,4.5
"55093",55,93,2004,23181,22212,969,4.2
"55093",55,93,2005,23337,22384,953,4.1
"55093",55,93,2006,23684,22678,1006,4.2
"55093",55,93,2007,23806,22767,1039,4.4
"55093",55,93,2008,24033,22981,1052,4.4
"55093",55,93,2009,23490,21706,1784,7.6
"55093",55,93,2010,23984,22317,1667,7
"55093",55,93,2011,23999,22549,1450,6
"55093",55,93,2012,23896,22577,1319,5.5
"55093",55,93,2013,24000,22736,1264,5.3
"55093",55,93,2014,24023,22961,1062,4.4
"55093",55,93,2015,24151,23203,948,3.9
"55093",55,93,2016,24775,23776,999,4
"55093",55,93,2017,25207,24362,845,3.4
"55095",55,95,1990,17160,16147,1013,5.9
"55095",55,95,1991,17460,16113,1347,7.7
"55095",55,95,1992,18147,16727,1420,7.8
"55095",55,95,1993,18642,17462,1180,6.3
"55095",55,95,1994,19689,18682,1007,5.1
"55095",55,95,1995,20467,19572,895,4.4
"55095",55,95,1996,21619,20741,878,4.1
"55095",55,95,1997,22517,21604,913,4.1
"55095",55,95,1998,22528,21612,916,4.1
"55095",55,95,1999,22050,21229,821,3.7
"55095",55,95,2000,22632,21848,784,3.5
"55095",55,95,2001,23336,22097,1239,5.3
"55095",55,95,2002,23507,22044,1463,6.2
"55095",55,95,2003,23997,22330,1667,6.9
"55095",55,95,2004,23660,22354,1306,5.5
"55095",55,95,2005,23865,22634,1231,5.2
"55095",55,95,2006,24182,22786,1396,5.8
"55095",55,95,2007,24222,22715,1507,6.2
"55095",55,95,2008,24061,22636,1425,5.9
"55095",55,95,2009,24271,21775,2496,10.3
"55095",55,95,2010,24047,21654,2393,10
"55095",55,95,2011,24148,22070,2078,8.6
"55095",55,95,2012,24002,22071,1931,8
"55095",55,95,2013,24313,22582,1731,7.1
"55095",55,95,2014,24445,23045,1400,5.7
"55095",55,95,2015,24625,23437,1188,4.8
"55095",55,95,2016,24970,23833,1137,4.6
"55095",55,95,2017,25067,24122,945,3.8
"55097",55,97,1990,32441,31239,1202,3.7
"55097",55,97,1991,34756,33319,1437,4.1
"55097",55,97,1992,36469,34781,1688,4.6
"55097",55,97,1993,37084,35181,1903,5.1
"55097",55,97,1994,36506,34666,1840,5
"55097",55,97,1995,36976,35252,1724,4.7
"55097",55,97,1996,37876,36280,1596,4.2
"55097",55,97,1997,38379,36778,1601,4.2
"55097",55,97,1998,37707,36224,1483,3.9
"55097",55,97,1999,36952,35712,1240,3.4
"55097",55,97,2000,38536,37155,1381,3.6
"55097",55,97,2001,38955,37281,1674,4.3
"55097",55,97,2002,39640,37669,1971,5
"55097",55,97,2003,40511,38437,2074,5.1
"55097",55,97,2004,40532,38538,1994,4.9
"55097",55,97,2005,39832,38004,1828,4.6
"55097",55,97,2006,40883,39040,1843,4.5
"55097",55,97,2007,41954,40073,1881,4.5
"55097",55,97,2008,42215,40302,1913,4.5
"55097",55,97,2009,43149,40072,3077,7.1
"55097",55,97,2010,39856,36670,3186,8
"55097",55,97,2011,39010,36073,2937,7.5
"55097",55,97,2012,38920,36073,2847,7.3
"55097",55,97,2013,38957,36265,2692,6.9
"55097",55,97,2014,39305,37117,2188,5.6
"55097",55,97,2015,39612,37797,1815,4.6
"55097",55,97,2016,39637,38131,1506,3.8
"55097",55,97,2017,39814,38589,1225,3.1
"55099",55,99,1990,7416,7024,392,5.3
"55099",55,99,1991,7296,6740,556,7.6
"55099",55,99,1992,7594,7119,475,6.3
"55099",55,99,1993,7631,7153,478,6.3
"55099",55,99,1994,7631,7089,542,7.1
"55099",55,99,1995,7877,7447,430,5.5
"55099",55,99,1996,7945,7438,507,6.4
"55099",55,99,1997,7714,7328,386,5
"55099",55,99,1998,7610,7115,495,6.5
"55099",55,99,1999,7119,6623,496,7
"55099",55,99,2000,8351,7914,437,5.2
"55099",55,99,2001,8498,8023,475,5.6
"55099",55,99,2002,8445,8001,444,5.3
"55099",55,99,2003,8682,8196,486,5.6
"55099",55,99,2004,8593,8185,408,4.7
"55099",55,99,2005,8623,8202,421,4.9
"55099",55,99,2006,8671,8191,480,5.5
"55099",55,99,2007,8232,7811,421,5.1
"55099",55,99,2008,8353,7931,422,5.1
"55099",55,99,2009,8341,7433,908,10.9
"55099",55,99,2010,7563,6736,827,10.9
"55099",55,99,2011,7228,6581,647,9
"55099",55,99,2012,7049,6519,530,7.5
"55099",55,99,2013,6856,6384,472,6.9
"55099",55,99,2014,6780,6414,366,5.4
"55099",55,99,2015,6856,6551,305,4.4
"55099",55,99,2016,6908,6612,296,4.3
"55099",55,99,2017,6830,6573,257,3.8
"55101",55,101,1990,89858,85705,4153,4.6
"55101",55,101,1991,90065,84052,6013,6.7
"55101",55,101,1992,91399,84928,6471,7.1
"55101",55,101,1993,91674,86081,5593,6.1
"55101",55,101,1994,92748,87565,5183,5.6
"55101",55,101,1995,93509,89344,4165,4.5
"55101",55,101,1996,94108,90042,4066,4.3
"55101",55,101,1997,94486,90490,3996,4.2
"55101",55,101,1998,93725,89915,3810,4.1
"55101",55,101,1999,92773,88596,4177,4.5
"55101",55,101,2000,99119,95097,4022,4.1
"55101",55,101,2001,99399,93764,5635,5.7
"55101",55,101,2002,99437,92990,6447,6.5
"55101",55,101,2003,100048,92964,7084,7.1
"55101",55,101,2004,99736,93731,6005,6
"55101",55,101,2005,98509,92687,5822,5.9
"55101",55,101,2006,99399,93764,5635,5.7
"55101",55,101,2007,100263,94374,5889,5.9
"55101",55,101,2008,99874,94079,5795,5.8
"55101",55,101,2009,99391,89224,10167,10.2
"55101",55,101,2010,100315,90122,10193,10.2
"55101",55,101,2011,100522,91431,9091,9
"55101",55,101,2012,100430,92035,8395,8.4
"55101",55,101,2013,99749,91448,8301,8.3
"55101",55,101,2014,99872,93288,6584,6.6
"55101",55,101,2015,99429,93848,5581,5.6
"55101",55,101,2016,100112,95188,4924,4.9
"55101",55,101,2017,100142,96065,4077,4.1
"55103",55,103,1990,8674,8319,355,4.1
"55103",55,103,1991,8237,7670,567,6.9
"55103",55,103,1992,8271,7718,553,6.7
"55103",55,103,1993,8446,8027,419,5
"55103",55,103,1994,8824,8410,414,4.7
"55103",55,103,1995,8873,8492,381,4.3
"55103",55,103,1996,8848,8508,340,3.8
"55103",55,103,1997,8959,8627,332,3.7
"55103",55,103,1998,8911,8567,344,3.9
"55103",55,103,1999,8363,8067,296,3.5
"55103",55,103,2000,9581,9238,343,3.6
"55103",55,103,2001,9764,9346,418,4.3
"55103",55,103,2002,9896,9439,457,4.6
"55103",55,103,2003,10222,9738,484,4.7
"55103",55,103,2004,10050,9579,471,4.7
"55103",55,103,2005,9835,9411,424,4.3
"55103",55,103,2006,9942,9477,465,4.7
"55103",55,103,2007,9940,9420,520,5.2
"55103",55,103,2008,10234,9750,484,4.7
"55103",55,103,2009,10153,9257,896,8.8
"55103",55,103,2010,9631,8764,867,9
"55103",55,103,2011,9676,8955,721,7.5
"55103",55,103,2012,9709,9102,607,6.3
"55103",55,103,2013,9350,8782,568,6.1
"55103",55,103,2014,9311,8841,470,5
"55103",55,103,2015,9301,8911,390,4.2
"55103",55,103,2016,9299,8951,348,3.7
"55103",55,103,2017,9408,9128,280,3
"55105",55,105,1990,72243,68285,3958,5.5
"55105",55,105,1991,74126,64838,9288,12.5
"55105",55,105,1992,74837,68815,6022,8
"55105",55,105,1993,75499,70718,4781,6.3
"55105",55,105,1994,76881,73027,3854,5
"55105",55,105,1995,79385,76153,3232,4.1
"55105",55,105,1996,79812,76699,3113,3.9
"55105",55,105,1997,81340,77987,3353,4.1
"55105",55,105,1998,80145,76874,3271,4.1
"55105",55,105,1999,79257,76014,3243,4.1
"55105",55,105,2000,82306,78752,3554,4.3
"55105",55,105,2001,83189,78526,4663,5.6
"55105",55,105,2002,82531,77440,5091,6.2
"55105",55,105,2003,83037,77856,5181,6.2
"55105",55,105,2004,83115,78443,4672,5.6
"55105",55,105,2005,83193,78337,4856,5.8
"55105",55,105,2006,84165,79907,4258,5.1
"55105",55,105,2007,84388,79647,4741,5.6
"55105",55,105,2008,83528,78299,5229,6.3
"55105",55,105,2009,82403,72056,10347,12.6
"55105",55,105,2010,82699,73384,9315,11.3
"55105",55,105,2011,81187,73449,7738,9.5
"55105",55,105,2012,81437,74654,6783,8.3
"55105",55,105,2013,82183,75847,6336,7.7
"55105",55,105,2014,82308,77267,5041,6.1
"55105",55,105,2015,83405,79082,4323,5.2
"55105",55,105,2016,84444,80725,3719,4.4
"55105",55,105,2017,85722,82531,3191,3.7
"55107",55,107,1990,6973,6405,568,8.1
"55107",55,107,1991,6706,5988,718,10.7
"55107",55,107,1992,6849,6155,694,10.1
"55107",55,107,1993,7177,6382,795,11.1
"55107",55,107,1994,7161,6484,677,9.5
"55107",55,107,1995,7275,6716,559,7.7
"55107",55,107,1996,7122,6611,511,7.2
"55107",55,107,1997,7201,6647,554,7.7
"55107",55,107,1998,7178,6749,429,6
"55107",55,107,1999,7146,6804,342,4.8
"55107",55,107,2000,7887,7463,424,5.4
"55107",55,107,2001,7927,7446,481,6.1
"55107",55,107,2002,7937,7405,532,6.7
"55107",55,107,2003,7882,7364,518,6.6
"55107",55,107,2004,7865,7363,502,6.4
"55107",55,107,2005,7992,7493,499,6.2
"55107",55,107,2006,7888,7363,525,6.7
"55107",55,107,2007,7306,6772,534,7.3
"55107",55,107,2008,7248,6739,509,7
"55107",55,107,2009,7380,6426,954,12.9
"55107",55,107,2010,7141,6264,877,12.3
"55107",55,107,2011,6888,6127,761,11
"55107",55,107,2012,6782,6169,613,9
"55107",55,107,2013,6736,6161,575,8.5
"55107",55,107,2014,6997,6539,458,6.5
"55107",55,107,2015,7001,6619,382,5.5
"55107",55,107,2016,7029,6671,358,5.1
"55107",55,107,2017,7038,6727,311,4.4
"55109",55,109,1990,27195,26226,969,3.6
"55109",55,109,1991,27656,26083,1573,5.7
"55109",55,109,1992,28661,27048,1613,5.6
"55109",55,109,1993,29272,27944,1328,4.5
"55109",55,109,1994,29990,28906,1084,3.6
"55109",55,109,1995,30849,29893,956,3.1
"55109",55,109,1996,32044,31070,974,3
"55109",55,109,1997,32878,31917,961,2.9
"55109",55,109,1998,33350,32457,893,2.7
"55109",55,109,1999,33639,32839,800,2.4
"55109",55,109,2000,37744,36806,938,2.5
"55109",55,109,2001,39261,37747,1514,3.9
"55109",55,109,2002,40631,38359,2272,5.6
"55109",55,109,2003,42447,39923,2524,5.9
"55109",55,109,2004,43486,41352,2134,4.9
"55109",55,109,2005,44624,42583,2041,4.6
"55109",55,109,2006,46753,44441,2312,4.9
"55109",55,109,2007,47330,45004,2326,4.9
"55109",55,109,2008,47543,45411,2132,4.5
"55109",55,109,2009,47322,43525,3797,8
"55109",55,109,2010,47068,43468,3600,7.6
"55109",55,109,2011,47520,44473,3047,6.4
"55109",55,109,2012,47486,44758,2728,5.7
"55109",55,109,2013,47820,45249,2571,5.4
"55109",55,109,2014,48320,46161,2159,4.5
"55109",55,109,2015,48846,46977,1869,3.8
"55109",55,109,2016,49850,47979,1871,3.8
"55109",55,109,2017,50667,49100,1567,3.1
"55111",55,111,1990,26188,24788,1400,5.3
"55111",55,111,1991,26367,24646,1721,6.5
"55111",55,111,1992,27409,25823,1586,5.8
"55111",55,111,1993,28487,26877,1610,5.7
"55111",55,111,1994,31400,29922,1478,4.7
"55111",55,111,1995,32370,31064,1306,4
"55111",55,111,1996,33127,31881,1246,3.8
"55111",55,111,1997,33735,32509,1226,3.6
"55111",55,111,1998,33881,32734,1147,3.4
"55111",55,111,1999,34318,33360,958,2.8
"55111",55,111,2000,33079,32060,1019,3.1
"55111",55,111,2001,34204,32925,1279,3.7
"55111",55,111,2002,34171,32627,1544,4.5
"55111",55,111,2003,34951,33280,1671,4.8
"55111",55,111,2004,34338,32804,1534,4.5
"55111",55,111,2005,34203,32692,1511,4.4
"55111",55,111,2006,34783,33211,1572,4.5
"55111",55,111,2007,35050,33395,1655,4.7
"55111",55,111,2008,35292,33557,1735,4.9
"55111",55,111,2009,35710,32755,2955,8.3
"55111",55,111,2010,35853,32832,3021,8.4
"55111",55,111,2011,36010,33271,2739,7.6
"55111",55,111,2012,35638,33179,2459,6.9
"55111",55,111,2013,35392,33179,2213,6.3
"55111",55,111,2014,34996,33251,1745,5
"55111",55,111,2015,35329,33880,1449,4.1
"55111",55,111,2016,35366,34109,1257,3.6
"55111",55,111,2017,35768,34726,1042,2.9
"55113",55,113,1990,6366,5851,515,8.1
"55113",55,113,1991,6789,6248,541,8
"55113",55,113,1992,7448,6805,643,8.6
"55113",55,113,1993,7877,7268,609,7.7
"55113",55,113,1994,8453,7881,572,6.8
"55113",55,113,1995,8908,8387,521,5.8
"55113",55,113,1996,9206,8586,620,6.7
"55113",55,113,1997,9363,8742,621,6.6
"55113",55,113,1998,9245,8668,577,6.2
"55113",55,113,1999,9326,8833,493,5.3
"55113",55,113,2000,8406,7946,460,5.5
"55113",55,113,2001,8771,8251,520,5.9
"55113",55,113,2002,9200,8623,577,6.3
"55113",55,113,2003,9041,8404,637,7
"55113",55,113,2004,9225,8663,562,6.1
"55113",55,113,2005,9348,8793,555,5.9
"55113",55,113,2006,9344,8742,602,6.4
"55113",55,113,2007,9571,8921,650,6.8
"55113",55,113,2008,9138,8497,641,7
"55113",55,113,2009,9087,8179,908,10
"55113",55,113,2010,8393,7446,947,11.3
"55113",55,113,2011,8185,7275,910,11.1
"55113",55,113,2012,8278,7387,891,10.8
"55113",55,113,2013,8191,7295,896,10.9
"55113",55,113,2014,7959,7248,711,8.9
"55113",55,113,2015,7822,7203,619,7.9
"55113",55,113,2016,7948,7454,494,6.2
"55113",55,113,2017,8048,7671,377,4.7
"55115",55,115,1990,18316,17395,921,5
"55115",55,115,1991,18323,17030,1293,7.1
"55115",55,115,1992,17882,16718,1164,6.5
"55115",55,115,1993,18385,17332,1053,5.7
"55115",55,115,1994,20028,18880,1148,5.7
"55115",55,115,1995,20474,19454,1020,5
"55115",55,115,1996,20676,19749,927,4.5
"55115",55,115,1997,21319,20362,957,4.5
"55115",55,115,1998,21141,20273,868,4.1
"55115",55,115,1999,20276,19546,730,3.6
"55115",55,115,2000,21969,21149,820,3.7
"55115",55,115,2001,22390,21299,1091,4.9
"55115",55,115,2002,22572,21348,1224,5.4
"55115",55,115,2003,22985,21688,1297,5.6
"55115",55,115,2004,22410,21263,1147,5.1
"55115",55,115,2005,22408,21315,1093,4.9
"55115",55,115,2006,22485,21340,1145,5.1
"55115",55,115,2007,22167,21001,1166,5.3
"55115",55,115,2008,22167,21010,1157,5.2
"55115",55,115,2009,22679,20573,2106,9.3
"55115",55,115,2010,21884,19645,2239,10.2
"55115",55,115,2011,21776,19791,1985,9.1
"55115",55,115,2012,21622,19895,1727,8
"55115",55,115,2013,21470,19868,1602,7.5
"55115",55,115,2014,21302,20039,1263,5.9
"55115",55,115,2015,21302,20265,1037,4.9
"55115",55,115,2016,21373,20489,884,4.1
"55115",55,115,2017,21624,20925,699,3.2
"55117",55,117,1990,55741,53433,2308,4.1
"55117",55,117,1991,55612,52452,3160,5.7
"55117",55,117,1992,56327,53907,2420,4.3
"55117",55,117,1993,57700,55767,1933,3.4
"55117",55,117,1994,60092,58187,1905,3.2
"55117",55,117,1995,61677,59971,1706,2.8
"55117",55,117,1996,61638,59846,1792,2.9
"55117",55,117,1997,61202,59651,1551,2.5
"55117",55,117,1998,61828,60359,1469,2.4
"55117",55,117,1999,62034,60766,1268,2
"55117",55,117,2000,64092,62433,1659,2.6
"55117",55,117,2001,64373,61868,2505,3.9
"55117",55,117,2002,64264,61141,3123,4.9
"55117",55,117,2003,64458,61155,3303,5.1
"55117",55,117,2004,64083,61221,2862,4.5
"55117",55,117,2005,64550,61993,2557,4
"55117",55,117,2006,65296,62707,2589,4
"55117",55,117,2007,66076,63287,2789,4.2
"55117",55,117,2008,65688,62733,2955,4.5
"55117",55,117,2009,64930,58975,5955,9.2
"55117",55,117,2010,62239,56457,5782,9.3
"55117",55,117,2011,61055,56062,4993,8.2
"55117",55,117,2012,60309,56178,4131,6.8
"55117",55,117,2013,60768,57071,3697,6.1
"55117",55,117,2014,61231,58449,2782,4.5
"55117",55,117,2015,61297,58986,2311,3.8
"55117",55,117,2016,61965,59867,2098,3.4
"55117",55,117,2017,63073,61320,1753,2.8
"55119",55,119,1990,9933,9275,658,6.6
"55119",55,119,1991,9964,9098,866,8.7
"55119",55,119,1992,10023,9263,760,7.6
"55119",55,119,1993,10351,9561,790,7.6
"55119",55,119,1994,10769,9982,787,7.3
"55119",55,119,1995,10815,10112,703,6.5
"55119",55,119,1996,10869,10317,552,5.1
"55119",55,119,1997,10805,10243,562,5.2
"55119",55,119,1998,10513,9982,531,5.1
"55119",55,119,1999,10320,9909,411,4
"55119",55,119,2000,10942,10517,425,3.9
"55119",55,119,2001,11103,10546,557,5
"55119",55,119,2002,11209,10610,599,5.3
"55119",55,119,2003,11722,11050,672,5.7
"55119",55,119,2004,11402,10796,606,5.3
"55119",55,119,2005,11100,10493,607,5.5
"55119",55,119,2006,10954,10404,550,5
"55119",55,119,2007,10471,9871,600,5.7
"55119",55,119,2008,10450,9762,688,6.6
"55119",55,119,2009,10744,9508,1236,11.5
"55119",55,119,2010,11449,10273,1176,10.3
"55119",55,119,2011,11298,10340,958,8.5
"55119",55,119,2012,11080,10283,797,7.2
"55119",55,119,2013,10992,10286,706,6.4
"55119",55,119,2014,10640,10073,567,5.3
"55119",55,119,2015,10707,10236,471,4.4
"55119",55,119,2016,11121,10664,457,4.1
"55119",55,119,2017,11277,10888,389,3.4
"55121",55,121,1990,13375,12517,858,6.4
"55121",55,121,1991,13281,12217,1064,8
"55121",55,121,1992,13508,12363,1145,8.5
"55121",55,121,1993,13712,12702,1010,7.4
"55121",55,121,1994,14115,13164,951,6.7
"55121",55,121,1995,14371,13597,774,5.4
"55121",55,121,1996,14778,14055,723,4.9
"55121",55,121,1997,14730,13984,746,5.1
"55121",55,121,1998,14552,13929,623,4.3
"55121",55,121,1999,14149,13607,542,3.8
"55121",55,121,2000,15369,14739,630,4.1
"55121",55,121,2001,15715,14906,809,5.1
"55121",55,121,2002,15816,14942,874,5.5
"55121",55,121,2003,15885,14960,925,5.8
"55121",55,121,2004,15806,15044,762,4.8
"55121",55,121,2005,15752,15063,689,4.4
"55121",55,121,2006,16183,15484,699,4.3
"55121",55,121,2007,16308,15577,731,4.5
"55121",55,121,2008,16183,15441,742,4.6
"55121",55,121,2009,16315,15081,1234,7.6
"55121",55,121,2010,15984,14777,1207,7.6
"55121",55,121,2011,16199,15124,1075,6.6
"55121",55,121,2012,16367,15433,934,5.7
"55121",55,121,2013,16417,15500,917,5.6
"55121",55,121,2014,16531,15778,753,4.6
"55121",55,121,2015,16628,15978,650,3.9
"55121",55,121,2016,16727,16113,614,3.7
"55121",55,121,2017,16611,16102,509,3.1
"55123",55,123,1990,12587,12004,583,4.6
"55123",55,123,1991,12411,11604,807,6.5
"55123",55,123,1992,12586,11807,779,6.2
"55123",55,123,1993,13047,12287,760,5.8
"55123",55,123,1994,13461,12744,717,5.3
"55123",55,123,1995,13707,13033,674,4.9
"55123",55,123,1996,13673,13039,634,4.6
"55123",55,123,1997,13933,13307,626,4.5
"55123",55,123,1998,14083,13486,597,4.2
"55123",55,123,1999,13684,13131,553,4
"55123",55,123,2000,14306,13756,550,3.8
"55123",55,123,2001,14616,13928,688,4.7
"55123",55,123,2002,14859,14062,797,5.4
"55123",55,123,2003,15324,14513,811,5.3
"55123",55,123,2004,14762,14062,700,4.7
"55123",55,123,2005,14237,13592,645,4.5
"55123",55,123,2006,14399,13703,696,4.8
"55123",55,123,2007,14217,13477,740,5.2
"55123",55,123,2008,14662,13943,719,4.9
"55123",55,123,2009,15250,14060,1190,7.8
"55123",55,123,2010,15162,13966,1196,7.9
"55123",55,123,2011,15178,14121,1057,7
"55123",55,123,2012,15043,14084,959,6.4
"55123",55,123,2013,15138,14235,903,6
"55123",55,123,2014,15046,14319,727,4.8
"55123",55,123,2015,15505,14869,636,4.1
"55123",55,123,2016,15818,15243,575,3.6
"55123",55,123,2017,16052,15560,492,3.1
"55125",55,125,1990,8254,7791,463,5.6
"55125",55,125,1991,8468,7956,512,6
"55125",55,125,1992,8901,8446,455,5.1
"55125",55,125,1993,9401,8893,508,5.4
"55125",55,125,1994,9908,9312,596,6
"55125",55,125,1995,10537,10027,510,4.8
"55125",55,125,1996,10978,10465,513,4.7
"55125",55,125,1997,11162,10615,547,4.9
"55125",55,125,1998,11159,10634,525,4.7
"55125",55,125,1999,11233,10740,493,4.4
"55125",55,125,2000,10933,10370,563,5.1
"55125",55,125,2001,11292,10667,625,5.5
"55125",55,125,2002,11736,11029,707,6
"55125",55,125,2003,11688,10870,818,7
"55125",55,125,2004,11847,11090,757,6.4
"55125",55,125,2005,11766,11065,701,6
"55125",55,125,2006,11765,11050,715,6.1
"55125",55,125,2007,11588,10847,741,6.4
"55125",55,125,2008,11250,10526,724,6.4
"55125",55,125,2009,10993,9905,1088,9.9
"55125",55,125,2010,10345,9176,1169,11.3
"55125",55,125,2011,10164,9048,1116,11
"55125",55,125,2012,10101,9088,1013,10
"55125",55,125,2013,10183,9152,1031,10.1
"55125",55,125,2014,10085,9234,851,8.4
"55125",55,125,2015,10008,9307,701,7
"55125",55,125,2016,10012,9447,565,5.6
"55125",55,125,2017,10188,9744,444,4.4
"55127",55,127,1990,41724,40582,1142,2.7
"55127",55,127,1991,44918,43244,1674,3.7
"55127",55,127,1992,45313,43556,1757,3.9
"55127",55,127,1993,49044,47572,1472,3
"55127",55,127,1994,50386,48967,1419,2.8
"55127",55,127,1995,51452,50101,1351,2.6
"55127",55,127,1996,52749,51353,1396,2.6
"55127",55,127,1997,52406,50843,1563,3
"55127",55,127,1998,52462,51097,1365,2.6
"55127",55,127,1999,52978,51679,1299,2.5
"55127",55,127,2000,53747,52137,1610,3
"55127",55,127,2001,54814,52640,2174,4
"55127",55,127,2002,55579,52860,2719,4.9
"55127",55,127,2003,56384,53630,2754,4.9
"55127",55,127,2004,56264,53787,2477,4.4
"55127",55,127,2005,55870,53533,2337,4.2
"55127",55,127,2006,56073,53651,2422,4.3
"55127",55,127,2007,56079,53487,2592,4.6
"55127",55,127,2008,56534,53842,2692,4.8
"55127",55,127,2009,56186,51099,5087,9.1
"55127",55,127,2010,56361,51277,5084,9
"55127",55,127,2011,56264,51770,4494,8
"55127",55,127,2012,56035,51976,4059,7.2
"55127",55,127,2013,56804,52917,3887,6.8
"55127",55,127,2014,57017,53861,3156,5.5
"55127",55,127,2015,57027,54385,2642,4.6
"55127",55,127,2016,57919,55615,2304,4
"55127",55,127,2017,58265,56356,1909,3.3
"55129",55,129,1990,6294,5846,448,7.1
"55129",55,129,1991,6730,6202,528,7.8
"55129",55,129,1992,6786,6251,535,7.9
"55129",55,129,1993,7044,6506,538,7.6
"55129",55,129,1994,7146,6625,521,7.3
"55129",55,129,1995,7367,6867,500,6.8
"55129",55,129,1996,7595,7135,460,6.1
"55129",55,129,1997,7884,7390,494,6.3
"55129",55,129,1998,7869,7399,470,6
"55129",55,129,1999,7835,7383,452,5.8
"55129",55,129,2000,7979,7559,420,5.3
"55129",55,129,2001,8185,7688,497,6.1
"55129",55,129,2002,8132,7571,561,6.9
"55129",55,129,2003,8323,7711,612,7.4
"55129",55,129,2004,8243,7725,518,6.3
"55129",55,129,2005,8289,7783,506,6.1
"55129",55,129,2006,8093,7560,533,6.6
"55129",55,129,2007,7902,7361,541,6.8
"55129",55,129,2008,7842,7319,523,6.7
"55129",55,129,2009,7953,7176,777,9.8
"55129",55,129,2010,8043,7262,781,9.7
"55129",55,129,2011,7985,7274,711,8.9
"55129",55,129,2012,8089,7450,639,7.9
"55129",55,129,2013,8000,7406,594,7.4
"55129",55,129,2014,7934,7440,494,6.2
"55129",55,129,2015,7963,7536,427,5.4
"55129",55,129,2016,8005,7608,397,5
"55129",55,129,2017,8009,7697,312,3.9
"55131",55,131,1990,53579,51545,2034,3.8
"55131",55,131,1991,54686,51982,2704,4.9
"55131",55,131,1992,57355,54592,2763,4.8
"55131",55,131,1993,59226,57078,2148,3.6
"55131",55,131,1994,61965,59701,2264,3.7
"55131",55,131,1995,64047,62142,1905,3
"55131",55,131,1996,66031,64240,1791,2.7
"55131",55,131,1997,67201,65399,1802,2.7
"55131",55,131,1998,67950,66135,1815,2.7
"55131",55,131,1999,68411,66845,1566,2.3
"55131",55,131,2000,69541,67533,2008,2.9
"55131",55,131,2001,70376,67625,2751,3.9
"55131",55,131,2002,70495,67068,3427,4.9
"55131",55,131,2003,71193,67417,3776,5.3
"55131",55,131,2004,71547,68328,3219,4.5
"55131",55,131,2005,71985,68990,2995,4.2
"55131",55,131,2006,73930,70867,3063,4.1
"55131",55,131,2007,73845,70663,3182,4.3
"55131",55,131,2008,74474,71229,3245,4.4
"55131",55,131,2009,74836,68338,6498,8.7
"55131",55,131,2010,75605,69492,6113,8.1
"55131",55,131,2011,75296,70129,5167,6.9
"55131",55,131,2012,75076,70466,4610,6.1
"55131",55,131,2013,75273,70972,4301,5.7
"55131",55,131,2014,75787,72347,3440,4.5
"55131",55,131,2015,76121,73269,2852,3.7
"55131",55,131,2016,77492,74906,2586,3.3
"55131",55,131,2017,77851,75684,2167,2.8
"55133",55,133,1990,173719,167830,5889,3.4
"55133",55,133,1991,175593,168235,7358,4.2
"55133",55,133,1992,182470,175054,7416,4.1
"55133",55,133,1993,187880,181155,6725,3.6
"55133",55,133,1994,195148,188346,6802,3.5
"55133",55,133,1995,201058,195645,5413,2.7
"55133",55,133,1996,207110,201935,5175,2.5
"55133",55,133,1997,211533,206299,5234,2.5
"55133",55,133,1998,213893,208948,4945,2.3
"55133",55,133,1999,215611,211022,4589,2.1
"55133",55,133,2000,209660,203795,5865,2.8
"55133",55,133,2001,211037,203293,7744,3.7
"55133",55,133,2002,211632,201776,9856,4.7
"55133",55,133,2003,212988,202595,10393,4.9
"55133",55,133,2004,212347,203341,9006,4.2
"55133",55,133,2005,211868,203760,8108,3.8
"55133",55,133,2006,216291,208079,8212,3.8
"55133",55,133,2007,214220,205558,8662,4
"55133",55,133,2008,214460,205879,8581,4
"55133",55,133,2009,213079,197001,16078,7.5
"55133",55,133,2010,218013,202000,16013,7.3
"55133",55,133,2011,217776,203717,14059,6.5
"55133",55,133,2012,217595,205076,12519,5.8
"55133",55,133,2013,219057,206992,12065,5.5
"55133",55,133,2014,220628,210862,9766,4.4
"55133",55,133,2015,221565,213153,8412,3.8
"55133",55,133,2016,225680,217911,7769,3.4
"55133",55,133,2017,226578,219998,6580,2.9
"55135",55,135,1990,22911,21808,1103,4.8
"55135",55,135,1991,23546,22273,1273,5.4
"55135",55,135,1992,24299,23107,1192,4.9
"55135",55,135,1993,25766,24565,1201,4.7
"55135",55,135,1994,25878,24504,1374,5.3
"55135",55,135,1995,25961,24806,1155,4.4
"55135",55,135,1996,26418,25442,976,3.7
"55135",55,135,1997,27147,26188,959,3.5
"55135",55,135,1998,26867,25990,877,3.3
"55135",55,135,1999,26100,25223,877,3.4
"55135",55,135,2000,27706,26747,959,3.5
"55135",55,135,2001,28092,26778,1314,4.7
"55135",55,135,2002,28291,26772,1519,5.4
"55135",55,135,2003,28653,26998,1655,5.8
"55135",55,135,2004,28232,26744,1488,5.3
"55135",55,135,2005,28000,26521,1479,5.3
"55135",55,135,2006,28487,27060,1427,5
"55135",55,135,2007,28194,26694,1500,5.3
"55135",55,135,2008,28040,26539,1501,5.4
"55135",55,135,2009,28381,25665,2716,9.6
"55135",55,135,2010,27744,25123,2621,9.4
"55135",55,135,2011,27712,25400,2312,8.3
"55135",55,135,2012,27389,25311,2078,7.6
"55135",55,135,2013,27362,25361,2001,7.3
"55135",55,135,2014,27329,25783,1546,5.7
"55135",55,135,2015,27062,25804,1258,4.6
"55135",55,135,2016,27076,26008,1068,3.9
"55135",55,135,2017,26715,25859,856,3.2
"55137",55,137,1990,9043,8492,551,6.1
"55137",55,137,1991,9099,8424,675,7.4
"55137",55,137,1992,9281,8632,649,7
"55137",55,137,1993,9516,8810,706,7.4
"55137",55,137,1994,9459,8776,683,7.2
"55137",55,137,1995,9798,9237,561,5.7
"55137",55,137,1996,10174,9569,605,5.9
"55137",55,137,1997,10723,10105,618,5.8
"55137",55,137,1998,10618,10079,539,5.1
"55137",55,137,1999,10366,9889,477,4.6
"55137",55,137,2000,11756,11249,507,4.3
"55137",55,137,2001,12345,11680,665,5.4
"55137",55,137,2002,12414,11636,778,6.3
"55137",55,137,2003,12749,11904,845,6.6
"55137",55,137,2004,12556,11802,754,6
"55137",55,137,2005,12598,11903,695,5.5
"55137",55,137,2006,12842,12117,725,5.6
"55137",55,137,2007,12718,11975,743,5.8
"55137",55,137,2008,12710,11961,749,5.9
"55137",55,137,2009,12851,11578,1273,9.9
"55137",55,137,2010,12026,10731,1295,10.8
"55137",55,137,2011,11919,10752,1167,9.8
"55137",55,137,2012,12020,10968,1052,8.8
"55137",55,137,2013,11830,10816,1014,8.6
"55137",55,137,2014,11619,10789,830,7.1
"55137",55,137,2015,11497,10774,723,6.3
"55137",55,137,2016,11523,10946,577,5
"55137",55,137,2017,11557,11103,454,3.9
"55139",55,139,1990,83581,80711,2870,3.4
"55139",55,139,1991,84969,81795,3174,3.7
"55139",55,139,1992,88428,85452,2976,3.4
"55139",55,139,1993,91675,88104,3571,3.9
"55139",55,139,1994,93838,90323,3515,3.7
"55139",55,139,1995,95157,92320,2837,3
"55139",55,139,1996,96968,94285,2683,2.8
"55139",55,139,1997,97627,94835,2792,2.9
"55139",55,139,1998,96983,94364,2619,2.7
"55139",55,139,1999,95565,93371,2194,2.3
"55139",55,139,2000,89268,86736,2532,2.8
"55139",55,139,2001,91273,87792,3481,3.8
"55139",55,139,2002,92228,87665,4563,4.9
"55139",55,139,2003,92052,87134,4918,5.3
"55139",55,139,2004,91465,87216,4249,4.6
"55139",55,139,2005,91185,87160,4025,4.4
"55139",55,139,2006,92363,88220,4143,4.5
"55139",55,139,2007,93681,89412,4269,4.6
"55139",55,139,2008,94371,90227,4144,4.4
"55139",55,139,2009,95244,87924,7320,7.7
"55139",55,139,2010,92451,85227,7224,7.8
"55139",55,139,2011,92403,85891,6512,7
"55139",55,139,2012,92511,86350,6161,6.7
"55139",55,139,2013,91681,85828,5853,6.4
"55139",55,139,2014,91612,86838,4774,5.2
"55139",55,139,2015,91521,87644,3877,4.2
"55139",55,139,2016,93421,90102,3319,3.6
"55139",55,139,2017,94244,91437,2807,3
"55141",55,141,1990,37407,35838,1569,4.2
"55141",55,141,1991,37979,36224,1755,4.6
"55141",55,141,1992,38821,36665,2156,5.6
"55141",55,141,1993,39494,37388,2106,5.3
"55141",55,141,1994,39677,37770,1907,4.8
"55141",55,141,1995,39781,38079,1702,4.3
"55141",55,141,1996,40068,38492,1576,3.9
"55141",55,141,1997,40686,38927,1759,4.3
"55141",55,141,1998,40469,38649,1820,4.5
"55141",55,141,1999,39807,38333,1474,3.7
"55141",55,141,2000,40745,39121,1624,4
"55141",55,141,2001,41065,39056,2009,4.9
"55141",55,141,2002,41067,38674,2393,5.8
"55141",55,141,2003,41428,38964,2464,5.9
"55141",55,141,2004,40303,37978,2325,5.8
"55141",55,141,2005,39548,37319,2229,5.6
"55141",55,141,2006,40100,37957,2143,5.3
"55141",55,141,2007,41927,39705,2222,5.3
"55141",55,141,2008,42050,39765,2285,5.4
"55141",55,141,2009,41876,38201,3675,8.8
"55141",55,141,2010,39966,36256,3710,9.3
"55141",55,141,2011,40011,36675,3336,8.3
"55141",55,141,2012,39717,36723,2994,7.5
"55141",55,141,2013,39013,36177,2836,7.3
"55141",55,141,2014,34773,32453,2320,6.7
"55141",55,141,2015,34448,32552,1896,5.5
"55141",55,141,2016,34749,33112,1637,4.7
"55141",55,141,2017,35313,33985,1328,3.8
"56001",56,1,1990,16709,15821,888,5.3
"56001",56,1,1991,16251,15678,573,3.5
"56001",56,1,1992,15976,15517,459,2.9
"56001",56,1,1993,15318,14908,410,2.7
"56001",56,1,1994,16261,15850,411,2.5
"56001",56,1,1995,16726,16361,365,2.2
"56001",56,1,1996,16972,16657,315,1.9
"56001",56,1,1997,16790,16460,330,2
"56001",56,1,1998,17497,17138,359,2.1
"56001",56,1,1999,18323,18002,321,1.8
"56001",56,1,2000,18291,17666,625,3.4
"56001",56,1,2001,18485,17850,635,3.4
"56001",56,1,2002,18358,17754,604,3.3
"56001",56,1,2003,18772,18160,612,3.3
"56001",56,1,2004,19829,19248,581,2.9
"56001",56,1,2005,19369,18835,534,2.8
"56001",56,1,2006,18612,18125,487,2.6
"56001",56,1,2007,18535,18087,448,2.4
"56001",56,1,2008,18913,18435,478,2.5
"56001",56,1,2009,19705,18882,823,4.2
"56001",56,1,2010,21381,20425,956,4.5
"56001",56,1,2011,21832,20915,917,4.2
"56001",56,1,2012,20736,19845,891,4.3
"56001",56,1,2013,20692,19916,776,3.8
"56001",56,1,2014,20487,19781,706,3.4
"56001",56,1,2015,20681,20027,654,3.2
"56001",56,1,2016,21007,20341,666,3.2
"56001",56,1,2017,20471,19888,583,2.8
"56003",56,3,1990,4868,4576,292,6
"56003",56,3,1991,4749,4454,295,6.2
"56003",56,3,1992,4824,4498,326,6.8
"56003",56,3,1993,4868,4568,300,6.2
"56003",56,3,1994,5055,4726,329,6.5
"56003",56,3,1995,5145,4846,299,5.8
"56003",56,3,1996,5362,5045,317,5.9
"56003",56,3,1997,5547,5243,304,5.5
"56003",56,3,1998,5757,5398,359,6.2
"56003",56,3,1999,5793,5431,362,6.2
"56003",56,3,2000,5316,5044,272,5.1
"56003",56,3,2001,5326,5075,251,4.7
"56003",56,3,2002,5164,4892,272,5.3
"56003",56,3,2003,5210,4953,257,4.9
"56003",56,3,2004,5313,5067,246,4.6
"56003",56,3,2005,5299,5060,239,4.5
"56003",56,3,2006,5291,5071,220,4.2
"56003",56,3,2007,4865,4668,197,4
"56003",56,3,2008,4930,4732,198,4
"56003",56,3,2009,5066,4625,441,8.7
"56003",56,3,2010,5631,5255,376,6.7
"56003",56,3,2011,5741,5391,350,6.1
"56003",56,3,2012,5637,5320,317,5.6
"56003",56,3,2013,5583,5293,290,5.2
"56003",56,3,2014,5579,5329,250,4.5
"56003",56,3,2015,5571,5323,248,4.5
"56003",56,3,2016,5547,5275,272,4.9
"56003",56,3,2017,5396,5173,223,4.1
"56005",56,5,1990,16402,15596,806,4.9
"56005",56,5,1991,16641,15818,823,4.9
"56005",56,5,1992,16741,15797,944,5.6
"56005",56,5,1993,17188,16283,905,5.3
"56005",56,5,1994,18070,17240,830,4.6
"56005",56,5,1995,18364,17495,869,4.7
"56005",56,5,1996,18549,17686,863,4.7
"56005",56,5,1997,18719,17788,931,5
"56005",56,5,1998,19151,18242,909,4.7
"56005",56,5,1999,19684,18714,970,4.9
"56005",56,5,2000,19898,19278,620,3.1
"56005",56,5,2001,21384,20814,570,2.7
"56005",56,5,2002,22090,21434,656,3
"56005",56,5,2003,21824,21055,769,3.5
"56005",56,5,2004,21925,21262,663,3
"56005",56,5,2005,23193,22592,601,2.6
"56005",56,5,2006,24864,24332,532,2.1
"56005",56,5,2007,25965,25440,525,2
"56005",56,5,2008,27357,26822,535,2
"56005",56,5,2009,28805,27265,1540,5.3
"56005",56,5,2010,26296,24709,1587,6
"56005",56,5,2011,25872,24605,1267,4.9
"56005",56,5,2012,26119,24907,1212,4.6
"56005",56,5,2013,25698,24607,1091,4.2
"56005",56,5,2014,26254,25376,878,3.3
"56005",56,5,2015,25867,24844,1023,4
"56005",56,5,2016,24436,22697,1739,7.1
"56005",56,5,2017,23083,21945,1138,4.9
"56007",56,7,1990,8820,8362,458,5.2
"56007",56,7,1991,8660,8159,501,5.8
"56007",56,7,1992,8315,7828,487,5.9
"56007",56,7,1993,8360,7863,497,5.9
"56007",56,7,1994,8709,8259,450,5.2
"56007",56,7,1995,8700,8240,460,5.3
"56007",56,7,1996,8510,8069,441,5.2
"56007",56,7,1997,8290,7889,401,4.8
"56007",56,7,1998,8267,7832,435,5.3
"56007",56,7,1999,8407,7985,422,5
"56007",56,7,2000,8093,7749,344,4.3
"56007",56,7,2001,7965,7617,348,4.4
"56007",56,7,2002,7789,7439,350,4.5
"56007",56,7,2003,7706,7296,410,5.3
"56007",56,7,2004,7606,7274,332,4.4
"56007",56,7,2005,7612,7316,296,3.9
"56007",56,7,2006,7813,7552,261,3.3
"56007",56,7,2007,8234,7996,238,2.9
"56007",56,7,2008,8266,7998,268,3.2
"56007",56,7,2009,7950,7376,574,7.2
"56007",56,7,2010,8254,7698,556,6.7
"56007",56,7,2011,8158,7670,488,6
"56007",56,7,2012,8215,7790,425,5.2
"56007",56,7,2013,8378,8016,362,4.3
"56007",56,7,2014,8438,8102,336,4
"56007",56,7,2015,8455,8139,316,3.7
"56007",56,7,2016,8376,7987,389,4.6
"56007",56,7,2017,7957,7641,316,4
"56009",56,9,1990,5728,5408,320,5.6
"56009",56,9,1991,5777,5477,300,5.2
"56009",56,9,1992,5996,5648,348,5.8
"56009",56,9,1993,6127,5785,342,5.6
"56009",56,9,1994,6231,5917,314,5
"56009",56,9,1995,6390,6053,337,5.3
"56009",56,9,1996,6513,6167,346,5.3
"56009",56,9,1997,6566,6183,383,5.8
"56009",56,9,1998,6593,6252,341,5.2
"56009",56,9,1999,6669,6340,329,4.9
"56009",56,9,2000,6581,6318,263,4
"56009",56,9,2001,6517,6267,250,3.8
"56009",56,9,2002,6271,6010,261,4.2
"56009",56,9,2003,6523,6233,290,4.4
"56009",56,9,2004,6539,6282,257,3.9
"56009",56,9,2005,6674,6428,246,3.7
"56009",56,9,2006,6807,6574,233,3.4
"56009",56,9,2007,6892,6696,196,2.8
"56009",56,9,2008,7344,7142,202,2.8
"56009",56,9,2009,7634,7197,437,5.7
"56009",56,9,2010,7568,7155,413,5.5
"56009",56,9,2011,7659,7289,370,4.8
"56009",56,9,2012,7976,7634,342,4.3
"56009",56,9,2013,8108,7811,297,3.7
"56009",56,9,2014,8340,8089,251,3
"56009",56,9,2015,8332,8026,306,3.7
"56009",56,9,2016,7887,7401,486,6.2
"56009",56,9,2017,7481,7151,330,4.4
"56011",56,11,1990,2676,2592,84,3.1
"56011",56,11,1991,2687,2607,80,3
"56011",56,11,1992,2752,2664,88,3.2
"56011",56,11,1993,2895,2788,107,3.7
"56011",56,11,1994,2878,2769,109,3.8
"56011",56,11,1995,3048,2923,125,4.1
"56011",56,11,1996,3050,2914,136,4.5
"56011",56,11,1997,2978,2843,135,4.5
"56011",56,11,1998,2979,2823,156,5.2
"56011",56,11,1999,3069,2922,147,4.8
"56011",56,11,2000,3172,3054,118,3.7
"56011",56,11,2001,3109,3001,108,3.5
"56011",56,11,2002,3074,2963,111,3.6
"56011",56,11,2003,3128,2998,130,4.2
"56011",56,11,2004,3211,3089,122,3.8
"56011",56,11,2005,3253,3141,112,3.4
"56011",56,11,2006,3354,3260,94,2.8
"56011",56,11,2007,3396,3303,93,2.7
"56011",56,11,2008,3480,3379,101,2.9
"56011",56,11,2009,3596,3391,205,5.7
"56011",56,11,2010,3910,3715,195,5
"56011",56,11,2011,3885,3696,189,4.9
"56011",56,11,2012,3814,3628,186,4.9
"56011",56,11,2013,3691,3527,164,4.4
"56011",56,11,2014,3711,3567,144,3.9
"56011",56,11,2015,3716,3586,130,3.5
"56011",56,11,2016,3745,3575,170,4.5
"56011",56,11,2017,3679,3551,128,3.5
"56013",56,13,1990,15730,14548,1182,7.5
"56013",56,13,1991,15648,14549,1099,7
"56013",56,13,1992,16097,14880,1217,7.6
"56013",56,13,1993,16306,15152,1154,7.1
"56013",56,13,1994,17073,15827,1246,7.3
"56013",56,13,1995,17547,16256,1291,7.4
"56013",56,13,1996,17770,16416,1354,7.6
"56013",56,13,1997,17413,16039,1374,7.9
"56013",56,13,1998,17537,16179,1358,7.7
"56013",56,13,1999,18020,16706,1314,7.3
"56013",56,13,2000,17664,16731,933,5.3
"56013",56,13,2001,18104,17186,918,5.1
"56013",56,13,2002,18147,17197,950,5.2
"56013",56,13,2003,17884,16893,991,5.5
"56013",56,13,2004,17697,16804,893,5
"56013",56,13,2005,17707,16875,832,4.7
"56013",56,13,2006,17585,16826,759,4.3
"56013",56,13,2007,17893,17221,672,3.8
"56013",56,13,2008,18397,17642,755,4.1
"56013",56,13,2009,19255,17768,1487,7.7
"56013",56,13,2010,20971,19514,1457,6.9
"56013",56,13,2011,21212,19844,1368,6.4
"56013",56,13,2012,21271,19989,1282,6
"56013",56,13,2013,21046,19848,1198,5.7
"56013",56,13,2014,20557,19537,1020,5
"56013",56,13,2015,20289,19160,1129,5.6
"56013",56,13,2016,20059,18631,1428,7.1
"56013",56,13,2017,19407,18327,1080,5.6
"56015",56,15,1990,5947,5675,272,4.6
"56015",56,15,1991,5926,5694,232,3.9
"56015",56,15,1992,6050,5771,279,4.6
"56015",56,15,1993,6071,5803,268,4.4
"56015",56,15,1994,6332,6054,278,4.4
"56015",56,15,1995,6438,6154,284,4.4
"56015",56,15,1996,6444,6125,319,5
"56015",56,15,1997,6384,6083,301,4.7
"56015",56,15,1998,6431,6137,294,4.6
"56015",56,15,1999,6536,6303,233,3.6
"56015",56,15,2000,6246,6015,231,3.7
"56015",56,15,2001,6137,5893,244,4
"56015",56,15,2002,5943,5694,249,4.2
"56015",56,15,2003,5875,5616,259,4.4
"56015",56,15,2004,5792,5543,249,4.3
"56015",56,15,2005,5678,5428,250,4.4
"56015",56,15,2006,5856,5630,226,3.9
"56015",56,15,2007,5861,5671,190,3.2
"56015",56,15,2008,6084,5869,215,3.5
"56015",56,15,2009,6315,5975,340,5.4
"56015",56,15,2010,7500,7132,368,4.9
"56015",56,15,2011,7641,7275,366,4.8
"56015",56,15,2012,7511,7160,351,4.7
"56015",56,15,2013,7333,7025,308,4.2
"56015",56,15,2014,7139,6883,256,3.6
"56015",56,15,2015,7095,6861,234,3.3
"56015",56,15,2016,7041,6799,242,3.4
"56015",56,15,2017,6983,6786,197,2.8
"56017",56,17,1990,2409,2316,93,3.9
"56017",56,17,1991,2432,2320,112,4.6
"56017",56,17,1992,2443,2309,134,5.5
"56017",56,17,1993,2509,2374,135,5.4
"56017",56,17,1994,2560,2431,129,5
"56017",56,17,1995,2426,2311,115,4.7
"56017",56,17,1996,2527,2422,105,4.2
"56017",56,17,1997,2409,2308,101,4.2
"56017",56,17,1998,2400,2292,108,4.5
"56017",56,17,1999,2438,2318,120,4.9
"56017",56,17,2000,2642,2544,98,3.7
"56017",56,17,2001,2631,2523,108,4.1
"56017",56,17,2002,2525,2408,117,4.6
"56017",56,17,2003,2387,2288,99,4.1
"56017",56,17,2004,2357,2266,91,3.9
"56017",56,17,2005,2312,2220,92,4
"56017",56,17,2006,2310,2226,84,3.6
"56017",56,17,2007,2350,2272,78,3.3
"56017",56,17,2008,2413,2334,79,3.3
"56017",56,17,2009,2537,2387,150,5.9
"56017",56,17,2010,2569,2435,134,5.2
"56017",56,17,2011,2600,2468,132,5.1
"56017",56,17,2012,2578,2456,122,4.7
"56017",56,17,2013,2557,2436,121,4.7
"56017",56,17,2014,2487,2384,103,4.1
"56017",56,17,2015,2405,2304,101,4.2
"56017",56,17,2016,2428,2313,115,4.7
"56017",56,17,2017,2329,2239,90,3.9
"56019",56,19,1990,3415,3250,165,4.8
"56019",56,19,1991,3359,3182,177,5.3
"56019",56,19,1992,3295,3104,191,5.8
"56019",56,19,1993,3341,3186,155,4.6
"56019",56,19,1994,3616,3476,140,3.9
"56019",56,19,1995,3590,3455,135,3.8
"56019",56,19,1996,3741,3601,140,3.7
"56019",56,19,1997,3719,3558,161,4.3
"56019",56,19,1998,3743,3593,150,4
"56019",56,19,1999,3918,3788,130,3.3
"56019",56,19,2000,3573,3438,135,3.8
"56019",56,19,2001,3525,3388,137,3.9
"56019",56,19,2002,3575,3436,139,3.9
"56019",56,19,2003,3652,3492,160,4.4
"56019",56,19,2004,3712,3578,134,3.6
"56019",56,19,2005,3783,3641,142,3.8
"56019",56,19,2006,3815,3696,119,3.1
"56019",56,19,2007,3888,3759,129,3.3
"56019",56,19,2008,4052,3919,133,3.3
"56019",56,19,2009,4100,3792,308,7.5
"56019",56,19,2010,4535,4226,309,6.8
"56019",56,19,2011,4517,4233,284,6.3
"56019",56,19,2012,4472,4234,238,5.3
"56019",56,19,2013,4478,4251,227,5.1
"56019",56,19,2014,4480,4279,201,4.5
"56019",56,19,2015,4212,4005,207,4.9
"56019",56,19,2016,4213,3990,223,5.3
"56019",56,19,2017,4196,4022,174,4.1
"56021",56,21,1990,36696,34868,1828,5
"56021",56,21,1991,36176,34668,1508,4.2
"56021",56,21,1992,37132,35571,1561,4.2
"56021",56,21,1993,37916,36402,1514,4
"56021",56,21,1994,38798,37206,1592,4.1
"56021",56,21,1995,39110,37660,1450,3.7
"56021",56,21,1996,39109,37711,1398,3.6
"56021",56,21,1997,38910,37494,1416,3.6
"56021",56,21,1998,39258,37875,1383,3.5
"56021",56,21,1999,40063,38724,1339,3.3
"56021",56,21,2000,40224,38689,1535,3.8
"56021",56,21,2001,40025,38401,1624,4.1
"56021",56,21,2002,40826,39131,1695,4.2
"56021",56,21,2003,41853,40011,1842,4.4
"56021",56,21,2004,41577,39737,1840,4.4
"56021",56,21,2005,41359,39658,1701,4.1
"56021",56,21,2006,41432,39830,1602,3.9
"56021",56,21,2007,41835,40350,1485,3.5
"56021",56,21,2008,42525,40864,1661,3.9
"56021",56,21,2009,43841,41003,2838,6.5
"56021",56,21,2010,46182,43092,3090,6.7
"56021",56,21,2011,47167,44249,2918,6.2
"56021",56,21,2012,47711,44967,2744,5.8
"56021",56,21,2013,48587,46258,2329,4.8
"56021",56,21,2014,48762,46656,2106,4.3
"56021",56,21,2015,48727,46788,1939,4
"56021",56,21,2016,48874,46866,2008,4.1
"56021",56,21,2017,48162,46383,1779,3.7
"56023",56,23,1990,5776,5411,365,6.3
"56023",56,23,1991,6027,5586,441,7.3
"56023",56,23,1992,6323,5819,504,8
"56023",56,23,1993,6175,5695,480,7.8
"56023",56,23,1994,6238,5791,447,7.2
"56023",56,23,1995,6379,5909,470,7.4
"56023",56,23,1996,6413,5989,424,6.6
"56023",56,23,1997,6293,5908,385,6.1
"56023",56,23,1998,6306,5918,388,6.2
"56023",56,23,1999,6627,6240,387,5.8
"56023",56,23,2000,7355,7065,290,3.9
"56023",56,23,2001,7544,7248,296,3.9
"56023",56,23,2002,7488,7147,341,4.6
"56023",56,23,2003,8370,8004,366,4.4
"56023",56,23,2004,8021,7707,314,3.9
"56023",56,23,2005,7807,7491,316,4
"56023",56,23,2006,8143,7860,283,3.5
"56023",56,23,2007,8892,8668,224,2.5
"56023",56,23,2008,8377,8081,296,3.5
"56023",56,23,2009,8416,7757,659,7.8
"56023",56,23,2010,8675,7947,728,8.4
"56023",56,23,2011,8740,8054,686,7.8
"56023",56,23,2012,8274,7685,589,7.1
"56023",56,23,2013,8165,7697,468,5.7
"56023",56,23,2014,8235,7812,423,5.1
"56023",56,23,2015,8431,8032,399,4.7
"56023",56,23,2016,8737,8331,406,4.6
"56023",56,23,2017,8727,8402,325,3.7
"56025",56,25,1990,31885,29944,1941,6.1
"56025",56,25,1991,31602,29596,2006,6.3
"56025",56,25,1992,31202,28921,2281,7.3
"56025",56,25,1993,31802,29499,2303,7.2
"56025",56,25,1994,32116,30129,1987,6.2
"56025",56,25,1995,32760,30898,1862,5.7
"56025",56,25,1996,32643,30596,2047,6.3
"56025",56,25,1997,32698,30865,1833,5.6
"56025",56,25,1998,33097,31341,1756,5.3
"56025",56,25,1999,33822,32066,1756,5.2
"56025",56,25,2000,36524,35070,1454,4
"56025",56,25,2001,37097,35721,1376,3.7
"56025",56,25,2002,37441,35925,1516,4
"56025",56,25,2003,38266,36617,1649,4.3
"56025",56,25,2004,38893,37474,1419,3.6
"56025",56,25,2005,39124,37778,1346,3.4
"56025",56,25,2006,39770,38585,1185,3
"56025",56,25,2007,39943,38905,1038,2.6
"56025",56,25,2008,40688,39546,1142,2.8
"56025",56,25,2009,41258,38548,2710,6.6
"56025",56,25,2010,39894,37110,2784,7
"56025",56,25,2011,41123,38628,2495,6.1
"56025",56,25,2012,42388,40242,2146,5.1
"56025",56,25,2013,43105,41150,1955,4.5
"56025",56,25,2014,43355,41612,1743,4
"56025",56,25,2015,42934,40821,2113,4.9
"56025",56,25,2016,41054,38155,2899,7.1
"56025",56,25,2017,39569,37467,2102,5.3
"56027",56,27,1990,1181,1137,44,3.7
"56027",56,27,1991,1170,1122,48,4.1
"56027",56,27,1992,1153,1098,55,4.8
"56027",56,27,1993,1134,1094,40,3.5
"56027",56,27,1994,1181,1153,28,2.4
"56027",56,27,1995,1235,1207,28,2.3
"56027",56,27,1996,1291,1262,29,2.2
"56027",56,27,1997,1214,1190,24,2
"56027",56,27,1998,1279,1244,35,2.7
"56027",56,27,1999,1330,1294,36,2.7
"56027",56,27,2000,1235,1189,46,3.7
"56027",56,27,2001,1215,1167,48,4
"56027",56,27,2002,1150,1098,52,4.5
"56027",56,27,2003,1149,1096,53,4.6
"56027",56,27,2004,1132,1089,43,3.8
"56027",56,27,2005,1116,1073,43,3.9
"56027",56,27,2006,1129,1092,37,3.3
"56027",56,27,2007,1190,1154,36,3
"56027",56,27,2008,1235,1193,42,3.4
"56027",56,27,2009,1299,1234,65,5
"56027",56,27,2010,1387,1323,64,4.6
"56027",56,27,2011,1395,1337,58,4.2
"56027",56,27,2012,1381,1328,53,3.8
"56027",56,27,2013,1381,1332,49,3.5
"56027",56,27,2014,1351,1306,45,3.3
"56027",56,27,2015,1330,1290,40,3
"56027",56,27,2016,1340,1297,43,3.2
"56027",56,27,2017,1319,1283,36,2.7
"56029",56,29,1990,13054,12442,612,4.7
"56029",56,29,1991,13120,12536,584,4.5
"56029",56,29,1992,13332,12764,568,4.3
"56029",56,29,1993,13690,13140,550,4
"56029",56,29,1994,14534,13946,588,4
"56029",56,29,1995,15239,14607,632,4.1
"56029",56,29,1996,15153,14508,645,4.3
"56029",56,29,1997,14945,14277,668,4.5
"56029",56,29,1998,15175,14488,687,4.5
"56029",56,29,1999,15401,14725,676,4.4
"56029",56,29,2000,14379,13789,590,4.1
"56029",56,29,2001,14340,13737,603,4.2
"56029",56,29,2002,14284,13650,634,4.4
"56029",56,29,2003,14609,13961,648,4.4
"56029",56,29,2004,14523,13935,588,4
"56029",56,29,2005,14379,13808,571,4
"56029",56,29,2006,14123,13618,505,3.6
"56029",56,29,2007,14091,13648,443,3.1
"56029",56,29,2008,14437,13927,510,3.5
"56029",56,29,2009,14910,13989,921,6.2
"56029",56,29,2010,15849,14876,973,6.1
"56029",56,29,2011,16094,15164,930,5.8
"56029",56,29,2012,16262,15360,902,5.5
"56029",56,29,2013,15864,15056,808,5.1
"56029",56,29,2014,15747,15046,701,4.5
"56029",56,29,2015,15801,15119,682,4.3
"56029",56,29,2016,15954,15208,746,4.7
"56029",56,29,2017,15688,15024,664,4.2
"56031",56,31,1990,3865,3669,196,5.1
"56031",56,31,1991,3813,3618,195,5.1
"56031",56,31,1992,3915,3693,222,5.7
"56031",56,31,1993,3974,3765,209,5.3
"56031",56,31,1994,4079,3876,203,5
"56031",56,31,1995,4200,4020,180,4.3
"56031",56,31,1996,4251,4087,164,3.9
"56031",56,31,1997,4329,4155,174,4
"56031",56,31,1998,4447,4234,213,4.8
"56031",56,31,1999,4660,4462,198,4.2
"56031",56,31,2000,4353,4174,179,4.1
"56031",56,31,2001,4169,3995,174,4.2
"56031",56,31,2002,4122,3930,192,4.7
"56031",56,31,2003,4078,3872,206,5.1
"56031",56,31,2004,4101,3895,206,5
"56031",56,31,2005,4012,3819,193,4.8
"56031",56,31,2006,3963,3788,175,4.4
"56031",56,31,2007,3913,3757,156,4
"56031",56,31,2008,3945,3785,160,4.1
"56031",56,31,2009,4138,3888,250,6
"56031",56,31,2010,4965,4690,275,5.5
"56031",56,31,2011,4963,4714,249,5
"56031",56,31,2012,4787,4553,234,4.9
"56031",56,31,2013,4804,4593,211,4.4
"56031",56,31,2014,4780,4596,184,3.8
"56031",56,31,2015,4922,4728,194,3.9
"56031",56,31,2016,4781,4554,227,4.7
"56031",56,31,2017,4783,4605,178,3.7
"56033",56,33,1990,12113,11441,672,5.5
"56033",56,33,1991,12125,11384,741,6.1
"56033",56,33,1992,12527,11804,723,5.8
"56033",56,33,1993,13157,12559,598,4.5
"56033",56,33,1994,13354,12710,644,4.8
"56033",56,33,1995,13680,13031,649,4.7
"56033",56,33,1996,13587,12947,640,4.7
"56033",56,33,1997,13490,12816,674,5
"56033",56,33,1998,13608,12919,689,5.1
"56033",56,33,1999,13724,13084,640,4.7
"56033",56,33,2000,14751,14153,598,4.1
"56033",56,33,2001,14648,14071,577,3.9
"56033",56,33,2002,14897,14301,596,4
"56033",56,33,2003,15124,14458,666,4.4
"56033",56,33,2004,15036,14458,578,3.8
"56033",56,33,2005,15048,14481,567,3.8
"56033",56,33,2006,15353,14868,485,3.2
"56033",56,33,2007,15654,15211,443,2.8
"56033",56,33,2008,16061,15566,495,3.1
"56033",56,33,2009,16508,15388,1120,6.8
"56033",56,33,2010,16132,14951,1181,7.3
"56033",56,33,2011,16062,14951,1111,6.9
"56033",56,33,2012,15903,14916,987,6.2
"56033",56,33,2013,15792,14923,869,5.5
"56033",56,33,2014,15903,15168,735,4.6
"56033",56,33,2015,15965,15286,679,4.3
"56033",56,33,2016,16151,15397,754,4.7
"56033",56,33,2017,15791,15164,627,4
"56035",56,35,1990,2663,2590,73,2.7
"56035",56,35,1991,2719,2642,77,2.8
"56035",56,35,1992,2782,2690,92,3.3
"56035",56,35,1993,2841,2742,99,3.5
"56035",56,35,1994,3010,2919,91,3
"56035",56,35,1995,3019,2906,113,3.7
"56035",56,35,1996,3055,2947,108,3.5
"56035",56,35,1997,2979,2896,83,2.8
"56035",56,35,1998,3037,2941,96,3.2
"56035",56,35,1999,3149,3037,112,3.6
"56035",56,35,2000,3559,3452,107,3
"56035",56,35,2001,3749,3651,98,2.6
"56035",56,35,2002,3880,3769,111,2.9
"56035",56,35,2003,4159,4034,125,3
"56035",56,35,2004,4493,4386,107,2.4
"56035",56,35,2005,4975,4873,102,2.1
"56035",56,35,2006,5640,5538,102,1.8
"56035",56,35,2007,6608,6512,96,1.5
"56035",56,35,2008,7015,6901,114,1.6
"56035",56,35,2009,7295,6972,323,4.4
"56035",56,35,2010,5691,5358,333,5.9
"56035",56,35,2011,5902,5632,270,4.6
"56035",56,35,2012,5572,5300,272,4.9
"56035",56,35,2013,5081,4842,239,4.7
"56035",56,35,2014,4872,4664,208,4.3
"56035",56,35,2015,4580,4340,240,5.2
"56035",56,35,2016,4237,3967,270,6.4
"56035",56,35,2017,4252,4066,186,4.4
"56037",56,37,1990,20349,19274,1075,5.3
"56037",56,37,1991,20691,19435,1256,6.1
"56037",56,37,1992,21109,19797,1312,6.2
"56037",56,37,1993,21231,19947,1284,6
"56037",56,37,1994,21792,20676,1116,5.1
"56037",56,37,1995,21711,20561,1150,5.3
"56037",56,37,1996,21092,19787,1305,6.2
"56037",56,37,1997,20767,19606,1161,5.6
"56037",56,37,1998,21093,19975,1118,5.3
"56037",56,37,1999,20664,19433,1231,6
"56037",56,37,2000,20709,19874,835,4
"56037",56,37,2001,20843,20032,811,3.9
"56037",56,37,2002,20176,19350,826,4.1
"56037",56,37,2003,20948,20123,825,3.9
"56037",56,37,2004,21326,20633,693,3.2
"56037",56,37,2005,22002,21360,642,2.9
"56037",56,37,2006,23299,22719,580,2.5
"56037",56,37,2007,23712,23184,528,2.2
"56037",56,37,2008,24273,23697,576,2.4
"56037",56,37,2009,24323,22765,1558,6.4
"56037",56,37,2010,23134,21608,1526,6.6
"56037",56,37,2011,23891,22633,1258,5.3
"56037",56,37,2012,24138,22986,1152,4.8
"56037",56,37,2013,23883,22838,1045,4.4
"56037",56,37,2014,23290,22362,928,4
"56037",56,37,2015,22794,21716,1078,4.7
"56037",56,37,2016,22165,20838,1327,6
"56037",56,37,2017,21581,20599,982,4.6
"56039",56,39,1990,8212,8049,163,2
"56039",56,39,1991,8537,8327,210,2.5
"56039",56,39,1992,8981,8724,257,2.9
"56039",56,39,1993,9534,9300,234,2.5
"56039",56,39,1994,10116,9895,221,2.2
"56039",56,39,1995,10507,10265,242,2.3
"56039",56,39,1996,10604,10313,291,2.7
"56039",56,39,1997,10687,10427,260,2.4
"56039",56,39,1998,11024,10798,226,2.1
"56039",56,39,1999,11675,11424,251,2.1
"56039",56,39,2000,14183,13833,350,2.5
"56039",56,39,2001,14238,13865,373,2.6
"56039",56,39,2002,13791,13378,413,3
"56039",56,39,2003,13709,13233,476,3.5
"56039",56,39,2004,13713,13291,422,3.1
"56039",56,39,2005,13756,13344,412,3
"56039",56,39,2006,13931,13577,354,2.5
"56039",56,39,2007,14375,14058,317,2.2
"56039",56,39,2008,14459,14036,423,2.9
"56039",56,39,2009,13882,12917,965,7
"56039",56,39,2010,13611,12569,1042,7.7
"56039",56,39,2011,13637,12614,1023,7.5
"56039",56,39,2012,13805,12881,924,6.7
"56039",56,39,2013,14107,13318,789,5.6
"56039",56,39,2014,14436,13768,668,4.6
"56039",56,39,2015,14725,14152,573,3.9
"56039",56,39,2016,15270,14748,522,3.4
"56039",56,39,2017,15467,15005,462,3
"56041",56,41,1990,9899,9246,653,6.6
"56041",56,41,1991,10086,9348,738,7.3
"56041",56,41,1992,10252,9394,858,8.4
"56041",56,41,1993,10702,9787,915,8.5
"56041",56,41,1994,10672,9829,843,7.9
"56041",56,41,1995,10917,10182,735,6.7
"56041",56,41,1996,11013,10211,802,7.3
"56041",56,41,1997,10651,10029,622,5.8
"56041",56,41,1998,10742,10141,601,5.6
"56041",56,41,1999,10528,9828,700,6.6
"56041",56,41,2000,10458,10031,427,4.1
"56041",56,41,2001,10776,10375,401,3.7
"56041",56,41,2002,11086,10617,469,4.2
"56041",56,41,2003,10976,10488,488,4.4
"56041",56,41,2004,10642,10240,402,3.8
"56041",56,41,2005,10646,10285,361,3.4
"56041",56,41,2006,10950,10620,330,3
"56041",56,41,2007,11113,10818,295,2.7
"56041",56,41,2008,11512,11179,333,2.9
"56041",56,41,2009,11570,10789,781,6.8
"56041",56,41,2010,10557,9815,742,7
"56041",56,41,2011,10167,9537,630,6.2
"56041",56,41,2012,10263,9689,574,5.6
"56041",56,41,2013,9960,9435,525,5.3
"56041",56,41,2014,9882,9408,474,4.8
"56041",56,41,2015,9695,9208,487,5
"56041",56,41,2016,9437,8895,542,5.7
"56041",56,41,2017,9138,8727,411,4.5
"56043",56,43,1990,4244,4046,198,4.7
"56043",56,43,1991,4281,4082,199,4.6
"56043",56,43,1992,4450,4186,264,5.9
"56043",56,43,1993,4520,4208,312,6.9
"56043",56,43,1994,4691,4422,269,5.7
"56043",56,43,1995,4831,4525,306,6.3
"56043",56,43,1996,4863,4594,269,5.5
"56043",56,43,1997,4805,4552,253,5.3
"56043",56,43,1998,4911,4626,285,5.8
"56043",56,43,1999,4891,4588,303,6.2
"56043",56,43,2000,4305,4103,202,4.7
"56043",56,43,2001,4222,4039,183,4.3
"56043",56,43,2002,4158,3949,209,5
"56043",56,43,2003,4233,4046,187,4.4
"56043",56,43,2004,4221,4052,169,4
"56043",56,43,2005,4260,4086,174,4.1
"56043",56,43,2006,4156,4005,151,3.6
"56043",56,43,2007,4194,4048,146,3.5
"56043",56,43,2008,4291,4139,152,3.5
"56043",56,43,2009,4404,4137,267,6.1
"56043",56,43,2010,4589,4318,271,5.9
"56043",56,43,2011,4591,4335,256,5.6
"56043",56,43,2012,4487,4254,233,5.2
"56043",56,43,2013,4362,4146,216,5
"56043",56,43,2014,4276,4091,185,4.3
"56043",56,43,2015,4277,4097,180,4.2
"56043",56,43,2016,4219,4021,198,4.7
"56043",56,43,2017,4115,3947,168,4.1
"56045",56,45,1990,3324,3177,147,4.4
"56045",56,45,1991,3194,3045,149,4.7
"56045",56,45,1992,3212,3027,185,5.8
"56045",56,45,1993,3208,3046,162,5
"56045",56,45,1994,3306,3127,179,5.4
"56045",56,45,1995,3374,3210,164,4.9
"56045",56,45,1996,3322,3150,172,5.2
"56045",56,45,1997,3246,3075,171,5.3
"56045",56,45,1998,3259,3104,155,4.8
"56045",56,45,1999,3367,3190,177,5.3
"56045",56,45,2000,3299,3156,143,4.3
"56045",56,45,2001,3313,3175,138,4.2
"56045",56,45,2002,3311,3178,133,4
"56045",56,45,2003,3186,3043,143,4.5
"56045",56,45,2004,3139,3014,125,4
"56045",56,45,2005,3165,3039,126,4
"56045",56,45,2006,3054,2947,107,3.5
"56045",56,45,2007,3159,3059,100,3.2
"56045",56,45,2008,3225,3122,103,3.2
"56045",56,45,2009,3313,3107,206,6.2
"56045",56,45,2010,4016,3822,194,4.8
"56045",56,45,2011,3966,3785,181,4.6
"56045",56,45,2012,3972,3811,161,4.1
"56045",56,45,2013,3956,3814,142,3.6
"56045",56,45,2014,3971,3841,130,3.3
"56045",56,45,2015,3970,3834,136,3.4
"56045",56,45,2016,3965,3769,196,4.9
"56045",56,45,2017,3771,3621,150,4
